AccountNumber,TaxMap,GPIN,LUC,Total Land,Land Unit Type,CurYr_LandMarketValue,CurYr_LandUseValue,CurYr_AgricultCredit,CurYr_BuildingValue,CurYr_SFYIValue,CurYr_MarketValue,PrevYr_LandMarketValue,PrevYr_LandUseValue,PrevYr_agricultCredit,PrevYr_BuildingValue,PrevYr_SFYIValue,PrevYr_MarketValue,Description,Full description,,,
102,31-1-0-103-B,6778-02-8104,SNGL FAM SUB,18.17,AC,216700,0,216700,501400,6700,724800,193200,0,193200,423700,3800,620700,A2,AG/LTD,,,
103,4-1-0-62-0,6813-40-0029,SNGL FAM SUB,6.25,AC,66500,0,66500,114000,15600,196100,65300,0,65300,100500,15600,181400,A1,AG/GEN,,,
104,64-12-A-8-0,7724-50-5388,SNGL FAM SUB,0,AC,77000,0,77000,216900,16200,310100,67000,0,67000,190700,14400,272100,R1,RES/LTD,,,
106,57-11-0-3-A,7715-17-3653,SNGL FAM SUB,0.97,AC,13000,0,13000,0,0,13000,11300,0,11300,0,0,11300,A2,AG/LTD,,,
107,57-11-0-4-0,7715-07-9260,AG 20-100 AC,34.024,AC,1080700,1064400,16300,0,4500,1085200,939100,924600,14500,0,4500,943600,A2,AG/LTD,,,
12,62-18-0-7-0,7704-64-9459,SNGL FAM SUB,3.19,AC,223500,0,223500,517900,5300,746700,200300,0,200300,458200,4700,663200,A2,AG/LTD,,,
13,5-1-0-36-E,6823-08-3444,SNGL FAM SUB,3.73,AC,59000,0,59000,87900,4700,151600,57900,0,57900,74300,2900,135100,A1,AG/GEN,,,
14,5-1-0-60-A,6823-62-3321,SNGL FAM SUB,13.53,AC,108600,0,108600,0,0,108600,107900,0,107900,0,0,107900,A1,AG/GEN,,,
15,5-17-0-1-0,6823-64-8417,SNGL FAM SUB,3.465,AC,52300,50600,1700,0,0,52300,51300,49800,1500,0,0,51300,A1,AG/GEN,,,
16,5-17-0-2-0,6823-64-9264,SNGL FAM SUB,3.55,AC,52700,51000,1700,0,0,52700,51800,50300,1500,0,0,51800,A1,AG/GEN,,,
17,5-17-0-3-0,6823-74-0082,SNGL FAM SUB,3.12,AC,50500,49000,1500,0,0,50500,49600,48200,1400,0,0,49600,A1,AG/GEN,,,
18,5-17-0-4-0,6823-73-2713,SNGL FAM SUB,6,AC,75000,72000,3000,0,0,75000,73700,71100,2600,0,0,73700,A1,AG/GEN,,,
19,5-17-0-5-0,6823-63-4594,SNGL FAM SUB,8.19,AC,79300,75500,3800,0,0,79300,77200,73700,3500,0,0,77200,A1,AG/GEN,,,
20,6-1-0-49-A,6832-18-4367,SNGL FAM SUB,3.3,AC,59100,0,59100,252700,0,311800,57400,0,57400,224400,0,281800,A1,AG/GEN,,,
21,7-4-0-A-0,6843-20-9666,SNGL FAM SUB,6.01,AC,69400,0,69400,341700,25900,437000,67500,0,67500,303200,26600,397300,A1,AG/GEN,,,
22,7-4-0-B-0,6843-30-0243,SNGL FAM SUB,4.04,AC,65100,0,65100,154500,42300,261900,63300,0,63300,133900,35500,232700,A1,AG/GEN,,,
23,7-4-0-C-0,6843-30-3382,SNGL FAM SUB,4.65,AC,70100,0,70100,152300,2000,224400,68200,0,68200,135300,2000,205500,A1,AG/GEN,,,
24,7-4-0-D-0,6843-20-7243,SNGL FAM SUB,0.29,AC,1800,0,1800,0,0,1800,1700,0,1700,0,0,1700,A1,AG/GEN,,,
25,9-7-0-B-1,6802-13-7560,SNGL FAM SUB,18.226,AC,82800,36100,46700,83500,1200,167500,82000,27200,54800,72400,1200,155600,A1,AG/GEN,,,
27,12-1-0-61-B,6832-60-7775,SNGL FAM SUB,2.14,AC,49600,0,49600,240900,38700,329200,48100,0,48100,209800,35700,293600,A1,AG/GEN,,,
28,12-1-0-71-B,6831-42-4512,SNGL FAM SUB,2,AC,51800,0,51800,0,0,51800,51500,0,51500,0,0,51500,A1,AG/GEN,,,
29,12-2-0-3-A,6821-93-5994,SNGL FAM SUB,2.625,AC,51700,0,51700,153100,500,205300,52200,0,52200,127300,500,180000,A1,AG/GEN,,,
30,12-23-0-A-0,6831-05-8560,SNGL FAM SUB,5.03,AC,67300,0,67300,0,0,67300,66900,0,66900,0,0,66900,A1,AG/GEN,,,
31,12-23-0-B-0,6831-05-8795,SNGL FAM SUB,5.3,AC,69000,0,69000,263000,3000,335000,68700,0,68700,220000,3000,291700,A1,AG/GEN,,,
32,12-23-0-C-0,6831-05-9917,SNGL FAM SUB,5.61,AC,71000,0,71000,0,0,71000,70800,0,70800,0,0,70800,A1,AG/GEN,,,
33,12-23-0-D-T,6831-06-9286,SNGL FAM SUB,7.83,AC,178600,75100,103500,0,12000,190600,85900,82500,3400,0,0,85900,A1,AG/GEN,,,
34,16-1-0-73-A,5890-72-3492,SNGL FAM SUB,2.92,AC,45700,0,45700,224700,0,270400,44700,0,44700,201900,0,246600,A1,AG/GEN,,,
35,16-1-0-73-B,5890-72-7246,SNGL FAM SUB,2.47,AC,44100,0,44100,238200,18400,300700,43100,0,43100,202200,15600,260900,A1,AG/GEN,,,
36,16-6-0-1-0,6800-20-9504,SNGL FAM SUB,10,AC,89200,0,89200,0,0,89200,83000,0,83000,0,0,83000,A1,AG/GEN,,,
37,16-6-0-2-0,6800-20-6748,SNGL FAM SUB,10,AC,89200,0,89200,333500,0,422700,83000,0,83000,280800,0,363800,A1,AG/GEN,,,
38,16-6-0-3-0,6800-21-3065,SNGL FAM SUB,10,AC,89200,0,89200,468400,0,557600,83000,0,83000,418600,0,501600,A1,AG/GEN,,,
39,16-6-0-4-0,6800-21-0264,SNGL FAM SUB,10,AC,89200,0,89200,0,0,89200,83000,0,83000,0,0,83000,A1,AG/GEN,,,
40,16-6-0-5-0,6800-11-7398,SNGL FAM SUB,6.72,AC,70800,67700,3100,0,0,70800,66600,63700,2900,0,0,66600,A1,AG/GEN,,,
41,16-6-0-6-0,6800-11-5526,SNGL FAM SUB,10,AC,89200,0,89200,379800,0,469000,83000,0,83000,343600,0,426600,A1,AG/GEN,,,
42,16-6-0-7-0,6800-10-1412,AG 20-100 AC,50,AC,176400,67000,109400,305400,37600,519400,176000,68200,107800,267200,35300,478500,A1,AG/GEN,,,
43,16-6-0-8-0,6709-09-6731,AG 20-100 AC,25,AC,82200,55500,26700,0,0,82200,81500,55500,26000,0,0,81500,A1,AG/GEN,,,
44,16-6-0-9-0,6709-29-2302,AG 20-100 AC,50,AC,193100,0,193100,418000,86300,697400,192600,0,192600,378500,80000,651100,A1,AG/GEN,,,
45,16-6-0-9-A,6709-28-5607,Cemetery,0.03,AC,100,0,100,0,0,100,100,0,100,0,0,100,A1,AG/GEN,,,
46,16-6-0-10-0,6709-28-0034,AG 20-100 AC,30,AC,105800,92000,13800,0,0,105800,105000,92200,12800,0,0,105000,A1,AG/GEN,,,
47,16-6-0-11-0,6709-08-8493,AG 20-100 AC,22.2,AC,104200,64500,39700,440400,28800,573400,101600,53900,47700,396300,26600,524500,A1,AG/GEN,,,
48,16-6-0-12-0,5799-99-6128,AG 20-100 AC,63.63,AC,184900,155600,29300,0,0,184900,182800,155800,27000,0,0,182800,A1,AG/GEN,,,
49,18-1-0-64-C,6820-65-2555,SNGL FAM SUB,5.43,AC,65700,0,65700,202800,0,268500,64600,0,64600,165800,0,230400,A1,AG/GEN,,,
50,18-4-0-4-K,6820-11-7221,SNGL FAM SUB,6.393,AC,70700,0,70700,85500,800,157000,67700,0,67700,69500,800,138000,A1,AG/GEN,,,
51,18-4-0-4-L,6820-11-3849,SNGL FAM SUB,8.32,AC,80400,0,80400,40600,6000,127000,78300,0,78300,34300,6000,118600,A1,AG/GEN,,,
52,19-1-0-47-A,6830-89-6953,SNGL FAM SUB,4.51,AC,80300,0,80300,206100,0,286400,73000,0,73000,169400,0,242400,A1,AG/GEN,,,
53,19-1-0-58-A,6830-82-8542,SNGL FAM SUB,1.5,AC,58900,0,58900,138700,1200,198800,55100,0,55100,118100,1200,174400,A1,AG/GEN,,,
56,20-1-0-51-A,6841-70-9216,SNGL FAM SUB,1.5,AC,13000,0,13000,0,0,13000,12800,0,12800,0,0,12800,A1,AG/GEN,,,
58,20-15-0-1-0,6840-35-8516,SNGL FAM SUB,2,AC,56800,0,56800,131100,3700,191600,54100,0,54100,108100,3700,165900,A1,AG/GEN,,,
59,20-15-0-2-0,6840-45-0405,SNGL FAM SUB,2,AC,56800,0,56800,213600,1500,271900,54100,0,54100,176600,1500,232200,A1,AG/GEN,,,
60,20-15-0-3-0,6840-45-2360,SNGL FAM SUB,2.08,AC,57600,0,57600,188500,2000,248100,54900,0,54900,157200,2000,214100,A1,AG/GEN,,,
70,22-1-0-2-D,6769-58-4902,SNGL FAM SUB,1.8,AC,70900,0,70900,0,0,70900,64700,0,64700,0,0,64700,A2,AG/LTD,,,
71,25-1-0-16-0,6709-11-6109,AG > 100 AC,112.515,AC,225000,171800,53200,0,1000,226000,225000,177000,48000,0,1000,226000,A1,AG/GEN,,,
72,25-1-0-17-0,6709-22-9670,AG 20-100 AC,50,AC,96900,73200,23700,0,0,96900,95000,73700,21300,0,0,95000,A1,AG/GEN,,,
73,27-1-0-66-A,6728-38-3674,SNGL FAM SUB,3.79,AC,57200,0,57200,216700,900,274800,56100,0,56100,197700,900,254700,A1,AG/GEN,,,
75,29-20-0-1-0,6749-53-7948,SNGL FAM SUB,3.29,AC,67100,0,67100,125700,500,193300,62600,0,62600,98700,500,161800,A1,AG/GEN,,,
76,29-20-0-2-0,6749-54-9127,SNGL FAM SUB,1.64,AC,53400,0,53400,100100,800,154300,50700,0,50700,82600,800,134100,A1,AG/GEN,,,
77,29-20-0-3-0,6749-63-0993,SNGL FAM SUB,2.03,AC,57300,0,57300,163900,400,221600,52700,0,52700,139700,400,192800,A1,AG/GEN,,,
78,29-20-0-4-0,6749-63-2896,SNGL FAM SUB,1.87,AC,55700,0,55700,9800,300,65800,51500,0,51500,10200,300,62000,A1,AG/GEN,,,
79,29-20-0-5-0,6749-63-5805,SNGL FAM SUB,1.63,AC,53300,0,53300,181800,800,235900,49600,0,49600,138800,800,189200,A1,AG/GEN,,,
80,29-20-0-6-0,6749-63-7842,SNGL FAM SUB,2.34,AC,63300,0,63300,89500,1100,153900,59200,0,59200,74400,1100,134700,A1,AG/GEN,,,
81,30-1-0-14-A,6759-42-4038,SNGL FAM SUB,2.5,AC,68900,0,68900,167100,2500,238500,65500,0,65500,138700,2500,206700,A2,AG/LTD,,,
82,30-1-0-14-B,6759-42-0014,SNGL FAM SUB,2.16,AC,65600,0,65600,151500,0,217100,62000,0,62000,125300,0,187300,A2,AG/LTD,,,
83,30-1-0-14-C,6759-32-9206,SNGL FAM SUB,5.61,AC,96800,0,96800,150900,28000,275700,90500,0,90500,124700,23300,238500,A1A2,AG GEN/,,,
84,30-1-0-101-B,6769-20-6910,SNGL FAM SUB,2.39,AC,95200,0,95200,245000,3700,343900,91000,0,91000,223500,3700,318200,A2,AG/LTD,,,
85,31-1-0-53-A,6769-86-8512,SNGL FAM SUB,1.81,AC,71000,0,71000,162100,4500,237600,63900,0,63900,134200,4500,202600,A2,AG/LTD,,,
86,31-1-0-53-B,6769-86-6663,SNGL FAM SUB,2.04,AC,73900,0,73900,148600,33000,255500,66400,0,66400,122600,31300,220300,A2,AG/LTD,,,
87,31-21-0-1-0,6769-95-7322,SNGL FAM SUB,2.098,AC,74600,0,74600,165200,22900,262700,68300,0,68300,137100,19600,225000,A2,AG/LTD,,,
88,31-21-0-2-0,6769-95-8666,SNGL FAM SUB,1.85,AC,71500,0,71500,151100,0,222600,65300,0,65300,124900,0,190200,A2,AG/LTD,,,
89,31-21-0-3-0,6779-05-0523,SNGL FAM SUB,1.69,AC,69600,0,69600,170300,2000,241900,63400,0,63400,142300,2000,207700,A2,AG/LTD,,,
90,31-22-0-1-0,6779-44-8971,SNGL FAM SUB,2.454,AC,82300,0,82300,180100,2000,264400,73500,0,73500,146200,2000,221700,A2,AG/LTD,,,
91,31-22-0-2-0,6779-55-0058,SNGL FAM SUB,2.561,AC,83600,0,83600,193800,2500,279900,74700,0,74700,158300,2500,235500,A2,AG/LTD,,,
92,31-22-0-3-0,6779-55-1286,SNGL FAM SUB,2.64,AC,87700,0,87700,150000,1500,239200,78400,0,78400,122700,1500,202600,A2,AG/LTD,,,
93,31-22-0-4-0,6779-54-3646,SNGL FAM SUB,6.148,AC,119700,0,119700,182000,20800,322500,106600,0,106600,149200,18300,274100,A2,AG/LTD,,,
94,31-22-0-5-0,6779-54-6198,SNGL FAM SUB,5.498,AC,112700,0,112700,154500,17400,284600,100400,0,100400,127600,15300,243300,A2,AG/LTD,,,
95,31-22-0-6-0,6779-63-0653,SNGL FAM SUB,5.89,AC,116900,0,116900,322200,3400,442500,104100,0,104100,267700,3500,375300,A2,AG/LTD,,,
96,33-6-0-1-0,6798-34-9785,SNGL FAM SUB,1.519,AC,83900,0,83900,269200,1500,354600,74900,0,74900,219200,1500,295600,RR,RES/RUR,,,
97,33-6-0-2-0,6798-34-6763,SNGL FAM SUB,1.598,AC,85000,0,85000,308200,0,393200,75900,0,75900,249000,0,324900,RR,RES/RUR,,,
98,33-6-0-3-0,6798-34-4456,SNGL FAM SUB,2.519,AC,97700,0,97700,304300,1000,403000,87200,0,87200,259500,1000,347700,RR,RES/RUR,,,
99,33-6-0-4-0,6798-34-4135,SNGL FAM SUB,2.01,AC,90600,0,90600,308000,0,398600,80900,0,80900,256200,0,337100,RR,RES/RUR,,,
101,31-1-0-103-A,6768-91-3979,Roads,1.16,AC,0,0,0,0,0,0,0,0,0,0,0,0,A2,AG/LTD,,,
108,62-11-0-A-0,7714-02-0500,COMM & IND,17.69,AC,1464200,0,1464200,9764900,7400,11236500,1355900,0,1355900,9765100,7400,11128400,M2,INDUS/G,,,
111,62-1-0-9-A,7704-92-2013,COMM & IND,21.586,AC,418600,0,418600,0,0,418600,387500,0,387500,0,0,387500,A2,AG/LTD,,,
112,62-1-0-10-A,7714-03-3194,COMM & IND,1.157,AC,159500,0,159500,0,0,159500,145000,0,145000,0,0,145000,B1,BUS/GEN,,,
113,62-1-0-10-B,7714-02-7976,COMM & IND,6.567,AC,862200,0,862200,693300,276500,1832000,783600,0,783600,671000,236300,1690900,B1,BUS/GEN,,,
114,62-1-0-10-C,7714-13-3152,COMM & IND,1.711,AC,224600,0,224600,0,75200,299800,204200,0,204200,0,70300,274500,B1,BUS/GEN,,,
115,62-1-0-10-D,7714-03-9195,COMM & IND,3.483,AC,457300,0,457300,486800,102700,1046800,415600,0,415600,468800,95000,979400,B1,BUS/GEN,,,
122,57-4-0-2-B,7705-28-7475,SNGL FAM SUB,18.1,AC,618800,0,618800,380100,58500,1057400,538500,0,538500,371300,48100,957900,A2,AG/LTD,,,
123,58-21-A-11-0,7716-33-9881,SNGL FAM SUB,2.365,AC,310000,0,310000,251800,0,561800,285000,0,285000,228900,0,513900,A2,AG/LTD,,,
124,62-1-0-15-0,7714-23-2205,COMM & IND,1.6,AC,148600,0,148600,163600,1000,313200,135300,0,135300,139100,700,275100,A2,AG/LTD,,,
128,45-1-0-4-0,6798-00-4488,SNGL FAM SUB,1.825,AC,82000,0,82000,115600,8900,206500,73200,0,73200,94300,8900,176400,A2,AG/LTD,,,
129,45-1-0-5-0,6798-00-6349,SNGL FAM SUB,1.363,AC,75100,0,75100,0,1200,76300,67100,0,67100,0,1200,68300,A2,AG/LTD,,,
130,58-3-A-23-0,7726-26-5724,SNGL FAM SUB,0,AC,88000,0,88000,168200,200,256400,80000,0,80000,139400,200,219600,RN,RESIDEN,,,
131,62-4-C-15-0,7714-04-3826,SNGL FAM SUB,0,AC,115000,0,115000,243900,0,358900,100000,0,100000,223700,0,323700,R1,RES/LTD,,,
132,2-3-0-33-0,6824-32-2359,SNGL FAM SUB,3.45,AC,48800,0,48800,134800,4500,188100,47700,0,47700,119200,4500,171400,A1,AG/GEN,,,
133,32-1-0-17-0,6779-83-1564,SNGL FAM SUB,4,AC,107300,0,107300,426100,0,533400,95900,0,95900,352500,0,448400,A2,AG/LTD,,,
134,58-1-0-98-0,7726-21-2984,SNGL FAM SUB,5.16,AC,172700,0,172700,170800,12700,356200,150200,0,150200,145500,10000,305700,A2,AG/LTD,,,
135,58-1-0-99-0,7726-22-0115,SNGL FAM SUB,0.84,AC,16300,0,16300,0,0,16300,14100,0,14100,0,0,14100,A2,AG/LTD,,,
137,28-9-0-3-0,6729-83-7936,SNGL FAM SUB,2.232,AC,56200,0,56200,141700,32100,230000,53700,0,53700,116800,29200,199700,A1,AG/GEN,,,
138,58-3-A-8-0,7726-16-5631,SNGL FAM SUB,0.0001,AC,88000,0,88000,140600,15700,244300,80000,0,80000,116700,12100,208800,RN,RESIDEN,,,
139,58-1-0-20-0,7716-44-8741,AG 20-100 AC,25,AC,686000,438200,247800,553900,81000,1320900,595700,380000,215700,468500,75200,1139400,A2,AG/LTD,,,
140,58-1-0-23-0,7716-54-3491,SNGL FAM SUB,14.25,AC,634100,627200,6900,0,3000,637100,356700,350600,6100,0,3000,359700,A2,AG/LTD,,,
141,58-4-G-9-0,7716-55-4399,SNGL FAM SUB,0,AC,5000,0,5000,0,0,5000,4600,0,4600,0,0,4600,A2,AG/LTD,,,
143,58-4-G-8-0,7716-55-4422,SNGL FAM SUB,0,AC,5000,0,5000,0,0,5000,4600,0,4600,0,0,4600,A2,AG/LTD,,,
144,58-1-0-13-0,7716-26-9394,SNGL FAM SUB,3.3,AC,128200,0,128200,0,0,128200,119000,0,119000,0,0,119000,A2,AG/LTD,,,
145,58-4-A-21-A,7716-46-8828,SNGL FAM SUB,0,AC,5000,0,5000,0,0,5000,4600,0,4600,0,0,4600,A2,AG/LTD,,,
146,58-4-C-15-0,7716-56-2682,SNGL FAM SUB,0,AC,10000,0,10000,0,0,10000,9100,0,9100,0,0,9100,A2,AG/LTD,,,
147,58-4-C-16-0,7716-56-2601,SNGL FAM SUB,0,AC,10000,0,10000,0,0,10000,9100,0,9100,0,0,9100,A2,AG/LTD,,,
148,58-4-D-5-A,7716-56-4404,SNGL FAM SUB,0,AC,5000,0,5000,0,0,5000,4600,0,4600,0,0,4600,A2,AG/LTD,,,
149,58-4-E-14-0,7716-55-5967,SNGL FAM SUB,0,AC,10000,0,10000,0,0,10000,9100,0,9100,0,0,9100,A2,AG/LTD,,,
150,58-4-F-9-0,7716-55-6772,SNGL FAM SUB,2.702,AC,162800,0,162800,0,0,162800,104000,0,104000,0,0,104000,A2,AG/LTD,,,
151,58-4-G-5-0,7716-55-2505,SNGL FAM SUB,0,AC,10000,0,10000,0,0,10000,9100,0,9100,0,0,9100,A2,AG/LTD,,,
152,58-4-G-7-0,7716-55-3475,SNGL FAM SUB,0,AC,10000,0,10000,0,0,10000,9100,0,9100,0,0,9100,A2,AG/LTD,,,
153,58-4-G-8-A,7716-55-4451,SNGL FAM SUB,0,AC,5000,0,5000,0,0,5000,4600,0,4600,0,0,4600,A2,AG/LTD,,,
154,58-4-G-9-A,7716-55-5327,SNGL FAM SUB,0,AC,5000,0,5000,0,0,5000,4600,0,4600,0,0,4600,A2,AG/LTD,,,
155,58-4-G-13-0,7716-55-8298,SNGL FAM SUB,0,AC,20100,0,20100,0,0,20100,18300,0,18300,0,0,18300,A2,AG/LTD,,,
157,58-4-B-12-0,7716-45-9930,SNGL FAM SUB,0,AC,10000,0,10000,0,0,10000,9100,0,9100,0,0,9100,A2,AG/LTD,,,
158,58-4-E-15-0,7716-55-4996,SNGL FAM SUB,0,AC,10000,0,10000,0,0,10000,9100,0,9100,0,0,9100,A2,AG/LTD,,,
159,58-4-E-16-0,7716-55-4915,SNGL FAM SUB,0,AC,10000,0,10000,0,0,10000,9100,0,9100,0,0,9100,A2,AG/LTD,,,
160,58-4-E-17-0,7716-55-3934,SNGL FAM SUB,0,AC,10000,0,10000,0,0,10000,9100,0,9100,0,0,9100,A2,AG/LTD,,,
161,58-4-E-18-0,7716-55-2930,SNGL FAM SUB,0,AC,10000,0,10000,0,0,10000,9100,0,9100,0,0,9100,A2,AG/LTD,,,
162,58-4-E-19-0,7716-55-1923,SNGL FAM SUB,0,AC,10000,0,10000,0,0,10000,9100,0,9100,0,0,9100,A2,AG/LTD,,,
163,58-4-F-1-0,7716-55-3724,SNGL FAM SUB,0,AC,10000,0,10000,0,0,10000,9100,0,9100,0,0,9100,A2,AG/LTD,,,
164,58-4-F-2-0,7716-55-3797,SNGL FAM SUB,0,AC,10000,0,10000,0,0,10000,9100,0,9100,0,0,9100,A2,AG/LTD,,,
165,58-4-F-3-0,7716-55-4776,SNGL FAM SUB,0,AC,10000,0,10000,0,0,10000,9100,0,9100,0,0,9100,A2,AG/LTD,,,
168,58-4-F-10-0,7716-55-7582,SNGL FAM SUB,1.547,AC,162800,0,162800,0,0,162800,104000,0,104000,0,0,104000,A2,AG/LTD,,,
176,58-4-F-18-0,7716-55-3687,SNGL FAM SUB,0,AC,10000,0,10000,0,0,10000,9100,0,9100,0,0,9100,A2,AG/LTD,,,
177,58-4-G-1-0,7716-45-9629,SNGL FAM SUB,0,AC,10000,0,10000,0,0,10000,9100,0,9100,0,0,9100,A2,AG/LTD,,,
178,58-4-G-2-0,7716-55-0702,SNGL FAM SUB,0,AC,10000,0,10000,0,0,10000,9100,0,9100,0,0,9100,A2,AG/LTD,,,
179,58-4-G-3-0,7716-55-0790,SNGL FAM SUB,0,AC,10000,0,10000,0,0,10000,9100,0,9100,0,0,9100,A2,AG/LTD,,,
180,58-4-G-4-0,7716-55-1621,SNGL FAM SUB,0,AC,10000,0,10000,0,0,10000,9100,0,9100,0,0,9100,A2,AG/LTD,,,
181,58-4-G-6-0,7716-55-2499,SNGL FAM SUB,0,AC,10000,0,10000,0,0,10000,9100,0,9100,0,0,9100,A2,AG/LTD,,,
182,58-4-G-10-0,7716-55-5384,SNGL FAM SUB,0,AC,10000,0,10000,0,0,10000,9100,0,9100,0,0,9100,A2,AG/LTD,,,
183,4-2-0-9-0,6813-19-6953,SNGL FAM SUB,3.66,AC,58100,0,58100,224100,7000,289200,57000,0,57000,191300,7000,255300,A1,AG/GEN,,,
184,2-3-0-17-0,6824-13-7358,SNGL FAM SUB,6.28,AC,61800,0,61800,195200,300,257300,60500,0,60500,167600,300,228400,A1,AG/GEN,,,
185,4-2-0-27-0,6813-39-9713,SNGL FAM SUB,3.45,AC,52700,0,52700,244500,1500,298700,51600,0,51600,205700,1100,258400,A1,AG/GEN,,,
186,4-3-0-10-0,6813-04-2171,SNGL FAM SUB,3.33,AC,52100,0,52100,90000,3000,145100,51000,0,51000,76700,2100,129800,A1,AG/GEN,,,
187,4-3-0-13-0,6803-93-6426,SNGL FAM SUB,3.42,AC,52500,0,52500,262500,3400,318400,51400,0,51400,220400,3400,275200,A1,AG/GEN,,,
188,5-3-0-10-0,6823-18-3952,SNGL FAM SUB,1.18,AC,45100,0,45100,151300,35300,231700,44200,0,44200,126800,29100,200100,A1,AG/GEN,,,
189,46-13-0-9-0,7717-06-5635,SNGL FAM SUB,5,AC,160400,0,160400,295000,2800,458200,143300,0,143300,255700,2800,401800,A2,AG/LTD,,,
191,14-2-0-7-A,6851-36-7025,SNGL FAM SUB,3.72,AC,70200,0,70200,102200,1200,173600,68800,0,68800,89200,1300,159300,A1,AG/GEN,,,
192,10-1-0-15-A,6801-43-1675,SNGL FAM SUB,1,AC,38800,0,38800,74700,18600,132100,38000,0,38000,65600,15800,119400,A1,AG/GEN,,,
193,57-10-0-24-0,7705-77-7031,SNGL FAM SUB,6.89,AC,265000,0,265000,735000,31300,1031300,240000,0,240000,671600,26900,938500,A2,AG/LTD,,,
194,32-1-0-51-C,6778-93-1149,SNGL FAM SUB,16.38,AC,230200,222200,8000,0,0,230200,204800,197800,7000,0,0,204800,A2,AG/LTD,,,
195,32-1-0-51-A,6778-93-8768,SNGL FAM SUB,9.98,AC,166500,0,166500,184100,21100,371700,148800,0,148800,149400,18100,316300,A2,AG/LTD,,,
196,27-1-0-68-0,6728-47-5854,SNGL FAM SUB,0.833,AC,16200,0,16200,0,0,16200,15800,0,15800,0,0,15800,A1,AG/GEN,,,
197,57-10-0-5-0,7705-76-5270,SNGL FAM SUB,6.237,AC,265000,0,265000,417100,55200,737300,240000,0,240000,379600,51600,671200,A2,AG/LTD,,,
198,55-1-0-13-A,6776-82-6259,SNGL FAM SUB,1.5,AC,77700,0,77700,175800,0,253500,69400,0,69400,146200,0,215600,A2,AG/LTD,,,
199,14-2-0-5-A,6851-35-4976,SNGL FAM SUB,7.37,AC,84300,0,84300,169700,8300,262300,82700,0,82700,137000,17200,236900,A1,AG/GEN,,,
200,47-1-0-103-0,7727-36-8466,SNGL FAM SUB,1.14,AC,102900,0,102900,115700,10200,228800,91900,0,91900,96400,9000,197300,A2,AG/LTD,,,
203,63-1-0-67-0,7714-23-6900,SNGL FAM SUB,2.11,AC,204400,0,204400,252200,22600,479200,177800,0,177800,216300,19800,413900,R3,RES/GEN,,,
204,63-1-0-104-A,7715-41-7276,SNGL FAM SUB,3.5,AC,132300,0,132300,0,0,132300,115000,0,115000,0,0,115000,A2,AG/LTD,,,
205,10-6-0-A-4,6801-54-3088,SNGL FAM SUB,13.43,AC,98000,21500,76500,302100,36200,436300,97200,19300,77900,263200,35500,395900,A1,AG/GEN,,,
206,10-9-0-1-0,6801-54-4827,SNGL FAM SUB,5,AC,57200,0,57200,0,0,57200,56000,0,56000,0,0,56000,A1,AG/GEN,,,
207,44-2-0-10-0,6787-73-2894,SNGL FAM SUB,1.62,AC,75200,0,75200,150500,1200,226900,67100,0,67100,114300,1200,182600,A2,AG/LTD,,,
208,44-11-0-C-0,6786-29-5753,SNGL FAM SUB,5.27,AC,111500,0,111500,0,0,111500,99500,0,99500,0,0,99500,A2,AG/LTD,,,
365,16-1-0-28-0,5890-23-9011,SNGL FAM SUB,8,AC,51200,0,51200,0,0,51200,49500,0,49500,0,0,49500,A1,AG/GEN,,,
366,43-6-0-2-B,6767-64-7412,SNGL FAM SUB,1.781,AC,75300,0,75300,161900,0,237200,67300,0,67300,133200,0,200500,A2,AG/LTD,,,
367,43-6-0-7-0,6767-84-0099,SNGL FAM SUB,5.3,AC,80700,0,80700,0,0,80700,71900,0,71900,0,0,71900,A2,AG/LTD,,,
369,5-1-0-39-0,6813-98-9660,SNGL FAM SUB,3.12,AC,50500,0,50500,21000,500,72000,49600,0,49600,18900,500,69000,A1,AG/GEN,,,
370,21-5-0-3-0,6850-52-0759,SNGL FAM SUB,3.5,AC,95000,0,95000,183700,0,278700,85500,0,85500,166600,0,252100,A2,AG/LTD,,,
371,14-1-0-11-0,6851-22-5740,AG > 100 AC,107.77,AC,662000,612300,49700,0,0,662000,649000,603200,45800,0,0,649000,A1,AG/GEN,,,
372,14-1-0-11-A,6851-24-0002,AG > 100 AC,102.74,AC,631100,583700,47400,0,0,631100,618700,575000,43700,0,0,618700,A1,AG/GEN,,,
373,33-1-0-14-0,6798-63-6198,SNGL FAM SUB,2,AC,83900,82900,1000,0,0,83900,74900,74000,900,0,0,74900,A2,AG/LTD,,,
374,33-1-0-15-0,6798-72-6637,AG 20-100 AC,74.72,AC,1018700,981500,37200,0,0,1018700,908700,876600,32100,0,0,908700,A2,AG/LTD,,,
375,45-1-0-1-B,6788-81-3460,COMM & IND,0.598,AC,60000,59700,300,0,0,60000,55600,55300,300,0,0,55600,A2,AG/LTD,,,
527,38-1-0-101-0,6707-98-0441,SNGL FAM SUB,5,AC,61200,0,61200,56000,1100,118300,60000,0,60000,49700,900,110600,A1,AG/GEN,,,
528,33-4-0-3-0,6798-53-4839,SNGL FAM SUB,2.61,AC,98900,0,98900,197300,2200,298400,88300,0,88300,162200,2200,252700,A2,AG/LTD,,,
529,30-11-0-7-0,6758-23-4174,SNGL FAM SUB,4.5,AC,87300,0,87300,247400,19200,353900,84600,0,84600,205000,16600,306200,A2,AG/LTD,,,
530,27-1-0-74-0,6728-47-5330,SNGL FAM SUB,15,AC,117200,0,117200,735200,0,852400,115000,0,115000,614800,0,729800,A1,AG/GEN,,,
531,27-1-0-75-0,6728-46-1497,SNGL FAM SUB,1.06,AC,39200,0,39200,0,0,39200,38400,0,38400,0,0,38400,A1,AG/GEN,,,
676,11-1-0-33-T,6811-72-2433-9999,AG 20-100 AC,30,AC,119700,104400,15300,0,0,119700,120000,107100,12900,0,0,120000,A1,AG/GEN,,,
677,12-1-0-44-0,6831-34-5556,AG 20-100 AC,20.31,AC,98800,89400,9400,0,0,98800,95500,86900,8600,0,0,95500,A1,AG/GEN,,,
678,12-1-0-46-0,6831-28-2233,AG 20-100 AC,44.46,AC,216600,179400,37200,0,0,216600,208100,173100,35000,0,0,208100,A1,AG/GEN,,,
680,13-1-0-52-0,6831-98-1034,AG > 100 AC,129.74,AC,307900,0,307900,0,0,307900,305400,0,305400,0,0,305400,A1,AG/GEN,,,
681,14-1-0-2-0,6852-22-6064,AG 20-100 AC,98.09,AC,251500,206300,45200,0,0,251500,246600,204900,41700,0,0,246600,A1,AG/GEN,,,
682,14-1-0-3-0,6852-41-1020,AG 20-100 AC,63.4,AC,161200,132000,29200,0,0,161200,158100,131200,26900,0,0,158100,A1,AG/GEN,,,
683,17-1-0-28-0,6800-62-8867,AG > 100 AC,245.6,AC,116800,0,116800,0,0,116800,107500,0,107500,0,0,107500,A1,AG/GEN,,,
684,17-1-0-45-0,6810-49-4707,AG 20-100 AC,84.6,AC,212400,169300,43100,0,40600,253000,215700,179300,36400,0,36200,251900,A1,AG/GEN,,,
685,18-1-0-1-0,6811-51-6419,AG 20-100 AC,36.57,AC,176600,159700,16900,0,0,176600,175500,160000,15500,0,0,175500,A1,AG/GEN,,,
686,18-1-0-2-0,6811-95-5561,AG > 100 AC,145.28,AC,354100,283700,70400,0,0,354100,345000,282900,62100,0,0,345000,A1,AG/GEN,,,
687,18-1-0-44-0,6810-84-7499,AG 20-100 AC,75.216,AC,187700,152700,35000,0,0,187700,188000,156000,32000,0,0,188000,A1,AG/GEN,,,
688,18-1-0-55-0,6821-31-2588,AG > 100 AC,504.232,AC,1270700,1029400,241300,0,0,1270700,1210200,995000,215200,0,0,1210200,A1,AG/GEN,,,
689,18-1-0-59-0,6820-48-6458,AG > 100 AC,268.65,AC,744700,609900,134800,0,0,744700,738800,623600,115200,0,0,738800,A1,AG/GEN,,,
690,18-1-0-61-0,6820-15-8652,AG 20-100 AC,91.65,AC,307800,265500,42300,0,0,307800,304700,265700,39000,0,0,304700,A1,AG/GEN,,,
691,18-1-0-63-0,6820-35-0708,AG 20-100 AC,57,AC,179300,153000,26300,0,0,179300,179600,155400,24200,0,0,179600,A1,AG/GEN,,,
852,25-1-0-1-0,5799-53-5999,SNGL FAM SUB,10.497,AC,73000,67900,5100,0,0,73000,71200,66700,4500,0,0,71200,A1,AG/GEN,,,
853,67-2-D-22-0,7723-55-9533,SNGL FAM SUB,0,AC,184000,0,184000,268800,1000,453800,160000,0,160000,230200,1000,391200,R1,RES/LTD,,,
854,25-1-0-2-0,5799-33-5203,AG 20-100 AC,57.54,AC,242300,170800,71500,226100,4600,473000,235900,167600,68300,190600,4600,431100,A1,AG/GEN,,,
855,13-13-0-8-0,6841-92-3433,SNGL FAM SUB,2,AC,58600,0,58600,204800,3500,266900,57500,0,57500,177800,3500,238800,A1,AG/GEN,,,
856,26-1-0-35-N,6708-91-5678,SNGL FAM SUB,3.005,AC,50000,0,50000,163700,57900,271600,49000,0,49000,137900,52900,239800,A1,AG/GEN,,,
209,44-20-0-3-0,6787-42-6745,SNGL FAM SUB,3.61,AC,111300,0,111300,0,0,111300,99400,0,99400,0,0,99400,A2,AG/LTD,,,
210,44-20-0-5-0,6787-42-3969,SNGL FAM SUB,3.05,AC,99300,0,99300,97100,300,196700,88600,0,88600,80900,300,169800,A2,AG/LTD,,,
211,32-2-0-2-0,6778-86-8431,SNGL FAM SUB,19.22,AC,260900,0,260900,0,0,260900,232100,0,232100,0,0,232100,A2,AG/LTD,,,
212,32-2-0-3-A,6778-87-6127,SNGL FAM SUB,3.65,AC,95900,0,95900,0,0,95900,85700,0,85700,0,0,85700,A2,AG/LTD,,,
214,17-1-0-24-0,6709-59-6078,SNGL FAM SUB,1.62,AC,42300,0,42300,235800,0,278100,41400,0,41400,0,0,41400,A1,AG/GEN,,,
215,17-1-0-25-0,6709-59-4142,SNGL FAM SUB,1.127,AC,39500,0,39500,169100,4800,213400,38700,0,38700,146500,4900,190100,A1,AG/GEN,,,
216,17-1-0-25-A,6709-59-1299,SNGL FAM SUB,2.06,AC,44700,0,44700,184200,35600,264500,43800,0,43800,137200,28800,209800,A1,AG/GEN,,,
217,45-1-0-19-A,6797-09-5169,SNGL FAM SUB,1.79,AC,82600,0,82600,257400,41100,381100,73700,0,73700,214600,33900,322200,A2,AG/LTD,,,
218,46-9-0-B-4,7707-77-3653,SNGL FAM SUB,7.344,AC,191800,0,191800,231700,1600,425100,174400,0,174400,192100,1600,368100,A2,AG/LTD,,,
219,26-9-0-A-0,6719-13-5866,SNGL FAM SUB,10.99,AC,70500,0,70500,0,0,70500,69700,0,69700,0,0,69700,A1,AG/GEN,,,
220,26-2-0-2-D,6719-00-2363,SNGL FAM SUB,10.4,AC,91400,0,91400,230200,100,321700,89700,0,89700,202600,100,292400,A1,AG/GEN,,,
221,26-1-0-63-0,6719-13-0638,SNGL FAM SUB,4,AC,57600,0,57600,0,1100,58700,56000,0,56000,0,1100,57100,A1,AG/GEN,,,
222,33-2-0-1-0,6798-06-9672,SNGL FAM SUB,4.417,AC,113300,0,113300,105900,5100,224300,101300,0,101300,86700,5100,193100,A2,AG/LTD,,,
223,63-1-0-132-D,7715-71-1735,SNGL FAM SUB,1,AC,108400,0,108400,0,0,108400,94300,0,94300,0,0,94300,A2,AG/LTD,,,
224,44-1-0-53-0,6787-31-1219,AG 20-100 AC,20,AC,227000,0,227000,0,0,227000,202300,0,202300,0,0,202300,A2,AG/LTD,,,
225,44-1-0-76-0,6787-52-8758,SNGL FAM SUB,1.72,AC,81500,0,81500,241900,1500,324900,72800,0,72800,196800,1500,271100,A2,AG/LTD,,,
227,30-1-0-102-0,6769-30-2137,SNGL FAM SUB,3.484,AC,91000,0,91000,223800,64500,379300,84900,0,84900,161100,58500,304500,A2,AG/LTD,,,
228,44-2-0-4-0,6787-73-8645,SNGL FAM SUB,1.3,AC,74200,0,74200,115400,1000,190600,66300,0,66300,93400,1000,160700,A2,AG/LTD,,,
229,26-1-0-56-0,6719-22-7198,SNGL FAM SUB,4,AC,57100,0,57100,94700,4700,156500,56000,0,56000,81600,4700,142300,A1,AG/GEN,,,
230,26-1-0-55-0,6719-22-5073,SNGL FAM SUB,2.34,AC,47000,41100,5900,0,4300,51300,46000,40400,5600,0,4300,50300,A1,AG/GEN,,,
231,26-1-0-57-0,6719-22-3212,SNGL FAM SUB,6.27,AC,70900,26600,44300,160900,11600,243400,69600,26500,43100,136100,11600,217300,B1A1,BS & AG,,,
232,26-1-0-70-0,6719-36-0045,SNGL FAM SUB,14.49,AC,112200,0,112200,115600,0,227800,112200,0,112200,90400,0,202600,A1,AG/GEN,,,
233,26-1-0-71-0,6719-46-4179,AG 20-100 AC,57.66,AC,265700,0,265700,249700,87300,602700,264600,0,264600,205100,80600,550300,A1,AG/GEN,,,
234,12-1-0-1-A,6822-87-0296,SNGL FAM SUB,1,AC,40300,0,40300,69200,3000,112500,39000,0,39000,68300,3000,110300,A1,AG/GEN,,,
235,55-14-0-8-0,6785-48-1400,SNGL FAM SUB,6.33,AC,147100,0,147100,330400,0,477500,131400,0,131400,272400,0,403800,A2,AG/LTD,,,
236,45-1-0-58-C,6797-08-6501,SNGL FAM SUB,1,AC,70100,0,70100,119900,0,190000,62600,0,62600,92700,0,155300,A2,AG/LTD,,,
237,44-2-0-6-A,6787-74-9172,SNGL FAM SUB,0.67,AC,58700,0,58700,91100,800,150600,52400,0,52400,74000,800,127200,A2,AG/LTD,,,
238,44-20-0-4-0,6787-42-5100,SNGL FAM SUB,6,AC,136100,0,136100,0,0,136100,121600,0,121600,0,0,121600,A2,AG/LTD,,,
239,6-1-0-60-0,6832-59-8472,AG 20-100 AC,46.86,AC,276100,212300,63800,0,3300,279400,270100,209300,60800,0,3100,273200,A1,AG/GEN,,,
240,44-1-0-52-A,6787-32-3380,SNGL FAM SUB,19.418,AC,269600,260600,9000,0,0,269600,241100,232800,8300,0,0,241100,A2,AG/LTD,,,
241,44-1-0-53-A,6787-31-3954,SNGL FAM SUB,6.46,AC,114800,111800,3000,0,0,114800,102700,100000,2700,0,0,102700,A2,AG/LTD,,,
242,44-12-0-A-0,6787-42-1938,SNGL FAM SUB,1.24,AC,73400,0,73400,280100,0,353500,65600,0,65600,233500,0,299100,A2,AG/LTD,,,
243,44-12-0-C-0,6787-42-0686,SNGL FAM SUB,1.29,AC,74100,73500,600,0,0,74100,66200,65700,500,0,0,66200,A2,AG/LTD,,,
244,43-7-0-5-0,6777-09-2456,SNGL FAM SUB,4.136,AC,95800,0,95800,12000,100,107900,85400,0,85400,11800,100,97300,A2,AG/LTD,,,
245,57-1-0-18-0,7706-24-0802,SNGL FAM SUB,11.44,AC,86600,0,86600,0,0,86600,75200,0,75200,0,0,75200,A2,AG/LTD,,,
246,57-1-0-29-0,7706-01-9955,SNGL FAM SUB,2.9,AC,144900,0,144900,52700,300,197900,126000,0,126000,45100,300,171400,A2,AG/LTD,,,
247,30-3-0-B-0,6768-39-2329,SNGL FAM SUB,3.736,AC,94000,0,94000,229700,2000,325700,87900,0,87900,195400,2000,285300,A2,AG/LTD,,,
248,45-1-0-58-0,6797-07-7415,SNGL FAM SUB,14.02,AC,265600,0,265600,0,0,265600,237700,0,237700,0,0,237700,A2,AG/LTD,,,
249,44-1-0-51-0,6787-33-6091,SNGL FAM SUB,2,AC,83900,0,83900,188900,10700,283500,74900,0,74900,159900,6700,241500,A2,AG/LTD,,,
250,57-1-0-32-0,7706-12-0643,SNGL FAM SUB,5,AC,203100,0,203100,655600,0,858700,176700,0,176700,553500,0,730200,A2,AG/LTD,,,
251,26-21-0-4-0,6709-94-2202,SNGL FAM SUB,5.008,AC,63600,0,63600,175400,17900,256900,117200,0,117200,146300,0,263500,RR,RES/RUR,,,
252,27-1-0-50-0,6729-06-0614,SNGL FAM SUB,17.93,AC,108800,0,108800,0,0,108800,105700,0,105700,0,0,105700,A1,AG/GEN,,,
253,29-12-0-2-0,6748-78-1789,SNGL FAM SUB,1,AC,54000,0,54000,0,0,54000,49900,0,49900,0,0,49900,A1,AG/GEN,,,
254,26-9-0-B-1,6719-14-8334,SNGL FAM SUB,4.03,AC,56900,0,56900,166500,21400,244800,55300,0,55300,141400,18600,215300,A1,AG/GEN,,,
255,17-1-0-39-B,6801-61-9682,SNGL FAM SUB,12.28,AC,89000,44400,44600,126100,9800,224900,88800,45900,42900,114100,9800,212700,A1,AG/GEN,,,
256,1-1-0-22-E,6804-66-0609,AG 20-100 AC,28,AC,136700,89900,46800,379700,90200,606600,134200,89500,44700,320300,83100,537600,A1,AG/GEN,,,
257,1-1-0-22-D,6804-77-3029,SNGL FAM SUB,0.425,AC,2200,0,2200,0,0,2200,2100,0,2100,0,0,2100,A1,AG/GEN,,,
258,1-1-0-22-F,6804-67-5664,AG 20-100 AC,20,AC,107800,0,107800,233700,21100,362600,105900,0,105900,204200,19600,329700,A1,AG/GEN,,,
259,55-1-0-45-C,6786-53-2128,SNGL FAM SUB,2.17,AC,89400,0,89400,0,0,89400,79800,0,79800,0,0,79800,A2,AG/LTD,,,
260,57-1-0-28-0,7706-01-9658,SNGL FAM SUB,5.128,AC,203500,0,203500,309300,100,512900,177000,0,177000,272400,100,449500,A2,AG/LTD,,,
261,44-11-0-D-0,6786-29-7245,SNGL FAM SUB,8.85,AC,183100,0,183100,119800,700,303600,163900,0,163900,101800,700,266400,A2,AG/LTD,,,
262,19-1-0-50-F,6830-77-6964,SNGL FAM SUB,11.75,AC,90200,79000,11200,0,0,90200,84000,73600,10400,0,0,84000,A1,AG/GEN,,,
263,18-1-0-6-B,6810-78-4487,AG 20-100 AC,21.258,AC,90300,76800,13500,0,3500,93800,86100,73400,12700,0,0,86100,A1,AG/GEN,,,
264,44-2-0-6-B,6787-74-8019,SNGL FAM SUB,1.03,AC,70600,0,70600,96400,0,167000,63000,0,63000,79300,0,142300,A2,AG/LTD,,,
266,44-1-0-52-0,6787-33-3052,SNGL FAM SUB,2.358,AC,88800,0,88800,102900,300,192000,79300,0,79300,84600,300,164200,A2,AG/LTD,,,
267,44-1-0-52-D,6787-32-6742,SNGL FAM SUB,2.508,AC,90900,0,90900,210800,1500,303200,81100,0,81100,173800,1500,256400,A2,AG/LTD,,,
268,26-1-0-61-0,6719-24-5787,SNGL FAM SUB,2.05,AC,46300,0,46300,123800,0,170100,44300,0,44300,101000,0,145300,A1,AG/GEN,,,
269,30-1-0-115-C,6759-54-8571,SNGL FAM SUB,3,AC,71000,0,71000,75900,6300,153200,63100,0,63100,63500,6300,132900,A2,AG/LTD,,,
270,44-1-0-54-0,6787-32-9358,SNGL FAM SUB,3,AC,94100,92700,1400,0,0,94100,84000,82700,1300,0,0,84000,A2,AG/LTD,,,
272,63-1-0-148-0,7715-70-8064,SNGL FAM SUB,6.33,AC,162900,0,162900,0,8000,170900,141500,0,141500,0,7100,148600,A2,AG/LTD,,,
274,26-1-0-62-0,6719-24-3545,SNGL FAM SUB,6.868,AC,71800,0,71800,105900,2200,179900,71400,0,71400,87000,2200,160600,A1,AG/GEN,,,
275,18-4-0-4-D,6820-10-3494,SNGL FAM SUB,2.851,AC,51100,0,51100,120600,4200,175900,49100,0,49100,100900,3500,153500,A1,AG/GEN,,,
276,47-13-0-C-0,7727-12-6153,SNGL FAM SUB,5.01,AC,213400,0,213400,0,0,213400,190700,0,190700,0,0,190700,A2,AG/LTD,,,
277,58-3-C-5-0,7726-16-9906,SNGL FAM SUB,0,AC,88000,0,88000,221000,200,309200,80000,0,80000,189000,200,269200,RN,RESIDEN,,,
278,44-2-0-5-0,6787-73-7427,SNGL FAM SUB,1.3,AC,74200,0,74200,112300,1500,188000,66300,0,66300,94700,1500,162500,A2,AG/LTD,,,
279,18-8-0-6-0,6820-10-6521,SNGL FAM SUB,2.913,AC,51500,0,51500,162700,19600,233800,49500,0,49500,133400,16600,199500,A1,AG/GEN,,,
280,26-9-0-B-0,6719-23-2567,SNGL FAM SUB,6.94,AC,73900,0,73900,0,0,73900,70700,0,70700,0,0,70700,A1,AG/GEN,,,
281,11-1-0-53-B,6822-33-4779,SNGL FAM SUB,3.13,AC,50600,0,50600,135000,2500,188100,49700,0,49700,121300,2500,173500,A1,AG/GEN,,,
282,43-1-0-79-A,6767-93-1573,SNGL FAM SUB,1.01,AC,70200,0,70200,204800,8900,283900,62700,0,62700,167300,8900,238900,A2,AG/LTD,,,
283,27-7-0-3-0,6718-78-0743,AG 20-100 AC,21.6,AC,124500,0,124500,269600,30800,424900,122000,0,122000,224900,25000,371900,A1,AG/GEN,,,
284,58-12-0-A-0,7726-27-5460,COMM & IND,5.293,AC,2771500,0,2771500,0,0,2771500,2519600,0,2519600,4000,1500,2525100,B1,BUS/GEN,,,
285,57-20-C-11-0,7716-00-6110,SNGL FAM SUB,1.804,AC,315000,0,315000,328900,0,643900,288800,0,288800,298900,0,587700,A2,AG/LTD,,,
286,64-1-0-77-A,7734-51-4766,Academic-Private,20.43,AC,1501300,0,1501300,2273000,105300,3879600,1305300,0,1305300,2260400,76000,3641700,A2,AG/LTD,,,
289,46-16-0-C-0,7707-71-7115,SNGL FAM SUB,13.8,AC,383200,256000,127200,622200,174400,1179800,341800,228500,113300,522000,166800,1030600,A2,AG/LTD,,,
290,46-1-0-37-A,7707-42-9457,SNGL FAM SUB,2.275,AC,128100,0,128100,253800,12600,394500,114400,0,114400,217300,12600,344300,A2RR,AG& RUR,,,
291,45-1-0-22-0,6788-90-3251,SNGL FAM SUB,8.73,AC,176800,0,176800,140200,1000,318000,157700,0,157700,115100,1000,273800,A2,AG/LTD,,,
292,13-10-0-3-0,6841-84-9985,SNGL FAM SUB,1.15,AC,9500,0,9500,0,0,9500,9300,0,9300,0,0,9300,A1,AG/GEN,,,
293,33-1-0-19-0,6798-93-9361,AG > 100 AC,123.3,AC,1541300,1478400,62900,0,0,1541300,1381000,1328000,53000,0,0,1381000,A2,AG/LTD,,,
294,46-1-0-5-0,7707-37-6148,AG 20-100 AC,97.339,AC,1620300,1574500,45800,0,0,1620300,1448600,1407200,41400,0,0,1448600,A2,AG/LTD,,,
295,46-1-0-50-0,7706-59-9672,AG > 100 AC,159.841,AC,2888000,1310300,1577700,5000,52600,2945600,2576300,1170400,1405900,5000,41900,2623200,A2RR,AG& RUR,,,
296,46-1-0-78-0,7707-79-3695,AG 20-100 AC,30,AC,528000,513000,15000,0,0,528000,471000,458100,12900,0,0,471000,A2,AG/LTD,,,
297,46-1-0-101-T,7707-88-8568-9999,AG 20-100 AC,36.207,AC,685500,546700,138800,0,10100,695600,614700,489600,125100,0,10000,624700,A2RR,AG& RUR,,,
298,45-1-0-101-0,6798-91-0133,AG 20-100 AC,73.03,AC,994000,957800,36200,0,0,994000,886800,855500,31300,0,0,886800,A2,AG/LTD,,,
299,45-1-0-101-A,6798-90-0089,SNGL FAM SUB,4,AC,55200,53400,1800,0,0,55200,49200,47500,1700,0,0,49200,A2,AG/LTD,,,
300,45-1-0-102-0,6798-81-2328,SNGL FAM SUB,11.69,AC,224000,218600,5400,0,0,224000,200500,195500,5000,0,0,200500,A2,AG/LTD,,,
301,46-1-0-37-0,7707-52-1056,AG 20-100 AC,28.388,AC,635800,523500,112300,68400,500,704700,567700,467600,100100,57800,500,626000,A2,AG/LTD,,,
302,46-1-0-38-0,7707-31-8704,SNGL FAM SUB,15.77,AC,352400,344400,8000,0,0,352400,314400,307600,6800,0,0,314400,A2,AG/LTD,,,
303,46-1-0-38-A,7707-41-0295,SNGL FAM SUB,12.5,AC,317800,311400,6400,0,0,317800,283800,278400,5400,0,0,283800,A2,AG/LTD,,,
304,46-1-0-40-0,7707-21-8695,AG 20-100 AC,20,AC,386900,377300,9600,0,0,386900,344700,336200,8500,0,0,344700,A2,AG/LTD,,,
305,46-1-0-47-0,7706-29-7598,AG 20-100 AC,79.099,AC,1344700,869800,474900,0,0,1344700,1202300,778400,423900,0,0,1202300,A2RR,AG& RUR,,,
306,46-1-0-48-0,7706-49-6645,SNGL FAM SUB,7.9,AC,218700,122800,95900,123500,100,342300,195000,109500,85500,105400,100,300500,A2,AG/LTD,,,
307,46-3-0-1-0,7707-51-7617,SNGL FAM SUB,10.94,AC,319700,314600,5100,0,0,319700,285200,280500,4700,0,0,285200,A2,AG/LTD,,,
308,46-1-0-39-0,7707-41-5194,SNGL FAM SUB,8.46,AC,264600,151800,112800,367800,300,632700,236100,135600,100500,309900,300,546300,A2,AG/LTD,,,
309,2-1-0-28-0,6814-73-1144,SNGL FAM SUB,0.82,AC,32600,0,32600,64600,2000,99200,32000,0,32000,56800,2000,90800,A1,AG/GEN,,,
310,31-1-0-45-0,6769-85-9933,SNGL FAM SUB,4,AC,97100,0,97100,88200,69700,255000,87800,0,87800,77100,53600,218500,A2,AG/LTD,,,
311,46-8-0-B-1,7707-52-6608,SNGL FAM SUB,2.56,AC,148100,0,148100,564100,8600,720800,132300,0,132300,482800,8100,623200,RR,RES/RUR,,,
312,33-1-0-17-0,6798-65-3420,AG 20-100 AC,78.72,AC,1102000,994200,107800,34800,900,1137700,984700,888900,95800,28000,900,1013600,A2,AG/LTD,,,
313,45-1-0-132-A,6797-39-9266,SNGL FAM SUB,7.23,AC,145600,0,145600,180900,10000,336500,129800,0,129800,149800,10000,289600,A2,AG/LTD,,,
314,45-1-0-25-0,6787-98-4295,SNGL FAM SUB,5,AC,133300,0,133300,100400,700,234400,119000,0,119000,82300,700,202000,A2,AG/LTD,,,
315,46-1-0-54-0,7716-08-2490,SNGL FAM SUB,8.136,AC,238900,0,238900,101200,11500,351600,213300,0,213300,84200,10300,307800,A2,AG/LTD,,,
316,46-1-0-54-A,7716-08-4929,SNGL FAM SUB,2.31,AC,128900,0,128900,177300,9000,315200,115100,0,115100,147600,9000,271700,A2,AG/LTD,,,
320,48-1-0-72-0,7727-95-6187,COMM & IND,80.47,AC,2117100,0,2117100,0,0,2117100,2010000,0,2010000,0,0,2010000,M2A2,INDUSTR,,,
323,54-1-0-7-0,6776-25-9712,SNGL FAM SUB,10,AC,155000,150400,4600,0,0,155000,138200,133900,4300,0,0,138200,A2,AG/LTD,,,
324,44-1-0-73-0,6786-49-9936,AG 20-100 AC,47.804,AC,597600,562400,35200,0,5000,602600,535400,504200,31200,0,5000,540400,A2,AG/LTD,,,
325,57-11-0-5-0,7715-06-6618,SNGL FAM SUB,11.83,AC,515100,333700,181400,430100,32100,977300,447700,289900,157800,207600,15500,670800,A2,AG/LTD,,,
326,42-24-0-A-0,6767-06-6035,COMM & IND,1.5,AC,187400,0,187400,543700,23500,754600,180200,0,180200,509100,17000,706300,RO,RES/OF,,,
327,61-5-0-D-1,6784-98-3750,SNGL FAM SUB,9.8,AC,33300,28800,4500,0,0,33300,29400,25200,4200,0,0,29400,A2,AG/LTD,,,
328,28-1-0-119-0,6739-83-4368,AG > 100 AC,237,AC,936000,775400,160600,181400,30300,1147700,883500,738000,145500,149800,28500,1061800,A1,AG/GEN,,,
329,20-1-0-70-0,6840-65-4187,SNGL FAM SUB,7.66,AC,94900,0,94900,180500,7100,282500,86200,0,86200,153100,7100,246400,A1,AG/GEN,,,
330,45-1-0-132-0,6797-39-2175,SNGL FAM SUB,2.901,AC,96300,0,96300,121700,800,218800,86000,0,86000,99700,800,186500,A2,AG/LTD,,,
332,45-1-0-132-B,6797-29-9127,SNGL FAM SUB,1.874,AC,82700,0,82700,155500,18100,256300,73900,0,73900,126500,15600,216000,A2,AG/LTD,,,
333,45-1-0-24-0,6787-89-1324,AG > 100 AC,152.6,AC,2182800,1987200,195600,5000,0,2187800,1952400,1779400,173000,5000,0,1957400,A2,AG/LTD,,,
334,12-1-0-74-0,6831-82-8507,SNGL FAM SUB,17,AC,58000,49300,8700,0,0,58000,50700,43400,7300,0,0,50700,A1,AG/GEN,,,
335,12-1-0-76-0,6831-72-5469,AG 20-100 AC,33.175,AC,210400,194500,15900,0,0,210400,244400,184800,59600,89600,1000,335000,A1,AG/GEN,,,
336,55-1-0-64-0,6786-64-2639,SNGL FAM SUB,9.45,AC,197700,123300,74400,66500,500,264700,176700,110500,66200,55100,500,232300,A2,AG/LTD,,,
337,42-1-0-96-0,6767-13-1213,COMM & IND,1.04,AC,98500,0,98500,160100,0,258600,94700,0,94700,145300,0,240000,B1,BUS/GEN,,,
338,12-1-0-73-A,6831-62-5580,SNGL FAM SUB,3.47,AC,68100,0,68100,0,0,68100,63000,0,63000,0,0,63000,A1,AG/GEN,,,
339,12-1-0-73-B,6831-62-4512,SNGL FAM SUB,4,AC,75200,0,75200,0,0,75200,68100,0,68100,0,0,68100,A1,AG/GEN,,,
340,29-1-0-43-0,6748-49-4459,AG 20-100 AC,79.381,AC,552200,439600,112600,442100,11900,1006200,543400,440900,102500,378300,11900,933600,A1,AG/GEN,,,
341,42-16-D-2-0,6757-93-0633,SNGL FAM SUB,0.8,AC,89700,0,89700,280900,0,370600,81400,0,81400,265600,0,347000,R1,RES/LTD,,,
342,42-16-D-3-0,6757-83-9734,SNGL FAM SUB,1.2,AC,97800,0,97800,318500,2400,418700,88800,0,88800,297700,2700,389200,R1,RES/LTD,,,
343,45-1-0-18-0,6797-09-8650,SNGL FAM SUB,0.601,AC,8300,0,8300,0,0,8300,7400,0,7400,0,0,7400,A2,AG/LTD,,,
344,45-1-0-19-0,6797-09-1694,SNGL FAM SUB,16.373,AC,288500,0,288500,127600,5500,421600,257900,0,257900,105100,5500,368500,A2,AG/LTD,,,
345,32-10-1-9-0,6778-68-7201,SNGL FAM SUB,1.65,AC,76700,0,76700,168900,1300,246900,68500,0,68500,138500,1300,208300,A2,AG/LTD,,,
347,57-10-0-38-0,7705-67-7724,SNGL FAM SUB,6.94,AC,265000,0,265000,784500,0,1049500,240000,0,240000,726500,0,966500,A2,AG/LTD,,,
348,57-10-0-30-A,7705-67-8110,SNGL FAM SUB,0.12,AC,2300,0,2300,0,0,2300,2100,0,2100,0,0,2100,A2,AG/LTD,,,
349,57-10-0-39-0,7705-67-7321,SNGL FAM SUB,5.18,AC,230000,0,230000,346600,33800,610400,210000,0,210000,335800,28500,574300,A2,AG/LTD,,,
351,16-2-0-D-0,5890-59-0449,AG 20-100 AC,26.24,AC,76300,64200,12100,0,0,76300,75200,64000,11200,0,0,75200,A1,AG/GEN,,,
352,58-21-B-6-0,7716-23-3782,SNGL FAM SUB,1.433,AC,310000,0,310000,522300,0,832300,285000,0,285000,486900,0,771900,A2,AG/LTD,,,
353,32-1-0-32-0,6778-67-9089,COMM & IND,2.39,AC,146500,0,146500,67000,0,213500,139600,0,139600,65600,0,205200,A2,AG/LTD,,,
354,67-3-F-2-0,7723-54-3029,SNGL FAM SUB,0,AC,184000,0,184000,288800,18200,491000,160000,0,160000,242700,15500,418200,R1,RES/LTD,,,
355,18-1-0-54-0,6821-01-9947,SNGL FAM SUB,2,AC,46000,0,46000,162400,200,208600,44000,0,44000,134900,200,179100,A1,AG/GEN,,,
356,43-6-0-2-A,6767-74-0495,SNGL FAM SUB,4.511,AC,104100,0,104100,111500,1000,216600,93000,0,93000,92200,1000,186200,A2,AG/LTD,,,
357,43-12-0-5-0,6767-99-7410,SNGL FAM SUB,5.26,AC,107100,0,107100,127500,18400,253000,95500,0,95500,104200,15500,215200,A2,AG/LTD,,,
358,16-1-0-29-0,5890-30-3473,AG 20-100 AC,57.174,AC,117300,0,117300,0,0,117300,114300,0,114300,0,0,114300,A1,AG/GEN,,,
359,16-1-0-32-0,5890-41-1773,SNGL FAM SUB,9.58,AC,47500,0,47500,0,0,47500,44700,0,44700,0,0,44700,A1,AG/GEN,,,
361,27-1-0-9-0,6719-60-2791,SNGL FAM SUB,1,AC,38800,0,38800,0,0,38800,38000,0,38000,0,0,38000,A1,AG/GEN,,,
362,15-5-0-20-0,5880-60-0093,SNGL FAM SUB,8.55,AC,66000,0,66000,0,0,66000,64400,0,64400,0,0,64400,A1,AG/GEN,,,
363,43-1-0-5-C,6767-58-3804,SNGL FAM SUB,3,AC,86900,0,86900,130300,6000,223200,77600,0,77600,107000,4300,188900,A2,AG/LTD,,,
364,43-1-0-5-0,6767-59-3402,SNGL FAM SUB,9.464,AC,141000,0,141000,257700,3800,402500,125800,0,125800,211900,3500,341200,A2,AG/LTD,,,
376,45-1-0-1-C,6788-71-9889,SNGL FAM SUB,11.897,AC,220500,132000,88500,265200,99800,585500,196600,117400,79200,218500,90700,505800,A2,AG/LTD,,,
377,45-1-0-1-D,6788-71-8333,SNGL FAM SUB,3.771,AC,110000,97500,12500,0,0,110000,98300,87100,11200,0,0,98300,A2,AG/LTD,,,
378,45-1-0-23-A,6788-80-7714,COMM & IND,14.807,AC,1155900,0,1155900,70000,3800,1229700,1084600,0,1084600,69300,2800,1156700,B1,BUS/GEN,,,
379,32-1-0-70-B,6788-55-2832,AG 20-100 AC,64.18,AC,410300,380700,29600,0,0,410300,365000,337700,27300,0,0,365000,A2,AG/LTD,,,
380,32-1-0-70-C,6788-63-2638,AG 20-100 AC,21.89,AC,249500,239400,10100,0,0,249500,223300,214000,9300,0,0,223300,A2,AG/LTD,,,
381,32-1-0-74-A,6788-52-4819,AG 20-100 AC,24.94,AC,400500,388500,12000,0,0,400500,357100,346500,10600,0,0,357100,A2,AG/LTD,,,
382,32-1-0-75-0,6788-62-1586,SNGL FAM SUB,5.99,AC,161400,71000,90400,375100,16000,552500,143900,63300,80600,309500,16000,469400,A2,AG/LTD,,,
383,32-1-0-76-0,6788-52-6189,SNGL FAM SUB,4.71,AC,131200,129000,2200,0,0,131200,117000,115000,2000,0,0,117000,A2,AG/LTD,,,
384,33-1-0-1-0,6788-76-7442,AG > 100 AC,211.68,AC,2413200,2315600,97600,0,0,2413200,2159100,2069100,90000,0,0,2159100,A2,AG/LTD,,,
385,33-1-0-2-0,6798-05-4879,COMM & IND,36.914,AC,1667800,1650800,17000,0,0,1667800,1544900,1529200,15700,0,0,1544900,M1,INDUS/L,,,
386,33-1-0-5-0,6798-16-6373,AG 20-100 AC,39.768,AC,548800,529000,19800,0,0,548800,550600,531300,19300,0,0,550600,A2,AG/LTD,,,
387,44-1-0-39-0,6788-50-1731,AG > 100 AC,218.908,AC,2889600,2788700,100900,0,0,2889600,2583100,2490100,93000,0,0,2583100,A2,AG/LTD,,,
388,45-1-0-1-0,6788-82-5277,AG 20-100 AC,89.096,AC,2133900,2092300,41600,0,700,2134600,1972200,1934300,37900,0,700,1972900,B1A2,BS AND,,,
389,45-1-0-1-A,6788-72-3843,SNGL FAM SUB,17.429,AC,306700,298400,8300,0,0,306700,274500,267000,7500,0,0,274500,A2,AG/LTD,,,
390,45-1-0-2-0,6798-01-4678,SNGL FAM SUB,6.83,AC,127100,0,127100,0,0,127100,113400,0,113400,0,0,113400,A2,AG/LTD,,,
391,58-1-0-37-0,7715-43-6450,AG 20-100 AC,46.77,AC,2081300,2059700,21600,0,0,2081300,986800,966900,19900,0,0,986800,A2,AG/LTD,,,
392,33-1-0-1-A,6788-78-5695,AG 20-100 AC,40,AC,528000,509600,18400,0,0,528000,472000,455000,17000,0,0,472000,A2,AG/LTD,,,
393,31-1-0-33-0,6768-99-8508,SNGL FAM SUB,0.25,AC,3000,0,3000,0,0,3000,2700,0,2700,0,0,2700,A2,AG/LTD,,,
394,31-1-0-33-A,6768-99-7600,SNGL FAM SUB,0.75,AC,9000,0,9000,0,0,9000,8000,0,8000,0,0,8000,A2,AG/LTD,,,
395,31-1-0-34-0,6768-88-9590,AG 20-100 AC,25.5,AC,306000,294200,11800,0,0,306000,272900,262100,10800,0,0,272900,A2,AG/LTD,,,
396,38-1-0-10-A,6707-99-8513,SNGL FAM SUB,0.99,AC,38400,0,38400,101000,5000,144400,37600,0,37600,86100,5000,128700,A1,AG/GEN,,,
397,43-1-0-7-0,6767-57-0515,SNGL FAM SUB,5.82,AC,130400,0,130400,99200,6900,236500,116600,0,116600,82700,6900,206200,A2,AG/LTD,,,
398,62-17-C-1-0,7714-06-1194,SNGL FAM SUB,0,AC,115000,0,115000,186500,800,302300,100000,0,100000,168700,800,269500,R1,RES/LTD,,,
399,13-1-0-22-A,6841-65-8788,SNGL FAM SUB,1.29,AC,52400,0,52400,80800,1500,134700,51500,0,51500,71000,1500,124000,A1,AG/GEN,,,
400,32-10-1-19-0,6778-69-7512,SNGL FAM SUB,9.71,AC,166600,0,166600,346100,22700,535400,148900,0,148900,287700,20400,457000,A2,AG/LTD,,,
401,17-3-0-2-B,6709-49-1806,SNGL FAM SUB,1.52,AC,41200,0,41200,0,0,41200,40900,0,40900,0,0,40900,A1,AG/GEN,,,
402,47-1-0-66-0,7717-98-4323,SNGL FAM SUB,1.464,AC,97000,0,97000,156200,3400,256600,86700,0,86700,141000,3400,231100,A2,AG/LTD,,,
403,57-5-0-3-0,7706-47-3668,AG 20-100 AC,40.54,AC,1030700,863000,167700,1342300,207200,2580200,896700,750200,146500,1158200,189100,2244000,A2,AG/LTD,,,
404,62-24-0-5-0,7704-97-3357,SNGL FAM SUB,2.68,AC,198000,0,198000,356100,12000,566100,180000,0,180000,316600,12000,508600,R1,RES/LTD,,,
406,39-8-0-D-0,6727-34-9583,AG > 100 AC,161.986,AC,618400,502800,115600,293300,25600,937300,534800,435600,99200,258800,25600,819200,A1,AG/GEN,,,
409,50-4-0-A-0,6726-60-1333,SNGL FAM SUB,0.332,AC,14800,0,14800,164900,100,179800,14500,0,14500,142400,100,157000,A1,AG/GEN,,,
410,50-4-0-B-0,6726-60-1498,SNGL FAM SUB,0.596,AC,20800,0,20800,0,0,20800,20400,0,20400,0,0,20400,A1,AG/GEN,,,
411,50-4-0-C-0,6726-60-0487,SNGL FAM SUB,0.47,AC,16400,0,16400,0,0,16400,16100,0,16100,0,0,16100,A1,AG/GEN,,,
412,12-1-0-76-A,6831-72-1907,SNGL FAM SUB,2.29,AC,47900,0,47900,0,0,47900,44200,0,44200,0,0,44200,A1,AG/GEN,,,
413,12-1-0-77-0,6831-73-6414,SNGL FAM SUB,11.7,AC,111800,0,111800,412700,39500,564000,105700,0,105700,343800,39500,489000,A1,AG/GEN,,,
414,43-8-0-D-1,6778-41-6422,SNGL FAM SUB,2.168,AC,84700,0,84700,411300,0,496000,75700,0,75700,330100,0,405800,A2,AG/LTD,,,
415,43-1-0-63-0,6778-41-3445,SNGL FAM SUB,4.67,AC,122900,0,122900,204700,28300,355900,109900,0,109900,168400,24900,303200,A2,AG/LTD,,,
416,43-6-0-4-0,6767-74-4537,SNGL FAM SUB,5.7,AC,114900,0,114900,0,0,114900,102300,0,102300,0,0,102300,A2,AG/LTD,,,
417,43-6-0-4-A,6767-74-1935,SNGL FAM SUB,1.5,AC,71300,0,71300,133000,3500,207800,63700,0,63700,109600,3500,176800,A2,AG/LTD,,,
419,43-6-0-2-D,6767-74-1182,SNGL FAM SUB,1.782,AC,73000,0,73000,0,0,73000,65200,0,65200,0,0,65200,A2,AG/LTD,,,
420,43-10-0-B-2,6767-75-0714,SNGL FAM SUB,1,AC,64100,0,64100,67900,700,132700,57200,0,57200,56100,700,114000,A2,AG/LTD,,,
421,5-6-0-F-1,6813-76-3403,SNGL FAM SUB,2,AC,44800,0,44800,0,0,44800,44000,0,44000,0,0,44000,A1,AG/GEN,,,
422,45-1-0-1-E,6788-91-6438,COMM & IND,8.673,AC,838000,0,838000,0,500,838500,776200,0,776200,0,500,776700,B1A2,BS AND,,,
423,43-1-0-79-0,6767-93-2726,SNGL FAM SUB,1.73,AC,80600,0,80600,97100,1500,179200,72000,0,72000,80000,1500,153500,A2,AG/LTD,,,
424,57-10-0-37-0,7705-68-7286,SNGL FAM SUB,4.08,AC,230000,0,230000,598400,0,828400,210000,0,210000,574900,0,784900,A2,AG/LTD,,,
425,9-1-0-77-B,5892-86-6421,SNGL FAM SUB,2.18,AC,43000,0,43000,116800,0,159800,42100,0,42100,101100,0,143200,A1,AG/GEN,,,
426,39-1-0-28-0,6727-04-7606,SNGL FAM SUB,2,AC,44400,0,44400,79700,400,124500,43500,0,43500,68200,400,112100,A1,AG/GEN,,,
427,30-1-0-62-A,6759-52-2910,SNGL FAM SUB,1.012,AC,54100,0,54100,109900,500,164500,50000,0,50000,86100,500,136600,A2,AG/LTD,,,
428,57-20-A-2-0,7706-91-5525,SNGL FAM SUB,13.101,AC,624000,0,624000,1611000,184700,2419700,572000,0,572000,1448500,179900,2200400,A2,AG/LTD,,,
429,1-1-0-23-A,6804-55-9793,SNGL FAM SUB,10.54,AC,88400,0,88400,0,0,88400,89000,0,89000,0,5000,94000,A1,AG/GEN,,,
430,1-1-0-23-0,6804-65-4619,SNGL FAM SUB,1.451,AC,42000,0,42000,74100,2600,118700,36900,0,36900,64900,2000,103800,A1,AG/GEN,,,
431,1-1-0-36-0,6814-43-5126,SNGL FAM SUB,1,AC,5100,0,5100,0,500,5600,5000,0,5000,0,500,5500,A1,AG/GEN,,,
432,1-1-0-35-0,6814-43-4321,SNGL FAM SUB,1.269,AC,41100,0,41100,210700,0,251800,40300,0,40300,188400,0,228700,A1,AG/GEN,,,
433,55-2-0-7-0,6785-34-5864,SNGL FAM SUB,1.33,AC,88100,0,88100,211900,3800,303800,78700,0,78700,171000,3800,253500,R2,RES/LTD,,,
434,47-1-0-80-H,7726-07-4910,COMM & IND,0.87,AC,297100,0,297100,0,0,297100,270100,0,270100,0,0,270100,B1,BUS/GEN,,,
435,29-12-0-6-0,6748-68-9117,SNGL FAM SUB,1.291,AC,56900,0,56900,172900,0,229800,52600,0,52600,140700,0,193300,A1,AG/GEN,,,
436,5-1-0-71-A,6823-68-9916,SNGL FAM SUB,3,AC,47400,0,47400,204400,20900,272700,46600,0,46600,180200,18300,245100,A1,AG/GEN,,,
437,5-1-0-71-B,6823-68-6696,SNGL FAM SUB,3.373,AC,49200,0,49200,110100,2400,161700,48400,0,48400,95700,2200,146300,A1,AG/GEN,,,
438,46-12-0-5-0,7717-10-6739,SNGL FAM SUB,3.54,AC,156900,0,156900,247500,500,404900,140200,0,140200,206800,500,347500,A2,AG/LTD,,,
439,33-4-0-23-0,6798-42-4982,SNGL FAM SUB,6.14,AC,139800,0,139800,270700,31700,442200,124700,0,124700,220100,27100,371900,A2,AG/LTD,,,
440,64-1-0-36-0,7724-62-7261,Academic-Private,1.2,AC,43500,0,43500,0,33700,77200,37800,0,37800,0,29900,67700,R3,RES/GEN,,,
441,42-15-0-5-0,6757-61-2796,SNGL FAM SUB,3.57,AC,162400,0,162400,0,0,162400,141600,0,141600,0,0,141600,A2,AG/LTD,,,
442,28-1-0-58-E,6738-19-4334,SNGL FAM SUB,1.33,AC,42500,0,42500,116800,2500,161800,41500,0,41500,96800,2500,140800,A1,AG/GEN,,,
443,20-1-0-41-C,6840-32-7711,SNGL FAM SUB,2.6,AC,62500,0,62500,120300,1000,183800,59700,0,59700,99500,1000,160200,A1,AG/GEN,,,
444,31-1-0-40-0,6768-99-8729,SNGL FAM SUB,1.02,AC,64400,0,64400,73800,2000,140200,57500,0,57500,61300,2000,120800,A2,AG/LTD,,,
445,29-1-0-82-0,6749-76-4108,SNGL FAM SUB,9.65,AC,116900,0,116900,684500,0,801400,113500,0,113500,596200,0,709700,A1,AG/GEN,,,
446,29-1-0-85-0,6749-75-9610,SNGL FAM SUB,4.618,AC,88300,0,88300,0,0,88300,85700,0,85700,0,0,85700,A1,AG/GEN,,,
447,29-19-0-A-0,6759-06-5332,SNGL FAM SUB,3.59,AC,79100,0,79100,502100,0,581200,75500,0,75500,413400,0,488900,A1,AG/GEN,,,
448,43-1-0-23-0,6767-65-0090,SNGL FAM SUB,5,AC,114100,0,114100,93100,0,207200,102000,0,102000,76300,0,178300,A2,AG/LTD,,,
449,58-21-A-6-0,7716-43-8710,SNGL FAM SUB,1.42,AC,310000,0,310000,266700,0,576700,285000,0,285000,244800,0,529800,A2,AG/LTD,,,
450,47-1-0-100-0,7727-22-5183,SNGL FAM SUB,0.81,AC,72200,0,72200,95400,500,168100,64400,0,64400,79100,500,144000,A2,AG/LTD,,,
451,55-16-0-12-0,6776-63-3694,SNGL FAM SUB,7.8,AC,149400,0,149400,0,19500,168900,133400,0,133400,0,19500,152900,A2,AG/LTD,,,
452,56-1-0-76-A,6796-80-3891,AG 20-100 AC,61.5,AC,1088600,1057200,31400,0,0,1088600,947100,920700,26400,0,0,947100,A2,AG/LTD,,,
453,56-1-0-77-0,6796-70-2487,SNGL FAM SUB,18,AC,536600,527400,9200,0,9300,545900,466200,458500,7700,0,9300,475500,A2,AG/LTD,,,
454,56-1-0-77-A,6796-71-5148,SNGL FAM SUB,19.7,AC,530500,520500,10000,0,500,531000,460600,452100,8500,0,500,461100,A2,AG/LTD,,,
455,56-1-0-77-B,6796-60-8806,SNGL FAM SUB,10,AC,354200,200600,153600,89300,900,444400,307800,174300,133500,76900,900,385600,A2,AG/LTD,,,
456,20-1-0-70-C,6840-72-9081,SNGL FAM SUB,16.4,AC,155300,0,155300,9500,0,164800,152300,0,152300,9000,0,161300,A1,AG/GEN,,,
457,5-13-0-26-0,6813-63-5044,SNGL FAM SUB,8.16,AC,65700,0,65700,0,0,65700,64400,0,64400,0,0,64400,A1,AG/GEN,,,
458,64-4-2-12-0,7724-94-4127,SNGL FAM SUB,0,AC,20200,0,20200,0,0,20200,17600,0,17600,0,0,17600,RN,RESIDEN,,,
459,56-1-0-78-A,6796-63-5285,AG 20-100 AC,48.33,AC,937100,747000,190100,842700,140000,1919800,814900,649500,165400,707900,125900,1648700,A2,AG/LTD,,,
460,11-5-0-A-0,6822-53-2164,SNGL FAM SUB,5.28,AC,61500,0,61500,0,0,61500,60400,0,60400,0,0,60400,A1,AG/GEN,,,
461,57-22-0-D-0,7706-72-0114,SNGL FAM SUB,10,AC,385700,0,385700,718200,5300,1109200,335700,0,335700,599900,3600,939200,A2,AG/LTD,,,
462,55-1-0-53-A,6786-36-0630,SNGL FAM SUB,8,AC,170900,0,170900,0,500,171400,152900,0,152900,0,500,153400,A2,AG/LTD,,,
463,18-1-0-45-0,6810-95-4642,AG 20-100 AC,43.34,AC,133800,113800,20000,0,0,133800,130000,111600,18400,0,0,130000,A1,AG/GEN,,,
465,57-22-0-B-0,7706-72-0915,SNGL FAM SUB,6.9,AC,304200,0,304200,0,0,304200,264700,0,264700,0,0,264700,A2,AG/LTD,,,
466,57-22-0-C-0,7706-72-0509,SNGL FAM SUB,6.9,AC,304200,0,304200,1281900,0,1586100,264700,0,264700,1107600,0,1372300,A2,AG/LTD,,,
468,15-1-0-32-0,5789-28-1258,SNGL FAM SUB,1.576,AC,40900,0,40900,140200,700,181800,40000,0,40000,122000,700,162700,A1,AG/GEN,,,
469,31-1-0-10-0,6769-63-6834,SNGL FAM SUB,11.058,AC,168200,0,168200,137400,5500,311100,154700,0,154700,111800,5500,272000,A2,AG/LTD,,,
470,31-1-0-7-0,6769-64-6283,SNGL FAM SUB,9.59,AC,206100,0,206100,289400,1700,497200,181500,0,181500,244500,1700,427700,A2,AG/LTD,,,
471,31-1-0-7-A,6769-64-2359,SNGL FAM SUB,0.938,AC,60100,0,60100,11700,2100,73900,54300,0,54300,11800,1500,67600,A2,AG/LTD,,,
472,14-1-0-10-0,6851-55-2816,AG > 100 AC,231.29,AC,707900,601300,106600,0,0,707900,694000,595700,98300,0,0,694000,A1,AG/GEN,,,
473,62-2-B-14-0,7704-94-9602,SNGL FAM SUB,0,AC,115000,0,115000,335300,0,450300,100000,0,100000,312000,0,412000,R1,RES/LTD,,,
474,38-1-0-40-0,6707-63-1684,SNGL FAM SUB,1.52,AC,41700,0,41700,200500,3300,245500,40900,0,40900,169300,3000,213200,A1,AG/GEN,,,
475,62-21-0-11-0,7704-98-3351,Cmn Area/Open Spc,2.26,AC,0,0,0,0,0,0,0,0,0,0,0,0,A2,AG/LTD,,,
476,15-5-0-2-0,5789-76-1747,SNGL FAM SUB,8.01,AC,67500,0,67500,0,0,67500,66000,0,66000,0,0,66000,A1,AG/GEN,,,
477,15-5-0-3-0,5789-66-8881,SNGL FAM SUB,8.01,AC,67500,0,67500,0,0,67500,66000,0,66000,0,0,66000,A1,AG/GEN,,,
478,24-2-0-2-A,5789-65-8071,SNGL FAM SUB,10.23,AC,25600,0,25600,0,0,25600,25600,0,25600,0,0,25600,A1,AG/GEN,,,
479,24-2-0-3-A,5789-65-6033,SNGL FAM SUB,10.02,AC,25100,0,25100,0,0,25100,25100,0,25100,0,0,25100,A1,AG/GEN,,,
480,62-18-0-9-0,7704-64-4964,SNGL FAM SUB,3.44,AC,229400,0,229400,378200,17300,624900,200300,0,200300,333600,15800,549700,A2,AG/LTD,,,
481,12-1-0-32-B,6831-02-6752,SNGL FAM SUB,2,AC,47600,0,47600,187100,2000,236700,47300,0,47300,153900,2000,203200,A1,AG/GEN,,,
482,12-1-0-71-A,6831-42-1696,SNGL FAM SUB,3.08,AC,61900,0,61900,151500,0,213400,58800,0,58800,114500,0,173300,A1,AG/GEN,,,
483,16-1-0-11-0,5890-68-4985,SNGL FAM SUB,0.5,AC,27200,0,27200,36400,0,63600,26600,0,26600,32500,0,59100,A1,AG/GEN,,,
484,11-1-0-40-0,6821-58-1008,AG 20-100 AC,35,AC,178500,152300,26200,0,0,178500,175000,150900,24100,0,0,175000,A1,AG/GEN,,,
485,19-1-0-40-A,6831-62-0032,SNGL FAM SUB,1,AC,47000,0,47000,10600,4900,62500,44700,0,44700,10600,3500,58800,A1,AG/GEN,,,
486,12-2-0-1-0,6831-05-0056,SNGL FAM SUB,4,AC,60500,0,60500,44600,600,105700,59900,0,59900,36100,600,96600,A1,AG/GEN,,,
487,12-2-0-1-C,6821-95-5180,SNGL FAM SUB,2,AC,37600,0,37600,0,0,37600,38400,0,38400,0,0,38400,A1,AG/GEN,,,
488,12-2-0-3-0,6821-74-3217,AG 20-100 AC,20.092,AC,131900,122600,9300,0,0,131900,129200,120700,8500,0,0,129200,A1,AG/GEN,,,
489,12-1-0-32-0,6831-11-8716,AG > 100 AC,132.58,AC,712000,0,712000,28200,400,740600,688800,0,688800,23900,900,713600,A1,AG/GEN,,,
490,12-1-0-33-0,6831-13-4154,SNGL FAM SUB,8.3,AC,74600,0,74600,0,0,74600,73800,0,73800,0,0,73800,A1,AG/GEN,,,
492,12-1-0-40-0,6831-33-9863,SNGL FAM SUB,2.862,AC,59000,0,59000,34500,1100,94600,57400,0,57400,29400,1100,87900,A1,AG/GEN,,,
493,9-1-0-14-0,5892-73-1307,SNGL FAM SUB,2.62,AC,44600,0,44600,188900,15300,248800,43700,0,43700,174300,13200,231200,A1,AG/GEN,,,
494,19-1-0-35-0,6831-01-5778,SNGL FAM SUB,2.92,AC,53400,0,53400,200600,22500,276500,54500,0,54500,166400,19300,240200,A1,AG/GEN,,,
495,26-1-0-15-B,6719-03-0615,SNGL FAM SUB,2.969,AC,51800,0,51800,116200,1500,169500,49800,0,49800,96800,1500,148100,A1,AG/GEN,,,
496,19-1-0-4-0,6821-92-8368,SNGL FAM SUB,7.12,AC,80500,0,80500,315500,3500,399500,74400,0,74400,261200,3500,339100,A1,AG/GEN,,,
497,19-1-0-5-0,6831-02-1195,SNGL FAM SUB,2.88,AC,53200,0,53200,0,0,53200,54200,0,54200,3000,0,57200,A1,AG/GEN,,,
498,12-1-0-31-D,6821-94-9077,SNGL FAM SUB,1.56,AC,44300,0,44300,103300,1000,148600,43900,0,43900,85400,1000,130300,A1,AG/GEN,,,
500,12-1-0-27-0,6821-95-6650,SNGL FAM SUB,3.74,AC,56900,0,56900,120400,24600,201900,55100,0,55100,100000,21200,176300,A1,AG/GEN,,,
501,12-1-0-39-0,6831-33-8431,SNGL FAM SUB,4.75,AC,76700,0,76700,198100,25900,300700,74000,0,74000,165900,22500,262400,A1,AG/GEN,,,
502,2-1-0-2-0,6814-55-3630,SNGL FAM SUB,1.8,AC,43800,0,43800,129500,400,173700,43000,0,43000,112900,400,156300,A1,AG/GEN,,,
503,4-1-0-48-0,6813-05-3546,SNGL FAM SUB,3.651,AC,53200,0,53200,115400,5100,173700,52300,0,52300,99000,4700,156000,A1,AG/GEN,,,
504,4-1-0-35-0,6803-87-9564,SNGL FAM SUB,2.632,AC,48000,0,48000,159600,69400,277000,47200,0,47200,145800,58300,251300,A1,AG/GEN,,,
505,4-1-0-26-A,6803-72-5781,AG 20-100 AC,24.29,AC,111400,71000,40400,246500,96600,454500,107900,54000,53900,221500,87400,416800,A1,AG/GEN,,,
506,4-1-0-42-A,6814-31-9614,AG 20-100 AC,34.42,AC,210100,154500,55600,195900,20900,426900,206000,152700,53300,172000,20500,398500,A1,AG/GEN,,,
507,46-7-0-D-1,7707-53-7023,SNGL FAM SUB,1.79,AC,117000,0,117000,128000,18200,263200,104500,0,104500,107600,15400,227500,RR,RES/RUR,,,
508,16-2-0-F-0,5890-39-7757,AG 20-100 AC,26.24,AC,73200,61100,12100,0,0,73200,71400,60200,11200,0,0,71400,A1,AG/GEN,,,
509,45-1-0-27-B,6787-97-3495,SNGL FAM SUB,1.56,AC,78900,0,78900,198800,2000,279700,70500,0,70500,162100,2000,234600,A2,AG/LTD,,,
510,38-1-0-25-0,6707-78-2124,SNGL FAM SUB,12.85,AC,101800,0,101800,79100,4500,185400,99900,0,99900,69000,4500,173400,A1,AG/GEN,,,
511,38-1-0-25-A,6707-77-4939,SNGL FAM SUB,2.1,AC,45000,0,45000,179600,9000,233600,44100,0,44100,156300,9000,209400,A1,AG/GEN,,,
513,14-3-0-22-0,6851-37-4246,SNGL FAM SUB,3.45,AC,70500,0,70500,240000,500,311000,69000,0,69000,163800,500,233300,A1,AG/GEN,,,
514,38-1-0-62-0,6716-09-6714,SNGL FAM SUB,13.607,AC,55800,0,55800,0,0,55800,54400,0,54400,0,0,54400,A1,AG/GEN,,,
515,64-4-2-2-0,7724-93-3179,SNGL FAM SUB,0,,70000,0,70000,135900,21200,227100,60000,0,60000,114900,18700,193600,RN,RESIDEN,,,
516,48-1-0-21-0,7727-54-1477,AG > 100 AC,110.56,AC,6963000,6908400,54600,0,0,6963000,6517300,6469900,47400,0,0,6517300,B1A2,BS AND,,,
517,17-1-0-79-0,6810-10-0873,SNGL FAM SUB,5.751,AC,68800,0,68800,121400,11000,201200,53900,0,53900,115900,7600,177400,A1,AG/GEN,,,
518,32-12-0-4-0,6789-03-3142,SNGL FAM SUB,15.43,AC,219900,144000,75900,600200,101800,921900,195700,127800,67900,514200,77200,787100,A2,AG/LTD,,,
519,48-1-0-58-B,7738-31-4043,AG 20-100 AC,31.74,AC,1636100,1384100,252000,0,0,1636100,1461900,1236500,225400,0,0,1461900,M2A2,INDUSTR,,,
522,31-1-0-58-0,6769-96-8702,SNGL FAM SUB,18.66,AC,249100,0,249100,156200,19100,424400,229900,0,229900,130000,17600,377500,A2,AG/LTD,,,
523,42-1-0-66-B,6757-98-5681,COMM & IND,0.99,AC,133700,0,133700,262100,27000,422800,128600,0,128600,245700,18200,392500,B1,BUS/GEN,,,
524,67-2-C-13-0,7723-54-5660,SNGL FAM SUB,0,AC,184000,0,184000,320200,600,504800,160000,0,160000,276100,600,436700,R1,RES/LTD,,,
525,67-13-C-13-0,7733-36-2243,SNGL FAM SUB,0,AC,265000,0,265000,849200,0,1114200,220000,0,220000,686400,0,906400,R1,RES/LTD,,,
526,6-4-0-4-0,6832-88-9517,SNGL FAM SUB,5.67,AC,79900,0,79900,195400,2000,277300,78300,0,78300,170000,2000,250300,A1,AG/GEN,,,
532,67-2-B-10-0,7723-45-9479,SNGL FAM SUB,0,AC,184000,0,184000,317600,200,501800,160000,0,160000,269100,200,429300,R1,RES/LTD,,,
533,38-1-0-35-0,6707-66-0001,AG 20-100 AC,35.74,AC,146500,0,146500,0,0,146500,143000,127800,15200,0,0,143000,A1,AG/GEN,,,
534,57-20-B-2-0,7716-01-0247,SNGL FAM SUB,3.139,AC,365000,0,365000,571200,0,936200,335000,0,335000,551700,0,886700,A2,AG/LTD,,,
535,27-5-0-2-C,6728-77-3456,SNGL FAM SUB,0.56,AC,31500,0,31500,134100,0,165600,30900,0,30900,112400,0,143300,A1,AG/GEN,,,
536,42-7-0-A-1,6757-46-8337,SNGL FAM SUB,4.45,AC,95100,0,95100,270300,8300,373700,85800,0,85800,231500,11100,328400,A2,AG/LTD,,,
537,32-10-2-17-0,6778-69-0816,SNGL FAM SUB,4.52,AC,118000,0,118000,213000,20100,351100,105500,0,105500,175900,17500,298900,A2,AG/LTD,,,
538,5-14-0-2-0,6823-69-5604,SNGL FAM SUB,7.577,AC,69600,0,69600,0,0,69600,68300,0,68300,0,0,68300,A1,AG/GEN,,,
539,20-11-0-23-0,6841-91-5524,SNGL FAM SUB,2,AC,55600,0,55600,137500,5400,198500,52500,0,52500,127100,5400,185000,A1,AG/GEN,,,
540,30-1-0-60-C,6759-42-8262,SNGL FAM SUB,1.43,AC,58300,0,58300,151500,19300,229100,54400,0,54400,129400,16900,200700,A2,AG/LTD,,,
542,67-19-0-2-0,7733-37-8135,SNGL FAM SUB,0.93,AC,265000,0,265000,423500,0,688500,220000,0,220000,340000,0,560000,R1,RES/LTD,,,
543,67-19-0-3-0,7733-36-9918,SNGL FAM SUB,0.9,AC,265000,0,265000,576400,0,841400,220000,0,220000,485500,0,705500,R1,RES/LTD,,,
544,66-4-0-16-0,7723-24-9394,SNGL FAM SUB,3.558,AC,862500,0,862500,2907200,0,3769700,750000,0,750000,2731000,0,3481000,A2,AG/LTD,,,
545,67-13-B-6-0,7733-36-3972,SNGL FAM SUB,0,AC,265000,0,265000,563300,800,829100,220000,0,220000,440200,800,661000,R1,RES/LTD,,,
546,43-20-0-22-0,6768-41-6423,SNGL FAM SUB,3.32,AC,96800,0,96800,236800,0,333600,88000,0,88000,209100,0,297100,A2,AG/LTD,,,
547,43-20-0-23-0,6768-41-4776,SNGL FAM SUB,3.4,AC,96800,0,96800,206000,42000,344800,88000,0,88000,184800,35900,308700,A2,AG/LTD,,,
548,43-20-0-24-0,6768-41-7880,SNGL FAM SUB,3.32,AC,96800,0,96800,200600,400,297800,88000,0,88000,175800,400,264200,A2,AG/LTD,,,
549,43-20-0-25-0,6768-51-0893,SNGL FAM SUB,3.05,AC,96800,0,96800,249300,0,346100,88000,0,88000,199300,0,287300,A2,AG/LTD,,,
550,5-14-0-3-0,6823-69-3460,SNGL FAM SUB,6.554,AC,64600,0,64600,316700,0,381300,63500,0,63500,267400,0,330900,A1,AG/GEN,,,
551,19-1-0-62-A,6830-71-5949,SNGL FAM SUB,8.03,AC,99400,42100,57300,64100,16900,180400,90000,37100,52900,55300,14300,159600,A1,AG/GEN,,,
552,67-17-0-D-0,7733-12-1940,SNGL FAM SUB,5.48,AC,343700,0,343700,806500,31600,1181800,298700,0,298700,685000,31600,1015300,A2,AG/LTD,,,
553,7-1-0-8-0,6842-29-4057,AG 20-100 AC,20,AC,148800,99300,49500,288300,130000,567100,145400,98200,47200,251200,124400,521000,A1,AG/GEN,,,
554,46-20-0-C-0,7706-08-8022,AG 20-100 AC,22.51,AC,612300,479400,132900,904200,75600,1592100,531900,416700,115200,764400,67700,1364000,A2,AG/LTD,,,
555,46-20-0-E-0,7706-18-9013,SNGL FAM SUB,8.555,AC,3900,0,3900,0,0,3900,3600,0,3600,0,0,3600,A2,AG/LTD,,,
556,46-20-0-A-0,7706-27-3680,AG 20-100 AC,48.66,AC,22900,0,22900,0,0,22900,20700,0,20700,0,0,20700,A2,AG/LTD,,,
557,46-20-0-D-0,7706-28-0428,SNGL FAM SUB,12.494,AC,384000,256300,127700,852400,76900,1313300,333600,222700,110900,727700,74400,1135700,A2,AG/LTD,,,
558,46-20-0-B-0,7706-46-2823,SNGL FAM SUB,6.79,AC,3100,0,3100,0,0,3100,2900,0,2900,0,0,2900,A2,AG/LTD,,,
559,46-20-0-F-0,7706-36-7836,SNGL FAM SUB,13.215,AC,6100,0,6100,0,0,6100,5600,0,5600,0,0,5600,A2,AG/LTD,,,
560,4-1-0-42-0,6814-32-4288,SNGL FAM SUB,2.13,AC,45500,0,45500,234900,3600,284000,44700,0,44700,214200,3400,262300,A1,AG/GEN,,,
561,4-3-0-17-0,6803-82-9184,SNGL FAM SUB,4.57,AC,58700,0,58700,168900,5000,232600,57500,0,57500,142700,5000,205200,A1,AG/GEN,,,
562,42-1-0-52-0,6767-04-4112,COMM & IND,0.278,AC,31100,0,31100,0,0,31100,29800,0,29800,0,0,29800,RO,RES/OF,,,
563,42-13-0-1-0,6767-04-4223,COMM & IND,1.832,AC,228800,0,228800,939500,61300,1229600,220000,0,220000,927000,45600,1192600,BN,BUS/NHD,,,
564,47-1-0-91-B,7726-18-9006,COMM & IND,1.002,AC,750700,0,750700,547300,38100,1336100,713500,0,713500,518700,34300,1266500,B1,BUS/GEN,,,
565,64-1-0-74-B,7734-42-6677,COMM & IND,1.2,AC,488900,0,488900,611400,60000,1160300,452600,0,452600,596800,40400,1089800,B1,BUS/GEN,,,
566,47-1-0-80-E,7726-08-2167,COMM & IND,0.991,AC,675100,0,675100,351100,72900,1099100,613800,0,613800,302300,50300,966400,B1,BUS/GEN,,,
567,13-7-0-1-0,6842-92-6983,SNGL FAM SUB,4.18,AC,66800,20400,46400,8800,0,75600,65500,20100,45400,9200,0,74700,A1,AG/GEN,,,
568,13-7-0-2-0,6842-93-5196,SNGL FAM SUB,4.5,AC,74800,0,74800,0,0,74800,73300,0,73300,0,0,73300,A1,AG/GEN,,,
569,16-1-0-2-0,5891-51-8514,SNGL FAM SUB,5,AC,41600,0,41600,0,0,41600,40500,0,40500,0,0,40500,A1,AG/GEN,,,
570,46-1-0-56-0,7716-08-8146,SNGL FAM SUB,0.78,AC,84900,0,84900,84700,3000,172600,75800,0,75800,71800,3000,150600,A2,AG/LTD,,,
571,13-7-0-5-0,6842-93-0168,SNGL FAM SUB,4.5,AC,59800,0,59800,0,0,59800,58800,0,58800,0,0,58800,A1,AG/GEN,,,
572,63-6-0-A-0,7714-90-4165,SNGL FAM SUB,5.229,AC,148000,0,148000,0,5600,153600,128600,0,128600,0,0,128600,A2,AG/LTD,,,
573,63-6-0-B-0,7724-00-0019,SNGL FAM SUB,6.417,AC,318300,0,318300,0,9500,327800,276700,0,276700,0,9500,286200,R1A2,RES LTD,,,
574,63-6-0-C-0,7714-90-9643,SNGL FAM SUB,6.679,AC,327300,0,327300,638500,60800,1026600,284500,0,284500,534800,57600,876900,R1A2,RES LTD,,,
575,47-25-0-12-0,7727-00-2535,SNGL FAM SUB,1.1,AC,129200,0,129200,325700,2200,457100,115300,0,115300,274400,1600,391300,A2,AG/LTD,,,
576,63-27-0-1-0,7715-71-1172,SNGL FAM SUB,1.39,AC,116400,0,116400,136700,21100,274200,101200,0,101200,116100,17900,235200,A2,AG/LTD,,,
577,63-27-0-2-0,7715-71-2238,SNGL FAM SUB,0.845,AC,100800,0,100800,130600,600,232000,87700,0,87700,113300,700,201700,A2,AG/LTD,,,
578,63-27-0-12-0,7715-70-0937,SNGL FAM SUB,2.09,AC,130600,0,130600,76200,19200,226000,113600,0,113600,65200,19200,198000,A2,AG/LTD,,,
579,63-30-0-D-0,7715-60-5141,SNGL FAM SUB,1.73,AC,123300,0,123300,251700,5000,380000,107200,0,107200,228800,3500,339500,A2,AG/LTD,,,
580,63-30-0-G-0,7715-60-2389,SNGL FAM SUB,1.47,AC,118000,0,118000,205600,0,323600,102600,0,102600,187600,0,290200,A2,AG/LTD,,,
581,62-2-B-17-0,7704-95-7056,SNGL FAM SUB,0,AC,115000,0,115000,229700,3700,348400,100000,0,100000,210500,1800,312300,R1,RES/LTD,,,
582,60-8-0-B-2,6784-28-8349,SNGL FAM SUB,5.69,AC,251100,0,251100,402600,32400,686100,224000,0,224000,328900,27000,579900,A2,AG/LTD,,,
583,62-9-0-3-0,7714-29-1205,SNGL FAM SUB,7,AC,393400,0,393400,1255200,0,1648600,342000,0,342000,1250700,0,1592700,A2,AG/LTD,,,
584,26-1-0-69-0,6719-25-3236,SNGL FAM SUB,5,AC,63500,0,63500,116900,37200,217600,62000,0,62000,96300,36600,194900,A1,AG/GEN,,,
585,13-1-0-26-0,6841-88-7017,SNGL FAM SUB,4.51,AC,74900,0,74900,196100,19800,290800,73400,0,73400,172700,17800,263900,A1,AG/GEN,,,
586,13-1-0-25-A,6841-88-1386,SNGL FAM SUB,3.41,AC,65800,0,65800,199100,24400,289300,64500,0,64500,173000,21300,258800,A1,AG/GEN,,,
587,67-11-C-8-0,7733-36-0223,SNGL FAM SUB,0,AC,265000,0,265000,757200,0,1022200,220000,0,220000,605000,7900,832900,R1,RES/LTD,,,
588,67-13-B-10-0,7733-36-2783,SNGL FAM SUB,0,AC,265000,0,265000,468500,1000,734500,220000,0,220000,408300,1000,629300,R1,RES/LTD,,,
589,38-1-0-124-0,6717-24-7232,SNGL FAM SUB,8,AC,47700,0,47700,0,0,47700,46700,0,46700,0,0,46700,A1,AG/GEN,,,
590,47-1-0-63-0,7717-98-5824,SNGL FAM SUB,1.3,AC,94200,0,94200,191200,29100,314500,84200,0,84200,159400,24600,268200,A2,AG/LTD,,,
591,4-6-0-31-0,6813-42-1255,SNGL FAM SUB,8.702,AC,67700,0,67700,0,0,67700,66300,0,66300,0,0,66300,A1,AG/GEN,,,
592,4-1-0-10-0,6803-44-0712,SNGL FAM SUB,2,AC,44500,0,44500,124000,2500,171000,43500,0,43500,108100,2500,154100,A1,AG/GEN,,,
593,47-23-0-1-0,7717-23-6355,SNGL FAM SUB,2,AC,110000,0,110000,171300,700,282000,98200,0,98200,144300,700,243200,A2,AG/LTD,,,
594,43-20-0-33-0,6768-61-6842,SNGL FAM SUB,2.78,AC,96800,0,96800,214900,3800,315500,88000,0,88000,187700,3800,279500,A2,AG/LTD,,,
595,6-6-0-32-0,6833-93-2011,SNGL FAM SUB,5.69,AC,60800,0,60800,110300,3000,174100,54100,0,54100,97600,3000,154700,A1,AG/GEN,,,
596,19-1-0-50-B,6830-57-5005,AG 20-100 AC,32,AC,206400,144600,61800,306100,56700,569200,195600,132500,63100,253100,44100,492800,A1,AG/GEN,,,
597,14-2-0-13-0,6851-27-5379,SNGL FAM SUB,3.15,AC,67800,0,67800,184800,19600,272200,66400,0,66400,157400,20300,244100,A1,AG/GEN,,,
598,39-4-0-7-0,6726-57-9658,SNGL FAM SUB,5,AC,63200,0,63200,186600,22400,272200,62000,0,62000,159300,18400,239700,A1,AG/GEN,,,
599,16-1-0-72-B,6800-03-3130,SNGL FAM SUB,1.86,AC,42600,0,42600,139200,4000,185800,40600,0,40600,124800,4000,169400,A1,AG/GEN,,,
600,55-15-0-2-0,6785-67-3214,SNGL FAM SUB,3,AC,114300,0,114300,239100,1000,354400,102000,0,102000,199600,1000,302600,A2,AG/LTD,,,
601,31-6-0-1-0,6778-42-7076,SNGL FAM SUB,6.38,AC,125400,0,125400,275400,18400,419200,112100,0,112100,230800,16900,359800,A2,AG/LTD,,,
602,13-17-0-6-0,6832-90-5364,SNGL FAM SUB,2.94,AC,60200,0,60200,157800,34500,252500,59500,0,59500,137300,27700,224500,A1,AG/GEN,,,
603,20-8-A-3-0,6840-32-9219,SNGL FAM SUB,1.617,AC,53900,0,53900,141200,8500,203600,51800,0,51800,126000,5500,183300,A1,AG/GEN,,,
604,2-1-0-31-0,6814-62-6505,SNGL FAM SUB,4.214,AC,56100,0,56100,179800,54200,290100,55100,0,55100,157900,45200,258200,A1,AG/GEN,,,
605,39-6-0-3-0,6726-17-5145,SNGL FAM SUB,1,AC,38800,0,38800,114500,600,153900,38000,0,38000,97700,600,136300,A1,AG/GEN,,,
606,46-21-B-1-0,7707-99-4876,SNGL FAM SUB,2.5,AC,129400,0,129400,233200,900,363500,117600,0,117600,196900,900,315400,A2,AG/LTD,,,
607,18-1-0-33-0,6729-69-7507,SNGL FAM SUB,7.885,AC,62600,0,62600,0,0,62600,61900,0,61900,0,0,61900,A1,AG/GEN,,,
608,18-1-0-35-B,6820-60-3562,SNGL FAM SUB,2.42,AC,48500,0,48500,68500,700,117700,45800,0,45800,59500,700,106000,A1,AG/GEN,,,
609,6-1-0-11-0,6823-73-8589,SNGL FAM SUB,1.23,AC,40900,0,40900,167400,300,208600,40200,0,40200,145600,300,186100,A1,AG/GEN,,,
610,6-1-0-16-0,6823-83-0588,SNGL FAM SUB,2.977,AC,49800,0,49800,39600,200,89600,48900,0,48900,35300,200,84400,A1,AG/GEN,,,
611,6-1-0-12-0,6823-74-9163,SNGL FAM SUB,6,AC,65200,0,65200,0,0,65200,64000,0,64000,0,0,64000,A1,AG/GEN,,,
614,6-1-0-17-0,6823-83-0109,SNGL FAM SUB,1.023,AC,39800,0,39800,145600,700,186100,39100,0,39100,125700,4500,169300,A1,AG/GEN,,,
615,6-1-0-11-C,6823-83-2371,SNGL FAM SUB,2,AC,44800,0,44800,0,0,44800,44000,0,44000,0,0,44000,A1,AG/GEN,,,
616,45-1-0-94-A,6797-88-6247,SNGL FAM SUB,2.21,AC,86800,0,86800,146400,900,234100,77500,0,77500,119400,900,197800,A2,AG/LTD,,,
617,45-1-0-92-A,6797-87-4930,SNGL FAM SUB,2.32,AC,88300,0,88300,175500,42700,306500,78800,0,78800,143100,35700,257600,A2,AG/LTD,,,
618,45-1-0-94-0,6797-88-5039,SNGL FAM SUB,2.557,AC,91600,0,91600,136700,2600,230900,81800,0,81800,112800,2600,197200,A2,AG/LTD,,,
619,43-15-0-7-0,6768-91-6093,SNGL FAM SUB,3.32,AC,92000,0,92000,182700,3500,278200,83600,0,83600,166400,3500,253500,A2,AG/LTD,,,
620,26-5-0-B-0,6709-54-9892,SNGL FAM SUB,6.13,AC,48100,0,48100,0,0,48100,47200,0,47200,0,0,47200,A1,AG/GEN,,,
621,39-1-0-10-0,6717-67-7149,SNGL FAM SUB,11.43,AC,92000,0,92000,267600,65700,425300,90200,0,90200,244600,56400,391200,A1,AG/GEN,,,
622,42-1-0-1-0,6757-49-5010,SNGL FAM SUB,4.62,AC,99700,0,99700,199100,7300,306100,87500,0,87500,167500,7300,262300,A2,AG/LTD,,,
623,18-4-0-4-E,6820-12-1172,SNGL FAM SUB,6,AC,68500,0,68500,0,0,68500,65500,0,65500,0,0,65500,A1,AG/GEN,,,
624,67-2-B-5-0,7723-56-0365,SNGL FAM SUB,0,AC,184000,0,184000,247600,22400,454000,160000,0,160000,206200,21500,387700,R1,RES/LTD,,,
625,64-19-E-16-0,7733-37-9510,SNGL FAM SUB,0,AC,265000,0,265000,416100,0,681100,220000,0,220000,379600,0,599600,R1,RES/LTD,,,
626,5-3-0-21-0,6823-29-5839,SNGL FAM SUB,4.68,AC,69500,0,69500,0,0,69500,68100,0,68100,0,0,68100,A1,AG/GEN,,,
627,15-1-0-15-0,5880-65-1607,AG 20-100 AC,23.835,AC,60300,45100,15200,0,0,60300,59600,45300,14300,0,0,59600,A1,AG/GEN,,,
628,15-1-0-16-0,5880-55-3523,SNGL FAM SUB,5,AC,49300,0,49300,104500,3900,157700,48200,0,48200,90900,3900,143000,A1,AG/GEN,,,
629,15-1-0-14-0,5880-65-8711,SNGL FAM SUB,19.849,AC,50700,41500,9200,0,0,50700,49600,41200,8400,0,0,49600,A1,AG/GEN,,,
630,44-17-0-7-0,6787-24-2143,SNGL FAM SUB,3.79,AC,103600,0,103600,0,6000,109600,92500,0,92500,0,5000,97500,A2,AG/LTD,,,
631,44-17-0-1-0,6787-23-0742,SNGL FAM SUB,1.38,AC,76100,0,76100,133000,800,209900,68000,0,68000,108600,800,177400,A2,AG/LTD,,,
632,64-12-B-16-0,7723-59-7968,SNGL FAM SUB,0,AC,61600,0,61600,0,0,61600,53600,0,53600,0,0,53600,R1,RES/LTD,,,
633,64-12-B-17-0,7723-59-6938,SNGL FAM SUB,0,AC,77000,0,77000,117700,2900,197600,67000,0,67000,102700,3000,172700,R1,RES/LTD,,,
634,44-1-0-50-D,6787-33-8211,SNGL FAM SUB,2.2,AC,89100,0,89100,197400,5000,291500,79500,0,79500,159900,5000,244400,A2,AG/LTD,,,
635,57-1-0-14-0,7706-23-5762,SNGL FAM SUB,8.709,AC,311100,0,311100,0,0,311100,270800,0,270800,0,0,270800,A2,AG/LTD,,,
636,47-23-0-5-0,7717-22-6497,SNGL FAM SUB,2,AC,110000,0,110000,149100,40700,299800,98200,0,98200,124500,35200,257900,A2,AG/LTD,,,
637,44-17-0-5-0,6787-23-7664,SNGL FAM SUB,1.38,AC,76100,0,76100,126900,0,203000,68000,0,68000,104700,0,172700,A2,AG/LTD,,,
638,63-1-0-197-0,7723-39-9344,SNGL FAM SUB,3,AC,205600,0,205600,0,0,205600,178800,0,178800,0,0,178800,A2,AG/LTD,,,
639,48-13-0-D-0,7726-69-7264,SNGL FAM SUB,4.91,AC,207600,0,207600,0,0,207600,185300,0,185300,0,0,185300,A2,AG/LTD,,,
640,6-1-0-21-0,6833-00-2925,SNGL FAM SUB,19.88,AC,164300,0,164300,0,0,164300,159200,0,159200,0,0,159200,A1,AG/GEN,,,
641,6-1-0-21-A,6833-00-8506,SNGL FAM SUB,1.32,AC,42900,0,42900,0,0,42900,41600,0,41600,0,0,41600,A1B1,AG GEN/,,,
642,59-1-0-39-0,7726-93-1453,SNGL FAM SUB,5.6,AC,36300,0,36300,0,0,36300,32900,0,32900,0,0,32900,A2,AG/LTD,,,
643,17-1-0-77-0,6810-01-7122,SNGL FAM SUB,3.3,AC,51000,0,51000,0,0,51000,50700,0,50700,0,0,50700,A1,AG/GEN,,,
644,46-1-0-113-A,7707-87-1007,SNGL FAM SUB,3.4411,AC,179900,0,179900,335700,56000,571600,163500,0,163500,282700,54200,500400,A2,AG/LTD,,,
645,46-1-0-113-B,7707-77-8087,SNGL FAM SUB,2,AC,165000,0,165000,369300,5700,540000,150000,0,150000,318500,5100,473600,A2,AG/LTD,,,
646,62-21-0-3-0,7704-98-9512,SNGL FAM SUB,5,AC,302500,0,302500,379800,6700,689000,263000,0,263000,356300,6700,626000,A2,AG/LTD,,,
648,45-6-0-1-A,6797-40-2639,AG 20-100 AC,30.981,AC,556400,0,556400,319300,14000,889700,496500,0,496500,263600,14000,774100,A2,AG/LTD,,,
649,47-16-0-B-2,7718-30-2193,SNGL FAM SUB,2,AC,116000,0,116000,201000,400,317400,103600,0,103600,174700,400,278700,A2,AG/LTD,,,
650,9-1-0-46-B,5892-30-8298,SNGL FAM SUB,2.33,AC,43600,0,43600,0,0,43600,42700,0,42700,0,0,42700,A1,AG/GEN,,,
652,56-2-0-1-0,6795-78-1732,AG 20-100 AC,45.12,AC,1212100,725900,486200,445000,18000,1675100,1052600,629500,423100,376700,18000,1447300,A2,AG/LTD,,,
653,30-1-0-119-0,6759-55-4248,SNGL FAM SUB,15,AC,154900,0,154900,94200,4700,253800,142000,0,142000,80300,2900,225200,A2,AG/LTD,,,
654,29-12-0-5-0,6748-78-0218,SNGL FAM SUB,1.464,AC,58600,0,58600,91800,200,150600,54300,0,54300,76800,200,131300,A1,AG/GEN,,,
655,55-14-0-10-0,6785-18-4339,SNGL FAM SUB,6.9,AC,154600,0,154600,547300,0,701900,138100,0,138100,450800,0,588900,A2,AG/LTD,,,
656,4-1-0-12-0,6803-33-9805,SNGL FAM SUB,13.65,AC,110500,0,110500,198500,23600,332600,107600,0,107600,170200,19900,297700,A1,AG/GEN,,,
659,44-16-0-21-0,6787-29-9435,SNGL FAM SUB,3.13,AC,129000,0,129000,199700,14000,342700,115000,0,115000,178200,13700,306900,A2,AG/LTD,,,
660,21-1-0-53-0,6850-83-1275,SNGL FAM SUB,2.65,AC,74200,0,74200,387200,0,461400,67100,0,67100,321400,0,388500,A2,AG/LTD,,,
661,29-8-0-1-0,6749-96-4747,SNGL FAM SUB,2.97,AC,73300,0,73300,262100,72000,407400,69400,0,69400,216100,63800,349300,A1,AG/GEN,,,
662,29-10-0-C-0,6749-85-7713,SNGL FAM SUB,1.15,AC,55500,0,55500,114300,700,170500,51400,0,51400,93900,700,146000,A1,AG/GEN,,,
663,29-10-0-L-0,6749-93-0976,SNGL FAM SUB,11.09,AC,110700,0,110700,0,0,110700,122800,0,122800,0,0,122800,A1,AG/GEN,,,
664,29-1-0-95-0,6749-96-7399,SNGL FAM SUB,3,AC,73600,0,73600,139500,900,214000,69700,0,69700,115500,900,186100,A1,AG/GEN,,,
665,42-1-0-16-0,6757-60-4817,SNGL FAM SUB,8.394,AC,242800,0,242800,0,0,242800,211000,0,211000,0,0,211000,A2,AG/LTD,,,
666,18-1-0-65-A,6820-53-4791,SNGL FAM SUB,8.218,AC,79800,0,79800,141900,2900,224600,81300,0,81300,117600,3200,202100,A1,AG/GEN,,,
668,3-1-0-12-0,5892-69-8020,SNGL FAM SUB,18.302,AC,78900,70500,8400,0,0,78900,76300,68500,7800,0,0,76300,A1,AG/GEN,,,
669,4-1-0-57-0,6812-19-5071,AG 20-100 AC,59,AC,234000,171600,62400,516600,0,750600,229500,169700,59800,461300,0,690800,A1,AG/GEN,,,
671,7-1-0-3-0,6843-11-2685,AG > 100 AC,173.166,AC,442000,362200,79800,0,0,442000,434400,360800,73600,0,0,434400,A1,AG/GEN,,,
672,9-14-0-4-0,5892-50-8298,AG 20-100 AC,25.74,AC,77800,65900,11900,0,0,77800,77200,66300,10900,0,0,77200,A1,AG/GEN,,,
673,10-1-0-8-0,6802-30-9503,AG > 100 AC,154.35,AC,299700,226800,72900,0,0,299700,293700,227900,65800,0,0,293700,A1,AG/GEN,,,
674,10-1-0-9-0,6801-69-9247,AG > 100 AC,344.03,AC,807000,610100,196900,61800,74800,943600,791000,611000,180000,67500,58900,917400,A1,AG/GEN,,,
675,11-1-0-27-0,6811-85-8243,AG 20-100 AC,23.14,AC,97200,86500,10700,0,0,97200,104100,94300,9800,0,0,104100,A1,AG/GEN,,,
694,19-1-0-21-0,6729-68-3275,AG > 100 AC,106,AC,273100,224200,48900,0,0,273100,267500,222400,45100,0,0,267500,A1,AG/GEN,,,
695,20-1-0-2-0,6841-31-1254,AG > 100 AC,185.2,AC,686100,600700,85400,0,0,686100,666700,588000,78700,0,0,666700,A1,AG/GEN,,,
696,20-1-0-20-0,6840-01-3427,AG 20-100 AC,44.696,AC,334300,313700,20600,0,0,334300,326300,307300,19000,0,0,326300,A1,AG/GEN,,,
697,20-1-0-27-0,6739-98-2630,AG 20-100 AC,80.17,AC,285700,248700,37000,0,0,285700,288600,254500,34100,0,0,288600,A1,AG/GEN,,,
698,20-1-0-28-0,6749-08-2070,AG 20-100 AC,48.08,AC,176000,153800,22200,0,0,176000,173100,152700,20400,0,0,173100,A1,AG/GEN,,,
700,20-1-0-46-0,6840-68-0214,AG 20-100 AC,57.67,AC,351500,324900,26600,0,0,351500,339700,315200,24500,0,0,339700,A1,AG/GEN,,,
705,22-1-0-12-0,6779-17-4909,SNGL FAM SUB,4.97,AC,30100,27800,2300,0,0,30100,26800,24700,2100,0,0,26800,A2,AG/LTD,,,
706,25-1-0-4-0,5799-94-6912,AG > 100 AC,412.08,AC,817000,627000,190000,0,0,817000,796700,621600,175100,0,0,796700,A1,AG/GEN,,,
709,27-1-0-3-0,6719-54-9361,AG 20-100 AC,75.9,AC,283800,248800,35000,0,0,283800,288400,256100,32300,0,0,288400,A1,AG/GEN,,,
711,27-1-0-24-0,6718-62-9187,SNGL FAM SUB,10.48,AC,67700,62900,4800,0,0,67700,66400,61900,4500,0,0,66400,A1,AG/GEN,,,
712,27-1-0-25-0,6718-83-9581,AG > 100 AC,219.03,AC,449000,348000,101000,0,0,449000,435600,343000,92600,0,0,435600,A1,AG/GEN,,,
713,27-1-0-26-0,6728-11-0834,AG 20-100 AC,84.61,AC,215000,176000,39000,0,0,215000,211500,175500,36000,0,0,211500,A1,AG/GEN,,,
714,27-1-0-42-0,6718-85-3798,AG > 100 AC,243.24,AC,498600,386500,112100,0,0,498600,486500,383100,103400,0,0,486500,A1,AG/GEN,,,
717,28-1-0-116-0,6738-59-4766,AG 20-100 AC,37.5,AC,141400,124100,17300,0,0,141400,135000,119100,15900,0,0,135000,A1,AG/GEN,,,
719,28-1-0-120-0,6739-65-4392,AG > 100 AC,154.61,AC,535800,456900,78900,0,0,535800,528800,462300,66500,0,0,528800,A1,AG/GEN,,,
720,28-1-0-122-0,6739-86-8555,AG > 100 AC,110.3,AC,335200,282700,52500,0,158900,494100,309900,262800,47100,0,158900,468800,A1,AG/GEN,,,
721,29-1-0-2-0,6749-27-2258,AG 20-100 AC,42.08,AC,195500,176100,19400,0,0,195500,181800,163900,17900,0,0,181800,A1,AG/GEN,,,
722,29-1-0-105-0,6759-03-9136,AG 20-100 AC,64.4,AC,400100,370400,29700,0,0,400100,367100,339700,27400,0,0,367100,A1,AG/GEN,,,
723,29-1-0-109-0,6759-10-0609,AG 20-100 AC,46.2,AC,222500,201200,21300,0,0,222500,217100,197500,19600,0,0,217100,A1,AG/GEN,,,
725,38-1-0-114-0,6718-51-3448,AG 20-100 AC,95.849,AC,244400,200200,44200,0,0,244400,239600,198900,40700,0,0,239600,A1,AG/GEN,,,
726,38-1-0-115-0,6717-49-4962,AG 20-100 AC,33.48,AC,120500,105100,15400,0,0,120500,117200,103000,14200,0,0,117200,A1,AG/GEN,,,
727,38-1-0-122-0,6717-43-9922,AG > 100 AC,128.215,AC,353100,294000,59100,0,0,353100,346200,291700,54500,0,0,346200,A1,AG/GEN,,,
728,38-1-0-129-0,6717-40-2883,AG > 100 AC,329.3,AC,675100,523300,151800,0,0,675100,658600,518600,140000,0,0,658600,A1,AG/GEN,,,
729,39-1-0-1-0,6718-70-6805,AG > 100 AC,138.13,AC,331300,267600,63700,0,0,331300,324800,266100,58700,0,0,324800,A1,AG/GEN,,,
730,39-1-0-2-0,6718-91-5393,AG 20-100 AC,70.13,AC,178800,146500,32300,0,0,178800,175300,145500,29800,0,0,175300,A1,AG/GEN,,,
733,40-1-0-28-0,6737-25-5624,AG > 100 AC,127.836,AC,378100,319200,58900,0,0,378100,371800,317500,54300,0,0,371800,A1,AG/GEN,,,
734,40-1-0-29-0,6737-44-0407,AG 20-100 AC,46.833,AC,200700,179100,21600,0,0,200700,196700,176800,19900,0,0,196700,A1,AG/GEN,,,
735,40-1-0-32-0,6737-78-6559,AG > 100 AC,268.524,AC,990900,867100,123800,0,0,990900,966700,852600,114100,0,0,966700,A1,AG/GEN,,,
736,67-12-0-15-0,7723-46-7739,SNGL FAM SUB,3.099,AC,370500,0,370500,445700,17700,833900,323000,0,323000,387800,17000,727800,R1,RES/LTD,,,
737,17-1-0-92-0,6810-21-4209,SNGL FAM SUB,7.13,AC,74800,0,74800,0,0,74800,71700,0,71700,0,0,71700,A1,AG/GEN,,,
738,55-15-0-13-0,6785-77-4641,SNGL FAM SUB,3,AC,114300,0,114300,349300,1000,464600,102000,0,102000,293000,1000,396000,A2,AG/LTD,,,
739,55-15-0-11-0,6785-77-3114,SNGL FAM SUB,3,AC,93600,0,93600,0,0,93600,83600,0,83600,0,0,83600,A2,AG/LTD,,,
740,62-4-D-9-0,7714-04-9573,SNGL FAM SUB,0,AC,115000,0,115000,308000,18500,441500,100000,0,100000,282400,16700,399100,R1,RES/LTD,,,
741,54-3-0-D-0,6766-81-8935,AG 20-100 AC,62.94,AC,811900,783300,28600,0,5000,816900,727100,701100,26000,0,5000,732100,A2,AG/LTD,,,
742,54-3-0-E-0,6766-91-3401,AG 20-100 AC,30.35,AC,440800,426900,13900,0,0,440800,394100,381700,12400,0,0,394100,A2,AG/LTD,,,
743,54-3-0-C-0,6766-82-1986,AG 20-100 AC,58.3,AC,944200,577800,366400,1561200,265400,2770800,842100,515300,326800,1288800,241500,2372400,A2,AG/LTD,,,
744,55-1-0-45-A,6786-52-1975,SNGL FAM SUB,0.91,AC,67000,0,67000,0,0,67000,59800,0,59800,0,0,59800,A2,AG/LTD,,,
745,45-4-0-1-0,6796-47-7979,SNGL FAM SUB,1.78,AC,95000,0,95000,5000,100,100100,84800,0,84800,5000,100,89900,A2,AG/LTD,,,
746,45-4-0-2-0,6796-48-9057,SNGL FAM SUB,1.037,AC,83300,0,83300,0,0,83300,74300,0,74300,0,0,74300,A2,AG/LTD,,,
747,32-10-1-4-0,6778-78-5745,SNGL FAM SUB,1.11,AC,68900,0,68900,171800,5300,246000,61500,0,61500,141000,5000,207500,A2,AG/LTD,,,
748,67-1-0-20-A,7733-34-2502,SNGL FAM SUB,3.18,AC,257600,0,257600,364300,0,621900,224000,0,224000,304100,0,528100,A2,AG/LTD,,,
749,67-16-0-1-0,7733-34-2787,SNGL FAM SUB,4.104,AC,292200,0,292200,0,0,292200,254000,0,254000,0,0,254000,A2,AG/LTD,,,
750,43-21-0-18-0,6767-42-0578,SNGL FAM SUB,2.211,AC,88400,0,88400,195700,300,284400,78900,0,78900,159000,300,238200,A2,AG/LTD,,,
751,44-19-0-8-0,6778-91-4561,SNGL FAM SUB,5.25,AC,107000,0,107000,196400,2200,305600,95500,0,95500,166200,2200,263900,A2,AG/LTD,,,
752,62-4-E-3-0,7714-04-5799,SNGL FAM SUB,0,AC,115000,0,115000,227700,0,342700,100000,0,100000,208500,0,308500,R1,RES/LTD,,,
753,31-1-0-32-0,6768-97-6955,SNGL FAM SUB,1.471,AC,71200,0,71200,230500,3500,305200,63600,0,63600,190800,3500,257900,A2,AG/LTD,,,
754,1-1-0-18-0,6804-99-4327,AG 20-100 AC,42.236,AC,172300,152800,19500,0,0,172300,168900,150900,18000,0,0,168900,A1,AG/GEN,,,
755,20-12-0-5-0,6840-99-2221,SNGL FAM SUB,2.13,AC,56700,0,56700,189000,1400,247100,53000,0,53000,163400,1600,218000,A1,AG/GEN,,,
756,17-1-0-90-0,6810-30-3375,SNGL FAM SUB,18.33,AC,127000,0,127000,87700,0,214700,124700,0,124700,74500,0,199200,A1,AG/GEN,,,
757,20-11-0-26-0,6851-02-1118,SNGL FAM SUB,2.11,AC,59500,0,59500,145600,2200,207300,58400,0,58400,128300,2000,188700,A1,AG/GEN,,,
758,47-1-0-67-0,7727-08-3775,SNGL FAM SUB,2.583,AC,113300,0,113300,206500,11700,331500,101300,0,101300,174700,11700,287700,RR,RES/RUR,,,
759,64-9-0-1-0,7724-90-4673,SNGL FAM SUB,2.8,AC,233200,0,233200,370200,31400,634800,202700,0,202700,310500,28900,542100,A2,AG/LTD,,,
760,57-17-0-2-0,7706-23-1808,SNGL FAM SUB,4.59,AC,202800,0,202800,238600,56300,497700,176500,0,176500,199300,47600,423400,A2,AG/LTD,,,
761,46-1-0-91-0,7718-00-4486,SNGL FAM SUB,1.73,AC,109000,0,109000,303300,65000,477300,97400,0,97400,278000,34900,410300,A2,AG/LTD,,,
762,30-3-0-A-0,6768-28-8888,SNGL FAM SUB,13.499,AC,162200,0,162200,137300,8000,307500,152900,0,152900,114000,6500,273400,A2,AG/LTD,,,
763,64-19-E-1-0,7733-38-7005,SNGL FAM SUB,0,AC,251800,0,251800,574400,23100,849300,209000,0,209000,473400,20100,702500,R1,RES/LTD,,,
764,46-1-0-75-0,7707-34-7389,AG 20-100 AC,22.55,AC,561200,392600,168600,737000,600,1298800,501100,350800,150300,605000,600,1106700,A2,AG/LTD,,,
765,57-23-0-1-0,7706-12-8323,SNGL FAM SUB,3.66,AC,178400,0,178400,0,0,178400,155200,0,155200,0,0,155200,A2,AG/LTD,,,
766,57-23-0-2-0,7706-22-3187,SNGL FAM SUB,6.41,AC,250700,0,250700,579800,4000,834500,218200,0,218200,483700,4000,705900,A2,AG/LTD,,,
767,5-3-0-11-0,6823-19-1068,SNGL FAM SUB,1.23,AC,45500,0,45500,167400,0,212900,44500,0,44500,146200,0,190700,A1,AG/GEN,,,
768,30-1-0-77-0,6758-76-0093,AG > 100 AC,152.84,AC,1447400,1366400,81000,0,0,1447400,1349400,1275800,73600,0,0,1349400,A2,AG/LTD,,,
769,13-1-0-15-A,6841-57-9136,SNGL FAM SUB,0.71,AC,4300,0,4300,0,0,4300,4200,0,4200,0,0,4200,A1,AG/GEN,,,
770,13-1-0-25-0,6841-77-1531,AG 20-100 AC,63.89,AC,306000,196400,109600,391300,35900,733200,300000,194000,106000,346200,29800,676000,A1,AG/GEN,,,
771,30-1-0-76-C,6758-86-6856,SNGL FAM SUB,11.51,AC,176900,171300,5600,0,0,176900,159200,154300,4900,0,0,159200,A2,AG/LTD,,,
772,31-1-0-102-0,6768-93-0207,SNGL FAM SUB,5.3,AC,132000,0,132000,130600,26900,289500,118100,0,118100,108000,23700,249800,A2,AG/LTD,,,
773,31-1-0-103-0,6768-92-6407,AG 20-100 AC,48.98,AC,582300,494800,87500,0,18300,600600,517800,440000,77800,0,15400,533200,A2,AG/LTD,,,
774,14-2-0-22-0,6851-38-0330,SNGL FAM SUB,4.22,AC,74200,0,74200,149100,4900,228200,72700,0,72700,133600,5800,212100,A1,AG/GEN,,,
775,55-19-0-1-0,6776-85-9197,SNGL FAM SUB,4.362,AC,116500,0,116500,296800,400,413700,104000,0,104000,249100,400,353500,A2,AG/LTD,,,
776,55-19-0-2-0,6776-85-7245,SNGL FAM SUB,2.654,AC,92900,0,92900,201400,2000,296300,82900,0,82900,170200,2000,255100,A2,AG/LTD,,,
777,55-19-0-3-0,6776-85-5133,SNGL FAM SUB,2.841,AC,95500,0,95500,177200,9100,281800,85200,0,85200,146000,7900,239100,A2,AG/LTD,,,
778,18-4-0-2-A,6729-29-8721,SNGL FAM SUB,9.879,AC,88500,0,88500,0,0,88500,86800,0,86800,0,0,86800,A1,AG/GEN,,,
779,67-1-0-11-A,7723-53-8571,SNGL FAM SUB,17.07,AC,777100,0,777100,0,273500,1050600,675400,0,675400,0,238400,913800,A2R1,AG LTD/,,,
781,55-15-0-21-0,6785-57-7320,SNGL FAM SUB,3.06,AC,115200,0,115200,354400,1500,471100,102800,0,102800,296600,1500,400900,A2,AG/LTD,,,
782,43-1-0-57-B,6768-81-1304,Roads,0.8,AC,0,0,0,0,0,0,0,0,0,0,0,0,A2,AG/LTD,,,
783,48-2-B-1-0,7726-68-8131,SNGL FAM SUB,0.6,AC,130000,0,130000,389600,38800,558400,117000,0,117000,337500,36400,490900,R1,RES/LTD,,,
784,42-5-0-10-0,6767-04-1480,SNGL FAM SUB,0,AC,70000,0,70000,142000,2800,214800,64000,0,64000,132600,3000,199600,R3,RES/GEN,,,
785,57-1-0-34-C,7706-40-4204,SNGL FAM SUB,13,AC,456200,0,456200,361900,20400,838500,397200,0,397200,302300,17200,716700,A2,AG/LTD,,,
786,20-11-0-3-0,6841-91-1309,SNGL FAM SUB,2,AC,58600,0,58600,177600,3200,239400,57500,0,57500,163600,3200,224300,A1,AG/GEN,,,
787,4-2-0-30-0,6814-40-4484,SNGL FAM SUB,3.67,AC,53900,0,53900,334700,500,389100,52800,0,52800,282200,500,335500,A1,AG/GEN,,,
788,62-20-E-5-0,7714-16-0382,SNGL FAM SUB,0,AC,115000,0,115000,234300,0,349300,100000,0,100000,215400,0,315400,R1,RES/LTD,,,
789,57-20-E-1-0,7715-19-7150,SNGL FAM SUB,2.432,AC,315000,0,315000,298700,0,613700,288800,0,288800,274900,0,563700,A2,AG/LTD,,,
790,29-6-0-A-0,6749-83-1679,SNGL FAM SUB,10.189,AC,134700,0,134700,0,0,134700,136300,0,136300,0,0,136300,A1,AG/GEN,,,
791,29-6-0-B-0,6749-83-1345,SNGL FAM SUB,8.23,AC,118900,0,118900,0,0,118900,117900,0,117900,0,0,117900,A1,AG/GEN,,,
793,42-1-0-118-0,6766-27-3647,SNGL FAM SUB,10.565,AC,135800,0,135800,465400,5000,606200,121100,0,121100,393500,5000,519600,A2,AG/LTD,,,
794,42-1-0-120-0,6767-30-0939,AG 20-100 AC,28.14,AC,322400,309400,13000,0,0,322400,288100,276100,12000,0,0,288100,A2,AG/LTD,,,
795,43-1-0-32-0,6767-41-3435,SNGL FAM SUB,2.2,AC,87400,0,87400,325200,2500,415100,78100,0,78100,267200,2500,347800,A2,AG/LTD,,,
796,43-1-0-32-A,6767-41-1232,SNGL FAM SUB,2.17,AC,86900,0,86900,331900,64300,483100,77700,0,77700,270800,57200,405700,A2,AG/LTD,,,
797,43-1-0-32-B,6767-31-9062,SNGL FAM SUB,1.501,AC,77300,0,77300,248200,48600,374100,69100,0,69100,202900,42700,314700,A2,AG/LTD,,,
798,63-1-0-147-0,7715-80-9519,AG 20-100 AC,54.63,AC,1453200,1401900,51300,0,0,1453200,1262000,1216100,45900,0,0,1262000,A2,AG/LTD,,,
799,42-1-0-25-0,6766-07-9586,COMM & IND,1.461,AC,182500,0,182500,0,0,182500,78600,0,78600,3000,0,81600,B1,BUS/GEN,,,
801,42-1-0-26-0,6766-07-8786,COMM & IND,1.357,AC,178000,0,178000,347500,12500,538000,103600,0,103600,326700,8600,438900,B1,BUS/GEN,,,
802,30-1-0-65-0,6759-52-9693,AG 20-100 AC,31.31,AC,314900,300500,14400,500,0,315400,294300,281000,13300,500,0,294800,A2,AG/LTD,,,
803,29-3-0-13-0,6749-63-8282,SNGL FAM SUB,3.41,AC,77400,0,77400,0,0,77400,73800,0,73800,0,0,73800,A1,AG/GEN,,,
804,29-1-0-70-0,6749-73-0406,SNGL FAM SUB,4.38,AC,86200,0,86200,196600,500,283300,83400,0,83400,168900,500,252800,A1,AG/GEN,,,
805,29-1-0-73-B,6749-55-7445,SNGL FAM SUB,10.315,AC,128700,0,128700,0,0,128700,126700,0,126700,0,0,126700,A1,AG/GEN,,,
806,29-3-0-12-0,6749-62-9906,SNGL FAM SUB,2.59,AC,69700,0,69700,334500,0,404200,65600,0,65600,276600,0,342200,A1,AG/GEN,,,
807,29-3-0-13-A,6749-63-9037,SNGL FAM SUB,0.59,AC,5900,0,5900,0,0,5900,5500,0,5500,0,0,5500,A1,AG/GEN,,,
808,29-3-0-18-0,6749-63-5579,SNGL FAM SUB,1.24,AC,49200,0,49200,0,0,49200,46600,0,46600,0,0,46600,A1,AG/GEN,,,
809,29-1-0-102-0,6749-84-1087,SNGL FAM SUB,6.136,AC,101200,0,101200,5000,0,106200,100700,0,100700,28300,700,129700,A1,AG/GEN,,,
810,29-1-0-100-0,6749-84-2333,SNGL FAM SUB,4.175,AC,84400,0,84400,0,0,84400,81300,0,81300,0,0,81300,A1,AG/GEN,,,
811,29-1-0-101-0,6749-84-2578,SNGL FAM SUB,4.175,AC,84400,0,84400,0,0,84400,81300,0,81300,0,0,81300,A1,AG/GEN,,,
812,29-3-0-14-0,6749-63-5185,SNGL FAM SUB,2.22,AC,57900,0,57900,214500,0,272400,54200,0,54200,173500,0,227700,A1,AG/GEN,,,
813,20-1-0-94-0,6759-07-7368,SNGL FAM SUB,2.44,AC,68300,0,68300,108200,9000,185500,64900,0,64900,89100,7400,161400,A1,AG/GEN,,,
814,29-3-0-30-0,6749-33-3537,SNGL FAM SUB,11.75,AC,130800,0,130800,398800,0,529600,128600,0,128600,327800,0,456400,A1,AG/GEN,,,
815,38-1-0-104-0,6717-18-2466,SNGL FAM SUB,5,AC,61200,0,61200,202000,22500,285700,60000,0,60000,173100,19700,252800,A1,AG/GEN,,,
816,29-1-0-125-0,6748-98-8910,SNGL FAM SUB,9.962,AC,121500,0,121500,0,0,121500,115300,0,115300,0,0,115300,A1,AG/GEN,,,
817,16-4-0-10-0,5890-46-8135,SNGL FAM SUB,1,AC,38800,0,38800,140500,700,180000,38000,0,38000,125200,700,163900,A1,AG/GEN,,,
818,16-4-0-20-A,5890-46-6332,SNGL FAM SUB,1.61,AC,41000,0,41000,188600,0,229600,40100,0,40100,163400,0,203500,A1,AG/GEN,,,
819,64-12-C-2-0,7724-60-0384,SNGL FAM SUB,0,AC,77000,0,77000,190700,3000,270700,67000,0,67000,163100,3000,233100,R1,RES/LTD,,,
820,62-20-B-5-0,7714-15-5629,SNGL FAM SUB,0,AC,115000,0,115000,284900,0,399900,100000,0,100000,257400,0,357400,R1,RES/LTD,,,
821,29-1-0-41-0,6748-52-3014,SNGL FAM SUB,2,AC,64000,0,64000,187800,800,252600,59300,0,59300,160300,800,220400,A1,AG/GEN,,,
822,67-11-B-5-0,7733-26-2466,SNGL FAM SUB,0,AC,265000,0,265000,855000,3000,1123000,220000,0,220000,719500,3000,942500,R1,RES/LTD,,,
823,18-4-0-2-D,6729-29-3469,SNGL FAM SUB,2.02,AC,46100,0,46100,11500,1100,58700,44100,0,44100,10700,900,55700,A1,AG/GEN,,,
824,30-1-0-119-A,6759-46-7033,SNGL FAM SUB,9.837,AC,169900,0,169900,1000,0,170900,155900,0,155900,1000,0,156900,R1,RES/LTD,,,
825,29-1-0-47-0,6748-69-1369,SNGL FAM SUB,7,AC,108600,0,108600,0,0,108600,106300,0,106300,0,0,106300,A1,AG/GEN,,,
826,29-7-0-2-0,6748-69-7578,SNGL FAM SUB,0.71,AC,28800,0,28800,32400,2500,63700,26600,0,26600,26600,2500,55700,A1,AG/GEN,,,
827,43-1-0-75-0,6777-31-5856,AG > 100 AC,107.182,AC,1231900,1043900,188000,319000,27000,1577900,1096700,931400,165300,265900,27000,1389600,A2,AG/LTD,,,
828,43-1-0-50-0,6777-43-3483,AG > 100 AC,168.02,AC,1859300,0,1859300,0,0,1859300,2515900,0,2515900,0,0,2515900,RP,"RURAL,P",,,
829,67-10-0-15-0,7733-14-6978,SNGL FAM SUB,6.7,AC,430100,0,430100,757500,0,1187600,360500,0,360500,607400,0,967900,R1,RES/LTD,,,
830,43-8-0-A-1,6778-50-2525,SNGL FAM SUB,3.4,AC,91500,0,91500,303900,17500,412900,81700,0,81700,251400,13800,346900,A2,AG/LTD,,,
831,62-18-0-13-0,7704-63-4721,SNGL FAM SUB,3.29,AC,225900,0,225900,550100,15600,791600,200300,0,200300,541200,13600,755100,A2,AG/LTD,,,
832,13-1-0-25-B,6841-78-9817,SNGL FAM SUB,9,AC,93300,0,93300,171000,7900,272200,91400,0,91400,150100,6600,248100,A1,AG/GEN,,,
834,18-6-0-6-0,6820-08-7779,SNGL FAM SUB,6.85,AC,73300,0,73300,147400,300,221000,73100,0,73100,120000,300,193400,A1,AG/GEN,,,
835,63-27-0-11-0,7715-71-4174,SNGL FAM SUB,2.59,AC,147500,0,147500,332700,16500,496700,128200,0,128200,302900,16500,447600,A2,AG/LTD,,,
836,62-2-B-16-0,7704-94-7990,SNGL FAM SUB,0,AC,115000,0,115000,172900,500,288400,100000,0,100000,160900,500,261400,R1,RES/LTD,,,
837,16-1-0-39-A,5890-53-4698,SNGL FAM SUB,10.36,AC,68800,0,68800,193700,9400,271900,66100,0,66100,170200,9400,245700,A1,AG/GEN,,,
838,3-1-0-3-0,6803-38-1399,SNGL FAM SUB,16,AC,92200,0,92200,96500,6700,195400,90600,0,90600,84100,7000,181700,A1,AG/GEN,,,
839,10-4-0-1-0,6802-52-1440,AG 20-100 AC,39.4,AC,112700,0,112700,0,0,112700,111200,0,111200,0,0,111200,A1,AG/GEN,,,
840,43-1-0-90-0,6776-47-2888,SNGL FAM SUB,14,AC,132900,0,132900,0,0,132900,118300,0,118300,0,0,118300,A2,AG/LTD,,,
841,27-1-0-46-0,6719-70-6641,SNGL FAM SUB,7.76,AC,74000,70100,3900,0,0,74000,72700,69300,3400,0,0,72700,A1,AG/GEN,,,
842,27-1-0-47-0,6728-09-2497,SNGL FAM SUB,1.7,AC,4300,3500,800,0,0,4300,4300,3600,700,0,0,4300,A1,AG/GEN,,,
843,27-1-0-48-0,6719-91-7676,AG > 100 AC,350.29,AC,1206000,999800,206200,7500,1800,1215300,1178500,988600,189900,7500,1800,1187800,A1,AG/GEN,,,
844,56-1-0-39-0,6795-13-0401,AG > 100 AC,132.173,AC,2087900,1917500,170400,96400,0,2184300,1866500,1714700,151800,79100,0,1945600,A2,AG/LTD,,,
845,46-1-0-97-A,7707-99-1811,SNGL FAM SUB,1.73,AC,112600,0,112600,189100,22200,323900,102400,0,102400,162200,22200,286800,A2,AG/LTD,,,
846,9-1-0-19-0,5892-63-7702,SNGL FAM SUB,4.25,AC,50500,0,50500,147900,0,198400,49400,0,49400,126000,0,175400,A1,AG/GEN,,,
847,39-1-0-50-0,6717-81-4667,SNGL FAM SUB,2,AC,44400,0,44400,81500,4000,129900,43500,0,43500,67900,4100,115500,A1,AG/GEN,,,
848,27-1-0-82-0,6728-32-7597,SNGL FAM SUB,8,AC,75100,0,75100,220000,0,295100,73700,0,73700,183700,0,257400,A1,AG/GEN,,,
849,67-11-C-5-0,7733-26-5674,SNGL FAM SUB,0,AC,265000,0,265000,547600,2300,814900,220000,0,220000,435300,1600,656900,R1,RES/LTD,,,
850,20-8-A-2-0,6840-42-2010,SNGL FAM SUB,3.99,AC,74900,0,74900,252000,38100,365000,72000,0,72000,227800,36900,336700,A1,AG/GEN,,,
851,11-9-0-C-1,6822-64-2281,SNGL FAM SUB,5.13,AC,60800,0,60800,149600,1700,212100,59700,0,59700,129100,1700,190500,A1,AG/GEN,,,
857,26-8-0-5-A,6708-92-4107,Roads,4.088,AC,0,0,0,0,0,0,0,0,0,0,0,0,A1,AG/GEN,,,
858,27-5-0-3-A,6728-66-7829,SNGL FAM SUB,2.27,AC,46500,0,46500,56400,0,102900,45600,0,45600,48600,0,94200,A1,AG/GEN,,,
859,27-1-0-45-A,6718-79-6892,SNGL FAM SUB,2.28,AC,46000,0,46000,0,0,46000,45000,0,45000,0,0,45000,A1,AG/GEN,,,
860,27-1-0-45-0,6718-79-7987,SNGL FAM SUB,1.5,AC,22500,0,22500,5000,200,27700,22000,0,22000,5000,200,27200,A1,AG/GEN,,,
861,39-1-0-33-0,6727-03-8273,SNGL FAM SUB,8.5,AC,80800,0,80800,0,0,80800,79300,0,79300,0,0,79300,A1,AG/GEN,,,
862,39-1-0-35-0,6727-03-6546,SNGL FAM SUB,5,AC,61200,0,61200,0,0,61200,60000,0,60000,0,0,60000,A1,AG/GEN,,,
863,38-1-0-60-0,6717-00-0652,SNGL FAM SUB,12.812,AC,69900,64000,5900,0,0,69900,68400,63000,5400,0,0,68400,A1,AG/GEN,,,
864,38-1-0-61-0,6717-10-1603,AG 20-100 AC,51.946,AC,132500,108600,23900,0,0,132500,129900,107800,22100,0,0,129900,A1,AG/GEN,,,
865,44-14-0-2-0,6787-63-0492,SNGL FAM SUB,1.67,AC,80700,0,80700,80500,0,161200,72000,0,72000,66500,0,138500,A2,AG/LTD,,,
866,51-2-0-3-0,6736-40-8906,SNGL FAM SUB,5.53,AC,62500,0,62500,77400,0,139900,61400,0,61400,65900,0,127300,A1,AG/GEN,,,
867,46-1-0-55-A,7716-07-7994,SNGL FAM SUB,1.73,AC,115600,0,115600,246600,8600,370800,103300,0,103300,208000,8600,319900,A2,AG/LTD,,,
868,39-1-0-31-0,6727-13-2402,SNGL FAM SUB,1.5,AC,41600,0,41600,180700,200,222500,40800,0,40800,155600,200,196600,A1,AG/GEN,,,
869,39-1-0-34-0,6727-03-9699,SNGL FAM SUB,4,AC,55600,0,55600,42100,100,97800,54500,0,54500,36600,100,91200,A1,AG/GEN,,,
870,30-1-0-95-0,6768-06-0178,SNGL FAM SUB,7.5,AC,126900,0,126900,0,0,126900,117500,0,117500,0,0,117500,A2,AG/LTD,,,
871,30-1-0-97-0,6768-16-1343,SNGL FAM SUB,8.75,AC,122600,0,122600,0,0,122600,114400,0,114400,0,0,114400,A2,AG/LTD,,,
1041,28-4-0-2-0,6739-00-7286,SNGL FAM SUB,1,AC,40000,0,40000,74900,100,115000,39500,0,39500,62300,100,101900,A1,AG/GEN,,,
1042,5-1-0-36-A,6823-07-2411,SNGL FAM SUB,3.14,AC,50600,0,50600,69500,0,120100,49700,0,49700,57300,0,107000,A1,AG/GEN,,,
1043,28-1-0-54-0,6738-17-0366,SNGL FAM SUB,0.82,AC,36100,0,36100,0,0,36100,35600,0,35600,0,0,35600,A1,AG/GEN,,,
1044,51-7-0-A-2,6736-10-9415,SNGL FAM SUB,1.78,AC,43600,0,43600,209100,43300,296000,42700,0,42700,189900,44300,276900,A1,AG/GEN,,,
1045,32-1-0-1-A,6779-76-0570,SNGL FAM SUB,3.529,AC,100500,0,100500,208200,5500,314200,89800,0,89800,169200,4700,263700,A2,AG/LTD,,,
1047,27-3-0-2-0,6728-34-9799,SNGL FAM SUB,16.98,AC,128300,0,128300,96900,900,226100,125900,0,125900,83200,900,210000,A1,AG/GEN,,,
1048,6-1-0-4-A,6823-87-3213,SNGL FAM SUB,1.77,AC,43600,0,43600,37000,900,81500,42900,0,42900,32900,900,76700,A1,AG/GEN,,,
1050,18-1-0-35-A,6820-60-7398,SNGL FAM SUB,9.62,AC,74000,0,74000,0,0,74000,73700,0,73700,0,0,73700,A1,AG/GEN,,,
1051,18-1-0-34-0,6820-70-2311,SNGL FAM SUB,10.25,AC,72800,0,72800,96700,400,169900,71400,0,71400,79300,500,151200,A1,AG/GEN,,,
1052,29-1-0-116-0,6748-89-7076,SNGL FAM SUB,1.957,AC,62600,0,62600,96100,600,159300,57800,0,57800,78400,600,136800,A1,AG/GEN,,,
1221,63-1-0-139-0,7715-81-5917,SNGL FAM SUB,1.95,AC,127800,0,127800,66500,100,194400,111100,0,111100,56500,100,167700,A2,AG/LTD,,,
1222,29-8-0-3-C,6759-07-2213,SNGL FAM SUB,2,AC,64000,0,64000,203200,1000,268200,59800,0,59800,168200,1000,229000,A1,AG/GEN,,,
1223,29-1-0-135-0,6748-87-8353,SNGL FAM SUB,10,AC,129200,85100,44100,0,0,129200,124600,81000,43600,0,0,124600,A1,AG/GEN,,,
1224,42-1-0-47-0,6767-03-3444,SNGL FAM SUB,2.866,AC,272800,0,272800,0,0,272800,241900,0,241900,0,0,241900,RO,RES/OF,,,
1225,26-1-0-46-A,6719-11-7444,COMM & IND,0.34,AC,24300,0,24300,184900,0,209200,23600,0,23600,181000,0,204600,B1,BUS/GEN,,,
1226,27-1-0-43-A,6718-89-5113,SNGL FAM SUB,16.92,AC,128000,81500,46500,255900,124200,508100,125600,80800,44800,214400,146200,486200,A1,AG/GEN,,,
1227,39-5-0-3-0,6717-62-8870,SNGL FAM SUB,10.21,AC,85800,81000,4800,0,0,85800,84100,79700,4400,0,0,84100,A1,AG/GEN,,,
1228,38-1-0-25-C,6707-77-1649,SNGL FAM SUB,2,AC,44400,0,44400,169100,0,213500,43500,0,43500,144000,0,187500,A1,AG/GEN,,,
1229,43-1-0-3-0,6767-69-9884,AG 20-100 AC,22.57,AC,291400,281000,10400,0,0,291400,259300,249700,9600,0,0,259300,A2,AG/LTD,,,
1230,9-1-0-32-A,5892-44-2593,SNGL FAM SUB,2,AC,42400,0,42400,56900,500,99800,41500,0,41500,50100,500,92100,A1,AG/GEN,,,
1397,44-1-0-24-A,6777-91-4499,SNGL FAM SUB,0.486,AC,7700,0,7700,0,0,7700,6900,0,6900,0,0,6900,A2,AG/LTD,,,
1400,43-20-0-12-0,6768-52-0326,SNGL FAM SUB,3.55,AC,96800,0,96800,168800,8500,274100,88000,0,88000,151700,8500,248200,A2,AG/LTD,,,
1401,67-3-F-1-0,7723-54-4204,SNGL FAM SUB,0,AC,184000,0,184000,520500,0,704500,160000,0,160000,450200,0,610200,R1,RES/LTD,,,
1402,55-14-0-17-0,6786-30-7414,SNGL FAM SUB,13.8,AC,245700,0,245700,458700,2300,706700,219500,0,219500,381100,2300,602900,A2,AG/LTD,,,
1403,55-14-0-16-0,6786-30-3605,SNGL FAM SUB,8.48,AC,210500,0,210500,0,0,210500,188100,0,188100,0,0,188100,A2,AG/LTD,,,
872,39-1-0-41-0,6727-02-2658,SNGL FAM SUB,4,AC,55600,0,55600,194200,4200,254000,54500,0,54500,171100,4500,230100,A1,AG/GEN,,,
873,39-1-0-42-0,6727-02-4757,SNGL FAM SUB,3.09,AC,50500,0,50500,122200,400,173100,49500,0,49500,104200,400,154100,A1,AG/GEN,,,
874,62-21-0-1-0,7704-88-9785,SNGL FAM SUB,8.01,AC,378700,0,378700,412100,1700,792500,329200,0,329200,380200,1700,711100,A2,AG/LTD,,,
875,6-4-0-15-0,6832-77-2968,SNGL FAM SUB,6.19,AC,94800,0,94800,371100,20000,485900,92900,0,92900,324000,22200,439100,A1,AG/GEN,,,
876,6-4-0-16-0,6832-77-0739,SNGL FAM SUB,5.7,AC,91000,0,91000,255200,13000,359200,89200,0,89200,215200,13000,317400,A1,AG/GEN,,,
877,6-4-0-17-0,6832-67-7550,SNGL FAM SUB,10.61,AC,129100,0,129100,0,0,129100,86000,0,86000,0,0,86000,A1,AG/GEN,,,
879,6-4-0-19-0,6832-68-6501,SNGL FAM SUB,5.467,AC,78300,0,78300,287800,1000,367100,76700,0,76700,244100,1000,321800,A1,AG/GEN,,,
880,6-4-0-20-0,6832-68-3375,SNGL FAM SUB,6.44,AC,85900,0,85900,276700,27600,390200,84100,0,84100,245700,22500,352300,A1,AG/GEN,,,
881,6-4-0-21-0,6832-68-1189,SNGL FAM SUB,5.01,AC,74800,0,74800,226900,23500,325200,73300,0,73300,190200,28800,292300,A1,AG/GEN,,,
882,6-4-0-22-0,6832-68-0014,SNGL FAM SUB,5.07,AC,71500,0,71500,239500,6200,317200,70100,0,70100,202900,6200,279200,A1,AG/GEN,,,
883,12-8-0-12-0,6832-77-6297,SNGL FAM SUB,5.19,AC,87100,0,87100,394500,18200,499800,85300,0,85300,343000,21600,449900,A1,AG/GEN,,,
884,12-8-0-14-0,6832-76-3756,SNGL FAM SUB,6.02,AC,80800,0,80800,191300,0,272100,79200,0,79200,165900,0,245100,A1,AG/GEN,,,
885,17-1-0-58-0,6810-36-3935,SNGL FAM SUB,2,AC,44400,0,44400,169300,1000,214700,43500,0,43500,154000,1000,198500,A1,AG/GEN,,,
886,4-2-0-14-0,6814-30-2835,SNGL FAM SUB,5.42,AC,63200,0,63200,0,0,63200,61900,0,61900,0,0,61900,A1,AG/GEN,,,
887,43-20-0-3-0,6768-71-2869,SNGL FAM SUB,3.01,AC,96800,0,96800,160900,9700,267400,88000,0,88000,146300,9000,243300,A2,AG/LTD,,,
888,58-3-A-5-0,7726-16-2720,SNGL FAM SUB,0,AC,88000,0,88000,231800,14500,334300,80000,0,80000,197600,13400,291000,RN,RESIDEN,,,
889,4-2-0-23-0,6814-30-4130,SNGL FAM SUB,4.18,AC,56600,0,56600,214400,0,271000,55400,0,55400,182000,0,237400,A1,AG/GEN,,,
890,4-2-0-24-0,6814-30-5298,SNGL FAM SUB,4.01,AC,55700,0,55700,216800,2000,274500,54500,0,54500,183000,2000,239500,A1,AG/GEN,,,
891,4-2-0-25-0,6814-30-7456,SNGL FAM SUB,3.69,AC,54000,0,54000,205600,6500,266100,52900,0,52900,174600,5500,233000,A1,AG/GEN,,,
892,55-17-0-8-0,6785-47-3207,SNGL FAM SUB,3.02,AC,143300,0,143300,617200,65900,826400,127900,0,127900,500100,60900,688900,A2,AG/LTD,,,
893,20-3-0-1-C,6840-35-1837,SNGL FAM SUB,0.95,AC,44700,0,44700,0,0,44700,42500,0,42500,0,0,42500,A1,AG/GEN,,,
894,20-3-0-1-B,6840-25-8924,SNGL FAM SUB,0.96,AC,51800,0,51800,142300,24900,219000,47900,0,47900,87700,23700,159300,A1,AG/GEN,,,
895,58-4-G-12-0,7716-55-7288,SNGL FAM SUB,0,AC,10000,0,10000,0,0,10000,9100,0,9100,0,0,9100,A2,AG/LTD,,,
896,58-22-A-7-0,7715-27-4256,SNGL FAM SUB,3.02,AC,367900,0,367900,1065000,0,1432900,337700,0,337700,1015300,0,1353000,R3,RES/GEN,,,
897,55-18-0-4-0,6786-04-2890,SNGL FAM SUB,6.688,AC,148600,0,148600,248800,1500,398900,132600,0,132600,203200,1500,337300,A2,AG/LTD,,,
898,62-20-E-3-0,7714-16-2121,SNGL FAM SUB,0,AC,115000,0,115000,278600,2200,395800,100000,0,100000,252800,1500,354300,R1,RES/LTD,,,
899,62-20-E-4-0,7714-16-1251,SNGL FAM SUB,0,AC,115000,0,115000,293300,1000,409300,100000,0,100000,265900,1000,366900,R1,RES/LTD,,,
900,62-1-0-3-0,7704-17-1712,SNGL FAM SUB,11.9,AC,401800,0,401800,801700,37000,1240500,349100,0,349100,664100,37000,1050200,A2,AG/LTD,,,
901,32-1-0-59-B,6789-04-2816,SNGL FAM SUB,1.43,AC,70300,0,70300,0,0,70300,62700,0,62700,0,0,62700,A2,AG/LTD,,,
902,29-1-0-23-0,6748-02-3825,AG > 100 AC,108.95,AC,687900,637700,50200,0,0,687900,675500,629200,46300,0,0,675500,A1,AG/GEN,,,
903,44-1-0-73-A,6786-58-2491,SNGL FAM SUB,1.5,AC,77700,0,77700,274600,3400,355700,69400,0,69400,225200,3700,298300,A2,AG/LTD,,,
904,14-3-0-9-0,6851-49-1649,SNGL FAM SUB,6.12,AC,89400,0,89400,152400,23700,265500,87600,0,87600,141400,20800,249800,A1,AG/GEN,,,
905,14-3-0-10-0,6851-49-3026,SNGL FAM SUB,3.68,AC,72500,0,72500,190000,500,263000,71100,0,71100,179400,500,251000,A1,AG/GEN,,,
906,62-20-A-15-0,7714-15-0545,SNGL FAM SUB,0,AC,115000,0,115000,198500,0,313500,100000,0,100000,181700,0,281700,R1,RES/LTD,,,
907,21-7-0-36-0,6850-46-2668,SNGL FAM SUB,2.94,AC,60000,0,60000,136800,8700,205500,58700,0,58700,119500,8700,186900,A1,AG/GEN,,,
908,67-2-C-8-0,7723-55-3005,SNGL FAM SUB,0,AC,184000,0,184000,373600,29400,587000,160000,0,160000,314700,34100,508800,R1,RES/LTD,,,
909,15-1-0-30-0,5789-29-7213,SNGL FAM SUB,4.1,AC,50000,0,50000,5000,0,55000,48900,0,48900,5000,0,53900,A1,AG/GEN,,,
911,4-6-0-4-0,6813-53-6167,SNGL FAM SUB,8.852,AC,68300,0,68300,0,0,68300,66900,0,66900,0,0,66900,A1,AG/GEN,,,
912,5-13-0-29-0,6813-52-7389,SNGL FAM SUB,10.297,AC,73500,0,73500,174500,800,248800,64700,0,64700,157200,800,222700,A1,AG/GEN,,,
913,21-1-0-25-A,6759-27-3778,SNGL FAM SUB,1.87,AC,64800,0,64800,0,0,64800,58900,0,58900,0,0,58900,A2,AG/LTD,,,
915,9-3-0-3-A,5892-85-3105,SNGL FAM SUB,1.278,AC,39800,0,39800,67400,700,107900,39000,0,39000,59600,700,99300,A1,AG/GEN,,,
916,22-1-0-1-A,6769-38-8388,AG 20-100 AC,95.08,AC,607100,563300,43800,0,0,607100,542000,501600,40400,0,0,542000,A2,AG/LTD,,,
917,22-1-0-4-0,6769-68-3101,SNGL FAM SUB,4.19,AC,99200,0,99200,0,0,99200,89900,0,89900,0,0,89900,A2,AG/LTD,,,
918,32-1-0-70-0,6788-43-0957,AG > 100 AC,125.6,AC,1871100,0,1871100,1126400,361300,3358800,1667900,0,1667900,919400,330400,2917700,A2,AG/LTD,,,
919,32-1-0-70-AT,6788-26-8814-9999,AG 20-100 AC,64.18,AC,408100,279000,129100,0,105600,513700,373200,246300,126900,0,103400,476600,A2,AG/LTD,,,
926,9-3-0-4-0,5892-84-3611,SNGL FAM SUB,1,AC,38800,0,38800,13400,300,52500,38000,0,38000,13400,300,51700,A1,AG/GEN,,,
927,9-3-0-2-0,5892-74-9777,SNGL FAM SUB,5,AC,52500,0,52500,8900,12100,73500,51300,0,51300,9300,10800,71400,A1,AG/GEN,,,
928,9-1-0-4-0,5892-75-4874,SNGL FAM SUB,4,AC,49600,0,49600,94100,100,143800,47000,0,47000,82300,100,129400,A1,AG/GEN,,,
930,30-1-0-87-0,6758-82-9286,AG 20-100 AC,21.57,AC,294800,230400,64400,104900,2000,401700,263800,205000,58800,87600,2000,353400,A2,AG/LTD,,,
932,9-4-0-3-0,5892-70-4770,SNGL FAM SUB,1.01,AC,38900,0,38900,71600,400,110900,38100,0,38100,62600,400,101100,A1,AG/GEN,,,
934,1-1-0-20-C,6804-87-2325,SNGL FAM SUB,1.74,AC,43500,0,43500,8700,4600,56800,42700,0,42700,9100,2800,54600,A1,AG/GEN,,,
935,6-9-0-6-0,6833-71-5211,SNGL FAM SUB,2.44,AC,47300,0,47300,14800,4400,66500,46300,0,46300,19800,2000,68100,A1,AG/GEN,,,
936,9-1-0-2-0,5892-65-5559,SNGL FAM SUB,15,AC,77100,0,77100,0,0,77100,73000,0,73000,0,0,73000,A1,AG/GEN,,,
937,9-1-0-3-0,5892-75-2888,SNGL FAM SUB,1,AC,38800,0,38800,0,0,38800,38000,0,38000,0,0,38000,A1,AG/GEN,,,
938,9-1-0-8-0,5892-64-6678,SNGL FAM SUB,7,AC,48300,0,48300,0,0,48300,46500,0,46500,0,0,46500,A1,AG/GEN,,,
939,9-1-0-45-0,5892-40-7018,AG 20-100 AC,22.22,AC,67600,57400,10200,0,0,67600,66700,57300,9400,0,0,66700,A1,AG/GEN,,,
940,9-1-0-73-0,5892-84-6305,SNGL FAM SUB,4.776,AC,52400,50200,2200,0,0,52400,51200,49200,2000,0,0,51200,A1,AG/GEN,,,
941,9-1-0-78-0,5892-93-4754,AG 20-100 AC,30.151,AC,98600,43200,55400,299400,80200,478200,96300,42800,53500,268700,86400,451400,A1,AG/GEN,,,
942,9-1-0-80-0,5892-83-7050,SNGL FAM SUB,7.88,AC,52000,48400,3600,0,0,52000,49100,45800,3300,0,0,49100,A1,AG/GEN,,,
943,21-1-0-29-0,6759-27-6411,SNGL FAM SUB,4.78,AC,94300,0,94300,0,0,94300,85300,0,85300,0,0,85300,A2,AG/LTD,,,
944,29-1-0-97-0,6759-04-9679,AG 20-100 AC,62.55,AC,351800,323000,28800,0,0,351800,356500,329900,26600,0,0,356500,A1,AG/GEN,,,
945,30-1-0-1-0,6759-15-9855,AG 20-100 AC,83.57,AC,539600,501100,38500,0,0,539600,476300,440800,35500,0,0,476300,A1A2,AG GEN/,,,
946,21-1-0-28-0,6759-27-6874,COMM & IND,2.46,AC,144900,0,144900,246200,6300,397400,140700,0,140700,236800,6400,383900,B1,BUS/GEN,,,
947,30-1-0-2-0,6759-37-0161,SNGL FAM SUB,1.21,AC,14900,0,14900,0,0,14900,12600,0,12600,0,0,12600,A2,AG/LTD,,,
948,9-1-0-42-0,5892-41-2623,SNGL FAM SUB,16.44,AC,82600,0,82600,0,0,82600,81200,0,81200,0,0,81200,A1,AG/GEN,,,
949,21-1-0-25-B,6759-27-1887,SNGL FAM SUB,2.34,AC,67000,0,67000,0,0,67000,63800,0,63800,0,0,63800,A2,AG/LTD,,,
950,38-1-0-56-0,6706-58-5315,SNGL FAM SUB,15.563,AC,109200,97400,11800,0,0,109200,107000,95800,11200,0,0,107000,A1,AG/GEN,,,
952,29-1-0-128-0,6758-08-0006,SNGL FAM SUB,14,AC,121500,0,121500,0,0,121500,119900,0,119900,0,0,119900,A1,AG/GEN,,,
953,22-1-0-5-0,6769-68-8235,SNGL FAM SUB,1.5,AC,67200,0,67200,178900,5500,251600,61100,0,61100,150300,5100,216500,A2,AG/LTD,,,
954,38-3-0-7-0,6717-34-2974,AG 20-100 AC,27,AC,110700,98300,12400,0,0,110700,108000,96500,11500,0,0,108000,A1,AG/GEN,,,
955,44-1-0-66-0,6786-67-9774,SNGL FAM SUB,2.31,AC,94100,0,94100,0,500,94600,84000,0,84000,0,500,84500,A2,AG/LTD,,,
956,45-1-0-41-0,6786-88-2494,SNGL FAM SUB,2,AC,98500,0,98500,317500,3000,419000,87900,0,87900,235100,3000,326000,A2,AG/LTD,,,
957,45-1-0-41-A,6786-88-2225,SNGL FAM SUB,2.94,AC,113400,0,113400,489700,5500,608600,101200,0,101200,402700,5500,509400,A2,AG/LTD,,,
958,3-1-0-13-0,5892-66-7946,SNGL FAM SUB,13.06,AC,61100,55100,6000,0,0,61100,58700,53100,5600,0,0,58700,A1,AG/GEN,,,
959,4-4-0-3-0,6804-60-4164,SNGL FAM SUB,13.72,AC,98800,0,98800,0,0,98800,97000,0,97000,0,0,97000,A1,AG/GEN,,,
960,42-1-0-113-0,6767-00-8913,SNGL FAM SUB,0.443,AC,60000,0,60000,196700,1000,257700,55000,0,55000,164300,1000,220300,RO,RES/OF,,,
961,42-1-0-113-A,6767-01-8161,SNGL FAM SUB,0.424,AC,60000,0,60000,0,0,60000,55000,0,55000,0,0,55000,RO,RES/OF,,,
962,50-5-0-25-0,6726-32-4193,SNGL FAM SUB,9.85,AC,77600,0,77600,920000,61100,1058700,74000,0,74000,827200,77200,978400,A1,AG/GEN,,,
963,9-3-0-2-A,5892-84-2405,SNGL FAM SUB,1,AC,38800,0,38800,99300,200,138300,38000,0,38000,86400,200,124600,A1,AG/GEN,,,
964,16-1-0-84-0,6709-38-5639,AG 20-100 AC,55.946,AC,186700,0,186700,314200,14400,515300,183400,0,183400,292800,12200,488400,A1,AG/GEN,,,
966,3-1-0-2-A,6803-12-3663,SNGL FAM SUB,1.302,AC,4700,4100,600,0,0,4700,4600,4000,600,0,0,4600,A1,AG/GEN,,,
967,3-1-0-2-B,6803-04-8124,AG > 100 AC,342.771,AC,902100,744100,158000,0,0,902100,884300,738600,145700,0,0,884300,A1,AG/GEN,,,
968,3-1-0-2-C,6803-27-5002,AG > 100 AC,120,AC,246200,190900,55300,0,0,246200,240000,189000,51000,0,0,240000,A1,AG/GEN,,,
969,9-1-0-47-0,5892-30-1292,SNGL FAM SUB,1.487,AC,40600,0,40600,0,0,40600,39500,0,39500,0,0,39500,A1,AG/GEN,,,
970,9-4-0-2-0,5892-70-4837,SNGL FAM SUB,1.01,AC,38900,0,38900,10300,600,49800,38100,0,38100,10300,400,48800,A1,AG/GEN,,,
971,45-1-0-35-0,6787-81-3706,SNGL FAM SUB,11,AC,221100,0,221100,147500,800,369400,197600,0,197600,122200,800,320600,A2,AG/LTD,,,
972,44-3-0-2-A,6777-82-4194,SNGL FAM SUB,0.391,AC,5400,0,5400,0,0,5400,4900,0,4900,0,0,4900,A2,AG/LTD,,,
973,51-1-0-42-0,6736-04-5018,AG 20-100 AC,57.95,AC,254700,182100,72600,235500,40200,530400,248700,180600,68100,205400,35000,489100,A1,AG/GEN,,,
974,48-1-0-58-0,7738-21-9697,SNGL FAM SUB,3.225,AC,168000,0,168000,195000,2000,365000,150000,0,150000,164900,2000,316900,A2,AG/LTD,,,
975,4-2-0-3-0,6814-20-3867,SNGL FAM SUB,2.243,AC,49900,0,49900,174000,0,223900,48900,0,48900,155300,0,204200,A1,AG/GEN,,,
976,4-2-0-1-0,6814-21-6161,SNGL FAM SUB,2.025,AC,48600,0,48600,234600,7100,290300,47600,0,47600,215100,7100,269800,A1,AG/GEN,,,
977,4-2-0-2-0,6814-20-5908,SNGL FAM SUB,2.135,AC,49300,0,49300,0,0,49300,48300,0,48300,0,0,48300,A1,AG/GEN,,,
978,48-1-0-49-B,7727-89-9735,SNGL FAM SUB,15.02,AC,420000,412700,7300,0,0,420000,375400,369000,6400,0,0,375400,A2,AG/LTD,,,
979,47-1-0-14-E,7716-28-9598,SNGL FAM SUB,8.147,AC,257700,0,257700,300800,42700,601200,229900,0,229900,251500,37200,518600,A2,AG/LTD,,,
980,48-1-0-49-0,7727-99-0648,SNGL FAM SUB,5.15,AC,206100,0,206100,121100,500,327700,184200,0,184200,100900,500,285600,A2,AG/LTD,,,
982,4-1-0-7-A,6803-44-4896,SNGL FAM SUB,0.7,AC,27200,0,27200,70300,2000,99500,26600,0,26600,62100,2000,90700,A1,AG/GEN,,,
984,14-2-0-1-0,6851-25-4376,SNGL FAM SUB,3.3,AC,69100,0,69100,148000,11100,228200,67700,0,67700,120700,16800,205200,A1,AG/GEN,,,
985,63-1-0-180-0,7724-03-2359,SNGL FAM SUB,0.774,AC,145900,0,145900,165700,800,312400,126900,0,126900,140000,800,267700,R3,RES/GEN,,,
986,46-1-0-85-B,7708-92-2146,SNGL FAM SUB,1.3,AC,29600,0,29600,0,0,29600,26500,0,26500,0,0,26500,A2,AG/LTD,,,
987,47-1-0-20-0,7716-37-3790,SNGL FAM SUB,1.34,AC,106800,0,106800,165900,200,272900,95300,0,95300,137900,200,233400,A2,AG/LTD,,,
989,58-1-0-42-0,7715-72-3597,SNGL FAM SUB,2.29,AC,141400,0,141400,537300,800,679500,122900,0,122900,474200,800,597900,A2,AG/LTD,,,
990,39-1-0-95-0,6727-57-6577,SNGL FAM SUB,10.13,AC,85400,42100,43300,784800,0,870200,83700,41700,42000,699600,0,783300,A1,AG/GEN,,,
1000,50-2-0-D-0,6716-52-7000,AG 20-100 AC,20.82,AC,139900,0,139900,359100,2000,501000,137100,0,137100,316600,2000,455700,A1,AG/GEN,,,
1001,4-2-0-4-0,6814-20-2746,SNGL FAM SUB,2.4,AC,50800,0,50800,142200,3500,196500,49800,0,49800,125300,1500,176600,A1,AG/GEN,,,
1002,20-1-0-25-0,6840-20-4810,AG 20-100 AC,30.28,AC,185700,171700,14000,0,0,185700,174900,162000,12900,0,0,174900,A1,AG/GEN,,,
1003,63-1-0-19-0,7714-47-6721,SNGL FAM SUB,1,AC,115100,0,115100,146800,13800,275700,100100,0,100100,125400,11700,237200,R3,RES/GEN,,,
1004,63-11-0-A-5,7714-57-0600,SNGL FAM SUB,6.541,AC,264200,0,264200,0,0,264200,229800,0,229800,0,0,229800,A2,AG/LTD,,,
1005,47-2-0-C-0,7717-87-8093,SNGL FAM SUB,2.755,AC,128800,0,128800,127700,15700,272200,115100,0,115100,106800,13200,235100,A2,AG/LTD,,,
1006,31-1-0-46-0,6769-94-4979,SNGL FAM SUB,3.012,AC,97600,0,97600,189200,102200,389000,90200,0,90200,157000,86600,333800,A2,AG/LTD,,,
1007,31-1-0-49-B,6769-75-8295,SNGL FAM SUB,5.04,AC,103800,0,103800,289400,5000,398200,93100,0,93100,240200,5000,338300,A2,AG/LTD,,,
1008,46-23-0-14-0,7707-93-5658,SNGL FAM SUB,2.03,AC,165000,0,165000,391100,800,556900,150000,0,150000,328000,800,478800,A2,AG/LTD,,,
1009,58-3-C-6-0,7726-16-8866,SNGL FAM SUB,0,AC,88000,0,88000,161200,1200,250400,80000,0,80000,136300,1200,217500,RN,RESIDEN,,,
1010,43-20-0-13-0,6768-42-7377,SNGL FAM SUB,3.15,AC,96800,0,96800,199200,0,296000,88000,0,88000,173500,0,261500,A2,AG/LTD,,,
1011,5-1-0-59-0,6823-53-5807,SNGL FAM SUB,1,AC,40300,0,40300,114700,41500,196500,39000,0,39000,100300,34400,173700,A1,AG/GEN,,,
1012,5-1-0-82-0,6823-54-7153,SNGL FAM SUB,2.75,AC,54600,0,54600,0,0,54600,53000,0,53000,0,0,53000,A1,AG/GEN,,,
1013,13-1-0-2-A,6842-73-2641,AG 20-100 AC,32.683,AC,153600,94300,59300,160900,4600,319100,149100,91000,58100,144800,4300,298200,A1,AG/GEN,,,
1014,47-25-0-10-0,7727-00-4954,SNGL FAM SUB,1.9,AC,133900,0,133900,326900,0,460800,119600,0,119600,272100,0,391700,A2,AG/LTD,,,
1015,17-1-0-65-0,6810-35-1082,SNGL FAM SUB,5.67,AC,66900,0,66900,253500,0,320400,63700,0,63700,209300,0,273000,A1,AG/GEN,,,
1016,55-15-0-19-0,6785-67-1669,SNGL FAM SUB,3.01,AC,114500,0,114500,279600,1500,395600,102100,0,102100,226800,1500,330400,A2,AG/LTD,,,
1017,46-23-0-34-0,7707-95-0540,SNGL FAM SUB,2.151,AC,165000,0,165000,423200,0,588200,150000,0,150000,353000,0,503000,A2,AG/LTD,,,
1018,46-21-A-7-0,7708-90-6882,SNGL FAM SUB,2.32,AC,125400,0,125400,378900,34200,538500,114000,0,114000,327600,33200,474800,A2,AG/LTD,,,
1019,50-5-0-18-A,6726-30-1298,SNGL FAM SUB,2.34,AC,43100,0,43100,449300,0,492400,40200,0,40200,378700,0,418900,A1,AG/GEN,,,
1020,50-5-0-18-B,6725-39-1009,SNGL FAM SUB,6,AC,37100,0,37100,0,0,37100,36300,0,36300,0,0,36300,A1,AG/GEN,,,
1022,29-1-0-87-B,6749-96-1640,SNGL FAM SUB,4.05,AC,83300,0,83300,99000,300,182600,80100,0,80100,79700,300,160100,A1,AG/GEN,,,
1023,18-2-0-1-0,6820-19-4135,SNGL FAM SUB,15.8,AC,110500,0,110500,0,0,110500,109900,0,109900,0,0,109900,A1,AG/GEN,,,
1024,6-4-0-6-0,6832-87-2930,SNGL FAM SUB,6.87,AC,89200,0,89200,207200,3800,300200,87400,0,87400,164100,2000,253500,A1,AG/GEN,,,
1025,9-1-0-76-0,5892-86-5036,SNGL FAM SUB,2.7,AC,44900,0,44900,105900,1300,152100,44000,0,44000,91900,1300,137200,A1,AG/GEN,,,
1027,29-1-0-64-0,6749-44-7660,SNGL FAM SUB,1,AC,47000,0,47000,0,0,47000,44700,0,44700,0,0,44700,A1,AG/GEN,,,
1028,30-1-0-82-A,6758-93-6905,SNGL FAM SUB,15.6,AC,218700,0,218700,0,0,218700,201700,0,201700,0,0,201700,A2,AG/LTD,,,
1029,63-1-0-2-0,7715-22-9264,SNGL FAM SUB,3.54,AC,181900,0,181900,174800,8300,365000,158300,0,158300,147000,7800,313100,A2,AG/LTD,,,
1030,64-12-B-18-0,7723-59-5758,SNGL FAM SUB,0.0001,AC,77000,0,77000,214600,8000,299600,67000,0,67000,185700,8000,260700,R1,RES/LTD,,,
1031,64-12-B-18-A,7723-59-6748,SNGL FAM SUB,0.25,AC,10100,0,10100,0,0,10100,8800,0,8800,0,0,8800,R1,RES/LTD,,,
1032,64-12-B-19-0,7723-59-7718,SNGL FAM SUB,0,AC,38500,0,38500,0,0,38500,33500,0,33500,0,0,33500,R1,RES/LTD,,,
1033,12-11-0-1-0,6831-19-0686,SNGL FAM SUB,10.849,AC,122200,0,122200,323300,24300,469800,116300,0,116300,263900,21700,401900,A1,AG/GEN,,,
1034,12-11-0-2-0,6832-10-0122,SNGL FAM SUB,10.811,AC,118200,0,118200,0,0,118200,116000,0,116000,0,0,116000,A1,AG/GEN,,,
1036,51-1-0-43-0,6726-94-4854,SNGL FAM SUB,15,AC,117200,109700,7500,0,0,117200,115000,108600,6400,0,0,115000,A1,AG/GEN,,,
1037,51-1-0-44-0,6736-05-3221,AG 20-100 AC,23,AC,145400,134700,10700,0,0,145400,142500,132700,9800,0,0,142500,A1,AG/GEN,,,
1038,32-10-1-17-0,6778-59-9340,SNGL FAM SUB,1.48,AC,74200,0,74200,193800,1000,269000,66300,0,66300,157800,1000,225100,A2,AG/LTD,,,
1039,15-5-0-35-0,5880-70-0505,SNGL FAM SUB,8.16,AC,64600,0,64600,0,0,64600,63100,0,63100,0,0,63100,A1,AG/GEN,,,
1040,26-1-0-35-S,6708-82-2889,SNGL FAM SUB,11.911,AC,93800,0,93800,310100,25900,429800,92000,0,92000,265100,22000,379100,A1,AG/GEN,,,
1053,29-9-0-6-0,6749-90-4172,SNGL FAM SUB,8.07,AC,104900,0,104900,0,0,104900,101500,0,101500,0,0,101500,A1,AG/GEN,,,
1055,19-1-0-20-0,6820-70-9006,SNGL FAM SUB,11.75,AC,78400,0,78400,126100,0,204500,70300,0,70300,106300,0,176600,A1,AG/GEN,,,
1056,18-7-0-D-0,6820-08-4954,SNGL FAM SUB,3.64,AC,55600,0,55600,128400,1200,185200,52500,0,52500,105500,1200,159200,A1,AG/GEN,,,
1057,28-6-0-3-0,6728-99-9955,SNGL FAM SUB,2.78,AC,52600,0,52600,176400,1300,230300,50500,0,50500,150500,1400,202400,A1,AG/GEN,,,
1058,18-1-0-19-A,6719-97-9763,SNGL FAM SUB,11,AC,84000,0,84000,0,0,84000,83500,0,83500,0,0,83500,A1,AG/GEN,,,
1059,18-1-0-25-0,6719-97-9934,SNGL FAM SUB,10,AC,79100,0,79100,0,0,79100,78000,0,78000,0,0,78000,A1,AG/GEN,,,
1060,18-3-0-2-A,6810-70-0369,SNGL FAM SUB,16.8,AC,97900,0,97900,0,0,97900,95700,0,95700,0,0,95700,A1,AG/GEN,,,
1061,57-1-0-34-A,7706-20-9520,SNGL FAM SUB,12.21,AC,443800,0,443800,491600,38300,973700,386300,0,386300,418100,34500,838900,A2,AG/LTD,,,
1062,57-1-0-34-F,7706-31-3150,SNGL FAM SUB,10,AC,385700,0,385700,0,0,385700,335700,0,335700,0,0,335700,A2,AG/LTD,,,
1063,2-3-0-15-0,6824-24-0466,SNGL FAM SUB,4.92,AC,58500,0,58500,0,0,58500,57200,0,57200,0,0,57200,A1,AG/GEN,,,
1064,55-1-0-94-0,6785-55-9509,COMM & IND,12.49,AC,397700,0,397700,76300,1400,475400,368500,0,368500,73700,1400,443600,B1,BUS/GEN,,,
1065,55-1-0-95-0,6785-55-7805,COMM & IND,5.92,AC,193100,0,193100,72000,0,265100,178900,0,178900,58700,0,237600,B1,BUS/GEN,,,
1066,55-1-0-99-0,6785-23-9277,SNGL FAM SUB,14.18,AC,281700,163600,118100,335000,2500,619200,251700,146100,105600,285800,2500,540000,A2,AG/LTD,,,
1067,55-1-0-100-0,6785-22-7801,SNGL FAM SUB,10.672,AC,228700,223800,4900,0,0,228700,204400,199900,4500,0,0,204400,A2,AG/LTD,,,
1069,55-1-0-14-F,6775-74-7418,Islands,0.01,AC,200,0,200,0,0,200,200,0,200,0,0,200,A2,AG/LTD,,,
1070,55-1-0-93-0,6785-52-5551,AG 20-100 AC,56.282,AC,803300,704200,99100,130500,10500,944300,718000,628800,89200,107300,9200,834500,A2,AG/LTD,,,
1071,55-5-0-3-0,6785-66-7115,SNGL FAM SUB,4.018,AC,45500,0,45500,0,0,45500,40600,0,40600,0,0,40600,A2,AG/LTD,,,
1072,55-20-0-3-0,6785-45-7042,SNGL FAM SUB,4.123,AC,134200,0,134200,505700,6600,646500,119700,0,119700,426300,6300,552300,A2,AG/LTD,,,
1073,42-1-0-38-0,6767-02-6166,COMM & IND,1.837,AC,229400,0,229400,1666100,91000,1986500,220600,0,220600,1542300,65600,1828500,B1,BUS/GEN,,,
1075,55-20-0-2-0,6785-45-3261,SNGL FAM SUB,3.021,AC,116000,0,116000,0,0,116000,103500,0,103500,0,0,103500,A2,AG/LTD,,,
1076,55-12-0-D-0,6785-33-3830,AG 20-100 AC,23.31,AC,390600,379900,10700,0,0,390600,348200,338300,9900,0,0,348200,A2,AG/LTD,,,
1077,55-1-0-10-A,6776-82-8085,SNGL FAM SUB,1.2,AC,73100,0,73100,151600,0,224700,65300,0,65300,124700,0,190000,A2,AG/LTD,,,
1078,55-1-0-96-0,6785-55-2857,COMM & IND,3.51,AC,143900,0,143900,181100,10800,335800,133300,0,133300,150200,11000,294500,RO,RES/OF,,,
1079,16-1-0-52-0,5890-78-2035,AG 20-100 AC,36.03,AC,128800,72800,56000,252600,3000,384400,125600,71600,54000,219000,3000,347600,A1,AG/GEN,,,
1080,16-1-0-51-0,5890-56-5415,SNGL FAM SUB,5.604,AC,55400,52500,2900,0,0,55400,54100,0,54100,0,0,54100,A1,AG/GEN,,,
1081,41-2-0-23-0,6748-41-8930,SNGL FAM SUB,2.11,AC,65100,0,65100,223700,16200,305000,60300,0,60300,181000,2600,243900,A1,AG/GEN,,,
1082,55-17-0-9-0,6785-46-4728,SNGL FAM SUB,4.808,AC,171400,0,171400,351500,0,522900,153000,0,153000,287800,0,440800,A2,AG/LTD,,,
1083,4-6-0-15-0,6813-44-8708,SNGL FAM SUB,8.01,AC,65200,0,65200,0,0,65200,63900,0,63900,0,0,63900,A1,AG/GEN,,,
1086,20-1-0-88-0,6749-88-8516,AG 20-100 AC,56.057,AC,652600,0,652600,0,0,652600,611000,0,611000,0,0,611000,R1,RES/LTD,,,
1087,29-1-0-118-0,6748-99-0587,SNGL FAM SUB,1.93,AC,63300,0,63300,245300,0,308600,57200,0,57200,203200,0,260400,A1,AG/GEN,,,
1088,45-1-0-56-0,6797-07-0205,SNGL FAM SUB,3.99,AC,121800,0,121800,0,0,121800,108900,0,108900,0,0,108900,A2,AG/LTD,,,
1089,45-1-0-57-0,6787-97-9768,SNGL FAM SUB,8.23,AC,184300,0,184300,69100,500,253900,164500,0,164500,57600,500,222600,A2,AG/LTD,,,
1090,29-16-0-B-0,6749-67-1194,SNGL FAM SUB,5.28,AC,94000,0,94000,234600,4400,333000,90100,0,90100,201800,4900,296800,A1,AG/GEN,,,
1091,45-8-0-B-0,6798-70-1904,SNGL FAM SUB,2.38,AC,78600,0,78600,119600,1100,199300,70200,0,70200,92200,1100,163500,A2,AG/LTD,,,
1092,29-14-0-1-0,6749-51-0151,SNGL FAM SUB,1.27,AC,56700,0,56700,177900,200,234800,52400,0,52400,146600,200,199200,A1,AG/GEN,,,
1093,20-9-0-I-0,6749-48-6257,AG 20-100 AC,26.04,AC,123400,0,123400,0,0,123400,122400,0,122400,0,0,122400,A1,AG/GEN,,,
1094,29-16-0-D-3,6749-66-7802,SNGL FAM SUB,2.25,AC,66400,0,66400,114400,12900,193700,62300,0,62300,98000,11500,171800,A1,AG/GEN,,,
1095,29-16-0-D-1,6749-67-8067,SNGL FAM SUB,3.02,AC,73800,0,73800,211100,1500,286400,68900,0,68900,176900,1500,247300,A1,AG/GEN,,,
1096,29-16-0-D-2,6749-76-1582,SNGL FAM SUB,2,AC,64000,0,64000,252600,0,316600,59800,0,59800,212500,0,272300,A1,AG/GEN,,,
1097,29-1-0-79-A,6749-66-9813,SNGL FAM SUB,1.02,AC,54200,0,54200,178900,1300,234400,50100,0,50100,146600,1400,198100,A1,AG/GEN,,,
1098,29-16-0-C-0,6749-67-4088,SNGL FAM SUB,5.27,AC,93900,0,93900,405200,0,499100,90000,0,90000,0,0,90000,A1,AG/GEN,,,
1100,39-1-0-79-0,6726-28-0624,SNGL FAM SUB,0.76,AC,33900,0,33900,109100,0,143000,31800,0,31800,76700,0,108500,A1,AG/GEN,,,
1101,46-1-0-74-0,7707-54-8352,AG 20-100 AC,85.5,AC,1500500,1369100,131400,78000,0,1578500,1341300,1222900,118400,66000,0,1407300,A2RR,AG& RUR,,,
1102,57-1-0-33-0,7706-21-0729,SNGL FAM SUB,8.705,AC,280200,0,280200,566700,7000,853900,243800,0,243800,485000,7000,735800,A2,AG/LTD,,,
1104,57-25-B-15-0,7716-24-6084,Cmn Area/Open Spc,3.637,AC,0,0,0,0,0,0,0,0,0,0,0,0,A2,AG/LTD,,,
1105,58-21-A-1-A,7716-53-3727,Cmn Area/Open Spc,0.446,AC,0,0,0,0,0,0,0,0,0,0,0,0,A2,AG/LTD,,,
1107,57-1-0-53-C,7715-19-2119,Cmn Area/Open Spc,0.51,AC,0,0,0,0,0,0,0,0,0,0,0,0,A2,AG/LTD,,,
1108,57-1-0-53-D,7715-09-3170,Cmn Area/Open Spc,9.554,AC,0,0,0,0,0,0,0,0,0,0,0,0,A2,AG/LTD,,,
1109,57-20-C-12-A,7715-09-6609,Cmn Area/Open Spc,7.529,AC,0,0,0,0,0,0,0,0,0,0,0,0,A2,AG/LTD,,,
1110,57-20-C-12-B,7706-90-9024,Cmn Area/Open Spc,6.132,AC,0,0,0,0,0,0,0,0,0,0,0,0,A2,AG/LTD,,,
1111,58-18-E-5-A,7715-29-6223,Cmn Area/Open Spc,0.088,AC,0,0,0,0,0,0,0,0,0,0,0,0,A2,AG/LTD,,,
1112,47-1-0-43-F,7716-99-7265,COMM & IND,0,AC,0,0,0,1083400,0,1083400,0,0,0,1083400,0,1083400,M1,INDUS/L,,,
1113,47-1-0-43-C,7716-98-7925,COMM & IND,3.411,AC,1343900,0,1343900,1416200,27500,2787600,1221800,0,1221800,1289100,27700,2538600,B1,BUS/GEN,,,
1114,62-7-0-B-0,7705-91-5297,SNGL FAM SUB,15.04,AC,562700,0,562700,558200,4000,1124900,489900,0,489900,473600,4000,967500,A2,AG/LTD,,,
1116,63-1-0-38-0,7714-33-9757,COMM & IND,0.338,AC,44400,0,44400,0,0,44400,40300,0,40300,0,0,40300,BN,BUS/NHD,,,
1118,63-1-0-102-0,7715-40-4792,SNGL FAM SUB,9.468,AC,291300,0,291300,0,0,291300,253500,0,253500,0,0,253500,A2,AG/LTD,,,
1119,63-18-0-1-0,7714-44-1902,SNGL FAM SUB,1.407,AC,126000,0,126000,0,0,126000,109600,0,109600,0,0,109600,R3,RES/GEN,,,
1128,63-23-0-1-A,7713-69-8712,SNGL FAM SUB,5.883,AC,286300,0,286300,762500,111700,1160500,249100,0,249100,649400,103900,1002400,A2,AG/LTD,,,
1129,63-23-0-1-C,7714-70-3373,SNGL FAM SUB,0.5,AC,93500,0,93500,153700,0,247200,81300,0,81300,129000,0,210300,A2,AG/LTD,,,
1130,63-23-0-1-D,7713-79-7967,SNGL FAM SUB,0.5,AC,93500,0,93500,90600,200,184300,81300,0,81300,77200,200,158700,A2,AG/LTD,,,
1131,9-1-0-61-0,5891-88-1949,SNGL FAM SUB,1.603,AC,41000,0,41000,86400,600,128000,40100,0,40100,75400,600,116100,A1,AG/GEN,,,
1132,9-1-0-62-0,5891-78-9835,SNGL FAM SUB,1.603,AC,41000,0,41000,0,0,41000,39800,0,39800,0,0,39800,A1,AG/GEN,,,
1133,67-1-0-15-B,7733-13-5720,SNGL FAM SUB,5,AC,325700,0,325700,549700,30900,906300,283100,0,283100,474600,29200,786900,A2,AG/LTD,,,
1134,43-20-0-30-0,6768-51-9644,SNGL FAM SUB,3.01,AC,96800,0,96800,156400,1200,254400,88000,0,88000,136700,1300,226000,A2,AG/LTD,,,
1135,45-1-0-77-0,6797-60-8985,SNGL FAM SUB,5.52,AC,157300,0,157300,281300,700,439300,140200,0,140200,232500,700,373400,A2,AG/LTD,,,
1137,46-22-0-C-0,7706-98-5633,SNGL FAM SUB,8.829,AC,319100,0,319100,0,0,319100,284700,0,284700,0,0,284700,A2,AG/LTD,,,
1139,42-8-1-3-0,6767-18-1319,SNGL FAM SUB,1.513,AC,66000,0,66000,134800,4800,205600,60500,0,60500,112800,4800,178100,A2,AG/LTD,,,
1140,42-8-1-1-0,6767-08-9472,SNGL FAM SUB,1.24,AC,66000,0,66000,68100,0,134100,60500,0,60500,67100,0,127600,A2,AG/LTD,,,
1141,20-1-0-92-D,6759-09-6363,SNGL FAM SUB,1.53,AC,59200,0,59200,188500,30300,278000,56300,0,56300,162600,24500,243400,A1,AG/GEN,,,
1142,20-1-0-92-0,6759-08-5795,SNGL FAM SUB,1.5,AC,13100,0,13100,0,0,13100,12500,0,12500,0,0,12500,A1,AG/GEN,,,
1143,20-1-0-93-0,6759-18-3081,SNGL FAM SUB,4.83,AC,90100,0,90100,103200,88800,282100,87800,0,87800,84500,71800,244100,A1,AG/GEN,,,
1144,21-1-0-24-0,6759-18-5247,SNGL FAM SUB,2,AC,64000,0,64000,238100,0,302100,60300,0,60300,192900,0,253200,A2,AG/LTD,,,
1146,13-1-0-45-0,6841-54-9949,SNGL FAM SUB,11.523,AC,79800,0,79800,0,0,79800,78400,0,78400,0,0,78400,A1,AG/GEN,,,
1147,13-2-0-2-A,6841-96-2086,AG 20-100 AC,38.72,AC,273100,0,273100,651000,68400,992500,270300,0,270300,570200,64900,905400,A1,AG/GEN,,,
1148,31-1-0-74-0,6779-40-5282,SNGL FAM SUB,3,AC,92900,0,92900,28100,0,121000,83000,0,83000,22900,0,105900,A2,AG/LTD,,,
1149,31-1-0-51-A,6769-86-4619,SNGL FAM SUB,2.26,AC,76500,0,76500,248100,20100,344700,68800,0,68800,205500,16700,291000,A2,AG/LTD,,,
1150,31-1-0-50-0,6769-86-4981,SNGL FAM SUB,1.83,AC,71300,0,71300,182900,22400,276600,65100,0,65100,149900,17500,232500,A2,AG/LTD,,,
1151,30-10-0-11-0,6759-36-6855,SNGL FAM SUB,1.39,AC,58800,0,58800,157500,1500,217800,54000,0,54000,129800,1500,185300,A1,AG/GEN,,,
1152,20-1-0-91-A,6759-09-4563,SNGL FAM SUB,2.74,AC,70800,0,70800,205100,33600,309500,68000,0,68000,175400,31000,274400,A1,AG/GEN,,,
1154,21-17-0-1-0,6759-18-7457,SNGL FAM SUB,6.036,AC,97100,40500,56600,235000,73100,405200,91700,39600,52100,187700,63300,342700,A2,AG/LTD,,,
1155,30-1-0-73-0,6758-89-9656,SNGL FAM SUB,2.32,AC,70300,0,70300,39900,2000,112200,63600,0,63600,33700,2000,99300,A2,AG/LTD,,,
1157,58-2-0-10-0,7726-36-1043,SNGL FAM SUB,0,AC,88000,0,88000,197100,500,285600,80000,0,80000,171200,500,251700,RN,RESIDEN,,,
1158,21-1-0-21-0,6759-29-8738,SNGL FAM SUB,2.466,AC,72000,0,72000,195200,6000,273200,65100,0,65100,162000,6000,233100,A2,AG/LTD,,,
1159,6-8-0-A-0,6833-82-2133,SNGL FAM SUB,1.9,AC,44400,0,44400,19200,5600,69200,43500,0,43500,18800,5600,67900,A1,AG/GEN,,,
1160,32-1-0-37-0,6778-85-3307,SNGL FAM SUB,1.94,AC,77600,0,77600,172800,19000,269400,69300,0,69300,141900,15700,226900,A2,AG/LTD,,,
1161,55-15-0-17-0,6785-67-5977,SNGL FAM SUB,3.01,AC,114500,0,114500,353200,0,467700,102100,0,102100,261700,0,363800,A2,AG/LTD,,,
1162,31-11-0-5-0,6779-30-0861,SNGL FAM SUB,7.46,AC,144900,0,144900,0,0,144900,129600,0,129600,0,0,129600,RR,RES/RUR,,,
1163,29-1-0-117-0,6748-99-7636,SNGL FAM SUB,11.34,AC,134800,0,134800,105700,0,240500,130600,0,130600,93500,0,224100,A1,AG/GEN,,,
1164,12-5-0-4-0,6832-35-2264,SNGL FAM SUB,4.44,AC,58200,0,58200,124800,4000,187000,56200,0,56200,109500,4000,169700,A1,AG/GEN,,,
1165,43-1-0-2-C,6768-60-8900,SNGL FAM SUB,6.78,AC,132500,0,132500,301400,31800,465700,118100,0,118100,249600,26900,394600,A2,AG/LTD,,,
1166,45-1-0-126-0,6797-58-4251,COMM & IND,3.646,AC,320600,0,320600,238100,2200,560900,300100,0,300100,240000,1800,541900,A2,AG/LTD,,,
1167,45-1-0-127-0,6797-58-1149,COMM & IND,2,AC,200800,0,200800,139600,0,340400,186000,0,186000,133000,0,319000,A2,AG/LTD,,,
1168,45-1-0-127-AT,6797-58-1555,COMM & IND,10.334,AC,584000,0,584000,0,0,584000,551000,0,551000,0,0,551000,A2,AG/LTD,,,
1169,31-11-0-7-0,6779-31-0701,SNGL FAM SUB,12.76,AC,198200,0,198200,396700,0,594900,177200,0,177200,317300,0,494500,A2,AG/LTD,,,
1170,45-1-0-64-0,6797-67-1112,SNGL FAM SUB,0.96,AC,70000,0,70000,188900,500,259400,62500,0,62500,157500,500,220500,A2,AG/LTD,,,
1171,45-1-0-65-0,6797-67-1324,SNGL FAM SUB,1.04,AC,70700,0,70700,0,0,70700,63100,0,63100,0,0,63100,A2,AG/LTD,,,
1172,31-11-0-6-0,6779-21-9167,SNGL FAM SUB,8.276,AC,147000,0,147000,431700,6700,585400,131400,0,131400,363600,5800,500800,RR,RES/RUR,,,
1173,48-1-0-59-A,7738-20-8627,SNGL FAM SUB,0.84,AC,83200,0,83200,0,17300,100500,74300,0,74300,0,13700,88000,A2,AG/LTD,,,
1174,32-1-0-46-B,6778-85-4078,SNGL FAM SUB,1.26,AC,67800,0,67800,155200,25100,248100,60600,0,60600,127800,21600,210000,A2,AG/LTD,,,
1175,32-1-0-47-0,6778-84-6888,SNGL FAM SUB,1.5,AC,71300,0,71300,91800,9200,172300,63700,0,63700,75800,9200,148700,A2,AG/LTD,,,
1176,32-1-0-65-0,6789-50-2890,SNGL FAM SUB,5.141,AC,123700,121300,2400,0,0,123700,236200,227800,8400,0,0,236200,A2,AG/LTD,,,
1177,48-1-0-59-0,7738-20-8819,SNGL FAM SUB,0.99,AC,98000,0,98000,221800,200,320000,87500,0,87500,185200,200,272900,A2,AG/LTD,,,
1178,32-1-0-48-0,6778-84-9646,SNGL FAM SUB,2.618,AC,87400,0,87400,492400,6200,586000,78100,0,78100,405800,5500,489400,A2,AG/LTD,,,
1179,45-1-0-60-A,6797-48-2053,SNGL FAM SUB,7.78,AC,167700,0,167700,123200,1000,291900,150100,0,150100,100200,1000,251300,A2,AG/LTD,,,
1180,45-1-0-63-B,6797-66-1877,SNGL FAM SUB,3.72,AC,107600,0,107600,281400,31400,420400,96100,0,96100,230300,27200,353600,A2,AG/LTD,,,
1181,32-1-0-19-0,6779-72-3573,AG 20-100 AC,26.74,AC,270100,0,270100,0,0,270100,239300,0,239300,0,0,239300,A2,AG/LTD,,,
1182,57-20-B-4-0,7716-01-5038,SNGL FAM SUB,2.587,AC,365000,0,365000,598800,43100,1006900,335000,0,335000,574300,41500,950800,A2,AG/LTD,,,
1183,57-20-B-5-0,7716-00-3902,SNGL FAM SUB,1.989,AC,315000,0,315000,658300,2500,975800,288800,0,288800,624200,2500,915500,A2,AG/LTD,,,
1184,57-4-0-2-C,7705-29-2034,AG 20-100 AC,28.903,AC,885600,675400,210200,360300,59500,1305400,770700,588000,182700,354200,52100,1177000,A2,AG/LTD,,,
1185,21-3-0-1-A,6850-92-9089,SNGL FAM SUB,3.49,AC,84100,0,84100,176000,2500,262600,75800,0,75800,148500,2500,226800,A2,AG/LTD,,,
1186,31-11-0-1-0,6779-40-2173,SNGL FAM SUB,6.066,AC,121900,0,121900,364800,3000,489700,108900,0,108900,301000,3000,412900,RR,RES/RUR,,,
1187,45-1-0-63-0,6797-57-9442,SNGL FAM SUB,0.84,AC,64800,0,64800,107000,100,171900,57800,0,57800,89900,100,147800,A2,AG/LTD,,,
1188,45-1-0-63-A,6797-56-9425,SNGL FAM SUB,19.24,AC,321800,0,321800,0,500,322300,287000,0,287000,0,500,287500,A2,AG/LTD,,,
1189,45-1-0-126-A,6797-57-9817,COMM & IND,2.376,AC,234400,0,234400,0,0,234400,223200,0,223200,0,0,223200,M1,INDUS/L,,,
1190,46-1-0-118-B,7717-04-7220,SNGL FAM SUB,4.295,AC,165000,0,165000,275200,53500,493700,150000,0,150000,226500,48700,425200,A2R1,AG LTD/,,,
1191,66-4-0-8-0,7723-34-3904,SNGL FAM SUB,3.32,AC,672800,0,672800,1384800,37800,2095400,585000,0,585000,1319500,37100,1941600,A2,AG/LTD,,,
1192,67-2-C-4-0,7723-55-2654,SNGL FAM SUB,0,AC,184000,0,184000,294300,800,479100,160000,0,160000,251200,800,412000,R1,RES/LTD,,,
1194,2-3-0-25-0,6824-22-3561,SNGL FAM SUB,5.358,AC,57500,0,57500,176900,16700,251100,56300,0,56300,150200,14200,220700,A1,AG/GEN,,,
1195,26-1-0-19-0,6719-01-3360,SNGL FAM SUB,1.75,AC,43400,0,43400,109800,8400,161600,42500,0,42500,90700,15300,148500,A1,AG/GEN,,,
1196,39-5-0-1-0,6717-73-5584,AG 20-100 AC,21.4,AC,142800,132300,10500,0,7000,149800,140000,130800,9200,0,7000,147000,A1,AG/GEN,,,
1197,63-1-0-109-0,7715-41-0808,SNGL FAM SUB,4.14,AC,195500,0,195500,513100,4700,713300,170100,0,170100,442700,5200,618000,A2,AG/LTD,,,
1198,14-3-0-19-0,6851-38-5062,SNGL FAM SUB,3.53,AC,71200,0,71200,134900,400,206500,69700,0,69700,121500,400,191600,A1,AG/GEN,,,
1199,63-1-0-141-0,7715-82-3166,SNGL FAM SUB,1.198,AC,119100,0,119100,569700,0,688800,103600,0,103600,490100,0,593700,A2,AG/LTD,,,
1201,5-3-0-8-0,6823-18-6605,SNGL FAM SUB,1.34,AC,46300,0,46300,0,0,46300,45400,0,45400,0,0,45400,A1,AG/GEN,,,
1202,63-1-0-138-A,7715-81-3701,SNGL FAM SUB,2.03,AC,129400,0,129400,484100,0,613500,112500,0,112500,403500,0,516000,A2,AG/LTD,,,
1203,63-1-0-140-0,7715-81-1521,SNGL FAM SUB,1.675,AC,122200,0,122200,524300,42800,689300,106200,0,106200,437500,36300,580000,A2,AG/LTD,,,
1204,63-1-0-138-0,7715-82-1071,SNGL FAM SUB,2,AC,128800,0,128800,207800,42200,378800,112000,0,112000,175800,37900,325700,A2,AG/LTD,,,
1205,20-1-0-94-A,6759-17-4100,SNGL FAM SUB,2.42,AC,68100,0,68100,34500,500,103100,64700,0,64700,29600,500,94800,A1,AG/GEN,,,
1206,20-1-0-96-0,6759-17-4168,SNGL FAM SUB,0.85,AC,8500,0,8500,0,0,8500,8800,0,8800,0,0,8800,A1,AG/GEN,,,
1207,43-3-0-6-0,6777-49-9614,SNGL FAM SUB,1.597,AC,78700,0,78700,184000,6500,269200,70300,0,70300,152700,6500,229500,A2,AG/LTD,,,
1209,17-1-0-60-A,6810-45-0926,SNGL FAM SUB,2.03,AC,44200,0,44200,76800,800,121800,43700,0,43700,69600,800,114100,A1,AG/GEN,,,
1211,44-16-0-13-0,6787-49-3029,SNGL FAM SUB,4.16,AC,129000,0,129000,220700,19700,369400,115000,0,115000,167100,5800,287900,A2,AG/LTD,,,
1212,64-19-E-14-0,7733-47-2600,SNGL FAM SUB,0,AC,265000,0,265000,0,0,265000,220000,0,220000,0,0,220000,R1,RES/LTD,,,
1213,15-5-0-4-0,5789-66-6815,SNGL FAM SUB,8.01,AC,67500,0,67500,395200,11000,473700,66000,0,66000,365100,11000,442100,A1,AG/GEN,,,
1214,15-5-0-21-0,5789-69-4549,SNGL FAM SUB,8.3,AC,65100,0,65100,590300,0,655400,63600,0,63600,510400,0,574000,A1,AG/GEN,,,
1215,24-2-0-4-A,5789-65-3078,SNGL FAM SUB,9.86,AC,24700,0,24700,0,0,24700,24700,0,24700,0,0,24700,A1,AG/GEN,,,
1217,43-1-0-63-A,6778-41-0997,SNGL FAM SUB,2.5,AC,91700,0,91700,176000,23700,291400,82000,0,82000,143000,19200,244200,A2,AG/LTD,,,
1218,20-11-0-16-0,6851-01-0104,SNGL FAM SUB,2,AC,55600,0,55600,171000,2300,228900,52500,0,52500,157100,2200,211800,A1,AG/GEN,,,
1219,57-1-0-28-B,7706-11-4437,SNGL FAM SUB,7.973,AC,234800,0,234800,0,0,234800,204200,0,204200,0,0,204200,A2,AG/LTD,,,
1220,62-21-0-8-0,7704-97-4922,SNGL FAM SUB,8.01,AC,378700,0,378700,353600,3100,735400,329200,0,329200,312800,2800,644800,A2,AG/LTD,,,
1231,46-23-0-22-0,7707-84-9424,SNGL FAM SUB,2.842,AC,181500,0,181500,353100,25500,560100,165000,0,165000,297000,21700,483700,A2,AG/LTD,,,
1232,40-1-0-31-0,6737-85-6639,AG > 100 AC,103.791,AC,332800,282500,50300,0,800,333600,330000,285600,44400,0,800,330800,A1,AG/GEN,,,
1233,40-1-0-39-0,6738-61-3195,AG 20-100 AC,37.162,AC,197700,180600,17100,0,0,197700,193200,177400,15800,0,0,193200,A1,AG/GEN,,,
1234,41-1-0-3-0,6737-95-8574,SNGL FAM SUB,11.171,AC,33500,28200,5300,0,0,33500,31300,26500,4800,0,0,31300,A1,AG/GEN,,,
1235,51-10-0-A-0,6736-16-6626,SNGL FAM SUB,5.28,AC,58900,56300,2600,0,5300,64200,57700,55400,2300,0,5300,63000,A1,AG/GEN,,,
1236,51-1-0-47-0,6736-16-7056,SNGL FAM SUB,3.528,AC,49100,0,49100,164300,2300,215700,48100,0,48100,143400,2300,193800,A1,AG/GEN,,,
1237,51-10-0-B-0,6736-26-2456,SNGL FAM SUB,5.54,AC,64200,61400,2800,0,0,64200,63000,60600,2400,0,0,63000,A1,AG/GEN,,,
1238,45-1-0-125-0,6797-58-9426,General Gov,3,AC,257400,0,257400,477500,26500,761400,245100,0,245100,470800,26500,742400,M2,INDUS/G,,,
1239,51-1-0-46-0,6736-35-9128,SNGL FAM SUB,18.862,AC,140000,0,140000,404200,0,544200,136800,0,136800,345100,0,481900,A1,AG/GEN,,,
1240,51-1-0-46-A,6736-35-6767,AG > 100 AC,151.64,AC,532300,410000,122300,178500,7200,718000,517800,407000,110800,155900,7200,680900,A1,AG/GEN,,,
1241,51-10-0-C-0,6736-26-6544,SNGL FAM SUB,1.54,AC,41800,39500,2300,0,6700,48500,41000,38800,2200,0,7200,48200,A1,AG/GEN,,,
1242,51-10-0-D-0,6736-36-1107,SNGL FAM SUB,17.24,AC,121600,74700,46900,424900,23900,570400,119200,74300,44900,365600,23400,508200,A1,AG/GEN,,,
1243,12-1-0-17-B,6822-91-4979,SNGL FAM SUB,3.04,AC,56900,0,56900,143600,10400,210900,55300,0,55300,123700,10200,189200,A1,AG/GEN,,,
1244,46-7-0-D-2A,7707-62-1833,SNGL FAM SUB,2.01,AC,122000,0,122000,140400,500,262900,109000,0,109000,116900,500,226400,RR,RES/RUR,,,
1245,37-1-0-2-0,6707-34-2911,AG 20-100 AC,58,AC,142700,105300,37400,0,0,142700,140000,105000,35000,0,0,140000,A1,AG/GEN,,,
1246,31-7-0-9-A,6779-55-4880,SNGL FAM SUB,1.6,AC,72700,0,72700,154100,2300,229100,64900,0,64900,118000,1000,183900,A2,AG/LTD,,,
1247,33-4-0-32-0,6798-52-7521,SNGL FAM SUB,3.14,AC,106200,0,106200,259400,1500,367100,94800,0,94800,215500,1500,311800,A2,AG/LTD,,,
1248,44-16-0-1-0,6787-29-4933,SNGL FAM SUB,3.92,AC,129000,0,129000,188400,50100,367500,115000,0,115000,152300,30300,297600,A2,AG/LTD,,,
1250,20-11-0-7-0,6841-92-2295,SNGL FAM SUB,2.02,AC,55800,0,55800,166000,14700,236500,52700,0,52700,144500,12700,209900,A1,AG/GEN,,,
1254,12-1-0-7-0,6832-16-5745,SNGL FAM SUB,12.04,AC,107900,0,107900,154100,46800,308800,105200,0,105200,132700,41400,279300,A1,AG/GEN,,,
1255,55-18-0-1-0,6776-93-3665,SNGL FAM SUB,4.753,AC,121100,0,121100,223100,67000,411200,108100,0,108100,186000,10700,304800,RR,RES/RUR,,,
1256,55-1-0-101-0,6785-12-9335,SNGL FAM SUB,10,AC,231200,0,231200,88100,38000,357300,206100,0,206100,71300,38000,315400,A2,AG/LTD,,,
1257,60-5-0-B-0,6785-11-0813,AG 20-100 AC,53.58,AC,831500,0,831500,0,0,831500,740400,0,740400,0,0,740400,A2,AG/LTD,,,
1258,55-1-0-102-0,6775-92-8814,SNGL FAM SUB,5,AC,17000,0,17000,0,0,17000,15000,0,15000,0,0,15000,A2,AG/LTD,,,
1259,55-4-0-A-0,6775-93-4661,AG 20-100 AC,38.1,AC,129500,0,129500,0,0,129500,114300,0,114300,0,0,114300,A2,AG/LTD,,,
1263,60-5-0-B-1,6785-21-5298,AG 20-100 AC,44.42,AC,732900,711600,21300,0,0,732900,653000,634000,19000,0,0,653000,A2,AG/LTD,,,
1264,60-5-0-C-0,6785-50-4827,AG > 100 AC,231,AC,3321800,3214700,107100,0,0,3321800,2960300,2862000,98300,0,0,2960300,A2,AG/LTD,,,
1265,60-5-0-E-0,6784-79-9799,SNGL FAM SUB,3.5,AC,11900,10300,1600,0,0,11900,10500,9000,1500,0,0,10500,A2,AG/LTD,,,
1266,61-5-0-D-0,6784-89-5029,AG 20-100 AC,45.8,AC,155700,134600,21100,0,0,155700,137400,117900,19500,0,0,137400,A2,AG/LTD,,,
1268,63-1-0-69-0,7714-71-4819,AG > 100 AC,444.665,AC,10466600,9801900,664700,647800,150900,11265300,9107800,8520000,587800,553100,146400,9807300,ROA2,RESIDEN,,,
1273,62-1-0-20-0,7714-14-7162,COMM & IND,2.73,AC,180100,0,180100,147200,0,327300,164500,0,164500,144700,0,309200,ROA2,RESIDEN,,,
1275,63-3-B-1-0,7714-92-5016,SNGL FAM SUB,0.87,AC,70000,0,70000,0,0,70000,60000,0,60000,0,0,60000,R1,RES/LTD,,,
1278,63-14-0-B-1,7714-83-3609,SNGL FAM SUB,9.474,AC,331100,0,331100,0,0,331100,301400,0,301400,0,0,301400,A2,AG/LTD,,,
1282,26-9-0-F-0,6719-35-9220,SNGL FAM SUB,14.99,AC,114700,68000,46700,75900,11000,201600,114900,70900,44000,62400,9400,186700,A1,AG/GEN,,,
1283,59-1-0-11-0,7726-76-0822,COMM & IND,1.194,AC,729000,0,729000,99100,0,828100,695900,0,695900,59500,0,755400,B1,BUS/GEN,,,
1284,28-1-0-98-0,6738-46-0038,SNGL FAM SUB,5,AC,77400,0,77400,152200,38000,267600,78600,0,78600,130000,31900,240500,A1,AG/GEN,,,
1285,5-13-0-22-0,6813-64-8003,SNGL FAM SUB,8.129,AC,65600,0,65600,340900,1500,408000,64300,0,64300,288700,1500,354500,A1,AG/GEN,,,
1286,5-13-0-21-0,6813-64-6490,SNGL FAM SUB,8.2,AC,65900,0,65900,222300,17100,305300,64500,0,64500,189000,14900,268400,A1,AG/GEN,,,
1287,13-10-0-8-0,6841-74-8899,SNGL FAM SUB,5.06,AC,84000,0,84000,36200,2900,123100,82400,0,82400,33500,2900,118800,A1,AG/GEN,,,
1288,11-1-0-55-0,6822-75-0927,SNGL FAM SUB,3.71,AC,53600,0,53600,0,0,53600,52600,0,52600,0,0,52600,A1,AG/GEN,,,
1289,29-3-0-23-0,6749-53-3500,SNGL FAM SUB,3.74,AC,70800,0,70800,138200,3600,212600,66100,0,66100,115100,3600,184800,A1,AG/GEN,,,
1290,28-1-0-17-0,6728-87-8424,SNGL FAM SUB,1,AC,38800,0,38800,175600,600,215000,38000,0,38000,153000,600,191600,A1,AG/GEN,,,
1291,17-1-0-87-0,6719-29-2334,AG > 100 AC,114.05,AC,380900,316700,64200,0,0,380900,359300,0,359300,0,0,359300,A1,AG/GEN,,,
1292,17-1-0-72-A,6810-11-6263,SNGL FAM SUB,2.71,AC,50300,0,50300,0,0,50300,47400,0,47400,0,0,47400,A1,AG/GEN,,,
1293,26-1-0-15-A,6709-93-4400,SNGL FAM SUB,2.953,AC,51700,0,51700,236500,0,288200,49700,0,49700,206500,0,256200,A1,AG/GEN,,,
1294,38-5-0-B-0,6717-08-0745,SNGL FAM SUB,15,AC,114100,0,114100,0,0,114100,111900,0,111900,0,0,111900,A1,AG/GEN,,,
1295,51-7-0-A-0,6736-10-6420,SNGL FAM SUB,6.28,AC,68400,0,68400,149200,3000,220600,67000,0,67000,119300,3200,189500,A1,AG/GEN,,,
1296,17-9-0-3-0,6810-04-1061,SNGL FAM SUB,3,AC,52000,0,52000,213100,0,265100,49000,0,49000,173600,0,222600,A1,AG/GEN,,,
1297,18-1-0-31-0,6729-59-3350,AG 20-100 AC,26.5,AC,150600,0,150600,2500,9900,163000,140000,0,140000,2500,11500,154000,A1,AG/GEN,,,
1298,17-1-0-78-A,6810-11-4151,SNGL FAM SUB,4.13,AC,58400,0,58400,70900,0,129300,55200,0,55200,57600,0,112800,A1,AG/GEN,,,
1299,17-1-0-93-0,6810-21-7061,SNGL FAM SUB,8.77,AC,78900,0,78900,0,0,78900,76900,0,76900,0,0,76900,A1,AG/GEN,,,
1300,17-1-0-93-B,6810-21-2601,SNGL FAM SUB,2.88,AC,51300,0,51300,0,0,51300,48300,0,48300,0,0,48300,A1,AG/GEN,,,
1301,17-1-0-78-0,6810-10-3936,SNGL FAM SUB,3.61,AC,55500,0,55500,0,0,55500,52400,0,52400,0,0,52400,A1,AG/GEN,,,
1302,17-1-0-93-A,6810-21-1321,SNGL FAM SUB,1.75,AC,44500,0,44500,237100,35800,317400,42100,0,42100,191800,31100,265000,A1,AG/GEN,,,
1303,12-5-0-6-0,6832-35-9529,SNGL FAM SUB,2.01,AC,63100,0,63100,172300,4200,239600,61300,0,61300,148400,2900,212600,A1,AG/GEN,,,
1304,20-12-0-9-0,6841-90-2278,SNGL FAM SUB,3.15,AC,63500,0,63500,201700,3700,268900,61200,0,61200,175300,2600,239100,A1,AG/GEN,,,
1305,20-12-0-10-0,6841-80-8690,SNGL FAM SUB,2.43,AC,57300,0,57300,247400,3700,308400,56300,0,56300,230600,3800,290700,A1,AG/GEN,,,
1306,6-1-0-46-0,6832-28-5046,SNGL FAM SUB,13.898,AC,114500,108100,6400,0,0,114500,111800,105900,5900,0,0,111800,A1,AG/GEN,,,
1310,65-1-0-1-0,7733-69-1312,AG 20-100 AC,45.61,AC,1704200,291800,1412400,534200,86900,2325300,1481600,253300,1228300,464300,76100,2022000,R1A2,RES LTD,,,
1312,65-1-0-4-0,7733-79-8294,SNGL FAM SUB,7.95,AC,75500,62300,13200,0,0,75500,66000,54400,11600,0,0,66000,A2,AG/LTD,,,
1313,62-2-C-1-0,7714-03-3925,SNGL FAM SUB,0,AC,115000,0,115000,245400,0,360400,100000,0,100000,224100,0,324100,R1,RES/LTD,,,
1314,66-3-0-4-0,7723-35-9907,SNGL FAM SUB,4.23,AC,390000,0,390000,570100,4000,964100,340000,0,340000,530900,3800,874700,R1,RES/LTD,,,
1315,46-1-0-97-G,7717-09-3965,SNGL FAM SUB,1.084,AC,98600,0,98600,265000,36800,400400,89700,0,89700,223900,30000,343600,A2,AG/LTD,,,
1316,58-13-0-C-1,7715-34-8551,SNGL FAM SUB,2,AC,141400,0,141400,214300,59100,414800,123000,0,123000,182500,54200,359700,A2,AG/LTD,,,
1317,18-4-0-A-2,6810-93-5000,AG 20-100 AC,25,AC,156300,0,156300,220500,26200,403000,158000,0,158000,185900,26900,370800,A1,AG/GEN,,,
1318,62-2-B-13-0,7704-94-9459,SNGL FAM SUB,0,AC,115000,0,115000,243000,400,358400,100000,0,100000,222200,400,322600,R1,RES/LTD,,,
1319,63-1-0-25-0,7714-46-1191,SNGL FAM SUB,7.89,AC,300400,0,300400,456000,1400,757800,261300,0,261300,445500,1400,708200,R3,RES/GEN,,,
1320,56-1-0-57-0,6786-95-9444,AG 20-100 AC,34.33,AC,591400,485500,105900,1298200,7500,1897100,527800,433800,94000,1039900,7500,1575200,A2,AG/LTD,,,
1321,18-1-0-8-0,6810-69-1974,SNGL FAM SUB,16.74,AC,126900,0,126900,116400,26800,270100,124600,0,124600,106500,30600,261700,A1,AG/GEN,,,
1322,30-1-0-29-B,6758-26-4055,SNGL FAM SUB,3,AC,73600,0,73600,55200,0,128800,68700,0,68700,49900,0,118600,A2,AG/LTD,,,
1323,50-5-0-29-0,6726-33-9912,SNGL FAM SUB,8.51,AC,71400,0,71400,0,0,71400,68000,0,68000,0,0,68000,A1,AG/GEN,,,
1324,55-15-0-16-0,6785-68-8027,SNGL FAM SUB,3.01,AC,114500,0,114500,322800,500,437800,102100,0,102100,265300,500,367900,A2,AG/LTD,,,
1325,68-1-0-2-A,7733-86-3542,SNGL FAM SUB,0,AC,17000,0,17000,0,0,17000,14800,0,14800,0,0,14800,A2,AG/LTD,,,
1326,6-4-0-9-0,6832-89-7487,SNGL FAM SUB,5.02,AC,74900,0,74900,146800,0,221700,73400,0,73400,129700,0,203100,A1,AG/GEN,,,
1327,67-2-C-2-0,7723-55-2964,SNGL FAM SUB,0,AC,184000,0,184000,405600,0,589600,160000,0,160000,340100,0,500100,R1,RES/LTD,,,
1328,32-4-0-2-0,6779-66-0174,SNGL FAM SUB,4.08,AC,102600,0,102600,222900,17200,342700,91700,0,91700,181400,14700,287800,A2,AG/LTD,,,
1329,3-2-0-1-0,6803-24-2006,SNGL FAM SUB,3.25,AC,51600,0,51600,144300,2400,198300,49300,0,49300,113900,2400,165600,A1,AG/GEN,,,
1330,3-2-0-3-0,6803-24-5351,SNGL FAM SUB,2.42,AC,46900,0,46900,11400,6700,65000,45100,0,45100,11300,5200,61600,A1,AG/GEN,,,
1331,58-3-A-27-0,7726-26-1939,SNGL FAM SUB,0,AC,88000,0,88000,174900,800,263700,80000,0,80000,146400,800,227200,RN,RESIDEN,,,
1332,38-1-0-23-0,6707-69-9551,AG 20-100 AC,20,AC,126200,0,126200,0,0,126200,123500,0,123500,0,0,123500,A1,AG/GEN,,,
1333,38-1-0-24-0,6707-68-8820,AG 20-100 AC,20,AC,126200,0,126200,0,0,126200,123500,0,123500,0,0,123500,A1,AG/GEN,,,
1334,27-1-0-41-A,6728-16-2380,AG 20-100 AC,25.743,AC,105500,0,105500,0,0,105500,104000,0,104000,0,0,104000,A1,AG/GEN,,,
1335,15-4-0-1-0,5880-30-0270,SNGL FAM SUB,4.51,AC,49500,0,49500,0,0,49500,48400,0,48400,0,0,48400,A1,AG/GEN,,,
1336,15-4-0-6-0,5789-39-1877,SNGL FAM SUB,9.75,AC,61000,0,61000,0,0,61000,59900,0,59900,0,0,59900,A1,AG/GEN,,,
1337,15-4-0-2-0,5880-30-4350,SNGL FAM SUB,1.21,AC,39600,0,39600,0,0,39600,38700,0,38700,0,0,38700,A1,AG/GEN,,,
1338,57-1-0-59-A,7716-05-5496,SNGL FAM SUB,4.33,AC,280300,102600,177700,40300,1100,321700,243700,89200,154500,34700,1100,279500,A2,AG/LTD,,,
1339,20-4-0-2-0,6841-81-4184,SNGL FAM SUB,0.4,AC,3500,0,3500,0,0,3500,3400,0,3400,0,0,3400,A1,AG/GEN,,,
1340,42-15-0-4-0,6757-61-3902,SNGL FAM SUB,3.25,AC,107700,0,107700,0,0,107700,93200,0,93200,0,0,93200,A2,AG/LTD,,,
1341,42-15-0-6-0,6757-61-3611,SNGL FAM SUB,4.15,AC,171100,0,171100,554400,0,725500,148700,0,148700,479400,0,628100,A2,AG/LTD,,,
1342,42-15-0-7-0,6757-61-3435,SNGL FAM SUB,3.085,AC,154900,0,154900,0,0,154900,135700,0,135700,0,0,135700,A2,AG/LTD,,,
1343,26-1-0-17-0,6719-12-1543,SNGL FAM SUB,1,AC,40000,0,40000,130600,200,170800,38000,0,38000,106700,200,144900,A1,AG/GEN,,,
1344,5-3-0-25-0,6824-21-1442,SNGL FAM SUB,3.45,AC,55000,0,55000,0,0,55000,54700,0,54700,0,0,54700,A1,AG/GEN,,,
1345,26-1-0-34-0,6708-71-9512,SNGL FAM SUB,12.618,AC,70900,0,70900,0,0,70900,69500,0,69500,0,0,69500,A1,AG/GEN,,,
1346,42-16-B-4-0,6757-93-5796,SNGL FAM SUB,1.6,AC,97800,0,97800,214600,0,312400,88800,0,88800,202800,0,291600,R1,RES/LTD,,,
1347,31-8-0-5-0,6779-51-9703,SNGL FAM SUB,6.99,AC,105900,0,105900,0,0,105900,94400,0,94400,0,0,94400,A2,AG/LTD,,,
1348,31-6-0-2-0,6778-42-9568,SNGL FAM SUB,6.38,AC,125400,0,125400,601700,113300,840400,112100,0,112100,513800,102100,728000,A2,AG/LTD,,,
1349,58-1-0-45-C,7715-83-1814,SNGL FAM SUB,5.92,AC,226000,0,226000,158000,29600,413600,196400,0,196400,133600,25200,355200,A2,AG/LTD,,,
1351,67-13-B-5-0,7733-37-2030,SNGL FAM SUB,0,AC,265000,0,265000,438100,1000,704100,220000,0,220000,389500,1000,610500,R1,RES/LTD,,,
1352,62-17-B-4-0,7714-06-0080,SNGL FAM SUB,0,AC,115000,0,115000,131200,5400,251600,100000,0,100000,119500,4700,224200,R1,RES/LTD,,,
1353,47-25-0-13-0,7727-00-1460,SNGL FAM SUB,1.02,AC,126700,0,126700,323600,3000,453300,113100,0,113100,271300,2200,386600,A2,AG/LTD,,,
1354,31-1-0-97-0,6778-32-7915,SNGL FAM SUB,2.35,AC,83500,0,83500,461800,0,545300,74600,0,74600,378100,0,452700,A2,AG/LTD,,,
1355,21-1-0-39-0,6759-39-9324,AG 20-100 AC,21.82,AC,256700,0,256700,239900,2700,499300,233100,0,233100,203000,2700,438800,A2,AG/LTD,,,
1356,58-24-0-4-0,7716-61-6035,SNGL FAM SUB,16.55,AC,530900,0,530900,1015900,147100,1693900,462100,0,462100,890200,129800,1482100,A2,AG/LTD,,,
1357,48-3-D-1-0,7726-57-3643,SNGL FAM SUB,0,AC,130000,0,130000,193500,300,323800,117000,0,117000,167800,300,285100,R1,RES/LTD,,,
1358,57-25-B-10-0,7716-13-6068,SNGL FAM SUB,3.223,AC,365000,0,365000,321000,0,686000,335000,0,335000,289500,0,624500,A2,AG/LTD,,,
1359,64-14-A-1-0,7733-17-8520,SNGL FAM SUB,0,AC,251800,0,251800,867100,0,1118900,209000,0,209000,688200,0,897200,R1,RES/LTD,,,
1360,58-19-0-4-0,7715-99-2290,SNGL FAM SUB,3.51,AC,165600,0,165600,494300,0,659900,144000,0,144000,420600,0,564600,A2,AG/LTD,,,
1361,58-19-0-5-0,7715-98-1798,SNGL FAM SUB,5.85,AC,208100,0,208100,387300,40700,636100,180800,0,180800,324700,34100,539600,A2,AG/LTD,,,
1362,58-19-0-6-0,7715-88-7645,SNGL FAM SUB,3.42,AC,163600,0,163600,545700,16600,725900,142200,0,142200,463900,15300,621400,A2,AG/LTD,,,
1363,58-19-0-7-0,7715-88-4824,SNGL FAM SUB,3.57,AC,167000,0,167000,764000,0,931000,145200,0,145200,654900,0,800100,A2,AG/LTD,,,
1364,58-19-0-8-0,7715-89-4225,SNGL FAM SUB,3.52,AC,165900,0,165900,536200,3000,705100,144200,0,144200,465300,3000,612500,A2,AG/LTD,,,
1365,58-19-0-9-0,7715-89-8129,SNGL FAM SUB,6.15,AC,225800,0,225800,504900,1200,731900,196300,0,196300,425600,1200,623100,A2,AG/LTD,,,
1366,48-4-0-B-0,7727-50-9395,SNGL FAM SUB,0.84,AC,94200,0,94200,0,3500,97700,84200,0,84200,0,3500,87700,A2,AG/LTD,,,
1367,58-24-0-3-0,7716-61-0184,SNGL FAM SUB,5.05,AC,248700,0,248700,895300,54600,1198600,216200,0,216200,742400,49800,1008400,A2,AG/LTD,,,
1368,47-1-0-82-0,7726-07-7811,COMM & IND,2.83,AC,2026300,0,2026300,216000,0,2242300,1925900,0,1925900,208500,0,2134400,B1,BUS/GEN,,,
1369,48-3-D-4-A,7726-57-5409,SNGL FAM SUB,0,AC,130000,0,130000,0,0,130000,18000,0,18000,0,0,18000,R1,RES/LTD,,,
1370,29-1-0-29-0,6748-33-7040,AG 20-100 AC,22.395,AC,233700,223400,10300,0,0,233700,227500,218000,9500,0,0,227500,A1,AG/GEN,,,
1371,47-1-0-83-0,7726-07-7333,COMM & IND,0.83,AC,365200,0,365200,207900,3000,576100,332000,0,332000,169500,3000,504500,B1,BUS/GEN,,,
1372,64-2-0-5-0,7733-07-0662,COMM & IND,1.077,AC,212600,0,212600,570400,27900,810900,196900,0,196900,560000,22200,779100,A2,AG/LTD,,,
1373,29-13-0-3-0,6748-42-7119,SNGL FAM SUB,1.5,AC,59000,0,59000,125300,300,184600,54600,0,54600,103100,300,158000,A1,AG/GEN,,,
1374,4-1-0-28-A,6803-86-2472,SNGL FAM SUB,5.07,AC,60500,0,60500,0,12200,72700,59400,0,59400,0,12200,71600,A1,AG/GEN,,,
1375,5-10-0-2-0,6813-89-3871,SNGL FAM SUB,15.26,AC,105200,0,105200,0,0,105200,103200,0,103200,0,0,103200,A1,AG/GEN,,,
1376,58-3-C-3-0,7726-17-7005,SNGL FAM SUB,0,AC,88000,0,88000,198500,3200,289700,80000,0,80000,171800,3200,255000,RN,RESIDEN,,,
1378,46-1-0-76-E,7707-35-6716,SNGL FAM SUB,10.8,AC,234800,0,234800,242600,2400,479800,209900,0,209900,202900,2400,415200,A2,AG/LTD,,,
1379,67-2-B-13-0,7723-45-9071,SNGL FAM SUB,0,AC,184000,0,184000,282800,15400,482200,160000,0,160000,238500,13600,412100,R1,RES/LTD,,,
1380,57-1-0-69-0,7706-84-7054,AG 20-100 AC,46.47,AC,2011200,0,2011200,6417600,312000,8740800,1748200,0,1748200,6123100,285500,8156800,A2,AG/LTD,,,
1381,13-1-0-43-0,6841-83-2645,SNGL FAM SUB,2,AC,58600,0,58600,161000,16200,235800,57500,0,57500,142000,13900,213400,A1,AG/GEN,,,
1382,13-9-0-4-0,6841-74-3051,SNGL FAM SUB,4.75,AC,81700,0,81700,182200,5800,269700,80200,0,80200,159000,5800,245000,A1,AG/GEN,,,
1384,67-2-B-14-0,7723-54-0807,SNGL FAM SUB,0,AC,184000,0,184000,272000,600,456600,160000,0,160000,231400,600,392000,R1,RES/LTD,,,
1385,32-1-0-15-0,6779-84-0184,SNGL FAM SUB,1.66,AC,73600,0,73600,23100,800,97500,65700,0,65700,18900,800,85400,A2,AG/LTD,,,
1386,6-11-0-1-0,6823-89-9133,SNGL FAM SUB,2,AC,44800,0,44800,144000,18300,207100,44000,0,44000,124200,18300,186500,A1,AG/GEN,,,
1387,6-11-0-2-0,6823-99-1451,SNGL FAM SUB,4,AC,55000,0,55000,182100,6000,243100,54000,0,54000,156700,6000,216700,A1,AG/GEN,,,
1389,57-1-0-3-0,7706-35-8345,SNGL FAM SUB,1.13,AC,23800,0,23800,0,0,23800,20700,0,20700,0,0,20700,A2,AG/LTD,,,
1390,57-5-0-2-0,7706-45-5911,AG 20-100 AC,40.05,AC,1004600,0,1004600,887100,17000,1908700,872600,0,872600,740100,17000,1629700,A2,AG/LTD,,,
1391,51-5-0-A-0,6735-33-0376,AG 20-100 AC,57.37,AC,137900,0,137900,764900,68500,971300,133300,0,133300,694300,47700,875300,A1,AG/GEN,,,
1392,63-1-0-81-0,7713-99-4469,SNGL FAM SUB,19.482,AC,651700,0,651700,692000,900,1344600,566800,0,566800,589000,900,1156700,A2,AG/LTD,,,
1393,47-17-0-A-1,7718-21-8668,SNGL FAM SUB,7.08,AC,202400,0,202400,224400,31200,458000,180800,0,180800,190100,26700,397600,A2,AG/LTD,,,
1394,63-1-0-50-0,7714-35-6267,SNGL FAM SUB,3,AC,168900,0,168900,148500,18400,335800,146900,0,146900,126000,15500,288400,R3,RES/GEN,,,
1395,6-1-0-37-A,6822-77-5692,SNGL FAM SUB,10.14,AC,101400,0,101400,252900,2300,356600,98900,0,98900,217900,1800,318600,A1,AG/GEN,,,
1396,44-1-0-23-0,6777-91-5658,SNGL FAM SUB,0.52,AC,63800,0,63800,330000,26800,420600,57000,0,57000,278900,22700,358600,A2,AG/LTD,,,
1404,44-1-0-50-A,6787-23-9258,SNGL FAM SUB,1.68,AC,80800,0,80800,158300,0,239100,72200,0,72200,129000,0,201200,A2,AG/LTD,,,
1405,44-1-0-50-C,6787-43-1198,SNGL FAM SUB,0.51,AC,8100,0,8100,0,0,8100,7200,0,7200,0,0,7200,A2,AG/LTD,,,
1406,20-11-0-13-0,6841-91-9727,SNGL FAM SUB,2,AC,55600,0,55600,190000,3200,248800,52500,0,52500,174100,2500,229100,A1,AG/GEN,,,
1407,63-1-0-10-0,7715-30-0752,SNGL FAM SUB,6.2361,AC,260600,0,260600,142500,15300,418400,226900,0,226900,120900,14200,362000,A2,AG/LTD,,,
1408,29-1-0-55-0,6749-61-1518,SNGL FAM SUB,2.89,AC,72600,0,72600,255400,0,328000,67700,0,67700,211700,0,279400,A1,AG/GEN,,,
1568,38-1-0-88-0,6707-94-2970,SNGL FAM SUB,2,AC,24500,23600,900,0,0,24500,24000,23100,900,0,0,24000,A1,AG/GEN,,,
1569,26-7-0-3-0,6708-94-4590,SNGL FAM SUB,3.01,AC,50100,0,50100,0,0,50100,49100,0,49100,0,0,49100,A1,AG/GEN,,,
1570,26-7-0-4-0,6708-94-3622,SNGL FAM SUB,3.01,AC,50100,0,50100,265500,30600,346200,49100,0,49100,225800,25500,300400,A1,AG/GEN,,,
1571,26-7-0-5-0,6708-94-1755,SNGL FAM SUB,3.01,AC,50100,0,50100,0,0,50100,49100,0,49100,0,0,49100,A1,AG/GEN,,,
1572,26-2-0-3-C,6709-91-1096,SNGL FAM SUB,5,AC,63200,0,63200,156900,200,220300,62000,0,62000,137500,200,199700,A1,AG/GEN,,,
1573,43-20-0-10-0,6768-52-5326,SNGL FAM SUB,3.15,AC,96800,0,96800,144800,4700,246300,88000,0,88000,126100,5000,219100,A2,AG/LTD,,,
1574,64-19-E-17-0,7733-37-8658,SNGL FAM SUB,0,AC,265000,0,265000,427100,0,692100,220000,0,220000,379300,0,599300,R1,RES/LTD,,,
1575,57-14-0-A-0,7706-72-8465,SNGL FAM SUB,8.87,AC,356000,0,356000,0,0,356000,309800,0,309800,0,0,309800,A2,AG/LTD,,,
1576,57-14-0-B-0,7706-72-6018,SNGL FAM SUB,4.75,AC,257800,0,257800,331000,34000,622800,224100,0,224100,292700,29200,546000,A2,AG/LTD,,,
1577,57-14-0-C-0,7706-81-0948,SNGL FAM SUB,4.67,AC,291000,0,291000,0,0,291000,252900,0,252900,0,0,252900,A2,AG/LTD,,,
1739,64-4-1-3-0,7724-93-1334,SNGL FAM SUB,0,AC,70000,0,70000,124700,79100,273800,60000,0,60000,106800,67300,234100,RN,RESIDEN,,,
1742,64-4-1-5-0,7724-93-1459,SNGL FAM SUB,0,AC,35000,0,35000,0,0,35000,30000,0,30000,0,0,30000,RN,RESIDEN,,,
1743,64-4-1-6-0,7724-93-1559,SNGL FAM SUB,0,AC,35000,0,35000,0,0,35000,30000,0,30000,0,0,30000,RN,RESIDEN,,,
1744,64-4-1-7-0,7724-93-1669,SNGL FAM SUB,0,AC,35000,0,35000,0,0,35000,30000,0,30000,0,0,30000,RN,RESIDEN,,,
1745,64-4-1-8-0,7724-93-1768,SNGL FAM SUB,0,AC,35000,0,35000,0,0,35000,30000,0,30000,0,0,30000,RN,RESIDEN,,,
1746,64-4-1-28-0,7724-83-9460,SNGL FAM SUB,0,AC,20200,0,20200,0,0,20200,17600,0,17600,0,0,17600,RN,RESIDEN,,,
1747,64-4-1-29-0,7724-83-9330,SNGL FAM SUB,0,AC,20200,0,20200,0,0,20200,17600,0,17600,0,0,17600,RN,RESIDEN,,,
1748,45-1-0-92-0,6797-87-9799,SNGL FAM SUB,13.048,AC,243600,0,243600,0,0,243600,218000,0,218000,0,0,218000,A2,AG/LTD,,,
1749,31-10-2-7-0,6779-50-2456,SNGL FAM SUB,3.4,AC,101900,0,101900,220800,7800,330500,91100,0,91100,182000,7800,280900,A2,AG/LTD,,,
1750,18-1-0-28-0,6729-27-5504,SNGL FAM SUB,4.21,AC,58900,0,58900,229600,0,288500,55700,0,55700,187500,0,243200,A1,AG/GEN,,,
1751,27-1-0-55-0,6729-26-2433,SNGL FAM SUB,17,AC,123500,0,123500,5000,200,128700,126000,0,126000,5000,200,131200,A1,AG/GEN,,,
1752,51-2-0-1-A,6736-41-3102,SNGL FAM SUB,1,AC,34900,0,34900,63200,1200,99300,34200,0,34200,54700,1200,90100,A1,AG/GEN,,,
1753,17-1-0-12-0,6709-48-9163,AG 20-100 AC,75,AC,247800,212900,34900,0,0,247800,241500,209600,31900,0,0,241500,A1,AG/GEN,,,
1754,43-11-0-11-0,6767-87-2909,SNGL FAM SUB,1.15,AC,72300,0,72300,280700,2500,355500,64500,0,64500,233800,2500,300800,A2,AG/LTD,,,
1755,18-1-0-29-A,6729-28-6541,SNGL FAM SUB,4.71,AC,61800,0,61800,234600,0,296400,58400,0,58400,197700,0,256100,A1,AG/GEN,,,
1756,27-1-0-78-0,6728-54-3959,SNGL FAM SUB,10,AC,89200,0,89200,89600,100,178900,87500,0,87500,76400,100,164000,A1,AG/GEN,,,
1757,18-1-0-28-A,6729-27-3974,SNGL FAM SUB,3.07,AC,52400,0,52400,103600,4900,160900,50400,0,50400,87400,4900,142700,A1,AG/GEN,,,
1758,18-1-0-28-B,6729-28-5196,SNGL FAM SUB,4.97,AC,63300,0,63300,0,0,63300,61800,0,61800,0,0,61800,A1,AG/GEN,,,
1759,46-21-A-3-0,7708-80-8478,SNGL FAM SUB,2.23,AC,123500,0,123500,244000,200,367700,112200,0,112200,204100,200,316500,A2,AG/LTD,,,
1760,46-23-0-21-0,7707-94-1724,SNGL FAM SUB,2.694,AC,180200,0,180200,358500,900,539600,163800,0,163800,267600,900,432300,A2,AG/LTD,,,
1761,55-1-0-88-B,6785-44-4690,SNGL FAM SUB,3,AC,103100,0,103100,429200,0,532300,92000,0,92000,353000,0,445000,A2,AG/LTD,,,
1762,30-1-0-5-0,6759-35-2737,AG 20-100 AC,42.58,AC,516000,431300,84700,664100,37700,1217800,482300,404700,77600,556400,33200,1071900,A1A2,AG GEN/,,,
1763,58-4-E-1-0,7716-56-0086,SNGL FAM SUB,0,AC,20100,0,20100,0,0,20100,18300,0,18300,0,0,18300,A2,AG/LTD,,,
1764,44-1-0-19-A,6777-92-8060,SNGL FAM SUB,0.938,AC,69000,0,69000,155400,0,224400,61700,0,61700,127900,0,189600,A2,AG/LTD,,,
1765,13-6-0-1-0,6841-81-6941,AG 20-100 AC,21.88,AC,218500,0,218500,172100,3000,393600,214300,0,214300,170900,3000,388200,A1,AG/GEN,,,
1409,29-1-0-57-B,6749-51-9519,SNGL FAM SUB,2.5,AC,68900,0,68900,0,0,68900,64000,0,64000,0,0,64000,A1,AG/GEN,,,
1410,62-1-0-26-0,7714-03-9781,COMM & IND,2.05,AC,269100,0,269100,393400,3500,666000,244600,0,244600,369400,3500,617500,B1R3,BUS/GEN,,,
1411,62-1-0-27-A,7714-04-9122,SNGL FAM SUB,0.005,AC,200,0,200,0,0,200,200,0,200,0,0,200,R3,RES/GEN,,,
1412,64-19-E-18-0,7733-37-7892,SNGL FAM SUB,0,AC,265000,0,265000,406300,0,671300,220000,0,220000,324300,0,544300,R1,RES/LTD,,,
1413,45-16-0-14-0,6798-62-2204,SNGL FAM SUB,2.17,AC,92800,0,92800,274900,9800,377500,82900,0,82900,226300,7100,316300,A2,AG/LTD,,,
1414,45-16-0-13-0,6798-62-2471,SNGL FAM SUB,2.05,AC,91200,0,91200,166900,5100,263200,81400,0,81400,136400,4800,222600,A2,AG/LTD,,,
1415,55-1-0-76-B,6786-60-8845,SNGL FAM SUB,2.9,AC,101500,0,101500,158500,3200,263200,90500,0,90500,126000,3200,219700,A2,AG/LTD,,,
1416,66-4-0-7-0,7723-34-4650,SNGL FAM SUB,3.33,AC,605500,0,605500,0,0,605500,526500,0,526500,0,0,526500,A2,AG/LTD,,,
1417,66-4-0-9-0,7723-34-0995,SNGL FAM SUB,3.32,AC,538200,0,538200,0,0,538200,468000,0,468000,0,0,468000,A2,AG/LTD,,,
1419,66-1-0-9-0,7723-26-9206,SNGL FAM SUB,8.022,AC,543400,0,543400,1151100,131000,1825500,472500,0,472500,1104200,117500,1694200,A2,AG/LTD,,,
1420,56-1-0-39-A,6795-03-0720,SNGL FAM SUB,5.823,AC,44000,0,44000,0,0,44000,39300,0,39300,0,0,39300,A2,AG/LTD,,,
1422,56-8-0-4-0,6795-08-0105,SNGL FAM SUB,13.498,AC,263500,0,263500,0,4000,267500,234900,0,234900,0,4000,238900,A2,AG/LTD,,,
1423,56-4-0-A-4,6795-08-4441,SNGL FAM SUB,2.77,AC,80600,79300,1300,0,0,80600,72000,70900,1100,0,0,72000,A2,AG/LTD,,,
1424,3-1-0-5-0,6803-22-1463,AG 20-100 AC,45.843,AC,166600,0,166600,0,0,166600,160500,0,160500,0,0,160500,A1,AG/GEN,,,
1425,3-1-0-5-A,6803-13-9336,SNGL FAM SUB,1,AC,3600,0,3600,0,0,3600,3500,0,3500,0,0,3500,A1,AG/GEN,,,
1426,67-1-0-8-0,7723-66-2961,SNGL FAM SUB,3,AC,250900,0,250900,409000,1000,660900,218100,0,218100,335700,1000,554800,R1,RES/LTD,,,
1427,66-3-0-6-0,7723-45-0205,SNGL FAM SUB,3.65,AC,390000,0,390000,747500,0,1137500,340000,0,340000,662400,0,1002400,R1,RES/LTD,,,
1428,20-9-0-H-0,6749-58-8000,AG 20-100 AC,26.04,AC,123400,0,123400,0,0,123400,122400,0,122400,0,0,122400,A1,AG/GEN,,,
1429,51-1-0-40-B,6726-92-8293,SNGL FAM SUB,5,AC,61200,0,61200,90700,1100,153000,60000,0,60000,75900,1100,137000,A1,AG/GEN,,,
1430,29-16-0-A-0,6749-57-9117,SNGL FAM SUB,5.28,AC,94000,0,94000,171800,4300,270100,90100,0,90100,141700,4400,236200,A1,AG/GEN,,,
1431,62-24-0-18-0,7704-87-9098,SNGL FAM SUB,3.25,AC,217800,0,217800,714100,47300,979200,198000,0,198000,621300,42500,861800,R1,RES/LTD,,,
1432,20-1-0-81-A,6840-70-3781,SNGL FAM SUB,1,AC,54000,0,54000,126700,9500,190200,49900,0,49900,103600,6600,160100,A1,AG/GEN,,,
1433,62-3-C-21-0,7714-04-4283,SNGL FAM SUB,0,AC,115000,0,115000,372000,12000,499000,100000,0,100000,349200,12000,461200,R1,RES/LTD,,,
1434,58-22-A-1-0,7715-46-0824,SNGL FAM SUB,3.618,AC,383300,0,383300,446400,0,829700,351800,0,351800,425300,0,777100,A2,AG/LTD,,,
1435,56-4-0-A-1,6785-96-8942,SNGL FAM SUB,11.03,AC,83300,0,83300,0,0,83300,74500,0,74500,0,0,74500,A2,AG/LTD,,,
1436,56-4-0-A-2,6795-17-3065,AG 20-100 AC,69.6,AC,700900,666200,34700,0,0,700900,626600,596700,29900,0,0,626600,A2,AG/LTD,,,
1437,58-1-0-64-0,7716-62-3561,AG 20-100 AC,29,AC,1298800,961700,337100,560900,7700,1867400,741300,516900,224400,470500,7700,1219500,A2,AG/LTD,,,
1438,18-7-0-C-0,6820-08-2801,SNGL FAM SUB,3.65,AC,55700,0,55700,269000,0,324700,53900,0,53900,225800,0,279700,A1,AG/GEN,,,
1439,11-1-0-8-0,6822-00-8052,SNGL FAM SUB,8.01,AC,101600,0,101600,194800,400,296800,99600,0,99600,178500,400,278500,A1,AG/GEN,,,
1440,62-1-0-30-A,7714-03-6760,COMM & IND,2.361,AC,168700,0,168700,150300,2600,321600,154000,0,154000,146500,2700,303200,B1,BUS/GEN,,,
1441,46-14-0-1-0,7718-01-6032,SNGL FAM SUB,1.76,AC,113300,0,113300,182200,32900,328400,103000,0,103000,144800,27800,275600,A2,AG/LTD,,,
1442,45-1-0-83-0,6797-93-2988,AG > 100 AC,165.57,AC,2523900,2278000,245900,375800,9800,2909500,2258000,2040400,217600,308200,9500,2575700,A2,AG/LTD,,,
1443,46-1-0-44-0,7706-09-9753,AG 20-100 AC,50,AC,769500,746200,23300,0,0,769500,669800,648500,21300,0,0,669800,A2,AG/LTD,,,
1444,46-1-0-51-0,7706-79-7661,AG 20-100 AC,78.1,AC,1530800,0,1530800,0,100,1530900,1366800,0,1366800,0,100,1366900,RP,"RURAL,P",,,
1445,46-1-0-22-A,7707-04-3860,SNGL FAM SUB,3.114,AC,121200,119600,1600,0,0,121200,108200,106900,1300,0,0,108200,A2,AG/LTD,,,
1446,46-17-0-5-0,7707-02-4816,SNGL FAM SUB,11,AC,245900,240800,5100,0,0,245900,219700,215000,4700,0,0,219700,A2,AG/LTD,,,
1447,46-17-0-6-0,7707-03-4421,SNGL FAM SUB,5,AC,153900,151600,2300,0,0,153900,137500,135400,2100,0,0,137500,A2,AG/LTD,,,
1448,31-1-0-37-0,6769-70-0231,AG > 100 AC,181.89,AC,1466000,1382100,83900,0,0,1466000,1327800,1250500,77300,0,0,1327800,A2,AG/LTD,,,
1449,45-11-0-1-0,6797-93-8027,SNGL FAM SUB,5,AC,137100,0,137100,407000,29000,573100,122500,0,122500,331800,29000,483300,A2,AG/LTD,,,
1450,45-11-0-2-0,6797-93-8433,SNGL FAM SUB,5,AC,137100,134600,2500,0,0,137100,122500,120400,2100,0,0,122500,A2,AG/LTD,,,
1451,45-11-0-3-0,6797-92-3783,SNGL FAM SUB,3,AC,45300,43800,1500,0,0,45300,40500,39200,1300,0,0,40500,A2,AG/LTD,,,
1452,45-11-0-4-0,6797-92-8624,SNGL FAM SUB,7,AC,148100,144800,3300,0,0,148100,132400,129400,3000,0,0,132400,A2,AG/LTD,,,
1453,45-11-0-7-0,6797-93-3236,SNGL FAM SUB,7,AC,148100,144500,3600,0,0,148100,132400,129400,3000,0,0,132400,A2,AG/LTD,,,
1454,45-1-0-66-0,6797-65-5689,AG 20-100 AC,72.02,AC,1192200,1088200,104000,58800,0,1251000,1064000,971100,92900,49300,0,1113300,A2,AG/LTD,,,
1455,45-1-0-68-0,6797-64-1231,AG 20-100 AC,21.1,AC,291200,281500,9700,0,0,291200,259500,250500,9000,0,0,259500,A2,AG/LTD,,,
1456,45-1-0-85-0,6797-85-9713,AG 20-100 AC,22.8,AC,442400,430900,11500,0,0,442400,394300,384500,9800,0,0,394300,A2,AG/LTD,,,
1457,46-1-0-41-0,7707-21-0933,AG 20-100 AC,25,AC,387500,376000,11500,0,0,387500,345000,334400,10600,0,0,345000,A2,AG/LTD,,,
1458,46-1-0-42-0,7707-11-2311,AG 20-100 AC,73.5,AC,1025300,991400,33900,0,0,1025300,912900,881700,31200,0,0,912900,A2,AG/LTD,,,
1459,46-1-0-51-A,7706-78-5031,AG 20-100 AC,80,AC,1360000,0,1360000,0,0,1360000,1216000,0,1216000,0,0,1216000,RP,"RURAL,P",,,
1460,46-1-0-12-0,7707-06-2872,AG 20-100 AC,43.5,AC,743600,722600,21000,0,0,743600,663300,644800,18500,0,0,663300,A2,AG/LTD,,,
1461,46-1-0-13-0,7707-05-3908,AG 20-100 AC,44.97,AC,769500,747000,22500,0,0,769500,686400,667100,19300,0,0,686400,A2,AG/LTD,,,
1462,45-1-0-80-0,6797-91-2204,SNGL FAM SUB,18.41,AC,302300,231800,70500,62500,700,365500,269500,206700,62800,52100,700,322300,A2,AG/LTD,,,
1463,46-17-0-8-0,7707-02-7641,SNGL FAM SUB,11,AC,176000,170900,5100,0,0,176000,157300,152600,4700,0,0,157300,A2,AG/LTD,,,
1464,46-1-0-19-0,7707-05-0363,SNGL FAM SUB,5.46,AC,198000,195200,2800,0,0,198000,176700,174400,2300,0,0,176700,A2,AG/LTD,,,
1465,46-1-0-21-0,6797-94-9982,SNGL FAM SUB,5.66,AC,202500,199600,2900,0,0,202500,180700,178300,2400,0,0,180700,A2,AG/LTD,,,
1466,19-5-0-5-0,6739-19-7903,SNGL FAM SUB,1.368,AC,56800,0,56800,133200,1000,191000,53400,0,53400,110200,1000,164600,A1,AG/GEN,,,
1467,4-1-0-67-A,6813-34-6596,AG 20-100 AC,25,AC,11500,0,11500,0,0,11500,10600,0,10600,0,0,10600,A1,AG/GEN,,,
1468,6-1-0-50-0,6832-19-4072,SNGL FAM SUB,11.35,AC,103600,0,103600,109700,1700,215000,96100,0,96100,105700,1700,203500,A1,AG/GEN,,,
1469,57-10-0-8-0,7705-66-6301,SNGL FAM SUB,6.316,AC,265000,0,265000,700700,186200,1151900,240000,0,240000,675400,176000,1091400,A2,AG/LTD,,,
1470,21-4-0-9-0,6759-47-0655,SNGL FAM SUB,7.8,AC,124000,0,124000,259400,14100,397500,113800,0,113800,230900,12300,357000,A2,AG/LTD,,,
1471,64-15-A-9-0,7733-37-4730,SNGL FAM SUB,0,AC,265000,0,265000,680300,0,945300,220000,0,220000,573100,0,793100,R1,RES/LTD,,,
1472,6-3-0-11-0,6832-48-6346,SNGL FAM SUB,5.03,AC,79300,0,79300,250200,0,329500,77700,0,77700,221500,0,299200,A1,AG/GEN,,,
1473,12-6-0-21-0,6832-55-1635,SNGL FAM SUB,8.95,AC,96900,0,96900,0,0,96900,94900,0,94900,0,0,94900,A1,AG/GEN,,,
1474,12-6-0-22-0,6832-45-9352,SNGL FAM SUB,8.17,AC,99300,0,99300,160300,12500,272100,97300,0,97300,136900,12500,246700,A1,AG/GEN,,,
1475,46-21-A-5-0,7708-90-1860,SNGL FAM SUB,2.13,AC,121300,0,121300,216200,6400,343900,110300,0,110300,182600,6400,299300,A2,AG/LTD,,,
1476,58-3-A-9-0,7726-16-6538,SNGL FAM SUB,0,AC,88000,0,88000,142000,800,230800,80000,0,80000,146300,1900,228200,RN,RESIDEN,,,
1478,55-14-0-2-0,6785-28-4548,SNGL FAM SUB,8.74,AC,178900,0,178900,0,0,178900,159800,0,159800,0,0,159800,A2,AG/LTD,,,
1479,55-14-0-3-0,6785-28-9233,SNGL FAM SUB,6.71,AC,152100,0,152100,292200,2100,446400,135900,0,135900,241700,2000,379600,A2,AG/LTD,,,
1488,55-17-0-6-0,6785-36-8881,SNGL FAM SUB,3.29,AC,148600,0,148600,469400,0,618000,132700,0,132700,385500,0,518200,A2,AG/LTD,,,
1489,60-4-0-7-0,6784-27-3980,SNGL FAM SUB,7.66,AC,257000,0,257000,835200,42500,1134700,229500,0,229500,665600,37300,932400,A2,AG/LTD,,,
1490,60-4-0-6-0,6784-28-1551,SNGL FAM SUB,5,AC,237200,0,237200,724800,0,962000,211600,0,211600,595300,0,806900,A2,AG/LTD,,,
1491,38-3-0-5-0,6717-15-2607,SNGL FAM SUB,17,AC,120400,0,120400,0,0,120400,118000,0,118000,0,0,118000,A1,AG/GEN,,,
1492,17-1-0-55-0,6810-26-8553,AG 20-100 AC,36.85,AC,154800,0,154800,0,0,154800,152800,0,152800,0,0,152800,A1,AG/GEN,,,
1493,4-6-0-17-0,6813-55-0607,SNGL FAM SUB,8.14,AC,65700,0,65700,0,0,65700,64300,0,64300,0,0,64300,A1,AG/GEN,,,
1494,5-13-0-18-0,6813-55-5837,SNGL FAM SUB,8.34,AC,66400,0,66400,0,0,66400,65000,0,65000,0,0,65000,A1,AG/GEN,,,
1495,5-13-0-19-0,6813-66-0020,SNGL FAM SUB,8.287,AC,66200,0,66200,0,0,66200,64900,0,64900,0,0,64900,A1,AG/GEN,,,
1496,55-21-0-1-0,6776-83-6026,SNGL FAM SUB,2.34,AC,90300,0,90300,216300,12200,318800,80700,0,80700,177600,10500,268800,A2,AG/LTD,,,
1497,5-1-0-81-B,6823-54-2756,SNGL FAM SUB,3,AC,56600,0,56600,242600,0,299200,55000,0,55000,204900,0,259900,A1,AG/GEN,,,
1498,27-1-0-81-0,6728-62-0740,AG > 100 AC,303.84,AC,140900,0,140900,0,0,140900,129200,0,129200,0,0,129200,A1,AG/GEN,,,
1499,9-1-0-18-0,5892-63-5394,SNGL FAM SUB,1.18,AC,39400,0,39400,75200,200,114800,38600,0,38600,66000,200,104800,A1,AG/GEN,,,
1500,44-10-0-6-0,6787-53-6257,SNGL FAM SUB,3.41,AC,108200,0,108200,283100,0,391300,96600,0,96600,250700,0,347300,A2,AG/LTD,,,
1501,43-1-0-79-B,6767-93-1378,SNGL FAM SUB,1.01,AC,70200,0,70200,103300,0,173500,62700,0,62700,84900,0,147600,A2,AG/LTD,,,
1502,44-10-0-3-0,6787-54-4020,SNGL FAM SUB,5.73,AC,132500,0,132500,257400,0,389900,118400,0,118400,210000,0,328400,A2,AG/LTD,,,
1503,55-1-0-85-0,6785-75-5028,SNGL FAM SUB,8,AC,153200,0,153200,139800,2100,295100,137100,0,137100,107600,2100,246800,A2,AG/LTD,,,
1504,55-1-0-86-0,6785-74-6869,SNGL FAM SUB,2,AC,83900,0,83900,256000,0,339900,74900,0,74900,216700,0,291600,A2,AG/LTD,,,
1505,56-1-0-1-C,6786-84-6842,SNGL FAM SUB,1,AC,70100,0,70100,150000,5100,225200,62600,0,62600,121600,3100,187300,A2,AG/LTD,,,
1506,56-1-0-17-0,6785-84-0867,SNGL FAM SUB,2,AC,85900,0,85900,0,0,85900,76700,0,76700,0,0,76700,A2,AG/LTD,,,
1507,58-3-B-8-0,7726-17-4048,SNGL FAM SUB,0,AC,88000,0,88000,161900,15000,264900,80000,0,80000,133300,12400,225700,RN,RESIDEN,,,
1508,4-6-0-1-0,6813-32-7938,SNGL FAM SUB,8.2,AC,81200,0,81200,277500,2500,361200,79400,0,79400,257400,2500,339300,A1,AG/GEN,,,
1509,43-11-0-6-0,6767-78-9218,SNGL FAM SUB,1.66,AC,79600,0,79600,202500,3000,285100,71100,0,71100,164800,3000,238900,A2,AG/LTD,,,
1511,19-1-0-13-0,6830-25-2248,SNGL FAM SUB,10.372,AC,125500,0,125500,0,0,125500,118300,0,118300,0,0,118300,A1,AG/GEN,,,
1512,51-1-0-40-A,6736-02-3310,SNGL FAM SUB,9.85,AC,88400,0,88400,208100,1800,298300,86700,0,86700,182900,1700,271300,A1,AG/GEN,,,
1513,64-7-0-B-0,7724-92-6225,SNGL FAM SUB,10.07,AC,474700,0,474700,0,0,474700,412600,0,412600,0,0,412600,B1A2,BS AND,,,
1514,55-17-0-4-0,6785-46-1277,SNGL FAM SUB,1.68,AC,89300,0,89300,362100,29700,481100,79700,0,79700,296100,26200,402000,A2,AG/LTD,,,
1515,40-1-0-13-0,6737-10-3879,AG 20-100 AC,23.81,AC,174200,116300,57900,77600,10300,262100,171100,115800,55300,66800,9300,247200,A1,AG/GEN,,,
1517,43-11-0-9-0,6767-88-2491,SNGL FAM SUB,2.18,AC,87100,0,87100,278800,35900,401800,77800,0,77800,236800,30200,344800,A2,AG/LTD,,,
1518,4-1-0-26-0,6803-62-8958,SNGL FAM SUB,3.28,AC,51800,0,51800,214200,5000,271000,50500,0,50500,188800,5000,244300,A1,AG/GEN,,,
1519,12-1-0-41-C,6831-14-6686,SNGL FAM SUB,5,AC,69600,0,69600,163900,2000,235500,60300,0,60300,136200,2000,198500,A1,AG/GEN,,,
1522,55-15-0-10-0T,6785-76-2921,SNGL FAM SUB,3,AC,93600,0,93600,344600,2500,440700,83600,0,83600,284600,2500,370700,A2,AG/LTD,,,
1523,32-2-0-3-C,6778-86-2303,SNGL FAM SUB,2.66,AC,88000,0,88000,0,0,88000,78600,0,78600,0,0,78600,A2,AG/LTD,,,
1524,29-1-0-73-C,6749-64-1364,SNGL FAM SUB,2,AC,57000,0,57000,0,8400,65400,52500,0,52500,0,7000,59500,A1,AG/GEN,,,
1525,19-1-0-67-0,6830-44-4277,AG 20-100 AC,30.7,AC,197700,183000,14700,0,0,197700,190300,177200,13100,0,0,190300,A1,AG/GEN,,,
1526,5-1-0-19-0,6812-78-5513,AG 20-100 AC,46,AC,118200,0,118200,0,0,118200,115900,0,115900,0,0,115900,A1,AG/GEN,,,
1527,64-4-2-34-0,7724-93-5378,SNGL FAM SUB,0,AC,70000,0,70000,142500,1000,213500,60000,0,60000,121000,1000,182000,RN,RESIDEN,,,
1528,64-4-2-35-0,7724-93-5478,SNGL FAM SUB,0,AC,35000,0,35000,0,22100,57100,30000,0,30000,0,18200,48200,RN,RESIDEN,,,
1529,5-9-0-2-0,6814-81-1827,SNGL FAM SUB,2.2,AC,45800,0,45800,0,0,45800,45000,0,45000,0,0,45000,A1,AG/GEN,,,
1530,58-4-C-18-0,7716-56-0549,SNGL FAM SUB,0,AC,10000,0,10000,0,0,10000,9100,0,9100,0,0,9100,A2,AG/LTD,,,
1531,58-1-0-6-0,7716-37-7036,SNGL FAM SUB,3,AC,134200,0,134200,0,6500,140700,119800,0,119800,0,5900,125700,A2,AG/LTD,,,
1532,42-19-0-7-0,6766-18-8616,SNGL FAM SUB,1.76,AC,76000,0,76000,201300,13800,291100,64200,0,64200,167300,11300,242800,R3A2,RES GEN,,,
1533,46-28-0-B-0,7717-08-6977,SNGL FAM SUB,2.304,AC,122100,0,122100,184900,1400,308400,109100,0,109100,162800,1400,273300,A2,AG/LTD,,,
1536,42-1-0-117-0,6766-29-7758,AG 20-100 AC,54.676,AC,711300,521300,190000,544200,35300,1290800,635200,464900,170300,441100,33100,1109400,A2,AG/LTD,,,
1537,5-1-0-24-0,6812-99-5633,SNGL FAM SUB,3.3,AC,51400,0,51400,47100,3700,102200,50500,0,50500,41600,3700,95800,A1,AG/GEN,,,
1538,56-7-0-1-0,6785-95-7178,SNGL FAM SUB,15.15,AC,265400,0,265400,0,0,265400,236600,0,236600,0,0,236600,A2,AG/LTD,,,
1539,56-8-0-3-0,6785-97-7348,SNGL FAM SUB,19.1,AC,401500,0,401500,0,0,401500,358300,0,358300,0,0,358300,A2,AG/LTD,,,
1540,56-8-0-2-0,6795-06-4657,AG 20-100 AC,22.6,AC,485700,0,485700,1356000,110100,1951800,433500,0,433500,1114900,92000,1640400,A2,AG/LTD,,,
1541,19-1-0-27-0,6739-18-7988,SNGL FAM SUB,13.5,AC,135800,128900,6900,0,0,135800,127400,121600,5800,0,0,127400,A1,AG/GEN,,,
1542,62-17-B-1-0,7704-95-8751,SNGL FAM SUB,0,AC,115000,0,115000,219000,1800,335800,100000,0,100000,197900,1800,299700,R1,RES/LTD,,,
1544,5-3-0-28-0,6824-11-5706,SNGL FAM SUB,4.33,AC,60900,0,60900,272400,0,333300,59700,0,59700,226200,0,285900,A1,AG/GEN,,,
1545,5-3-0-18-0,6824-10-7216,SNGL FAM SUB,4.25,AC,71300,0,71300,0,3700,75000,69900,0,69900,0,3300,73200,A1,AG/GEN,,,
1546,2-3-0-8-0,6824-34-4003,SNGL FAM SUB,3.521,AC,49100,0,49100,415600,23600,488300,48000,0,48000,377000,24100,449100,A1,AG/GEN,,,
1547,2-3-0-9-0,6824-34-4273,SNGL FAM SUB,4.44,AC,50200,0,50200,338900,0,389100,52200,0,52200,309100,0,361300,A1,AG/GEN,,,
1548,58-4-D-9-0,7716-56-6447,SNGL FAM SUB,0,AC,105600,0,105600,187700,36600,329900,96000,0,96000,154800,30100,280900,A2,AG/LTD,,,
1549,54-1-0-16-0,6765-89-0437,SNGL FAM SUB,1,AC,3400,0,3400,0,0,3400,3000,0,3000,0,0,3000,A2,AG/LTD,,,
1550,39-1-0-59-0,6717-70-9017,AG 20-100 AC,34.13,AC,174600,137000,37600,0,8400,183000,170500,134500,36000,0,7400,177900,A1,AG/GEN,,,
1551,19-1-0-19-A,6820-91-7504,SNGL FAM SUB,8.01,AC,88600,0,88600,243100,0,331700,84700,0,84700,208600,0,293300,A1,AG/GEN,,,
1552,45-1-0-43-C,6786-97-2812,SNGL FAM SUB,2.09,AC,99900,0,99900,0,0,99900,89200,0,89200,0,0,89200,A2,AG/LTD,,,
1553,45-1-0-43-B,6786-97-7831,SNGL FAM SUB,10,AC,231500,0,231500,370700,0,602200,206600,0,206600,301500,0,508100,A2,AG/LTD,,,
1554,43-14-0-A-0,6777-20-0448,AG 20-100 AC,56.665,AC,867600,568800,298800,785200,78100,1730900,775900,509700,266200,637800,65900,1479600,A2,AG/LTD,,,
1555,46-9-0-B-1,7707-48-8086,SNGL FAM SUB,4.04,AC,147000,0,147000,292600,1200,440800,133600,0,133600,252200,1200,387000,A2,AG/LTD,,,
1556,46-9-0-D-0,7707-48-2319,SNGL FAM SUB,8.16,AC,171900,167700,4200,0,0,171900,156300,152800,3500,0,0,156300,A2,AG/LTD,,,
1557,58-22-A-9-0,7715-27-2890,SNGL FAM SUB,3.041,AC,401500,0,401500,727300,1500,1130300,368500,0,368500,673700,1500,1043700,R3,RES/GEN,,,
1558,64-1-0-44-0,7734-03-2357,Place of Worship,7.308,AC,951300,0,951300,1688300,7200,2646800,827200,0,827200,1568400,3100,2398700,A2,AG/LTD,,,
1560,58-9-0-A-0,7715-93-2301,AG 20-100 AC,79.71,AC,3359100,2080700,1278400,1157100,97900,4614100,2921400,1808300,1113100,970800,95900,3988100,A2,AG/LTD,,,
1561,67-2-C-1-0,7723-56-2191,SNGL FAM SUB,0,AC,184000,0,184000,331200,5000,520200,160000,0,160000,276000,5000,441000,R1,RES/LTD,,,
1562,67-7-0-1-0,7723-56-9850,SNGL FAM SUB,1.33,AC,188400,0,188400,56600,1000,246000,163800,0,163800,97400,2500,263700,R1,RES/LTD,,,
1563,47-17-0-A-7B,7717-29-8269,SNGL FAM SUB,5.08,AC,168400,0,168400,208100,600,377100,150400,0,150400,173700,600,324700,A2,AG/LTD,,,
1564,46-14-0-9-0,7708-91-8581,SNGL FAM SUB,4.665,AC,157300,0,157300,204300,118900,480500,143000,0,143000,172600,110500,426100,A2,AG/LTD,,,
1565,39-1-0-15-C,6727-14-5607,SNGL FAM SUB,1.74,AC,42900,0,42900,125200,13100,181200,42100,0,42100,107200,13100,162400,A1,AG/GEN,,,
1566,5-13-0-24-0,6813-63-8407,SNGL FAM SUB,8.11,AC,65600,0,65600,0,0,65600,64200,0,64200,0,0,64200,A1,AG/GEN,,,
1567,47-1-0-43-D,7726-09-1237,COMM & IND,1.362,AC,403600,0,403600,410700,2500,816800,366800,0,366800,387400,2500,756700,B1,BUS/GEN,,,
1578,64-12-B-20-0,7723-59-8727,SNGL FAM SUB,0,AC,77000,0,77000,161500,1500,240000,67000,0,67000,142300,1500,210800,R1,RES/LTD,,,
1579,5-1-0-36-C,6823-08-1147,SNGL FAM SUB,4,AC,55000,0,55000,395500,4000,454500,54000,0,54000,348300,4000,406300,A1,AG/GEN,,,
1580,11-1-0-8-A,6822-00-6625,SNGL FAM SUB,10.03,AC,80400,75800,4600,0,0,80400,78200,73900,4300,0,0,78200,A1,AG/GEN,,,
1581,13-1-0-36-C,6841-97-7694,SNGL FAM SUB,8.53,AC,89800,41700,48100,238700,3300,331800,88000,41100,46900,208500,2700,299200,A1,AG/GEN,,,
1582,30-11-0-7-A,6758-23-6315,SNGL FAM SUB,3.717,AC,80200,0,80200,0,0,80200,76800,0,76800,0,0,76800,A2,AG/LTD,,,
1583,52-1-0-3-0,6745-37-8416,SNGL FAM SUB,1,AC,2100,0,2100,0,0,2100,2000,0,2000,0,0,2000,A1,AG/GEN,,,
1584,29-1-0-17-0,6749-02-7253,SNGL FAM SUB,17.4,AC,143300,0,143300,0,3500,146800,140600,0,140600,0,3500,144100,A1,AG/GEN,,,
1585,64-4-2-3-0,7724-93-3289,SNGL FAM SUB,0,AC,70000,0,70000,134900,23200,228100,60000,0,60000,115000,19900,194900,RN,RESIDEN,,,
1587,61-3-0-A-0,6795-52-5006,AG 20-100 AC,93.829,AC,893200,0,893200,0,0,893200,774300,0,774300,0,0,774300,RR,RES/RUR,,,
1588,61-3-0-I-0,6794-49-7733,AG 20-100 AC,21.12,AC,10800,0,10800,0,0,10800,9100,0,9100,0,0,9100,A2,AG/LTD,,,
1589,61-3-0-J-0,6795-40-6371,SNGL FAM SUB,5.9,AC,2900,0,2900,0,2000,4900,2600,0,2600,0,2000,4600,A2,AG/LTD,,,
1591,55-14-0-5-0,6785-47-4790,SNGL FAM SUB,10.7,AC,204700,0,204700,603700,59400,867800,183000,0,183000,494900,53300,731200,A2,AG/LTD,,,
1592,17-1-0-69-0,6800-93-1116,AG 20-100 AC,72.6,AC,182300,148800,33500,0,0,182300,181200,150300,30900,0,0,181200,A1,AG/GEN,,,
1593,48-1-0-14-0,7727-48-9020,SNGL FAM SUB,4.45,AC,196300,0,196300,0,21300,217600,175300,0,175300,0,17500,192800,A2,AG/LTD,,,
1594,48-1-0-17-A,7727-47-8658,SNGL FAM SUB,0.43,AC,12100,0,12100,0,0,12100,10800,0,10800,0,0,10800,A2,AG/LTD,,,
1595,48-1-0-43-0,7727-57-1257,COMM & IND,0.634,AC,85700,0,85700,0,0,85700,81700,0,81700,0,0,81700,M2,INDUS/G,,,
1596,48-1-0-43-A,7727-57-1210,COMM & IND,0.604,AC,81700,0,81700,0,0,81700,77800,0,77800,0,0,77800,M2,INDUS/G,,,
1597,48-1-0-44-0,7727-57-2441,COMM & IND,1.077,AC,145600,0,145600,0,0,145600,138700,0,138700,0,0,138700,M2,INDUS/G,,,
1598,48-1-0-45-0,7727-57-3675,COMM & IND,0.727,AC,98300,0,98300,0,0,98300,93600,0,93600,0,0,93600,M2,INDUS/G,,,
1599,14-1-0-1-0,6852-24-6069,AG 20-100 AC,43.25,AC,176100,149000,27100,0,0,176100,172600,154200,18400,0,0,172600,A1,AG/GEN,,,
1600,37-1-0-11-0,6706-39-3283,COMM & IND,1.73,AC,24200,0,24200,0,0,24200,23600,0,23600,0,0,23600,M2,INDUS/G,,,
1601,38-1-0-55-A,6706-38-7934,COMM & IND,0.516,AC,9800,0,9800,0,0,9800,9500,0,9500,0,0,9500,A1,AG/GEN,,,
1602,53-1-0-6-0,6766-34-3894,SNGL FAM SUB,0.34,AC,1200,0,1200,0,0,1200,1000,0,1000,0,0,1000,A2,AG/LTD,,,
1604,54-1-0-15-0,6765-99-2739,SNGL FAM SUB,9.69,AC,24700,0,24700,0,0,24700,21800,0,21800,0,0,21800,A2,AG/LTD,,,
1611,16-1-0-34-0,5890-51-9568,AG > 100 AC,122.305,AC,251000,194600,56400,0,0,251000,244600,192600,52000,0,0,244600,A1,AG/GEN,,,
1612,18-1-0-16-0,6719-77-2987,SNGL FAM SUB,3.38,AC,19900,0,19900,0,0,19900,18600,0,18600,0,0,18600,A1,AG/GEN,,,
1617,39-1-0-89-0,6727-42-6568,AG 20-100 AC,90.9,AC,278200,236300,41900,0,0,278200,272700,234100,38600,0,0,272700,A1,AG/GEN,,,
1618,17-1-0-35-0,6800-96-0609,AG > 100 AC,101,AC,226800,180200,46600,0,0,226800,220900,178000,42900,0,0,220900,A1,AG/GEN,,,
1619,42-1-0-66-D,6757-99-5068,COMM & IND,0.358,AC,65600,0,65600,92200,2800,160600,63000,0,63000,95600,2100,160700,B1,BUS/GEN,,,
1620,55-17-0-3-0,6785-46-3186,SNGL FAM SUB,1.63,AC,88600,0,88600,207900,500,297000,79000,0,79000,170700,500,250200,A2,AG/LTD,,,
1621,58-18-G-2-0,7716-40-9991,SNGL FAM SUB,2.039,AC,310000,0,310000,218900,11200,540100,285000,0,285000,200600,10400,496000,A2,AG/LTD,,,
1622,63-1-0-173-C,7724-14-9180,SNGL FAM SUB,1.49,AC,147400,0,147400,155300,800,303500,128100,0,128100,130100,800,259000,R3,RES/GEN,,,
1623,62-18-0-6-0,7704-74-2352,SNGL FAM SUB,3.28,AC,225600,0,225600,454500,14500,694600,200300,0,200300,434900,15200,650400,A2,AG/LTD,,,
1624,62-18-0-3-0,7704-74-4648,SNGL FAM SUB,3.15,AC,222600,0,222600,640000,17700,880300,200300,0,200300,609600,17200,827100,A2,AG/LTD,,,
1625,63-7-0-D-0,7723-08-6293,SNGL FAM SUB,6.883,AC,333200,0,333200,401100,1100,735400,289700,0,289700,339100,800,629600,R1A2,RES LTD,,,
1626,67-18-B-30-0,7733-25-9705,SNGL FAM SUB,3.133,AC,357000,0,357000,581100,15400,953500,299300,0,299300,462100,16000,777400,R1,RES/LTD,,,
1627,39-4-0-8-0,6726-67-1622,SNGL FAM SUB,5.01,AC,63300,0,63300,144100,300,207700,62100,0,62100,118400,300,180800,A1,AG/GEN,,,
1628,46-1-0-24-0,7707-14-0525,SNGL FAM SUB,4.957,AC,186800,0,186800,208900,42100,437800,166700,0,166700,174400,36800,377900,A2,AG/LTD,,,
1629,47-1-0-2-0,7718-51-3991,SNGL FAM SUB,5.73,AC,179400,176500,2900,0,0,179400,160300,157800,2500,0,0,160300,A2,AG/LTD,,,
1630,47-7-0-B-0,7717-69-8675,AG 20-100 AC,24.03,AC,372500,360400,12100,0,0,372500,331600,321300,10300,0,0,331600,A2,AG/LTD,,,
1631,47-1-0-56-0,7718-60-0685,AG 20-100 AC,36.677,AC,777800,562200,215600,95700,15900,889400,695200,503400,191800,82100,15900,793200,A2,AG/LTD,,,
1633,47-7-0-A-0,7718-70-3416,AG 20-100 AC,29.05,AC,464800,450500,14300,0,0,464800,415400,402900,12500,0,0,415400,A2,AG/LTD,,,
1634,47-26-0-2-0,7717-99-5578,SNGL FAM SUB,4.327,AC,145700,0,145700,251800,8700,406200,130200,0,130200,217100,8500,355800,A2,AG/LTD,,,
1635,47-26-0-4-0,7727-09-7654,SNGL FAM SUB,8.213,AC,236500,0,236500,371600,2400,610500,211300,0,211300,342000,2400,555700,A2,AG/LTD,,,
1636,13-1-0-28-A,6842-91-5991,SNGL FAM SUB,3,AC,67200,0,67200,13400,3000,83600,66000,0,66000,12700,3000,81700,A1,AG/GEN,,,
1637,47-6-0-1-0,7717-68-2328,AG 20-100 AC,71.96,AC,1259200,1099300,159900,266000,15700,1540900,1125200,984200,141000,225700,15700,1366600,A2,AG/LTD,,,
1639,14-3-0-12-0,6851-38-7868,SNGL FAM SUB,3.67,AC,72400,0,72400,156200,5100,233700,71000,0,71000,135200,5300,211500,A1,AG/GEN,,,
1641,19-1-0-70-0,6739-78-0603,AG > 100 AC,116.1,AC,351400,297900,53500,0,0,351400,338500,289200,49300,0,0,338500,A1,AG/GEN,,,
1643,39-1-0-6-0,6728-10-4281,SNGL FAM SUB,18.646,AC,80800,67600,13200,0,0,80800,79700,67200,12500,0,0,79700,A1,AG/GEN,,,
1644,39-1-0-8-0,6727-09-0088,AG > 100 AC,115.578,AC,430700,339100,91600,156500,2300,589500,418600,324300,94300,131400,2300,552300,A1,AG/GEN,,,
1645,39-1-0-9-0,6717-87-7867,AG > 100 AC,108.77,AC,332800,282700,50100,0,0,332800,326300,280100,46200,0,0,326300,A1,AG/GEN,,,
1646,39-1-0-11-0,6717-75-4912,AG > 100 AC,129.47,AC,533900,433400,100500,155400,7900,697200,521000,428200,92800,132500,7900,661400,A1,AG/GEN,,,
1647,39-1-0-14-0,6727-17-3247,AG 20-100 AC,98.25,AC,378700,332200,46500,0,0,378700,369400,327500,41900,0,0,369400,A1,AG/GEN,,,
1648,39-1-0-17-0,6717-85-7499,AG 20-100 AC,25,AC,161200,110700,50500,159700,6700,327600,158000,109700,48300,136800,6700,301500,A1,AG/GEN,,,
1649,39-1-0-23-0,6717-84-3342,SNGL FAM SUB,15.5,AC,120000,112100,7900,0,5000,125000,117800,111100,6700,0,5000,122800,A1,AG/GEN,,,
1650,46-24-0-4-0,7707-45-7529,SNGL FAM SUB,8.31,AC,192500,0,192500,284100,0,476600,172000,0,172000,238000,0,410000,A2,AG/LTD,,,
1651,15-5-0-19-0,5789-59-8615,SNGL FAM SUB,8.11,AC,58000,0,58000,0,0,58000,56700,0,56700,0,0,56700,A1,AG/GEN,,,
1652,46-13-0-6-0,7717-06-9661,SNGL FAM SUB,1.04,AC,93100,0,93100,0,0,93100,83100,0,83100,0,0,83100,A2,AG/LTD,,,
1653,46-13-0-7-0,7717-06-9476,SNGL FAM SUB,1.12,AC,94400,0,94400,244900,14500,353800,84300,0,84300,202700,14500,301500,A2,AG/LTD,,,
1654,46-13-0-8-0,7717-06-9390,SNGL FAM SUB,1.12,AC,94400,0,94400,0,0,94400,84300,0,84300,0,0,84300,A2,AG/LTD,,,
1655,46-23-0-42-0,7717-16-0024,SNGL FAM SUB,2.698,AC,165000,0,165000,428600,34800,628400,150000,0,150000,357300,34300,541600,A2,AG/LTD,,,
1656,4-6-0-16-0,6813-45-7244,SNGL FAM SUB,8.015,AC,65200,0,65200,91700,3000,159900,63900,0,63900,80200,3000,147100,A1,AG/GEN,,,
1657,1-1-0-3-0,6815-11-4340,SNGL FAM SUB,2.999,AC,49900,0,49900,238500,0,288400,49000,0,49000,201800,0,250800,A1,AG/GEN,,,
1658,57-1-0-26-B,7706-11-0273,SNGL FAM SUB,0.35,AC,4600,0,4600,0,0,4600,4000,0,4000,0,0,4000,A2,AG/LTD,,,
1659,57-1-0-26-C,7706-01-7289,SNGL FAM SUB,0.2,AC,5300,0,5300,0,0,5300,4600,0,4600,0,0,4600,A2,AG/LTD,,,
1660,57-1-0-26-D,7706-11-0243,SNGL FAM SUB,4.58,AC,189100,0,189100,220500,30400,440000,164500,0,164500,186100,25500,376100,A2,AG/LTD,,,
1661,46-1-0-97-B,7707-99-4571,SNGL FAM SUB,1.812,AC,114400,0,114400,185900,4300,304600,104000,0,104000,156000,3800,263800,A2,AG/LTD,,,
1663,27-7-0-2-A,6719-70-0438,SNGL FAM SUB,1.17,AC,39800,0,39800,48100,200,88100,39000,0,39000,42500,200,81700,A1,AG/GEN,,,
1664,29-3-0-27-0,6749-43-1590,SNGL FAM SUB,2.54,AC,60700,0,60700,115100,800,176600,56700,0,56700,95300,800,152800,A1,AG/GEN,,,
1665,38-1-0-30-0,6707-66-9358,SNGL FAM SUB,1,AC,38800,0,38800,158400,0,197200,38000,0,38000,134900,0,172900,A1,AG/GEN,,,
1666,27-7-0-2-0,6719-70-2348,SNGL FAM SUB,8.683,AC,81800,0,81800,0,0,81800,80300,0,80300,0,0,80300,A1,AG/GEN,,,
1667,27-7-0-2-B,6718-79-4855,SNGL FAM SUB,1.757,AC,43000,0,43000,78800,0,121800,42200,0,42200,67300,0,109500,A1,AG/GEN,,,
1668,29-3-0-21-0,6749-53-8512,SNGL FAM SUB,3.05,AC,65100,0,65100,219500,0,284600,60700,0,60700,181200,0,241900,A1,AG/GEN,,,
1669,50-5-0-9-0,6726-42-8908,SNGL FAM SUB,8.22,AC,70100,0,70100,0,0,70100,66700,0,66700,0,0,66700,A1,AG/GEN,,,
1670,67-13-B-4-0,7733-37-1104,SNGL FAM SUB,0,AC,265000,0,265000,372100,0,637100,220000,0,220000,301600,0,521600,R1,RES/LTD,,,
1671,26-1-0-40-0,6718-46-8530,AG 20-100 AC,25,AC,79500,0,79500,0,0,79500,77500,0,77500,0,0,77500,A1,AG/GEN,,,
1672,55-18-0-14-0,6776-95-4001,SNGL FAM SUB,10.405,AC,205500,0,205500,286600,10600,502700,183900,0,183900,233400,10900,428200,A2,AG/LTD,,,
1673,55-14-0-26-0,6786-21-9627,SNGL FAM SUB,19.8,AC,374900,0,374900,585800,26400,987100,335100,0,335100,469700,27300,832100,A2,AG/LTD,,,
1674,55-18-0-2-0,6776-94-6024,SNGL FAM SUB,10.65,AC,209100,0,209100,0,0,209100,187100,0,187100,0,0,187100,A2,AG/LTD,,,
1675,55-18-0-3-0,6776-94-7731,SNGL FAM SUB,5,AC,125300,0,125300,284100,33000,442400,111800,0,111800,235000,29700,376500,A2,AG/LTD,,,
1676,63-1-0-100-0,7715-40-7078,SNGL FAM SUB,15.86,AC,411500,0,411500,0,0,411500,357300,0,357300,0,0,357300,A2,AG/LTD,,,
1677,45-1-0-32-A,6787-84-7155,Parsonage,2,AC,85200,0,85200,130300,400,215900,76100,0,76100,113800,400,190300,A2,AG/LTD,,,
1678,42-3-0-4-0,6767-04-9021,SNGL FAM SUB,0.685,AC,70000,0,70000,277800,1600,349400,65000,0,65000,231600,1600,298200,R3,RES/GEN,,,
1679,67-12-0-8-0,7723-44-1890,SNGL FAM SUB,4.24,AC,390000,0,390000,428200,36600,854800,340000,0,340000,378800,31700,750500,R1,RES/LTD,,,
1680,30-1-0-104-A,6758-98-5851,SNGL FAM SUB,2.87,AC,76800,0,76800,369300,32500,478600,69300,0,69300,297600,28800,395700,A2,AG/LTD,,,
1681,58-8-0-2-C,7716-80-2094,SNGL FAM SUB,11.38,AC,313500,0,313500,267100,21200,601800,241500,0,241500,227400,22100,491000,A2,AG/LTD,,,
1682,62-20-A-16-0,7714-15-1642,SNGL FAM SUB,0,AC,115000,0,115000,338300,0,453300,100000,0,100000,307500,0,407500,R1,RES/LTD,,,
1683,39-4-0-3-0,6726-57-1845,SNGL FAM SUB,5.03,AC,63400,0,63400,104000,3600,171000,62200,0,62200,83300,3300,148800,A1,AG/GEN,,,
1684,46-9-0-B-2A,7707-58-8035,SNGL FAM SUB,5.3,AC,158100,0,158100,166000,0,324100,143700,0,143700,145000,0,288700,A2,AG/LTD,,,
1685,55-19-0-4-0,6776-84-1953,SNGL FAM SUB,6.493,AC,138800,0,138800,361000,0,499800,124100,0,124100,293100,0,417200,A2,AG/LTD,,,
1686,62-2-A-5-0,7704-93-5865,SNGL FAM SUB,0,AC,115000,0,115000,228500,4400,347900,100000,0,100000,214000,3500,317500,R1,RES/LTD,,,
1687,38-1-0-105-0,6717-18-5620,SNGL FAM SUB,2.982,AC,49900,0,49900,5000,0,54900,48900,0,48900,5000,0,53900,A1,AG/GEN,,,
1688,47-1-0-90-A,7726-37-4412,SNGL FAM SUB,0.167,AC,3700,0,3700,0,0,3700,3400,0,3400,0,0,3400,R3,RES/GEN,,,
1689,55-11-0-B-0,6786-44-9316,SNGL FAM SUB,7.58,AC,167100,0,167100,466000,0,633100,149100,0,149100,374400,0,523500,A2,AG/LTD,,,
1690,62-1-0-25-0,7714-13-0985,SNGL FAM SUB,0.7,AC,80600,0,80600,179600,10700,270900,70100,0,70100,153300,8700,232100,R3,RES/GEN,,,
1691,62-1-0-28-0,7714-04-9081,SNGL FAM SUB,0.488,AC,28100,0,28100,0,1000,29100,24400,0,24400,0,1000,25400,R3,RES/GEN,,,
1692,12-1-0-70-0,6831-53-2264,SNGL FAM SUB,1.01,AC,47100,0,47100,132400,24300,203800,44800,0,44800,111300,20600,176700,A1,AG/GEN,,,
1694,57-20-D-1-0,7715-19-0465,SNGL FAM SUB,2.229,AC,315000,0,315000,442900,0,757900,288800,0,288800,405400,0,694200,A2,AG/LTD,,,
1695,64-4-1-12-0,7724-94-1188,SNGL FAM SUB,0,AC,20200,0,20200,0,0,20200,17600,0,17600,0,0,17600,RN,RESIDEN,,,
1696,64-4-1-13-0,7724-94-1287,SNGL FAM SUB,0,AC,20200,0,20200,0,0,20200,17600,0,17600,0,0,17600,RN,RESIDEN,,,
1697,64-4-1-14-0,7724-94-1397,SNGL FAM SUB,0,AC,20200,0,20200,0,0,20200,17600,0,17600,0,0,17600,RN,RESIDEN,,,
1698,64-4-1-15-0,7724-94-1497,SNGL FAM SUB,0,AC,20200,0,20200,0,0,20200,17600,0,17600,0,0,17600,RN,RESIDEN,,,
1699,64-4-1-16-0,7724-94-2602,SNGL FAM SUB,0,AC,20200,0,20200,0,0,20200,17600,0,17600,0,0,17600,RN,RESIDEN,,,
1700,64-4-1-17-0,7724-94-0514,SNGL FAM SUB,0,AC,20200,0,20200,0,0,20200,17600,0,17600,0,0,17600,RN,RESIDEN,,,
1701,64-4-1-18-0,7724-94-0308,SNGL FAM SUB,0,AC,20200,0,20200,0,0,20200,17600,0,17600,0,0,17600,RN,RESIDEN,,,
1702,64-4-1-19-0,7724-94-0208,SNGL FAM SUB,0,AC,20200,0,20200,0,0,20200,17600,0,17600,0,0,17600,RN,RESIDEN,,,
1703,64-4-1-20-0,7724-84-9198,SNGL FAM SUB,0,AC,20200,0,20200,0,0,20200,17600,0,17600,0,0,17600,RN,RESIDEN,,,
1704,64-4-1-21-0,7724-84-9098,SNGL FAM SUB,0,AC,20200,0,20200,0,0,20200,17600,0,17600,0,0,17600,RN,RESIDEN,,,
1705,64-4-1-22-0,7724-83-9989,SNGL FAM SUB,0,AC,20200,0,20200,0,0,20200,17600,0,17600,0,0,17600,RN,RESIDEN,,,
1706,64-4-1-23-0,7724-83-9889,SNGL FAM SUB,0,AC,20200,0,20200,0,0,20200,17600,0,17600,0,0,17600,RN,RESIDEN,,,
1707,64-4-1-24-0,7724-83-9789,SNGL FAM SUB,0,AC,20200,0,20200,0,0,20200,17600,0,17600,0,0,17600,RN,RESIDEN,,,
1708,64-4-1-25-0,7724-83-9679,SNGL FAM SUB,0,AC,20200,0,20200,0,0,20200,17600,0,17600,0,0,17600,RN,RESIDEN,,,
1709,64-4-1-26-0,7724-83-9579,SNGL FAM SUB,0,AC,20200,0,20200,0,0,20200,17600,0,17600,0,0,17600,RN,RESIDEN,,,
1710,64-4-1-27-0,7724-83-9560,SNGL FAM SUB,0,AC,20200,0,20200,0,0,20200,17600,0,17600,0,0,17600,RN,RESIDEN,,,
1711,64-4-1-30-0,7724-83-9250,SNGL FAM SUB,0,AC,20200,0,20200,0,0,20200,17600,0,17600,0,0,17600,RN,RESIDEN,,,
1712,64-4-1-31-0,7724-83-9150,SNGL FAM SUB,0,AC,20200,0,20200,0,0,20200,17600,0,17600,0,0,17600,RN,RESIDEN,,,
1713,64-4-1-33-0,7724-82-9996,COMM & IND,0.402,AC,83300,0,83300,0,0,83300,77200,0,77200,0,0,77200,RN,RESIDEN,,,
1714,38-1-0-68-0,6717-03-1443,SNGL FAM SUB,10,AC,56300,0,56300,0,0,56300,55000,0,55000,0,0,55000,A1,AG/GEN,,,
1715,64-5-4-3-0,7724-94-8163,SNGL FAM SUB,0,AC,70000,0,70000,0,0,70000,30000,0,30000,0,0,30000,RN,RESIDEN,,,
1716,64-5-4-4-0,7724-94-8274,SNGL FAM SUB,0,AC,70000,0,70000,0,0,70000,17600,0,17600,0,0,17600,RN,RESIDEN,,,
1717,64-5-4-5-0,7724-94-8384,SNGL FAM SUB,0,AC,70000,0,70000,0,0,70000,17600,0,17600,0,0,17600,RN,RESIDEN,,,
1718,64-5-4-6-0,7724-94-8484,SNGL FAM SUB,0,AC,70000,0,70000,0,0,70000,17600,0,17600,0,0,17600,RN,RESIDEN,,,
1719,64-5-4-7-0,7724-94-8584,SNGL FAM SUB,0,AC,70000,0,70000,0,0,70000,17600,0,17600,0,0,17600,RN,RESIDEN,,,
1720,64-5-4-8-0,7724-94-9605,SNGL FAM SUB,0,AC,70000,0,70000,0,0,70000,17600,0,17600,0,0,17600,RN,RESIDEN,,,
1721,64-5-4-9-0,7734-03-0959,SNGL FAM SUB,0,AC,70000,0,70000,0,0,70000,17600,0,17600,0,0,17600,RN,RESIDEN,,,
1722,64-5-4-10-0,7734-04-0161,SNGL FAM SUB,0,AC,70000,0,70000,0,0,70000,17600,0,17600,0,0,17600,RN,RESIDEN,,,
1723,64-5-4-11-0,7734-04-0271,SNGL FAM SUB,0,AC,70000,0,70000,0,0,70000,17600,0,17600,0,0,17600,RN,RESIDEN,,,
1724,64-5-4-12-0,7734-04-0371,SNGL FAM SUB,0,AC,70000,0,70000,0,0,70000,17600,0,17600,0,0,17600,RN,RESIDEN,,,
1725,64-5-4-13-0,7734-04-0480,SNGL FAM SUB,0,AC,70000,0,70000,0,0,70000,17600,0,17600,0,0,17600,RN,RESIDEN,,,
1726,64-5-4-14-0,7734-04-0580,SNGL FAM SUB,0,AC,70000,0,70000,0,0,70000,17600,0,17600,0,0,17600,RN,RESIDEN,,,
1727,64-5-4-15-0,7734-04-0681,SNGL FAM SUB,0,AC,70000,0,70000,0,0,70000,17600,0,17600,0,0,17600,RN,RESIDEN,,,
1728,64-5-4-16-0,7734-04-1701,SNGL FAM SUB,0,AC,70000,0,70000,0,0,70000,17600,0,17600,0,0,17600,RN,RESIDEN,,,
1729,64-5-4-23-0,7734-04-4591,SNGL FAM SUB,0,AC,70000,0,70000,0,0,70000,17600,0,17600,0,0,17600,RN,RESIDEN,,,
1730,64-5-4-26-0,7734-04-3439,SNGL FAM SUB,0,AC,70000,0,70000,0,0,70000,17600,0,17600,0,0,17600,RN,RESIDEN,,,
1731,64-5-4-27-0,7734-04-3549,SNGL FAM SUB,0,AC,70000,0,70000,0,0,70000,17600,0,17600,0,0,17600,RN,RESIDEN,,,
1732,64-5-4-28-0,7734-04-3648,SNGL FAM SUB,0,AC,70000,0,70000,0,0,70000,17600,0,17600,0,0,17600,RN,RESIDEN,,,
1733,64-5-4-29-0,7734-04-3738,SNGL FAM SUB,0,AC,70000,0,70000,0,0,70000,17600,0,17600,0,0,17600,RN,RESIDEN,,,
1734,64-5-4-30-0,7734-04-2967,SNGL FAM SUB,0,AC,70000,0,70000,0,0,70000,17600,0,17600,0,0,17600,RN,RESIDEN,,,
1735,64-5-4-31-0,7734-04-1965,SNGL FAM SUB,0,AC,70000,0,70000,0,0,70000,17600,0,17600,0,0,17600,RN,RESIDEN,,,
1736,64-5-4-32-0,7734-04-0961,SNGL FAM SUB,0,AC,70000,0,70000,0,0,70000,17600,0,17600,0,0,17600,RN,RESIDEN,,,
1737,64-5-4-33-0,7724-94-9878,SNGL FAM SUB,0,AC,70000,0,70000,0,0,70000,17600,0,17600,0,0,17600,RN,RESIDEN,,,
1738,64-5-4-34-0,7724-94-8864,SNGL FAM SUB,0,AC,70000,0,70000,0,0,70000,17600,0,17600,0,0,17600,RN,RESIDEN,,,
1766,13-6-0-11-0,6841-83-9281,SNGL FAM SUB,0.62,AC,3500,0,3500,0,0,3500,3400,0,3400,0,0,3400,A1,AG/GEN,,,
1767,13-6-0-12-0,6841-93-1048,SNGL FAM SUB,0.55,AC,3300,0,3300,0,0,3300,3300,0,3300,0,0,3300,A1,AG/GEN,,,
1768,20-4-0-1-0,6841-81-3182,SNGL FAM SUB,0.4,AC,3500,0,3500,0,0,3500,3400,0,3400,0,0,3400,A1,AG/GEN,,,
1769,44-1-0-26-0,6787-02-1592,SNGL FAM SUB,3,AC,101700,0,101700,213600,4000,319300,90800,0,90800,177300,4000,272100,A2,AG/LTD,,,
1774,47-17-0-A-6A,7717-29-8854,SNGL FAM SUB,5.13,AC,169200,0,169200,193000,15400,377600,151200,0,151200,162200,13200,326600,A2,AG/LTD,,,
1775,13-6-0-3-0,6841-72-7047,AG 20-100 AC,21.87,AC,167000,0,167000,141100,1700,309800,163800,0,163800,122800,1500,288100,A1,AG/GEN,,,
1776,13-6-0-10-0,6841-83-8316,SNGL FAM SUB,0.6,AC,3400,0,3400,0,0,3400,3300,0,3300,0,0,3300,A1,AG/GEN,,,
1777,20-4-0-3-0,6841-81-5196,SNGL FAM SUB,0.4,AC,3500,0,3500,0,0,3500,3400,0,3400,0,0,3400,A1,AG/GEN,,,
1778,62-13-B-1-0,7714-05-4297,SNGL FAM SUB,0,AC,115000,0,115000,251800,100,366900,100000,0,100000,236600,100,336700,R1,RES/LTD,,,
1779,13-6-0-2-0,6841-81-1968,AG 20-100 AC,21.88,AC,167000,0,167000,0,0,167000,163800,0,163800,0,0,163800,A1,AG/GEN,,,
1781,13-1-0-44-C,6841-73-4086,SNGL FAM SUB,16,AC,142600,79500,63100,151200,32200,326000,139800,78600,61200,133300,31500,304600,A1,AG/GEN,,,
1784,47-25-0-7-0,7717-90-9889,SNGL FAM SUB,1.07,AC,128200,0,128200,288600,2500,419300,114500,0,114500,239900,2800,357200,A2,AG/LTD,,,
1785,62-20-E-1-0,7714-15-3983,SNGL FAM SUB,0,AC,115000,0,115000,234400,800,350200,100000,0,100000,213900,800,314700,R1,RES/LTD,,,
1786,26-11-0-3-A,6719-06-3023,Parsonage,2.52,AC,49100,0,49100,154200,1000,204300,47100,0,47100,134900,1000,183000,A1,AG/GEN,,,
1787,57-20-C-9-0,7716-00-8296,SNGL FAM SUB,1.6,AC,315000,0,315000,591300,21600,927900,288800,0,288800,532000,20700,841500,A2,AG/LTD,,,
1788,15-5-0-9-0,5789-56-1972,SNGL FAM SUB,8.01,AC,67500,0,67500,0,0,67500,66000,0,66000,0,0,66000,A1,AG/GEN,,,
1789,24-2-0-9-A,5789-45-8505,SNGL FAM SUB,10.44,AC,26100,0,26100,0,0,26100,26100,0,26100,0,0,26100,A1,AG/GEN,,,
1790,32-1-0-50-C,6778-93-9361,SNGL FAM SUB,10,AC,161300,0,161300,234500,27500,423300,143600,0,143600,197000,23500,364100,A2,AG/LTD,,,
1791,62-2-B-5-0,7704-94-6145,SNGL FAM SUB,0,AC,115000,0,115000,162900,400,278300,100000,0,100000,147900,400,248300,R1,RES/LTD,,,
1792,62-3-D-3-0,7714-03-5838,SNGL FAM SUB,0,AC,115000,0,115000,179000,0,294000,100000,0,100000,166400,0,266400,R1,RES/LTD,,,
1793,54-1-0-8-0,6776-42-2490,AG > 100 AC,222.7,AC,2277200,2165900,111300,0,125300,2402500,2036100,1940500,95600,0,111400,2147500,A2,AG/LTD,,,
1794,54-1-0-9-0,6775-39-5867,AG > 100 AC,150.51,AC,1777300,1103500,673800,3663700,211100,5652100,1582600,983400,599200,3396900,204400,5183900,A2,AG/LTD,,,
1795,54-1-0-10-0,6776-50-3734,SNGL FAM SUB,9.24,AC,173100,99000,74100,94700,7400,275200,154900,88800,66100,80100,6400,241400,A2,AG/LTD,,,
1796,54-1-0-14-0,6775-28-7639,AG 20-100 AC,94.8,AC,313500,266900,46600,0,0,313500,276600,237000,39600,0,0,276600,A2,AG/LTD,,,
1797,57-10-0-26-0,7705-86-3920,SNGL FAM SUB,4.71,AC,230000,0,230000,320800,2100,552900,210000,0,210000,297600,2200,509800,A2,AG/LTD,,,
1798,58-4-A-11-0,7716-57-5158,SNGL FAM SUB,0,AC,20100,0,20100,0,0,20100,18300,0,18300,0,0,18300,A2,AG/LTD,,,
1799,57-25-B-11-0,7716-13-5433,SNGL FAM SUB,4.604,AC,365000,0,365000,303200,700,668900,335000,0,335000,277400,700,613100,A2,AG/LTD,,,
1800,62-7-0-D-1,7705-80-7562,SNGL FAM SUB,2.82,AC,251200,0,251200,394500,500,646200,218500,0,218500,360400,500,579400,A2,AG/LTD,,,
1801,55-1-0-2-0,6776-83-4800,SNGL FAM SUB,3.14,AC,102400,0,102400,268400,2000,372800,91500,0,91500,219700,2000,313200,A2,AG/LTD,,,
1803,21-7-0-35-0,6850-46-5772,SNGL FAM SUB,2.78,AC,58800,0,58800,196700,13200,268700,57900,0,57900,171500,12500,241900,A1,AG/GEN,,,
1804,58-21-B-3-0,7716-23-8827,SNGL FAM SUB,1.422,AC,310000,0,310000,275000,500,585500,285000,0,285000,253700,500,539200,A2,AG/LTD,,,
1805,5-1-0-11-0,6813-76-2840,SNGL FAM SUB,2.207,AC,45900,0,45900,118400,2000,166300,45000,0,45000,103800,2000,150800,A1,AG/GEN,,,
1807,13-10-0-7-0,6841-84-0783,SNGL FAM SUB,5.03,AC,83800,0,83800,318500,0,402300,82200,0,82200,280100,0,362300,A1,AG/GEN,,,
1808,51-1-0-21-0,6735-32-3093,SNGL FAM SUB,0.93,AC,2400,0,2400,0,0,2400,2300,0,2300,0,0,2300,A1,AG/GEN,,,
1809,51-1-0-20-0,6735-32-6247,SNGL FAM SUB,1.03,AC,39000,0,39000,332700,0,371700,38200,0,38200,301600,0,339800,A1,AG/GEN,,,
1810,58-21-D-4-0,7716-32-6369,SNGL FAM SUB,3.023,AC,346800,0,346800,731500,35200,1113500,318300,0,318300,674900,29200,1022400,R3,RES/GEN,,,
1811,63-1-0-160-0,7714-95-5696,SNGL FAM SUB,8.327,AC,309400,0,309400,1224700,0,1534100,281300,0,281300,1115000,0,1396300,A2,AG/LTD,,,
1812,44-19-0-6-0,6778-92-5046,SNGL FAM SUB,8.56,AC,140500,0,140500,197800,3000,341300,125200,0,125200,170300,3000,298500,A2,AG/LTD,,,
1813,38-1-0-117-0,6717-48-7085,SNGL FAM SUB,15.5,AC,120000,0,120000,0,0,120000,117800,0,117800,0,0,117800,A1,AG/GEN,,,
1814,11-1-0-23-0,6821-16-3295,SNGL FAM SUB,6.001,AC,68500,0,68500,133900,0,202400,70500,0,70500,113800,0,184300,A1,AG/GEN,,,
1816,28-7-0-E-0,6729-94-4115,SNGL FAM SUB,4.33,AC,69700,0,69700,211100,5000,285800,69000,0,69000,178200,5000,252200,A1,AG/GEN,,,
1817,30-12-0-1-0,6758-98-8728,COMM & IND,1.26,AC,116200,0,116200,0,0,116200,112800,0,112800,0,0,112800,M1,INDUS/L,,,
1818,30-12-0-2-0,6758-99-8034,COMM & IND,1.32,AC,115600,0,115600,678300,30800,824700,112200,0,112200,678300,21800,812300,M1,INDUS/L,,,
1819,30-12-0-3-0,6758-99-7295,COMM & IND,1.145,AC,95300,0,95300,269400,19600,384300,92500,0,92500,255500,19200,367200,M1,INDUS/L,,,
1820,30-12-0-4-A,6758-98-9868,COMM & IND,0.7,AC,1500,0,1500,0,0,1500,1500,0,1500,0,0,1500,M1,INDUS/L,,,
1823,20-1-0-37-0,6840-31-4913,SNGL FAM SUB,0.93,AC,50200,0,50200,223900,0,274100,46400,0,46400,197400,0,243800,A1,AG/GEN,,,
1824,29-3-0-28-A,6749-43-0629,SNGL FAM SUB,3.48,AC,68700,0,68700,0,0,68700,64000,0,64000,0,0,64000,A1,AG/GEN,,,
1825,29-3-0-28-B,6749-33-9390,SNGL FAM SUB,1.4,AC,50600,0,50600,96300,800,147700,47800,0,47800,77100,800,125700,A1,AG/GEN,,,
1826,67-10-0-8-0,7733-06-5350,SNGL FAM SUB,0,AC,340000,0,340000,490000,0,830000,285000,0,285000,433300,0,718300,R1,RES/LTD,,,
1827,20-11-0-15-0,6841-91-9386,SNGL FAM SUB,2,AC,55600,0,55600,113100,2100,170800,52500,0,52500,131200,1500,185200,A1,AG/GEN,,,
1829,64-12-A-1-0,7724-60-0907,SNGL FAM SUB,0.946,AC,134800,0,134800,406900,0,541700,117300,0,117300,368300,0,485600,R1,RES/LTD,,,
1830,43-1-0-29-0,6767-52-2798,SNGL FAM SUB,1.32,AC,68700,0,68700,73900,9000,151600,61300,0,61300,60600,9000,130900,A2,AG/LTD,,,
1831,45-1-0-120-0,6797-77-6729,SNGL FAM SUB,1.7,AC,80200,0,80200,0,0,80200,71600,0,71600,0,0,71600,A2,AG/LTD,,,
1832,45-1-0-122-A,6797-77-7611,SNGL FAM SUB,0.88,AC,61700,0,61700,0,0,61700,55100,0,55100,0,0,55100,A2,AG/LTD,,,
1833,45-1-0-123-0,6797-77-7444,SNGL FAM SUB,1.052,AC,70800,0,70800,0,0,70800,63200,0,63200,0,0,63200,A2,AG/LTD,,,
1834,43-1-0-79-D,6767-93-3122,SNGL FAM SUB,0.44,AC,6300,0,6300,0,0,6300,5700,0,5700,0,0,5700,A2,AG/LTD,,,
1835,43-1-0-79-C,6767-93-3205,SNGL FAM SUB,2,AC,84500,0,84500,145900,22000,252400,75500,0,75500,119700,18800,214000,A2,AG/LTD,,,
1836,43-44-0-1-0,6767-91-9003,SNGL FAM SUB,3.795,AC,110300,0,110300,0,0,110300,98700,0,98700,0,0,98700,A2,AG/LTD,,,
1837,43-1-0-80-0,6767-93-1086,SNGL FAM SUB,1.15,AC,72300,0,72300,114700,1500,188500,64500,0,64500,95700,1500,161700,A2,AG/LTD,,,
1838,43-1-0-28-0,6767-53-2141,SNGL FAM SUB,2.59,AC,84000,0,84000,0,0,84000,75000,0,75000,0,0,75000,A2,AG/LTD,,,
1839,43-1-0-37-B,6767-63-3761,SNGL FAM SUB,1,AC,64100,0,64100,153500,2100,219700,57200,0,57200,118100,2100,177400,A2,AG/LTD,,,
1840,43-1-0-28-B,6767-53-3413,SNGL FAM SUB,3.02,AC,85900,0,85900,156500,0,242400,76600,0,76600,129600,0,206200,A2,AG/LTD,,,
1841,29-5-0-1-0,6749-74-4016,SNGL FAM SUB,3,AC,73600,0,73600,242900,23000,339500,69700,0,69700,199300,19400,288400,A1,AG/GEN,,,
1842,43-1-0-42-0,6767-63-1895,SNGL FAM SUB,1.08,AC,71300,0,71300,95800,2000,169100,63600,0,63600,78700,2000,144300,A2,AG/LTD,,,
1843,45-1-0-125-C,6797-77-6132,COMM & IND,5.61,AC,463600,0,463600,59600,0,523200,436200,0,436200,58900,0,495100,B1,BUS/GEN,,,
1844,58-1-0-102-0,7726-10-7069,AG 20-100 AC,38.17,AC,2673500,0,2673500,0,0,2673500,2388300,0,2388300,0,0,2388300,A2,AG/LTD,,,
1845,57-10-0-20-0,7705-78-2236,SNGL FAM SUB,3.99,AC,230000,0,230000,383500,131300,744800,210000,0,210000,373000,117500,700500,A2,AG/LTD,,,
1846,38-7-0-C-4,6717-08-8014,SNGL FAM SUB,7.17,AC,70300,0,70300,131400,10000,211700,68900,0,68900,116600,10000,195500,A1,AG/GEN,,,
1847,58-3-B-2-0,7726-07-8086,SNGL FAM SUB,0,AC,88000,0,88000,134000,300,222300,80000,0,80000,111900,300,192200,RN,RESIDEN,,,
1848,64-15-D-4-0,7733-27-9836,SNGL FAM SUB,0,AC,251800,0,251800,468600,2300,722700,209000,0,209000,409000,2300,620300,R1,RES/LTD,,,
1849,47-3-0-C-3,7717-95-2849,SNGL FAM SUB,1.93,AC,95000,0,95000,162400,10400,267800,84800,0,84800,136600,10400,231800,A2,AG/LTD,,,
1850,47-1-0-71-0,7727-21-0378,SNGL FAM SUB,1,AC,99000,0,99000,303500,700,403200,88400,0,88400,268400,700,357500,A2,AG/LTD,,,
1851,47-1-0-48-0,7727-01-3767,SNGL FAM SUB,9.06,AC,436100,308300,127800,403600,22600,862300,389600,275600,114000,340400,19000,749000,A2,AG/LTD,,,
1852,4-1-0-39-0,6803-98-4662,COMM & IND,2.4,AC,81800,0,81800,243800,6500,332100,79400,0,79400,237900,6500,323800,M2,INDUS/G,,,
1853,4-1-0-37-0,6803-98-3428,COMM & IND,1.67,AC,56900,0,56900,17300,0,74200,55300,0,55300,16800,0,72100,M2,INDUS/G,,,
1854,6-9-0-1-0,6833-72-8188,SNGL FAM SUB,2.1,AC,45500,0,45500,16900,3600,66000,44500,0,44500,16200,3300,64000,A1,AG/GEN,,,
1855,6-9-0-2-0,6833-71-8983,SNGL FAM SUB,2.54,AC,47800,0,47800,8000,0,55800,46800,0,46800,7700,0,54500,A1,AG/GEN,,,
1856,6-9-0-4-0,6833-71-6587,SNGL FAM SUB,2.5,AC,47600,0,47600,12200,2700,62500,46600,0,46600,12200,2700,61500,A1,AG/GEN,,,
1857,6-9-0-5-0,6833-71-5399,SNGL FAM SUB,2.42,AC,47200,0,47200,51900,2300,101400,46200,0,46200,52100,2300,100600,A1,AG/GEN,,,
1858,6-9-0-7-0,6833-71-4023,SNGL FAM SUB,2.39,AC,47000,0,47000,87800,3500,138300,46100,0,46100,73500,3500,123100,A1,AG/GEN,,,
1859,6-9-0-8-0,6833-70-3815,SNGL FAM SUB,2.42,AC,51300,0,51300,102900,4000,158200,46200,0,46200,86000,4000,136200,A1,AG/GEN,,,
1860,6-9-0-9-0,6833-71-0161,SNGL FAM SUB,2.59,AC,52200,0,52200,235800,0,288000,47100,0,47100,14400,0,61500,A1,AG/GEN,,,
1861,6-9-0-10-0,6833-61-7056,SNGL FAM SUB,2.37,AC,46900,0,46900,115800,13300,176000,46000,0,46000,97700,13000,156700,A1,AG/GEN,,,
1862,6-9-0-12-0,6833-71-0598,SNGL FAM SUB,4.42,AC,57800,0,57800,0,0,57800,56700,0,56700,0,0,56700,A1,AG/GEN,,,
1863,6-9-0-13-0,6833-72-4093,SNGL FAM SUB,4,AC,55600,0,55600,89800,4000,149400,54500,0,54500,74800,4000,133300,A1,AG/GEN,,,
1864,6-9-0-14-0,6833-72-3202,SNGL FAM SUB,2.96,AC,50000,0,50000,10500,1600,62100,49000,0,49000,10100,1300,60400,A1,AG/GEN,,,
1865,6-9-0-15-0,6833-72-0130,SNGL FAM SUB,3.59,AC,53400,0,53400,168300,400,222100,52300,0,52300,144700,400,197400,A1,AG/GEN,,,
1866,6-9-0-16-0,6833-61-7986,SNGL FAM SUB,2.78,AC,49100,0,49100,254200,31100,334400,48100,0,48100,222000,27800,297900,A1,AG/GEN,,,
1867,6-9-0-17-0,6833-61-5798,SNGL FAM SUB,2.31,AC,46600,0,46600,119400,6200,172200,45600,0,45600,109200,4400,159200,A1,AG/GEN,,,
1868,6-9-0-20-0,6833-61-3057,SNGL FAM SUB,2.18,AC,45900,0,45900,67900,1600,115400,45000,0,45000,36500,1500,83000,A1,AG/GEN,,,
1870,31-16-0-C-0,6778-06-9850,Roads,2.03,AC,0,0,0,0,0,0,0,0,0,0,0,0,A2,AG/LTD,,,
1871,31-16-0-3-0,6778-06-4662,SNGL FAM SUB,3.35,AC,99600,0,99600,220100,51300,371000,88900,0,88900,180500,43700,313100,A2,AG/LTD,,,
1872,31-16-0-4-0,6778-06-7944,SNGL FAM SUB,8.25,AC,154700,0,154700,0,0,154700,138400,0,138400,0,0,138400,A2,AG/LTD,,,
1873,31-16-0-5-0,6778-07-7286,SNGL FAM SUB,8.12,AC,153100,0,153100,244700,800,398600,136900,0,136900,206800,800,344500,A2,AG/LTD,,,
1874,31-16-0-7-0,6778-07-5834,SNGL FAM SUB,8.1,AC,152900,0,152900,349200,12300,514400,136700,0,136700,289600,12100,438400,A2,AG/LTD,,,
1875,31-16-0-8-0,6778-17-5229,SNGL FAM SUB,8,AC,143900,0,143900,247300,14000,405200,128600,0,128600,201800,13000,343400,A2,AG/LTD,,,
1877,48-1-0-35-A,7726-77-1438,SNGL FAM SUB,15.273,AC,3008800,0,3008800,0,0,3008800,1914800,0,1914800,0,0,1914800,A2,AG/LTD,,,
1881,48-1-0-33-0,7726-68-9284,MultiFamily,1.02,AC,118000,0,118000,0,0,118000,107300,0,107300,0,0,107300,R3,RES/GEN,,,
1882,48-1-0-34-0,7726-78-0170,MultiFamily,1.1,AC,127300,0,127300,0,0,127300,115700,0,115700,0,0,115700,R3,RES/GEN,,,
1883,48-1-0-35-0,7726-77-1958,MultiFamily,1.29,AC,149300,0,149300,0,0,149300,135700,0,135700,0,0,135700,R3,RES/GEN,,,
1885,13-15-0-1-0,6851-16-1299,SNGL FAM SUB,1.75,AC,51400,0,51400,134000,9900,195300,50400,0,50400,116400,8400,175200,A1,AG/GEN,,,
1887,12-22-0-4-0,6832-90-0564,SNGL FAM SUB,8.43,AC,85000,0,85000,108200,3800,197000,82900,0,82900,91600,3800,178300,A1,AG/GEN,,,
1888,5-13-0-10-0,6813-54-9576,SNGL FAM SUB,8.312,AC,66300,0,66300,0,0,66300,64900,0,64900,0,0,64900,A1,AG/GEN,,,
1889,4-6-0-32-0,6813-32-9611,SNGL FAM SUB,8.75,AC,67900,0,67900,142500,2500,212900,66500,0,66500,124900,2500,193900,A1,AG/GEN,,,
1890,4-6-0-14-0,6813-54-3816,SNGL FAM SUB,8.14,AC,65700,0,65700,195700,1000,262400,64300,0,64300,169100,1000,234400,A1,AG/GEN,,,
1891,47-3-0-C-1AT,7717-95-6862,AG 20-100 AC,22.26,AC,347300,336300,11000,0,0,347300,310200,300600,9600,0,0,310200,A2,AG/LTD,,,
1892,62-17-B-2-0,7704-95-9831,SNGL FAM SUB,0,AC,115000,0,115000,226400,22500,363900,100000,0,100000,204800,20500,325300,R1,RES/LTD,,,
1893,16-4-0-17-0,5890-35-9841,SNGL FAM SUB,3.68,AC,48400,0,48400,91800,0,140200,47400,0,47400,76500,0,123900,A1,AG/GEN,,,
1894,13-1-0-12-0,6841-48-4635,AG 20-100 AC,79.49,AC,422700,0,422700,0,0,422700,415000,0,415000,0,0,415000,A1,AG/GEN,,,
1896,4-3-0-14-0,6803-94-5035,AG 20-100 AC,47.36,AC,174100,0,174100,155000,51600,380700,171300,0,171300,134600,46500,352400,A1,AG/GEN,,,
1897,58-21-A-13-0,7716-33-6805,SNGL FAM SUB,1.317,AC,310000,0,310000,363600,41300,714900,285000,0,285000,330500,34600,650100,A2,AG/LTD,,,
1898,48-1-0-56-0,7738-21-6947,COMM & IND,0.18,AC,30700,0,30700,0,0,30700,29300,0,29300,0,0,29300,B1,BUS/GEN,,,
1899,15-1-0-34-0,5789-27-2133,SNGL FAM SUB,8.29,AC,65000,0,65000,132100,20900,218000,63500,0,63500,111700,18100,193300,A1,AG/GEN,,,
1900,57-16-0-1-0,7706-15-6921,SNGL FAM SUB,5,AC,2300,0,2300,0,0,2300,2100,0,2100,0,0,2100,A2,AG/LTD,,,
1901,57-16-0-3-0,7706-25-3967,SNGL FAM SUB,5.01,AC,2300,0,2300,0,0,2300,2100,0,2100,0,0,2100,A2,AG/LTD,,,
1902,57-16-0-4-0,7706-26-5468,SNGL FAM SUB,9.53,AC,112400,0,112400,231000,3500,346900,97900,0,97900,193800,3500,295200,A2,AG/LTD,,,
1903,57-16-0-7-0,7706-25-5577,SNGL FAM SUB,5.01,AC,2300,0,2300,0,0,2300,2100,0,2100,0,0,2100,A2,AG/LTD,,,
1904,57-24-0-1-0,7706-36-1435,SNGL FAM SUB,3,AC,1400,0,1400,0,0,1400,1300,0,1300,0,0,1300,A2,AG/LTD,,,
1905,57-24-0-2-0,7706-36-4335,SNGL FAM SUB,3.05,AC,1500,0,1500,0,0,1500,1300,0,1300,0,0,1300,A2,AG/LTD,,,
1906,57-24-0-3-0,7706-36-7211,SNGL FAM SUB,3.29,AC,1500,0,1500,0,0,1500,1400,0,1400,0,0,1400,A2,AG/LTD,,,
1907,57-24-0-4-0,7706-35-5914,SNGL FAM SUB,3.35,AC,1500,0,1500,0,0,1500,1400,0,1400,0,0,1400,A2,AG/LTD,,,
1908,57-24-0-5-0,7706-35-1933,SNGL FAM SUB,3.5,AC,1700,0,1700,0,0,1700,1500,0,1500,0,0,1500,A2,AG/LTD,,,
1909,57-24-0-6-0,7706-25-8897,SNGL FAM SUB,3.54,AC,1700,0,1700,0,0,1700,1500,0,1500,0,0,1500,A2,AG/LTD,,,
1910,57-24-0-6-A,7706-15-8589,SNGL FAM SUB,5.176,AC,2500,0,2500,0,0,2500,2200,0,2200,0,0,2200,A2,AG/LTD,,,
1911,60-1-0-9-A,6784-57-2047,SNGL FAM SUB,5,AC,17000,0,17000,0,0,17000,15000,0,15000,0,0,15000,A2,AG/LTD,,,
1912,54-2-0-3-0,6776-13-3167,SNGL FAM SUB,6.964,AC,124300,0,124300,368600,2500,495400,110900,0,110900,301000,1800,413700,A2,AG/LTD,,,
1913,54-2-0-9-0,6776-22-3640,SNGL FAM SUB,3.695,AC,91300,0,91300,0,0,91300,81500,0,81500,0,0,81500,A2,AG/LTD,,,
1915,28-5-0-1-0,6738-07-6080,SNGL FAM SUB,1.5,AC,44000,0,44000,0,7500,51500,41900,0,41900,0,7200,49100,A1,AG/GEN,,,
1916,9-1-0-46-0,5892-30-6260,SNGL FAM SUB,9.845,AC,66400,61800,4600,0,0,66400,63200,59000,4200,0,0,63200,A1,AG/GEN,,,
1917,30-5-0-B-0,6759-64-6968,SNGL FAM SUB,12.72,AC,140600,0,140600,144700,0,285300,127000,0,127000,108800,0,235800,A1,AG/GEN,,,
1918,28-1-0-71-A,6739-06-3008,SNGL FAM SUB,1.01,AC,47100,0,47100,84300,0,131400,44800,0,44800,72500,0,117300,A1,AG/GEN,,,
1919,47-17-0-A-3,7718-21-6044,SNGL FAM SUB,5.26,AC,171400,0,171400,623000,68500,862900,153200,0,153200,515700,67000,735900,A2,AG/LTD,,,
1920,22-1-0-2-A,6769-68-1805,SNGL FAM SUB,1.03,AC,61400,0,61400,153600,0,215000,55500,0,55500,130500,0,186000,A2,AG/LTD,,,
1921,29-16-0-G-0,6749-66-8402,SNGL FAM SUB,5.27,AC,93900,0,93900,160800,2000,256700,90000,0,90000,132800,2000,224800,A1,AG/GEN,,,
1922,20-6-0-7-0,6840-90-1294,SNGL FAM SUB,4.05,AC,82700,0,82700,360300,3500,446500,81600,0,81600,308200,2500,392300,A1,AG/GEN,,,
1923,30-5-0-C-0,6759-64-2238,SNGL FAM SUB,4.25,AC,85100,0,85100,0,0,85100,76900,0,76900,0,0,76900,A1,AG/GEN,,,
1924,13-1-0-6-0,6842-72-2648,SNGL FAM SUB,5,AC,57600,0,57600,0,0,57600,56600,0,56600,0,0,56600,A1,AG/GEN,,,
1925,13-1-0-5-0,6842-72-5778,SNGL FAM SUB,11.25,AC,65300,0,65300,0,0,65300,64100,0,64100,0,0,64100,A1,AG/GEN,,,
1926,13-1-0-40-0,6841-83-7858,SNGL FAM SUB,3.53,AC,71800,0,71800,145900,7500,225200,70500,0,70500,126300,5800,202600,A1,AG/GEN,,,
1927,28-5-0-2-0,6738-06-8919,SNGL FAM SUB,0.82,AC,28100,0,28100,0,8000,36100,27500,0,27500,0,8000,35500,A1,AG/GEN,,,
1928,28-5-0-3-0,6738-07-9040,SNGL FAM SUB,1.5,AC,43200,0,43200,0,0,43200,42900,0,42900,0,0,42900,A1,AG/GEN,,,
1929,27-7-0-2-D,6718-79-1912,SNGL FAM SUB,2.525,AC,47300,0,47300,107700,0,155000,46400,0,46400,88400,0,134800,A1,AG/GEN,,,
1930,28-1-0-63-0,6729-91-9675,SNGL FAM SUB,6.9,AC,59100,0,59100,0,0,59100,56400,0,56400,0,0,56400,A1,AG/GEN,,,
1931,57-16-0-6-0,7706-25-0389,SNGL FAM SUB,5,AC,213600,0,213600,431000,12500,657100,185900,0,185900,370300,12500,568700,A2,AG/LTD,,,
1932,28-1-0-28-0,6738-18-0423,SNGL FAM SUB,2.13,AC,48500,0,48500,202600,2400,253500,46500,0,46500,167000,2500,216000,A1,AG/GEN,,,
1934,30-1-0-114-0,6759-65-5523,SNGL FAM SUB,7.19,AC,36400,0,36400,0,0,36400,33800,0,33800,0,0,33800,A1,AG/GEN,,,
1936,38-1-0-39-A,6707-53-0878,AG 20-100 AC,30.574,AC,160100,105500,54600,150400,8400,318900,156300,103700,52600,131000,8900,296200,A1,AG/GEN,,,
1937,45-1-0-121-0,6797-77-9780,SNGL FAM SUB,0.234,AC,16400,0,16400,32100,500,49000,14600,0,14600,27400,500,42500,A2,AG/LTD,,,
1938,20-1-0-72-0,6840-95-2116,SNGL FAM SUB,16.6,AC,60400,52700,7700,0,0,60400,59800,52700,7100,0,0,59800,A1,AG/GEN,,,
1939,51-1-0-45-0,6726-96-3180,SNGL FAM SUB,2.57,AC,48400,0,48400,0,0,48400,47400,0,47400,0,0,47400,A1,AG/GEN,,,
1940,12-21-0-1-0,6832-54-4956,SNGL FAM SUB,4,AC,68300,0,68300,324500,0,392800,64500,0,64500,302700,0,367200,A1,AG/GEN,,,
1941,12-21-0-2-0,6832-54-7722,SNGL FAM SUB,4.02,AC,68500,0,68500,194200,5000,267700,64700,0,64700,170100,3700,238500,A1,AG/GEN,,,
1942,12-21-0-3-0,6832-55-9201,SNGL FAM SUB,8.31,AC,85300,0,85300,176500,4000,265800,83200,0,83200,154400,4000,241600,A1,AG/GEN,,,
1943,12-21-0-4-0,6832-65-2540,SNGL FAM SUB,8.25,AC,89400,0,89400,445700,3100,538200,87100,0,87100,384300,3400,474800,A1,AG/GEN,,,
1944,12-21-0-5-0,6832-65-4877,SNGL FAM SUB,8.84,AC,93400,0,93400,0,0,93400,91100,0,91100,0,0,91100,A1,AG/GEN,,,
2108,31-1-0-17-A,6768-47-7995,SNGL FAM SUB,2.97,AC,85000,0,85000,169500,24400,278900,78700,0,78700,139000,21000,238700,A2,AG/LTD,,,
2109,64-12-C-6-0,7724-50-8227,SNGL FAM SUB,0,AC,77000,0,77000,188900,2500,268400,67000,0,67000,159800,2500,229300,R1,RES/LTD,,,
2110,46-12-0-4-A,7717-11-7192,SNGL FAM SUB,3.73,AC,161200,0,161200,333600,0,494800,144100,0,144100,286100,0,430200,A2,AG/LTD,,,
2111,60-7-0-B-0,6785-10-2874,SNGL FAM SUB,4.33,AC,223700,0,223700,747000,70600,1041300,199500,0,199500,616700,58400,874600,A2,AG/LTD,,,
2112,63-2-0-2-0,7723-38-2027,SNGL FAM SUB,6.827,AC,331600,0,331600,0,0,331600,288200,0,288200,0,0,288200,R1A2,RES LTD,,,
2114,43-16-0-K-2,6776-07-2036,AG 20-100 AC,20.553,AC,285100,182200,102900,372700,102700,760500,254300,162800,91500,325600,94400,674300,A2,AG/LTD,,,
2115,43-16-0-K-3,6776-08-9059,SNGL FAM SUB,9.254,AC,159200,0,159200,271900,41300,472400,141800,0,141800,222200,37200,401200,A2,AG/LTD,,,
2117,46-1-0-35-0,7707-42-6761,SNGL FAM SUB,2.042,AC,122800,0,122800,234400,39600,396800,109700,0,109700,203200,33300,346200,RR,RES/RUR,,,
2118,46-27-A-6-0,7707-86-7278,SNGL FAM SUB,2.81,AC,165000,0,165000,320900,9000,494900,150000,0,150000,269500,6500,426000,RR,RES/RUR,,,
2119,57-20-B-6-0,7706-90-9797,SNGL FAM SUB,2.738,AC,315000,0,315000,350400,100,665500,288800,0,288800,336300,100,625200,A2,AG/LTD,,,
2277,67-13-B-9-0,7733-36-4720,SNGL FAM SUB,0,AC,265000,0,265000,718200,5000,988200,220000,0,220000,591600,5000,816600,R1,RES/LTD,,,
2278,4-6-0-30-0,6813-42-8256,SNGL FAM SUB,6.621,AC,60100,0,60100,0,0,60100,66300,0,66300,0,0,66300,A1,AG/GEN,,,
2279,28-1-0-70-A,6739-05-0014,SNGL FAM SUB,5.25,AC,75700,0,75700,0,0,75700,75700,0,75700,0,0,75700,A1,AG/GEN,,,
2280,39-1-0-83-0,6726-47-4743,SNGL FAM SUB,9.789,AC,92400,0,92400,148500,55200,296100,90700,0,90700,125700,59100,275500,A1,AG/GEN,,,
2281,62-13-A-1-0,7714-05-0540,SNGL FAM SUB,0,AC,115000,0,115000,393700,6300,515000,100000,0,100000,361300,5600,466900,R1,RES/LTD,,,
2283,46-27-A-12-0,7707-85-3162,SNGL FAM SUB,2,AC,165000,0,165000,234300,4100,403400,150000,0,150000,196300,3800,350100,RR,RES/RUR,,,
2284,50-5-0-1-0,6726-35-7121,SNGL FAM SUB,8.54,AC,73500,0,73500,185100,13200,271800,68100,0,68100,142900,13100,224100,A1,AG/GEN,,,
2285,20-1-0-58-A,6851-11-5543,SNGL FAM SUB,2.11,AC,59500,0,59500,217200,13800,290500,58400,0,58400,191800,13600,263800,A1,AG/GEN,,,
2286,40-4-0-A-0,6737-62-3844,SNGL FAM SUB,3,AC,62200,0,62200,96900,200,159300,61000,0,61000,82600,200,143800,A1,AG/GEN,,,
2287,40-4-0-B-0,6737-53-7596,SNGL FAM SUB,5.502,AC,78700,0,78700,0,0,78700,77300,0,77300,0,0,77300,A1,AG/GEN,,,
2288,18-5-0-A-5,6820-50-5086,SNGL FAM SUB,3,AC,52000,0,52000,141200,1200,194400,50000,0,50000,117400,1200,168600,A1,AG/GEN,,,
2290,40-4-0-B-1,6737-62-7744,SNGL FAM SUB,1.76,AC,54400,0,54400,104900,800,160100,53300,0,53300,89200,800,143300,A1,AG/GEN,,,
2291,57-2-0-9-0,7716-16-3751,SNGL FAM SUB,0.93,AC,96700,0,96700,138000,500,235200,86300,0,86300,114800,500,201600,A2,AG/LTD,,,
2292,67-12-0-12-0,7723-46-7121,SNGL FAM SUB,3.4,AC,397800,0,397800,807300,18100,1223200,346800,0,346800,784200,16300,1147300,R1,RES/LTD,,,
2293,67-12-0-14-0,7723-46-6425,SNGL FAM SUB,4.29,AC,405600,0,405600,1058200,38700,1502500,353600,0,353600,990100,37500,1381200,R1,RES/LTD,,,
1945,12-21-0-6-0,6832-66-8078,SNGL FAM SUB,9.92,AC,100700,0,100700,181400,2000,284100,98200,0,98200,157900,2000,258100,A1,AG/GEN,,,
1946,12-21-0-7-0,6832-65-9391,SNGL FAM SUB,8.38,AC,90300,0,90300,255700,23400,369400,88000,0,88000,224600,20800,333400,A1,AG/GEN,,,
1947,12-21-0-8-0,6832-64-5798,SNGL FAM SUB,8.33,AC,89900,0,89900,255500,38500,383900,87700,0,87700,224200,36500,348400,A1,AG/GEN,,,
1948,12-21-0-9-0,6832-64-2550,SNGL FAM SUB,8.45,AC,88200,0,88200,101700,10300,200200,86100,0,86100,93300,7500,186900,A1,AG/GEN,,,
1949,5-2-0-1-0,6823-28-1088,SNGL FAM SUB,4.5,AC,57600,0,57600,0,0,57600,56500,0,56500,0,0,56500,A1,AG/GEN,,,
1950,5-2-0-3-0,6823-27-6629,SNGL FAM SUB,2.4,AC,46800,0,46800,185000,500,232300,46000,0,46000,174500,500,221000,A1,AG/GEN,,,
1951,12-17-0-A-0,6831-78-0071,SNGL FAM SUB,14.67,AC,58700,51900,6800,0,0,58700,51500,0,51500,0,0,51500,A1,AG/GEN,,,
1952,12-17-0-B-0,6831-68-7172,SNGL FAM SUB,13.17,AC,52700,46600,6100,0,0,52700,46200,0,46200,0,0,46200,A1,AG/GEN,,,
1953,12-17-0-C-0,6831-68-4541,SNGL FAM SUB,15.05,AC,60200,53300,6900,0,0,60200,52800,0,52800,0,0,52800,A1,AG/GEN,,,
1954,12-17-0-D-0,6831-68-0635,SNGL FAM SUB,11.9,AC,51000,45500,5500,0,0,51000,41900,0,41900,0,0,41900,A1,AG/GEN,,,
1955,12-17-0-E-0,6831-58-6888,SNGL FAM SUB,8.44,AC,40000,36100,3900,0,0,40000,29600,0,29600,0,0,29600,A1,AG/GEN,,,
1956,12-17-0-F-0,6831-59-3144,SNGL FAM SUB,9.19,AC,42800,38600,4200,0,0,42800,32300,0,32300,0,0,32300,A1,AG/GEN,,,
1957,13-1-0-3-A,6842-76-5327,AG 20-100 AC,20.304,AC,128900,0,128900,204000,35600,368500,125900,0,125900,181300,30000,337200,A1,AG/GEN,,,
1958,13-1-0-3-B,6842-76-8729,SNGL FAM SUB,17.014,AC,115500,0,115500,129500,100600,345600,111100,0,111100,114000,93900,319000,A1,AG/GEN,,,
1959,13-4-0-1-0,6842-86-8030,SNGL FAM SUB,9.76,AC,79100,0,79100,115000,1500,195600,78400,0,78400,93800,1500,173700,A1,AG/GEN,,,
1967,29-3-0-4-A,6749-72-9761,SNGL FAM SUB,2.66,AC,70400,0,70400,16600,1500,88500,65500,0,65500,21800,1500,88800,A1,AG/GEN,,,
1968,20-1-0-53-0,6841-80-3502,SNGL FAM SUB,2.14,AC,59800,0,59800,51700,400,111900,58700,0,58700,50000,400,109100,A1,AG/GEN,,,
1969,21-1-0-52-A,6850-73-7757,SNGL FAM SUB,1.38,AC,58700,0,58700,177300,1300,237300,53900,0,53900,144600,1300,199800,A2,AG/LTD,,,
1970,20-1-0-43-0,6840-44-5941,SNGL FAM SUB,0.737,AC,34600,0,34600,208300,0,242900,32900,0,32900,182100,0,215000,A1,AG/GEN,,,
1971,21-1-0-52-0,6850-74-2263,SNGL FAM SUB,8.99,AC,137800,0,137800,37800,8900,184500,125000,0,125000,33100,8100,166200,A2,AG/LTD,,,
1972,20-11-0-20-0,6841-90-5920,SNGL FAM SUB,2.41,AC,59000,0,59000,164800,2200,226000,56000,0,56000,152200,1600,209800,A1,AG/GEN,,,
1973,29-2-0-5-0,6748-59-6907,SNGL FAM SUB,3.16,AC,75100,0,75100,196500,0,271600,70200,0,70200,163500,0,233700,A1,AG/GEN,,,
1974,17-1-0-23-0,6709-59-9045,SNGL FAM SUB,1.3,AC,40500,0,40500,222800,0,263300,39700,0,39700,195800,0,235500,A1,AG/GEN,,,
1975,18-1-0-60-0,6820-27-3503,SNGL FAM SUB,2,AC,46000,0,46000,0,1000,47000,44000,0,44000,0,1000,45000,A1,AG/GEN,,,
1976,9-1-0-43-0,5892-51-0708,SNGL FAM SUB,1.5,AC,40600,0,40600,81400,0,122000,39800,0,39800,72100,0,111900,A1,AG/GEN,,,
1977,39-1-0-97-0,6728-30-5370,AG 20-100 AC,30.95,AC,129900,115600,14300,0,0,129900,128200,115000,13200,0,0,128200,A1,AG/GEN,,,
1978,20-6-0-4-0,6840-80-1939,SNGL FAM SUB,4.07,AC,82800,0,82800,0,0,82800,81800,0,81800,0,0,81800,A1,AG/GEN,,,
1979,28-1-0-102-0,6738-56-3335,SNGL FAM SUB,14.37,AC,125500,0,125500,0,0,125500,123600,0,123600,0,0,123600,A1,AG/GEN,,,
1980,38-1-0-32-0,6707-75-0703,SNGL FAM SUB,5,AC,61200,0,61200,53000,0,114200,60000,0,60000,45800,100,105900,A1,AG/GEN,,,
1981,6-17-0-3-0,6823-75-2690,AG 20-100 AC,20.292,AC,115400,0,115400,0,0,115400,113200,0,113200,0,0,113200,A1,AG/GEN,,,
1982,6-1-0-9-A,6823-95-4451,SNGL FAM SUB,7.31,AC,27200,0,27200,0,0,27200,26700,0,26700,0,0,26700,A1,AG/GEN,,,
1983,5-1-0-75-0,6823-67-1605,SNGL FAM SUB,11.814,AC,27500,22100,5400,0,0,27500,26900,21900,5000,0,0,26900,A1,AG/GEN,,,
1984,12-1-0-67-0,6831-45-6240,AG 20-100 AC,24.1,AC,96600,0,96600,0,0,96600,86800,0,86800,0,0,86800,A1,AG/GEN,,,
1985,51-2-0-4-0,6736-50-3796,SNGL FAM SUB,7.933,AC,64000,0,64000,0,0,64000,62800,0,62800,0,0,62800,A1,AG/GEN,,,
1986,17-1-0-20-0,6709-68-5870,SNGL FAM SUB,3.42,AC,52400,0,52400,23600,100,76100,51300,0,51300,20300,100,71700,A1,AG/GEN,,,
1987,38-3-0-10-0,6717-46-1712,AG 20-100 AC,50.75,AC,242800,181100,61700,97000,1500,341300,237000,177900,59100,83400,1500,321900,A1,AG/GEN,,,
1988,9-1-0-41-0,5892-31-6296,SNGL FAM SUB,9.328,AC,67700,0,67700,129100,11200,208000,65700,0,65700,116100,9400,191200,A1,AG/GEN,,,
1989,45-1-0-112-A,6798-70-0381,SNGL FAM SUB,2.37,AC,78500,0,78500,255800,0,334300,70100,0,70100,211700,0,281800,A2,AG/LTD,,,
1990,58-1-0-43-0,7715-72-5791,SNGL FAM SUB,2.83,AC,145700,0,145700,0,0,145700,126700,0,126700,0,0,126700,A2,AG/LTD,,,
1991,64-1-0-67-0,7724-90-8768,SNGL FAM SUB,5,AC,260000,0,260000,37800,1100,298900,226000,0,226000,33000,1100,260100,A2,AG/LTD,,,
1992,22-1-0-8-A,6769-78-0459,SNGL FAM SUB,1.3,AC,64700,0,64700,121900,1500,188100,58700,0,58700,101000,1500,161200,A2,AG/LTD,,,
1993,50-1-0-7-A,6726-05-1193,SNGL FAM SUB,3,AC,50000,0,50000,100300,600,150900,49000,0,49000,87600,600,137200,A1,AG/GEN,,,
1994,62-20-B-3-0,7714-15-4425,SNGL FAM SUB,0,AC,115000,0,115000,285200,1000,401200,100000,0,100000,261900,1000,362900,R1,RES/LTD,,,
1995,1-1-0-24-A,6804-44-1733,AG 20-100 AC,51.95,AC,224900,146000,78900,207000,25600,457500,220600,144400,76200,179100,21800,421500,A1,AG/GEN,,,
1996,50-5-0-19-A,6726-30-0224,SNGL FAM SUB,2.14,AC,42100,0,42100,0,0,42100,39300,0,39300,0,0,39300,A1,AG/GEN,,,
1997,50-5-0-19-B,6725-29-9123,SNGL FAM SUB,6,AC,37100,0,37100,0,0,37100,36300,0,36300,0,0,36300,A1,AG/GEN,,,
1998,67-19-0-1-0,7733-36-7943,SNGL FAM SUB,1.07,AC,265000,0,265000,489400,0,754400,220000,0,220000,388600,0,608600,R1,RES/LTD,,,
1999,42-23-0-11-0,6767-32-1725,SNGL FAM SUB,3.128,AC,90500,0,90500,233200,800,324500,80800,0,80800,191200,800,272800,A2,AG/LTD,,,
2000,64-4-2-27-0,7724-92-3925,COMM & IND,0.4,AC,91200,0,91200,225900,10600,327700,84500,0,84500,214600,8200,307300,RO,RES/OF,,,
2001,64-4-2-28-0,7724-92-4915,COMM & IND,0.37,AC,69000,0,69000,0,0,69000,66900,0,66900,0,0,66900,RO,RES/OF,,,
2002,62-7-0-C-0,7715-01-3015,SNGL FAM SUB,18.44,AC,637500,628100,9400,0,169300,806800,554400,546500,7900,0,146900,701300,A2,AG/LTD,,,
2003,48-1-0-62-0,7737-29-0790,AG 20-100 AC,33.727,AC,2398800,2382900,15900,0,0,2398800,2141500,2127200,14300,0,0,2141500,A2,AG/LTD,,,
2004,46-1-0-9-A,7707-29-2422,SNGL FAM SUB,5.9,AC,161800,0,161800,127700,15600,305100,144600,0,144600,107300,13300,265200,A2,AG/LTD,,,
2005,50-5-0-16-A,6725-39-7919,SNGL FAM SUB,3.07,AC,46400,0,46400,0,5000,51400,43500,0,43500,0,5000,48500,A1,AG/GEN,,,
2006,50-5-0-16-B,6725-39-4093,SNGL FAM SUB,6.55,AC,39900,0,39900,0,0,39900,39100,0,39100,0,0,39100,A1,AG/GEN,,,
2008,48-1-0-60-0,7737-29-6245,AG 20-100 AC,42.076,AC,2570400,2550100,20300,0,300,2570700,2294200,2276200,18000,0,300,2294500,A2,AG/LTD,,,
2011,57-20-C-6-0,7716-10-1644,SNGL FAM SUB,3.3,AC,427100,0,427100,527500,0,954600,392000,0,392000,485900,0,877900,A2,AG/LTD,,,
2012,16-1-0-89-0,6800-13-8315,AG 20-100 AC,90.33,AC,202600,118400,84200,49100,3800,255500,197700,119900,77800,41400,3800,242900,A1,AG/GEN,,,
2013,31-2-0-2-A,6769-40-5622,SNGL FAM SUB,15.903,AC,221200,0,221200,240000,41600,502800,202600,0,202600,193800,36600,433000,A2,AG/LTD,,,
2014,38-1-0-121-0,6717-55-1944,AG 20-100 AC,81.3,AC,310000,0,310000,0,0,310000,302400,0,302400,0,0,302400,A1,AG/GEN,,,
2015,60-1-0-4-0,6784-07-4176,SNGL FAM SUB,12.691,AC,352800,0,352800,903300,7600,1263700,314800,0,314800,731700,7600,1054100,A2,AG/LTD,,,
2016,56-1-0-52-0,6796-26-6890,SNGL FAM SUB,5,AC,148700,0,148700,125400,1500,275600,132600,0,132600,103800,1500,237900,A2,AG/LTD,,,
2019,55-16-0-13-0,6776-63-7381,SNGL FAM SUB,5.94,AC,127900,0,127900,298600,68300,494800,114200,0,114200,244300,60200,418700,A2,AG/LTD,,,
2020,68-1-0-1-0,7733-74-6716,Cmn Area/Open Spc,6,AC,0,0,0,0,0,0,0,0,0,0,0,0,A2,AG/LTD,,,
2021,55-19-0-7-0,6776-85-6714,SNGL FAM SUB,2.097,AC,85200,0,85200,189300,1500,276000,76100,0,76100,154400,1500,232000,A2,AG/LTD,,,
2022,62-18-0-18-0,7704-64-9045,SNGL FAM SUB,3.14,AC,169300,0,169300,0,0,169300,150200,0,150200,0,0,150200,A2,AG/LTD,,,
2023,62-18-0-20-0,7704-73-4656,SNGL FAM SUB,3.06,AC,220500,0,220500,434900,3200,658600,200300,0,200300,390800,3400,594500,A2,AG/LTD,,,
2024,62-16-0-C-4,7704-40-7691,Cmn Area/Open Spc,10,AC,0,0,0,0,0,0,0,0,0,0,0,0,A2,AG/LTD,,,
2025,28-1-0-36-A,6738-06-1992,SNGL FAM SUB,2,AC,45400,0,45400,84200,0,129600,44500,0,44500,71800,0,116300,A1,AG/GEN,,,
2026,28-1-0-22-0,6728-97-7964,SNGL FAM SUB,6.47,AC,69400,0,69400,0,0,69400,68100,0,68100,0,0,68100,A1,AG/GEN,,,
2027,28-1-0-21-0,6728-97-8487,SNGL FAM SUB,1,AC,38800,0,38800,0,0,38800,38000,0,38000,0,0,38000,A1,AG/GEN,,,
2028,28-1-0-20-0,6728-97-7546,SNGL FAM SUB,2,AC,45400,0,45400,10000,900,56300,44500,0,44500,10000,900,55400,A1,AG/GEN,,,
2029,28-10-0-1-0,6738-45-2887,SNGL FAM SUB,3.6,AC,67500,0,67500,229100,0,296600,67700,0,67700,65100,0,132800,A1,AG/GEN,,,
2030,38-2-0-5-0,6718-00-5471,SNGL FAM SUB,1.33,AC,40600,0,40600,155000,1200,196800,39800,0,39800,129500,1300,170600,A1,AG/GEN,,,
2031,27-6-0-2-0,6728-56-1971,SNGL FAM SUB,12.5,AC,103200,0,103200,0,0,103200,101300,0,101300,0,0,101300,A1,AG/GEN,,,
2032,38-1-0-10-C,6707-99-5317,SNGL FAM SUB,1.5,AC,41600,0,41600,103000,400,145000,40800,0,40800,88000,400,129200,A1,AG/GEN,,,
2033,28-1-0-21-A,6738-07-2418,SNGL FAM SUB,2,AC,45400,0,45400,198100,100,243600,44500,0,44500,167600,100,212200,A1,AG/GEN,,,
2034,50-2-0-C-0,6716-62-1764,AG 20-100 AC,50,AC,81200,0,81200,663200,78000,822400,77400,0,77400,592700,73700,743800,A1,AG/GEN,,,
2035,45-1-0-72-C,6797-41-9628,AG > 100 AC,113.33,AC,1764900,985500,779400,1297500,114600,3177000,1575500,1440100,135400,1045000,104100,2724600,A2,AG/LTD,,,
2040,45-10-0-1-0,6797-72-0817,SNGL FAM SUB,2.6,AC,102000,0,102000,213800,0,315800,91100,0,91100,174800,0,265900,A2,AG/LTD,,,
2041,45-10-0-2-0,6797-62-8389,SNGL FAM SUB,2.08,AC,93800,0,93800,204000,34300,332100,83700,0,83700,166600,28900,279200,A2,AG/LTD,,,
2044,32-10-1-7-0,6778-78-0365,SNGL FAM SUB,1.92,AC,80500,0,80500,216000,2400,298900,72000,0,72000,176500,2400,250900,A2,AG/LTD,,,
2045,57-1-0-34-E,7706-30-7673,SNGL FAM SUB,14.91,AC,505100,0,505100,369100,36600,910800,439800,0,439800,312100,30600,782500,A2,AG/LTD,,,
2046,56-1-0-86-0,6796-92-1140,SNGL FAM SUB,3.54,AC,146700,0,146700,23100,500,170300,127500,0,127500,25000,500,153000,A2,AG/LTD,,,
2047,17-1-0-71-0,6810-11-7869,SNGL FAM SUB,0.213,AC,1300,0,1300,0,0,1300,1200,0,1200,0,0,1200,A1,AG/GEN,,,
2048,55-14-0-7-0,6785-48-7773,SNGL FAM SUB,8.35,AC,173700,0,173700,331600,1000,506300,155200,0,155200,276700,1000,432900,A2,AG/LTD,,,
2049,38-1-0-33-0,6707-65-9444,SNGL FAM SUB,1,AC,38800,0,38800,225200,0,264000,38000,0,38000,195800,0,233800,A1,AG/GEN,,,
2050,15-1-0-21-0,5880-61-1260,AG 20-100 AC,26.9,AC,102700,51000,51700,187000,10800,300500,102800,52700,50100,162200,10200,275200,A1,AG/GEN,,,
2051,27-1-0-31-0,6728-22-6789,SNGL FAM SUB,13.69,AC,97500,0,97500,92400,2000,191900,95800,0,95800,82400,2000,180200,A1,AG/GEN,,,
2052,62-4-C-14-0,7714-04-2986,SNGL FAM SUB,0,AC,115000,0,115000,0,21100,136100,100000,0,100000,0,18100,118100,R1,RES/LTD,,,
2053,39-1-0-30-0,6727-14-3036,SNGL FAM SUB,2.09,AC,44900,0,44900,53400,300,98600,44000,0,44000,46000,300,90300,A1,AG/GEN,,,
2054,44-14-0-1-0,6787-53-9357,SNGL FAM SUB,1.91,AC,84500,0,84500,170600,3500,258600,75400,0,75400,139400,3500,218300,A2,AG/LTD,,,
2055,44-14-0-3-0,6787-63-2428,SNGL FAM SUB,1.43,AC,76900,0,76900,0,0,76900,68700,0,68700,0,0,68700,A2,AG/LTD,,,
2056,44-1-0-77-0,6787-63-1041,SNGL FAM SUB,2.17,AC,88600,0,88600,81900,5000,175500,79100,0,79100,65300,5000,149400,A2,AG/LTD,,,
2058,55-1-0-51-0,6786-25-8536,SNGL FAM SUB,17.33,AC,208000,0,208000,0,0,208000,185400,0,185400,0,0,185400,A2,AG/LTD,,,
2059,55-1-0-87-0,6785-74-7178,SNGL FAM SUB,12.75,AC,186400,0,186400,0,0,186400,166600,0,166600,0,0,166600,A2,AG/LTD,,,
2060,44-10-0-1-0,6787-54-1054,SNGL FAM SUB,5.84,AC,134000,0,134000,0,0,134000,119700,0,119700,0,0,119700,A2,AG/LTD,,,
2061,44-1-0-47-A,6787-63-3556,SNGL FAM SUB,1.753,AC,82000,0,82000,194900,14700,291600,73200,0,73200,158300,12400,243900,A2,AG/LTD,,,
2062,43-1-0-79-E,6767-93-4542,SNGL FAM SUB,2.08,AC,85700,0,85700,240000,0,325700,76500,0,76500,200900,0,277400,A2,AG/LTD,,,
2063,43-1-0-37-C,6767-63-5670,SNGL FAM SUB,3,AC,86900,0,86900,155800,6500,249200,77600,0,77600,128100,6500,212200,A2,AG/LTD,,,
2064,43-12-0-1-0,6767-88-6336,SNGL FAM SUB,2.85,AC,96700,0,96700,91700,300,188700,86500,0,86500,75500,300,162300,A2,AG/LTD,,,
2065,62-20-B-7-0,7714-15-6912,SNGL FAM SUB,0,AC,115000,0,115000,363100,26800,504900,100000,0,100000,329700,22500,452200,R1,RES/LTD,,,
2067,55-1-0-53-0,6786-36-0723,SNGL FAM SUB,2,AC,83900,0,83900,21600,0,105500,74900,0,74900,23500,0,98400,A2,AG/LTD,,,
2068,63-1-0-7-0,7715-31-5373,SNGL FAM SUB,4.5,AC,207200,0,207200,706000,61400,974600,180300,0,180300,625100,53300,858700,A2,AG/LTD,,,
2069,42-15-0-3-A,6757-62-7174,SNGL FAM SUB,0.72,AC,48300,0,48300,72000,1900,122200,43600,0,43600,59400,1700,104700,A2,AG/LTD,,,
2070,42-15-0-3-B,6757-62-8145,SNGL FAM SUB,0.016,AC,1100,0,1100,0,0,1100,1000,0,1000,0,0,1000,A2,AG/LTD,,,
2071,42-15-0-3-0,6757-62-2069,SNGL FAM SUB,3.12,AC,86700,0,86700,90400,3500,180600,75000,0,75000,74900,3500,153400,A2,AG/LTD,,,
2072,44-1-0-47-0,6787-63-5660,SNGL FAM SUB,1.753,AC,82000,0,82000,363300,4900,450200,73200,0,73200,291700,4000,368900,A2,AG/LTD,,,
2073,43-12-0-2-0,6767-99-3318,SNGL FAM SUB,7.42,AC,128900,0,128900,0,0,128900,115000,0,115000,0,0,115000,A2,AG/LTD,,,
2075,30-1-0-96-0,6768-05-0740,SNGL FAM SUB,2.56,AC,73100,71800,1300,0,0,73100,68600,67500,1100,0,0,68600,A2,AG/LTD,,,
2076,59-1-0-38-A,7726-96-0570,COMM & IND,13.209,AC,9200100,0,9200100,0,0,9200100,8363700,0,8363700,0,0,8363700,M2,INDUS/G,,,
2077,30-1-0-92-A,6768-33-3982,AG 20-100 AC,99.045,AC,980100,288000,692100,0,154100,1134200,894400,264700,629700,0,140100,1034500,A2,AG/LTD,,,
2078,30-1-0-94-0,6768-35-0106,AG > 100 AC,265.36,AC,2642700,1022900,1619800,492000,344200,3478900,2453100,953900,1499200,416800,301300,3171200,A2RP,A2RP AG2 RPREV,,,
2079,58-4-D-10-0,7716-56-6382,SNGL FAM SUB,0.74,AC,96800,0,96800,153000,1500,251300,88000,0,88000,126700,1500,216200,A2,AG/LTD,,,
2080,55-1-0-7-0,6786-15-4173,SNGL FAM SUB,5.43,AC,131200,0,131200,43800,3000,178000,117100,0,117100,36100,3000,156200,A2,AG/LTD,,,
2081,45-1-0-104-C,6798-71-5228,SNGL FAM SUB,3.1,AC,88600,0,88600,90600,500,179700,79000,0,79000,72600,500,152100,A2,AG/LTD,,,
2082,38-1-0-111-0,6717-39-0805,SNGL FAM SUB,13.5,AC,102600,0,102600,63000,0,165600,100500,0,100500,53700,0,154200,A1,AG/GEN,,,
2083,43-1-0-88-C,6777-00-3436,SNGL FAM SUB,2,AC,84500,0,84500,122500,0,207000,75500,0,75500,102600,0,178100,A2,AG/LTD,,,
2084,43-1-0-88-D,6777-00-5369,SNGL FAM SUB,1,AC,70100,0,70100,216700,5500,292300,62600,0,62600,177900,5500,246000,A2,AG/LTD,,,
2085,55-16-0-6-0,6776-64-9813,SNGL FAM SUB,4.3,AC,133900,0,133900,310300,0,444200,119700,0,119700,259900,0,379600,A2,AG/LTD,,,
2086,47-1-0-97-0,7727-21-4688,SNGL FAM SUB,2.212,AC,114700,0,114700,127900,600,243200,102400,0,102400,110700,600,213700,A2,AG/LTD,,,
2087,55-11-0-A-1,6786-45-2700,AG 20-100 AC,40.55,AC,527200,294800,232400,562800,0,1090000,470200,262500,207700,457100,0,927300,A2,AG/LTD,,,
2089,45-1-0-65-A,6797-67-3206,SNGL FAM SUB,0.83,AC,64000,0,64000,136300,500,200800,57200,0,57200,114300,500,172000,A2,AG/LTD,,,
2090,45-1-0-65-B,6797-67-3136,SNGL FAM SUB,0.17,AC,2300,0,2300,0,0,2300,2100,0,2100,0,0,2100,A2,AG/LTD,,,
2091,45-1-0-127-B,6797-58-7306,SNGL FAM SUB,4.438,AC,323100,0,323100,0,0,323100,307600,0,307600,0,0,307600,A2,AG/LTD,,,
2092,58-21-A-14-0,7716-33-4816,SNGL FAM SUB,2.146,AC,310000,0,310000,416600,0,726600,285000,0,285000,383100,0,668100,A2,AG/LTD,,,
2093,46-14-0-2-0,7718-01-2075,SNGL FAM SUB,3.23,AC,133600,0,133600,252400,9200,395200,121500,0,121500,214500,5500,341500,A2,AG/LTD,,,
2094,63-16-0-2-0,7715-70-1754,SNGL FAM SUB,2.9,AC,153900,0,153900,178700,0,332600,133800,0,133800,156500,0,290300,A2,AG/LTD,,,
2095,32-1-0-34-0,6778-76-3791,SNGL FAM SUB,2.69,AC,88400,0,88400,0,0,88400,79000,0,79000,0,0,79000,A2,AG/LTD,,,
2096,32-2-0-1-0,6778-95-0009,SNGL FAM SUB,2.87,AC,91000,0,91000,265400,0,356400,81300,0,81300,225200,0,306500,A2,AG/LTD,,,
2097,48-8-0-1-0,7727-62-4208,SNGL FAM SUB,7.25,AC,303100,0,303100,0,0,303100,280300,0,280300,0,0,280300,A2,AG/LTD,,,
2098,17-1-0-47-A,6810-27-9538,SNGL FAM SUB,1,AC,38800,0,38800,106900,100,145800,38000,0,38000,95100,100,133200,A1,AG/GEN,,,
2099,17-1-0-47-B,6810-37-3723,SNGL FAM SUB,1.5,AC,41600,0,41600,0,0,41600,40500,0,40500,0,0,40500,A1,AG/GEN,,,
2100,17-1-0-47-C,6810-37-1843,SNGL FAM SUB,2,AC,44400,0,44400,0,0,44400,43000,0,43000,0,0,43000,A1,AG/GEN,,,
2101,9-1-0-55-0,5891-72-7518,SNGL FAM SUB,4,AC,47400,0,47400,0,100,47500,47000,0,47000,0,100,47100,A1,AG/GEN,,,
2103,27-1-0-2-0,6719-55-6111,SNGL FAM SUB,12.45,AC,101800,0,101800,56700,100,158600,101000,0,101000,45500,100,146600,A1,AG/GEN,,,
2104,63-1-0-95-0,7714-59-2802,SNGL FAM SUB,2.198,AC,132800,0,132800,222500,0,355300,115500,0,115500,184500,0,300000,A2,AG/LTD,,,
2105,67-13-C-6-0,7733-26-8712,SNGL FAM SUB,0,AC,265000,0,265000,941800,14600,1221400,220000,0,220000,620300,14400,854700,R1,RES/LTD,,,
2106,14-2-0-15-0,6851-28-6062,SNGL FAM SUB,3.71,AC,72800,0,72800,131500,1800,206100,71300,0,71300,109700,1800,182800,A1,AG/GEN,,,
2107,31-1-0-17-0,6768-57-1972,SNGL FAM SUB,4.97,AC,107800,0,107800,82000,8100,197900,98400,0,98400,69900,5300,173600,A2,AG/LTD,,,
2120,15-5-0-40-0,5880-71-9686,SNGL FAM SUB,8.16,AC,64600,0,64600,0,0,64600,63100,0,63100,0,0,63100,A1,AG/GEN,,,
2121,58-3-A-19-0,7726-26-8215,SNGL FAM SUB,0,AC,92400,0,92400,167600,900,260900,84000,0,84000,142100,900,227000,RN,RESIDEN,,,
2122,32-1-0-50-0,6778-74-9263,SNGL FAM SUB,5.32,AC,113300,0,113300,226000,12400,351700,101300,0,101300,186100,11600,299000,A2,AG/LTD,,,
2123,15-5-0-39-0,5880-71-9237,SNGL FAM SUB,8.12,AC,64400,0,64400,0,0,64400,62900,0,62900,0,0,62900,A1,AG/GEN,,,
2125,31-19-0-B-0,6779-30-7816,SNGL FAM SUB,3,AC,92900,0,92900,275400,49000,417300,83000,0,83000,223900,43000,349900,A2,AG/LTD,,,
2126,29-1-0-124-0,6758-07-6295,AG 20-100 AC,20,AC,137300,128100,9200,0,0,137300,136000,127500,8500,0,0,136000,A1,AG/GEN,,,
2127,43-15-0-1-0,6768-80-5977,SNGL FAM SUB,3.25,AC,92000,0,92000,58100,7100,157200,83600,0,83600,51900,6700,142200,A2,AG/LTD,,,
2128,67-2-D-12-0,7723-54-7326,SNGL FAM SUB,0,AC,184000,0,184000,242000,800,426800,160000,0,160000,201800,800,362600,R1,RES/LTD,,,
2129,19-6-0-B-1,6739-18-9001,SNGL FAM SUB,1.52,AC,58000,0,58000,106300,2400,166700,54800,0,54800,88000,2400,145200,A1,AG/GEN,,,
2130,5-1-0-49-0,6823-24-8714,SNGL FAM SUB,9.197,AC,55200,0,55200,118000,0,173200,54200,0,54200,89700,0,143900,A1,AG/GEN,,,
2131,67-2-D-11-0,7723-54-8500,SNGL FAM SUB,0,AC,184000,0,184000,237900,900,422800,160000,0,160000,203400,900,364300,R1,RES/LTD,,,
2132,47-17-0-A-4B,7718-20-7404,SNGL FAM SUB,4.92,AC,165600,0,165600,151600,22000,339200,148000,0,148000,126100,19300,293400,A2,AG/LTD,,,
2133,5-1-0-50-0,6823-33-7404,SNGL FAM SUB,12.61,AC,72000,0,72000,0,0,72000,70700,0,70700,0,0,70700,A1,AG/GEN,,,
2134,5-1-0-50-B,6823-34-7511,SNGL FAM SUB,3.74,AC,48300,0,48300,102200,0,150500,47400,0,47400,89700,0,137100,A1,AG/GEN,,,
2135,30-1-0-104-D,6758-99-5008,SNGL FAM SUB,1.95,AC,65800,0,65800,142600,64800,273200,59800,0,59800,117900,57400,235100,A2,AG/LTD,,,
2136,29-2-0-3-0,6749-60-2093,SNGL FAM SUB,2.93,AC,72900,0,72900,146600,2300,221800,68000,0,68000,121400,2300,191700,A1,AG/GEN,,,
2137,42-23-0-15-0,6767-33-6097,SNGL FAM SUB,2.035,AC,85700,0,85700,0,0,85700,76600,0,76600,0,0,76600,A2,AG/LTD,,,
2138,42-23-0-16-0,6767-32-8866,SNGL FAM SUB,4.508,AC,123100,0,123100,276100,700,399900,110000,0,110000,229300,700,340000,A2,AG/LTD,,,
2140,11-1-0-54-0,6822-65-0812,AG 20-100 AC,44.47,AC,205800,175000,30800,0,2700,208500,201700,172600,29100,0,2300,204000,A1,AG/GEN,,,
2141,27-1-0-71-0,6728-77-3907,AG 20-100 AC,25.6,AC,124000,112200,11800,0,0,124000,142500,0,142500,0,0,142500,A1,AG/GEN,,,
2142,27-5-0-2-B,6728-77-4484,SNGL FAM SUB,0.58,AC,3100,2800,300,0,0,3100,2900,0,2900,0,0,2900,A1,AG/GEN,,,
2143,42-17-0-A-0,6767-03-9495,COMM & IND,0.23,AC,34500,0,34500,23200,0,57700,33200,0,33200,21700,0,54900,B1,BUS/GEN,,,
2145,42-17-0-B-0,6767-03-9399,COMM & IND,0.77,AC,115600,0,115600,198000,6500,320100,111100,0,111100,185600,6600,303300,B1,BUS/GEN,,,
2146,64-1-0-77-0,7734-42-9303,COMM & IND,1,AC,407400,0,407400,159200,130700,697300,377200,0,377200,157500,104500,639200,B1,BUS/GEN,,,
2147,18-4-0-4-A,6820-30-7164,SNGL FAM SUB,2.03,AC,46200,0,46200,541900,0,588100,44200,0,44200,438600,0,482800,A1,AG/GEN,,,
2149,43-20-0-35-0,6768-51-6894,Cmn Area/Open Spc,5.865,AC,0,0,0,0,0,0,0,0,0,0,0,0,A2,AG/LTD,,,
2151,42-1-0-57-0,6767-05-2818,COMM & IND,0.5,AC,75100,0,75100,179100,5900,260100,72200,0,72200,166000,4100,242300,RO,RES/OF,,,
2152,30-1-0-88-0,6768-02-6181,AG 20-100 AC,29,AC,370800,302900,67900,85000,5200,461000,341100,279200,61900,70900,5200,417200,A2,AG/LTD,,,
2153,56-1-0-44-B,6795-69-9711,AG 20-100 AC,21.09,AC,518700,0,518700,0,0,518700,451000,0,451000,0,0,451000,A2,AG/LTD,,,
2154,11-1-0-8-B,6822-00-3142,SNGL FAM SUB,8.01,AC,78100,74400,3700,0,0,78100,76600,73200,3400,0,0,76600,A1,AG/GEN,,,
2155,38-1-0-67-0,6717-02-5800,SNGL FAM SUB,5,AC,25500,0,25500,0,0,25500,25000,0,25000,0,0,25000,A1,AG/GEN,,,
2156,38-1-0-75-0,6707-93-9006,SNGL FAM SUB,3,AC,28600,0,28600,0,0,28600,28000,0,28000,0,0,28000,A1,AG/GEN,,,
2157,5-3-0-1-0,6823-18-7510,SNGL FAM SUB,1.43,AC,47000,0,47000,0,0,47000,46100,0,46100,0,0,46100,A1,AG/GEN,,,
2158,5-3-0-3-0,6823-18-9761,SNGL FAM SUB,3.42,AC,57800,0,57800,250000,4000,311800,56600,0,56600,210700,11200,278500,A1,AG/GEN,,,
2159,5-3-0-4-0,6823-28-0939,SNGL FAM SUB,3.28,AC,57000,0,57000,0,0,57000,55800,0,55800,0,0,55800,A1,AG/GEN,,,
2160,63-11-0-A-1,7714-75-6114,SNGL FAM SUB,11.991,AC,410800,0,410800,486800,2900,900500,357300,0,357300,422500,3200,783000,A2,AG/LTD,,,
2161,63-12-0-4-A,7714-52-2888,SNGL FAM SUB,7.89,AC,362400,196300,166100,377800,35300,775500,315000,170600,144400,321000,33000,669000,A2,AG/LTD,,,
2162,6-1-0-39-B,6822-88-5414,SNGL FAM SUB,10,AC,101300,56400,44900,368900,22700,492900,98800,55900,42900,329800,22700,451300,A1,AG/GEN,,,
2163,6-10-0-3-0,6822-98-1104,SNGL FAM SUB,18.92,AC,142700,133300,9400,0,10200,152900,139400,131300,8100,0,8800,148200,A1,AG/GEN,,,
2164,58-18-G-3-0,7716-50-0626,SNGL FAM SUB,2.271,AC,310000,0,310000,398700,33700,742400,285000,0,285000,365300,27600,677900,A2,AG/LTD,,,
2165,55-16-0-8-0,6776-64-1345,SNGL FAM SUB,3.55,AC,108600,0,108600,0,0,108600,97000,0,97000,0,0,97000,A2,AG/LTD,,,
2166,55-1-0-36-B,6785-58-4160,SNGL FAM SUB,1.53,AC,78800,0,78800,246100,700,325600,70400,0,70400,199800,700,270900,A2,AG/LTD,,,
2167,58-21-C-8-0,7716-21-2990,SNGL FAM SUB,6.687,AC,365000,0,365000,1201200,109500,1675700,335000,0,335000,1148000,99500,1582500,R3,RES/GEN,,,
2168,58-21-C-9-0,7716-21-6855,SNGL FAM SUB,10.384,AC,444100,0,444100,0,0,444100,406600,0,406600,0,0,406600,R3,RES/GEN,,,
2169,46-23-0-10-0,7707-95-4164,SNGL FAM SUB,3.273,AC,165000,0,165000,0,0,165000,150000,0,150000,0,0,150000,A2,AG/LTD,,,
2170,46-23-0-11-0,7707-94-5715,SNGL FAM SUB,5.707,AC,165000,0,165000,408000,54100,627100,150000,0,150000,339900,47100,537000,A2,AG/LTD,,,
2172,18-1-0-14-0,6810-75-4739,SNGL FAM SUB,10.45,AC,91300,0,91300,115100,1100,207500,90000,0,90000,95000,1100,186100,A1,AG/GEN,,,
2173,5-3-0-12-0,6823-19-4174,SNGL FAM SUB,3.34,AC,57300,0,57300,201800,38700,297800,56100,0,56100,175400,34300,265800,A1,AG/GEN,,,
2174,5-3-0-20-0,6824-20-1175,SNGL FAM SUB,5.49,AC,78500,0,78500,228500,0,307000,77000,0,77000,193900,0,270900,A1,AG/GEN,,,
2175,32-1-0-40-D,6778-74-1801,SNGL FAM SUB,10,AC,195400,0,195400,283500,14500,493400,174000,0,174000,241800,14500,430300,A2,AG/LTD,,,
2176,17-1-0-85-0,6709-97-9091,SNGL FAM SUB,1,AC,40000,0,40000,154900,1500,196400,38000,0,38000,117900,600,156500,A1,AG/GEN,,,
2177,10-1-0-29-0,6812-23-0756,AG 20-100 AC,29.51,AC,104200,89100,15100,0,0,104200,103300,90600,12700,0,0,103300,A1,AG/GEN,,,
2178,10-1-0-29-E,6812-24-4586,SNGL FAM SUB,12.08,AC,83700,77500,6200,0,0,83700,82300,77100,5200,0,0,82300,A1,AG/GEN,,,
2180,32-1-0-12-0,6779-74-5420,AG 20-100 AC,30.48,AC,433700,311300,122400,10000,18400,462100,387700,278300,109400,10000,15400,413100,A2,AG/LTD,,,
2181,42-8-2-8-0,6767-28-4157,SNGL FAM SUB,0.88,AC,60000,0,60000,173500,300,233800,55000,0,55000,142000,300,197300,A2,AG/LTD,,,
2182,6-1-0-20-0,6823-71-9411,COMM & IND,0.58,AC,34200,0,34200,193300,34300,261800,33200,0,33200,188200,34200,255600,B1,BUS/GEN,,,
2183,11-1-0-32-A,6811-73-9818,AG 20-100 AC,20,AC,91700,82500,9200,0,0,91700,90000,81500,8500,0,0,90000,A1,AG/GEN,,,
2184,20-3-0-3-0,6840-35-5370,SNGL FAM SUB,2.159,AC,58300,0,58300,231600,2000,291900,54300,0,54300,196500,2000,252800,A1,AG/GEN,,,
2185,43-10-0-B-0,6767-65-7960,SNGL FAM SUB,2.66,AC,84900,0,84900,36100,0,121000,75800,0,75800,30300,0,106100,A2,AG/LTD,,,
2186,20-6-0-5-0,6840-80-3925,SNGL FAM SUB,4.01,AC,82300,0,82300,0,0,82300,81200,0,81200,0,0,81200,A1,AG/GEN,,,
2187,20-6-0-6-0,6840-80-8429,SNGL FAM SUB,3,AC,73200,0,73200,86300,400,159900,71700,0,71700,69600,400,141700,A1,AG/GEN,,,
2188,28-1-0-75-0,6739-26-7190,SNGL FAM SUB,1.01,AC,47100,0,47100,126200,0,173300,44800,0,44800,104300,0,149100,A1,AG/GEN,,,
2189,38-1-0-74-A,6707-94-8276,SNGL FAM SUB,1,AC,38800,0,38800,0,0,38800,38000,0,38000,0,0,38000,A1,AG/GEN,,,
2190,38-1-0-46-0,6707-61-0587,AG 20-100 AC,29.13,AC,148600,134800,13800,0,0,148600,145700,133300,12400,0,0,145700,A1,AG/GEN,,,
2191,28-1-0-3-0,6729-84-7868,SNGL FAM SUB,17.82,AC,153700,0,153700,131000,700,285400,149000,0,149000,111800,700,261500,A1,AG/GEN,,,
2192,39-5-0-4-0,6717-64-5055,AG 20-100 AC,27.6,AC,137000,123700,13300,0,0,137000,134200,122400,11800,0,0,134200,A1,AG/GEN,,,
2193,38-1-0-44-0,6707-52-7693,SNGL FAM SUB,0.89,AC,34500,0,34500,124300,18100,176900,33800,0,33800,106500,16600,156900,A1,AG/GEN,,,
2194,26-1-0-67-0,6719-05-9363,SNGL FAM SUB,6.142,AC,69300,0,69300,146600,40600,256500,68900,0,68900,119900,34100,222900,A1,AG/GEN,,,
2195,38-1-0-45-0,6707-62-4527,SNGL FAM SUB,4.33,AC,57400,55400,2000,0,0,57400,56300,54500,1800,0,0,56300,A1,AG/GEN,,,
2196,38-1-0-45-A,6707-62-2677,SNGL FAM SUB,1.6,AC,42200,41400,800,0,97700,139900,41300,40600,700,0,97700,139000,A1,AG/GEN,,,
2197,38-1-0-45-B,6707-62-1636,SNGL FAM SUB,3.76,AC,54300,52400,1900,0,0,54300,53200,51600,1600,0,0,53200,A1,AG/GEN,,,
2198,39-6-0-7-0,6726-17-8604,SNGL FAM SUB,1,AC,38800,0,38800,175000,700,214500,38000,0,38000,146900,700,185600,A1,AG/GEN,,,
2199,57-1-0-57-0,7715-29-2462,SNGL FAM SUB,2.5,AC,427500,0,427500,521800,5200,954500,391400,0,391400,503900,5000,900300,A2,AG/LTD,,,
2200,62-21-0-10-0,7704-88-4141,SNGL FAM SUB,8.01,AC,378700,0,378700,448100,10400,837200,329200,0,329200,431600,9000,769800,A2,AG/LTD,,,
2201,6-8-0-H-0,6833-83-8517,SNGL FAM SUB,2.7,AC,48700,0,48700,0,0,48700,47700,0,47700,0,0,47700,A1,AG/GEN,,,
2202,3-1-0-1-A,6803-29-3146,SNGL FAM SUB,19.25,AC,104900,0,104900,231100,9000,345000,103000,0,103000,198400,9000,310400,A1,AG/GEN,,,
2203,63-8-0-2-0,7724-16-3312,SNGL FAM SUB,9.9,AC,261600,0,261600,210000,67100,538700,227300,0,227300,178600,60100,466000,A2,AG/LTD,,,
2204,33-3-0-2-0,6798-36-9007,SNGL FAM SUB,1,AC,77100,0,77100,115900,0,193000,68900,0,68900,95600,0,164500,A2,AG/LTD,,,
2205,46-1-0-10-0,7707-08-5770,SNGL FAM SUB,8.176,AC,195900,0,195900,46400,900,243200,175100,0,175100,39400,900,215400,A2,AG/LTD,,,
2207,27-2-0-3-0,6719-60-1156,SNGL FAM SUB,1.83,AC,43400,0,43400,0,0,43400,42600,0,42600,0,0,42600,A1,AG/GEN,,,
2208,28-1-0-19-0,6728-97-4538,SNGL FAM SUB,3.86,AC,57700,0,57700,100700,13900,172300,56600,0,56600,86500,12000,155100,A1,AG/GEN,,,
2209,27-1-0-73-A,6728-47-1594,SNGL FAM SUB,1,AC,38800,0,38800,136900,0,175700,38000,0,38000,120100,0,158100,A1,AG/GEN,,,
2210,21-1-0-29-A,6759-27-8436,SNGL FAM SUB,1.51,AC,60300,0,60300,141400,0,201700,55200,0,55200,120500,0,175700,A2,AG/LTD,,,
2211,33-1-0-9-B,6798-35-6687,SNGL FAM SUB,2,AC,90900,0,90900,0,0,90900,81200,0,81200,0,0,81200,A2,AG/LTD,,,
2212,29-17-0-2-0,6749-60-8496,SNGL FAM SUB,2.1,AC,65000,0,65000,238300,10600,313900,60800,0,60800,199400,10600,270800,A1,AG/GEN,,,
2213,29-17-0-4-A,6749-60-5405,SNGL FAM SUB,1,AC,54000,0,54000,152900,18100,225000,49900,0,49900,125000,18100,193000,A1,AG/GEN,,,
2214,46-1-0-11-0,7707-08-2762,SNGL FAM SUB,1.114,AC,69100,0,69100,109300,100,178500,61700,0,61700,91700,100,153500,A2,AG/LTD,,,
2216,27-1-0-73-0,6728-47-0295,SNGL FAM SUB,2,AC,44900,0,44900,101800,300,147000,44000,0,44000,86500,300,130800,A1,AG/GEN,,,
2217,33-1-0-9-0,6798-35-9632,SNGL FAM SUB,6.418,AC,148400,0,148400,84200,900,233500,132300,0,132300,69400,900,202600,A2,AG/LTD,,,
2218,33-3-0-1-0,6798-46-0119,SNGL FAM SUB,1,AC,77100,0,77100,90100,300,167500,68900,0,68900,73900,300,143100,A2,AG/LTD,,,
2219,33-1-0-3-0,6788-84-8475,SNGL FAM SUB,16.69,AC,145100,0,145100,0,0,145100,129800,0,129800,0,0,129800,A2,AG/LTD,,,
2220,28-1-0-112-0,6739-82-8330,SNGL FAM SUB,1.36,AC,62300,0,62300,0,0,62300,59500,0,59500,0,0,59500,A1,AG/GEN,,,
2222,33-1-0-9-A,6798-35-7844,SNGL FAM SUB,1.05,AC,77800,0,77800,255300,0,333100,69500,0,69500,217200,0,286700,A2,AG/LTD,,,
2223,20-30-0-4-0,6840-10-5685,AG 20-100 AC,21.65,AC,117700,107700,10000,0,0,117700,108800,99600,9200,0,0,108800,A1,AG/GEN,,,
2224,67-2-B-1-0,7723-56-3642,SNGL FAM SUB,0,AC,165600,0,165600,642800,0,808400,144000,0,144000,565400,0,709400,R1,RES/LTD,,,
2225,67-2-C-3-0,7723-55-2759,SNGL FAM SUB,0,AC,184000,0,184000,356900,1500,542400,160000,0,160000,311500,1500,473000,R1,RES/LTD,,,
2226,20-1-0-21-0,6840-11-0124,AG 20-100 AC,32.9,AC,124700,109500,15200,0,0,124700,119200,105200,14000,0,0,119200,A1,AG/GEN,,,
2227,67-13-A-5-0,7733-37-5190,SNGL FAM SUB,0,AC,265000,0,265000,609300,3700,878000,220000,0,220000,498100,3300,721400,R1,RES/LTD,,,
2228,26-1-0-35-D,6718-03-2409,SNGL FAM SUB,3.06,AC,50300,0,50300,124600,37100,212000,49300,0,49300,107800,30800,187900,A1,AG/GEN,,,
2229,26-1-0-35-E,6718-03-1218,SNGL FAM SUB,3.043,AC,50200,0,50200,0,0,50200,49200,0,49200,0,0,49200,A2,AG/LTD,,,
2230,28-1-0-59-0,6739-10-4378,SNGL FAM SUB,2.01,AC,47700,0,47700,43100,1200,92000,45800,0,45800,36400,1200,83400,A1,AG/GEN,,,
2231,27-1-0-8-0,6719-70-2682,SNGL FAM SUB,1.07,AC,39200,0,39200,81400,500,121100,38400,0,38400,69500,500,108400,A1,AG/GEN,,,
2232,58-21-A-10-0,7716-43-2708,SNGL FAM SUB,1.557,AC,310000,0,310000,259300,0,569300,285000,0,285000,239000,0,524000,A2,AG/LTD,,,
2233,26-4-0-1-B1,6719-31-9402,SNGL FAM SUB,1,AC,38800,0,38800,0,0,38800,38000,0,38000,0,0,38000,A1,AG/GEN,,,
2234,19-1-0-22-0,6729-78-9536,SNGL FAM SUB,10,AC,29200,0,29200,0,0,29200,30000,0,30000,0,0,30000,A1,AG/GEN,,,
2235,38-1-0-110-0,6717-29-2963,SNGL FAM SUB,15.54,AC,105700,0,105700,0,0,105700,103400,0,103400,0,0,103400,A1,AG/GEN,,,
2237,28-1-0-3-A,6729-95-3040,SNGL FAM SUB,1,AC,47000,0,47000,74500,500,122000,44700,0,44700,62700,500,107900,A1,AG/GEN,,,
2238,28-1-0-71-C,6739-05-3603,SNGL FAM SUB,1.94,AC,54100,0,54100,109900,1000,165000,51600,0,51600,91300,1000,143900,A1,AG/GEN,,,
2239,26-4-0-1-B,6719-41-2415,SNGL FAM SUB,9.72,AC,87600,0,87600,148300,100,236000,86000,0,86000,130400,100,216500,A1,AG/GEN,,,
2240,18-6-0-10-0,6820-17-9828,SNGL FAM SUB,3.51,AC,54900,0,54900,233300,2700,290900,53100,0,53100,192800,2800,248700,A1,AG/GEN,,,
2241,18-6-0-11-0,6820-27-0982,SNGL FAM SUB,1.15,AC,6900,0,6900,0,0,6900,6300,0,6300,0,0,6300,A1,AG/GEN,,,
2242,27-8-0-A-1,6729-16-5838,SNGL FAM SUB,4.07,AC,58100,0,58100,92300,22400,172800,56400,0,56400,77600,18500,152500,A1,AG/GEN,,,
2243,20-1-0-16-B,6840-33-8666,SNGL FAM SUB,8.38,AC,109800,0,109800,0,0,109800,106000,0,106000,0,0,106000,A1,AG/GEN,,,
2246,27-1-0-51-0,6719-95-1944,SNGL FAM SUB,6.684,AC,64300,0,64300,0,0,64300,62700,0,62700,0,0,62700,A1,AG/GEN,,,
2247,18-4-0-5-A,6820-02-4323,AG 20-100 AC,45,AC,136100,0,136100,0,2500,138600,135000,0,135000,0,2500,137500,A1,AG/GEN,,,
2249,26-4-0-2-B3,6719-41-4358,SNGL FAM SUB,2.43,AC,47500,0,47500,115500,100,163100,46600,0,46600,101600,100,148300,A1,AG/GEN,,,
2250,18-1-0-26-0,6729-07-8616,SNGL FAM SUB,6,AC,68500,0,68500,273600,0,342100,68000,0,68000,224200,0,292200,A1,AG/GEN,,,
2251,18-1-0-26-B,6729-06-6901,SNGL FAM SUB,3.161,AC,52900,0,52900,279300,7700,339900,51000,0,51000,238400,7800,297200,A1,AG/GEN,,,
2252,18-6-0-8-0,6820-18-3200,SNGL FAM SUB,3.34,AC,53900,0,53900,129100,6500,189500,52000,0,52000,110000,6500,168500,A1,AG/GEN,,,
2253,18-1-0-26-C,6729-07-6461,SNGL FAM SUB,6,AC,68500,0,68500,0,0,68500,68000,0,68000,0,0,68000,A1,AG/GEN,,,
2254,18-6-0-9-0,6820-18-6206,SNGL FAM SUB,6.85,AC,73300,0,73300,185600,39000,297900,73100,0,73100,151300,31400,255800,A1,AG/GEN,,,
2255,26-4-0-2-B1,6719-41-7624,SNGL FAM SUB,2,AC,46000,0,46000,184500,1700,232200,44000,0,44000,151500,1900,197400,A1,AG/GEN,,,
2256,26-4-0-2-B,6719-52-0135,SNGL FAM SUB,8.06,AC,79000,0,79000,0,0,79000,76800,0,76800,0,0,76800,A1,AG/GEN,,,
2258,17-1-0-86-A,6719-07-5990,SNGL FAM SUB,2.15,AC,46900,0,46900,208300,29800,285000,44300,0,44300,169600,25300,239200,A1,AG/GEN,,,
2260,26-11-0-2-0,6719-07-5363,SNGL FAM SUB,10,AC,89100,0,89100,0,2300,91400,87500,0,87500,0,2300,89800,A1,AG/GEN,,,
2261,29-1-0-130-0,6748-97-2250,SNGL FAM SUB,6.066,AC,95900,24000,71900,260800,1600,358300,89400,22600,66800,220500,1600,311500,A1,AG/GEN,,,
2262,29-1-0-131-0,6748-96-4014,SNGL FAM SUB,12.38,AC,98800,93100,5700,0,0,98800,95600,90300,5300,0,0,95600,A1,AG/GEN,,,
2263,29-1-0-137-0,6748-96-7842,SNGL FAM SUB,10.895,AC,110300,105300,5000,0,0,110300,109600,105000,4600,0,0,109600,A1,AG/GEN,,,
2264,29-1-0-133-0,6748-86-6246,SNGL FAM SUB,5,AC,48400,46100,2300,0,0,48400,43700,41600,2100,0,0,43700,A1,AG/GEN,,,
2265,30-1-0-92-0,6768-03-2651,SNGL FAM SUB,2.03,AC,66800,0,66800,166700,1000,234500,60600,0,60600,138300,1000,199900,A2,AG/LTD,,,
2266,29-1-0-134-0,6748-96-1661,AG 20-100 AC,21.76,AC,152400,142400,10000,0,0,152400,148000,138800,9200,0,0,148000,A1,AG/GEN,,,
2267,58-22-A-13-0,7715-38-2131,SNGL FAM SUB,2.27,AC,460800,0,460800,927700,0,1388500,422400,0,422400,808900,0,1231300,A2,AG/LTD,,,
2268,55-14-0-9-0,6785-49-0052,SNGL FAM SUB,12.51,AC,228600,0,228600,597200,34000,859800,204300,0,204300,516000,32000,752300,A2,AG/LTD,,,
2269,57-20-C-8-0,7716-10-2301,SNGL FAM SUB,2,AC,365000,0,365000,662900,24100,1052000,335000,0,335000,635300,23800,994100,A2,AG/LTD,,,
2270,67-3-G-3-0,7723-53-5809,SNGL FAM SUB,0,AC,184000,0,184000,239300,600,423900,160000,0,160000,214300,600,374900,R1,RES/LTD,,,
2271,64-3-3-1-0,7724-73-8057,COMM & IND,0.65,AC,157400,0,157400,0,0,157400,152500,0,152500,0,0,152500,B1,BUS/GEN,,,
2273,14-2-0-17-0,6851-28-1552,SNGL FAM SUB,3.79,AC,73500,0,73500,253400,3600,330500,72000,0,72000,209500,3800,285300,A1,AG/GEN,,,
2274,62-20-A-23-0,7714-06-8215,SNGL FAM SUB,0,AC,115000,0,115000,271700,2000,388700,100000,0,100000,256200,2000,358200,R1,RES/LTD,,,
2275,17-4-0-3-0,6810-32-1914,SNGL FAM SUB,5.33,AC,65200,62700,2500,0,0,65200,61800,59500,2300,0,0,61800,A1,AG/GEN,,,
2276,57-9-0-3-A,7706-53-2435,SNGL FAM SUB,1.5,AC,122600,0,122600,176700,0,299300,106600,0,106600,156100,0,262700,A2,AG/LTD,,,
2294,40-4-0-C-0,6737-54-1299,SNGL FAM SUB,12.74,AC,109800,0,109800,0,0,109800,93400,0,93400,0,0,93400,A1,AG/GEN,,,
2295,43-15-0-5-0,6778-00-2873,SNGL FAM SUB,3.27,AC,92000,0,92000,210700,17500,320200,83600,0,83600,186900,17400,287900,A2,AG/LTD,,,
2296,60-9-0-2-0,6774-99-8092,SNGL FAM SUB,6.711,AC,428800,0,428800,448900,4000,881700,382600,0,382600,378700,4000,765300,A2,AG/LTD,,,
2297,62-18-0-19-0,7704-73-1865,SNGL FAM SUB,3.2,AC,170400,0,170400,0,0,170400,150200,0,150200,0,0,150200,A2,AG/LTD,,,
2298,62-18-0-4-0,7704-74-6369,SNGL FAM SUB,3.2,AC,223800,0,223800,416100,24000,663900,200300,0,200300,371000,23400,594700,A2,AG/LTD,,,
2299,6-4-0-A-0,6833-90-1219,SNGL FAM SUB,1.54,AC,47900,0,47900,0,0,47900,46900,0,46900,0,0,46900,A1,AG/GEN,,,
2300,6-4-0-1-0,6833-90-3113,SNGL FAM SUB,6.46,AC,86000,0,86000,0,0,86000,84300,0,84300,0,0,84300,A1,AG/GEN,,,
2301,6-4-0-2-0,6832-99-1699,SNGL FAM SUB,5.46,AC,78300,0,78300,339700,5100,423100,76700,0,76700,281200,5600,363500,A1,AG/GEN,,,
2302,6-4-0-10-0,6833-80-7081,SNGL FAM SUB,5.29,AC,77000,0,77000,376000,1500,454500,75400,0,75400,311000,1700,388100,A1,AG/GEN,,,
2303,67-13-C-10-0,7733-36-4446,SNGL FAM SUB,0,AC,265000,0,265000,381600,0,646600,220000,0,220000,339700,0,559700,R1,RES/LTD,,,
2304,46-2-0-2-A,7707-72-4492,SNGL FAM SUB,3.65,AC,159400,0,159400,184700,1400,345500,142500,0,142500,159700,1400,303600,A2RR,AG& RUR,,,
2305,4-3-0-9-0,6813-04-4346,SNGL FAM SUB,3.43,AC,52600,0,52600,167000,0,219600,51500,0,51500,140600,0,192100,A1,AG/GEN,,,
2307,62-2-C-8-0,7714-05-0021,SNGL FAM SUB,0,AC,115000,0,115000,282100,4200,401300,100000,0,100000,131500,0,231500,R1,RES/LTD,,,
2308,58-3-A-15-0,7726-26-2471,SNGL FAM SUB,0,AC,88000,0,88000,160600,1800,250400,80000,0,80000,137200,1800,219000,RN,RESIDEN,,,
2311,57-1-0-65-0,7716-07-8038,SNGL FAM SUB,9,AC,453700,449600,4100,0,0,453700,394400,390600,3800,0,0,394400,A2,AG/LTD,,,
2312,57-1-0-66-0,7716-06-6273,SNGL FAM SUB,0.12,AC,3800,0,3800,0,0,3800,3300,0,3300,0,0,3300,A2,AG/LTD,,,
2313,57-1-0-67-0,7706-86-5558,AG > 100 AC,122.85,AC,3236500,2974700,261800,182000,248600,3667100,2811400,2582600,228800,154700,225300,3191400,A2,AG/LTD,,,
2314,57-1-0-68-0,7706-85-2555,SNGL FAM SUB,9.92,AC,480500,0,480500,170100,76900,727500,417700,0,417700,176300,76900,670900,A2,AG/LTD,,,
2315,57-1-0-75-A,7706-75-0257,AG 20-100 AC,21.85,AC,739100,728500,10600,0,0,739100,642500,633100,9400,0,0,642500,A2,AG/LTD,,,
2316,67-10-0-29-0,7733-17-4072,SNGL FAM SUB,2.3,AC,323000,0,323000,1127700,48000,1498700,270800,0,270800,908300,37400,1216500,R1,RES/LTD,,,
2317,67-10-0-30-0,7733-17-7015,SNGL FAM SUB,2.8,AC,340000,0,340000,1601800,66400,2008200,285000,0,285000,1332200,63900,1681100,R1,RES/LTD,,,
2318,5-3-0-26-0,6824-11-8595,SNGL FAM SUB,3.32,AC,55000,0,55000,136700,0,191700,53900,0,53900,113800,0,167700,A1,AG/GEN,,,
2319,5-15-0-1-0,6823-32-7607,SNGL FAM SUB,2.24,AC,38800,0,38800,6900,800,46500,38400,0,38400,7100,600,46100,A1,AG/GEN,,,
2320,5-15-0-2-0,6823-32-6139,SNGL FAM SUB,8.87,AC,59500,0,59500,0,10200,69700,58300,0,58300,0,9500,67800,A1,AG/GEN,,,
2321,5-15-0-3-0,6823-42-2784,SNGL FAM SUB,3.92,AC,44300,0,44300,121800,3000,169100,43500,0,43500,103400,3000,149900,A1,AG/GEN,,,
2322,5-15-0-4-0,6823-42-2572,SNGL FAM SUB,2.71,AC,40600,0,40600,0,4700,45300,39800,0,39800,0,4400,44200,A1,AG/GEN,,,
2323,5-15-0-5-0,6823-42-1066,SNGL FAM SUB,8.39,AC,58000,0,58000,89600,2500,150100,56900,0,56900,75500,2500,134900,A1,AG/GEN,,,
2324,5-15-0-6-0,6823-31-8574,SNGL FAM SUB,8.39,AC,58000,0,58000,294700,15100,367800,56900,0,56900,225200,14800,296900,A1,AG/GEN,,,
2325,5-15-0-7-0,6823-31-1564,SNGL FAM SUB,4.92,AC,47400,0,47400,215600,1500,264500,46500,0,46500,182800,1500,230800,A1,AG/GEN,,,
2326,5-15-0-8-0,6823-21-7419,SNGL FAM SUB,8.48,AC,58300,0,58300,89700,8200,156200,57100,0,57100,71500,8200,136800,A1,AG/GEN,,,
2327,5-15-0-9-0,6823-21-6000,SNGL FAM SUB,8.18,AC,57400,0,57400,0,0,57400,56200,0,56200,0,0,56200,A1,AG/GEN,,,
2328,5-15-0-10-0,6823-20-2687,SNGL FAM SUB,9.03,AC,60000,0,60000,48400,7500,115900,58800,0,58800,40200,8100,107100,A1,AG/GEN,,,
2329,5-15-0-11-0,6823-11-8032,SNGL FAM SUB,8.26,AC,57600,0,57600,0,0,57600,56500,0,56500,0,0,56500,A1,AG/GEN,,,
2330,5-15-0-12-0,6823-21-0696,SNGL FAM SUB,8.38,AC,58000,0,58000,144700,4600,207300,56800,0,56800,122100,4600,183500,A1,AG/GEN,,,
2331,5-15-0-13-0,6823-22-4145,SNGL FAM SUB,8.25,AC,57600,0,57600,157300,2000,216900,56500,0,56500,132800,2000,191300,A1,AG/GEN,,,
2332,67-11-B-1-0,7733-17-9245,SNGL FAM SUB,0,AC,265000,0,265000,488400,8100,761500,220000,0,220000,387300,8400,615700,R1,RES/LTD,,,
2333,43-21-0-20-0,6767-42-3035,SNGL FAM SUB,2.152,AC,87500,0,87500,202500,100,290100,78200,0,78200,171400,100,249700,A2,AG/LTD,,,
2334,64-12-B-1-0,7724-61-3173,SNGL FAM SUB,0,AC,57800,0,57800,0,0,57800,50300,0,50300,0,0,50300,R1,RES/LTD,,,
2335,48-1-0-32-A,7726-68-8438,MultiFamily,1.3,AC,150400,0,150400,0,0,150400,136800,0,136800,0,0,136800,R3,RES/GEN,,,
2336,32-1-0-50-A,6778-92-7921,SNGL FAM SUB,10.42,AC,165800,0,165800,328600,30600,525000,147600,0,147600,275800,29400,452800,A2,AG/LTD,,,
2337,45-5-0-4-0,6797-77-2554,COMM & IND,6.62,AC,485600,0,485600,775900,85000,1346500,462400,0,462400,734300,87900,1284600,M1,INDUS/L,,,
2338,11-1-0-23-B,6821-16-5800,SNGL FAM SUB,2,AC,46000,0,46000,190100,500,236600,44500,0,44500,155000,500,200000,A1,AG/GEN,,,
2339,47-1-0-87-0,7726-37-0416,SNGL FAM URB,0.505,AC,222500,0,222500,18800,0,241300,202200,0,202200,14900,0,217100,R3,RES/GEN,,,
2340,19-1-0-14-B,6830-24-9243,SNGL FAM SUB,5.01,AC,86500,0,86500,194900,9600,291000,79200,0,79200,161100,8700,249000,A1,AG/GEN,,,
2341,5-13-0-28-0,6813-62-1596,SNGL FAM SUB,8.165,AC,65800,0,65800,0,0,65800,64400,0,64400,0,0,64400,A1,AG/GEN,,,
2342,15-5-0-12-0,5789-58-6157,SNGL FAM SUB,8.3,AC,65100,0,65100,0,0,65100,63600,0,63600,0,0,63600,A1,AG/GEN,,,
2343,15-5-0-17-0,5789-59-0530,SNGL FAM SUB,8.34,AC,65200,0,65200,321000,10000,396200,63700,0,63700,278000,10000,351700,A1,AG/GEN,,,
2344,55-15-0-1-0,6785-67-0067,SNGL FAM SUB,3.1,AC,115900,0,115900,256000,1100,373000,103400,0,103400,213200,900,317500,A2,AG/LTD,,,
2345,31-1-0-59-0,6779-06-7700,AG 20-100 AC,39.157,AC,476200,457700,18500,0,2000,478200,474300,398600,75700,236200,5800,716300,A2,AG/LTD,,,
2346,31-1-0-61-0,6779-16-6101,SNGL FAM SUB,18.096,AC,259000,186400,72600,791400,89500,1139900,231600,223800,7800,0,62200,293800,A2,AG/LTD,,,
2347,56-1-0-76-C,6796-90-6732,SNGL FAM SUB,15.293,AC,502000,118300,383700,502300,55700,1060000,436100,102500,333600,437100,47800,921000,A2,AG/LTD,,,
2348,56-1-0-76-B,6796-91-6334,SNGL FAM SUB,19.5,AC,597900,588900,9000,0,0,597900,519400,511100,8300,0,0,519400,A2,AG/LTD,,,
2349,42-16-B-8-0,6757-94-6368,SNGL FAM SUB,1.132,AC,81500,0,81500,197500,2100,281100,74000,0,74000,182900,2200,259100,R1,RES/LTD,,,
2350,64-19-E-5-0,7733-48-2198,SNGL FAM SUB,1.05,AC,251800,0,251800,794800,58900,1105500,209000,0,209000,623300,56100,888400,R1,RES/LTD,,,
2351,47-1-0-6-0,7718-31-7886,SNGL FAM SUB,0.7,AC,11900,0,11900,0,0,11900,10600,0,10600,0,0,10600,A2,AG/LTD,,,
2352,5-6-0-E-0,6813-66-9108,SNGL FAM SUB,4.23,AC,47700,0,47700,0,0,47700,46900,0,46900,0,0,46900,A1,AG/GEN,,,
2353,5-1-0-13-0,6813-65-7585,SNGL FAM SUB,10,AC,59900,0,59900,0,0,59900,58800,0,58800,0,0,58800,A1,AG/GEN,,,
2354,57-11-0-8-0,7715-16-7410,SNGL FAM SUB,11.412,AC,429100,0,429100,417900,8800,855800,373200,0,373200,349700,8000,730900,A2,AG/LTD,,,
2355,57-11-0-9-0,7715-15-7916,SNGL FAM SUB,6.025,AC,291200,0,291200,0,0,291200,253200,0,253200,0,0,253200,A2,AG/LTD,,,
2356,64-12-A-7-0,7724-50-6468,SNGL FAM SUB,0,AC,77000,0,77000,179900,15100,272000,67000,0,67000,153700,13300,234000,R1,RES/LTD,,,
2357,17-1-0-50-0,6810-18-2856,SNGL FAM SUB,2.02,AC,44500,0,44500,0,0,44500,43100,0,43100,0,0,43100,A1,AG/GEN,,,
2358,30-11-0-4-0,6758-22-2535,SNGL FAM SUB,4.5,AC,87300,0,87300,325600,2000,414900,86300,0,86300,267900,2000,356200,A2,AG/LTD,,,
2359,46-1-0-65-0,7717-00-8012,AG 20-100 AC,38.92,AC,1097500,1077800,19700,0,0,1097500,980800,964000,16800,0,0,980800,A2,AG/LTD,,,
2360,32-1-0-25-B,6778-89-4370,SNGL FAM SUB,0.63,AC,4500,0,4500,0,0,4500,4100,0,4100,0,0,4100,A2,AG/LTD,,,
2361,32-10-1-13-0,6778-68-3763,SNGL FAM SUB,1.73,AC,77800,0,77800,246700,5500,330000,69500,0,69500,207100,5500,282100,A2,AG/LTD,,,
2362,32-10-1-18-0,6778-69-3277,SNGL FAM SUB,3.64,AC,105300,0,105300,177800,16400,299500,94200,0,94200,145200,13400,252800,A2,AG/LTD,,,
2363,32-10-1-20-0,6778-79-2999,SNGL FAM SUB,14.09,AC,212500,0,212500,0,0,212500,189100,0,189100,0,0,189100,A2,AG/LTD,,,
2364,32-10-1-21-0,6778-79-8635,SNGL FAM SUB,9.35,AC,157500,0,157500,282100,59600,499200,140300,0,140300,226100,45000,411400,A2,AG/LTD,,,
2365,32-10-2-12-0,6779-60-9876,SNGL FAM SUB,9.76,AC,161900,0,161900,412300,0,574200,144200,0,144200,360700,0,504900,A2,AG/LTD,,,
2366,62-21-0-7-0,7704-97-8779,SNGL FAM SUB,8.01,AC,378700,0,378700,517800,0,896500,329200,0,329200,477700,0,806900,A2,AG/LTD,,,
2367,57-2-0-11-0,7716-16-3953,SNGL FAM SUB,1.21,AC,103800,0,103800,139800,1500,245100,92700,0,92700,118400,1500,212600,A2,AG/LTD,,,
2368,46-1-0-58-0,7716-27-0603,SNGL FAM SUB,3.3,AC,150100,0,150100,94700,0,244800,133900,0,133900,79000,0,212900,A2,AG/LTD,,,
2369,9-1-0-29-0,5892-33-5990,SNGL FAM SUB,8,AC,60800,0,60800,0,0,60800,59400,0,59400,0,0,59400,A1,AG/GEN,,,
2371,46-1-0-105-0,7717-16-5706,SNGL FAM SUB,18.4,AC,460000,0,460000,0,0,460000,410800,0,410800,0,0,410800,A2,AG/LTD,,,
2372,57-2-0-10-0,7716-16-1871,SNGL FAM SUB,0.94,AC,93100,0,93100,190300,20900,304300,83100,0,83100,159000,17600,259700,A2,AG/LTD,,,
2373,63-5-0-5-0,7724-14-4646,SNGL FAM SUB,2.22,AC,212500,0,212500,0,0,212500,190600,0,190600,0,0,190600,A2,AG/LTD,,,
2374,63-1-0-173-0,7724-14-7308,SNGL FAM SUB,2.016,AC,160200,0,160200,208500,24600,393300,139200,0,139200,181600,21600,342400,A2,AG/LTD,,,
2375,33-1-0-7-0,6798-46-9327,SNGL FAM SUB,1.85,AC,82300,0,82300,0,0,82300,73600,0,73600,0,0,73600,A2,AG/LTD,,,
2376,67-2-C-21-0,7723-55-4768,SNGL FAM SUB,0,AC,184000,0,184000,284400,1800,470200,160000,0,160000,236400,1800,398200,R1,RES/LTD,,,
2377,43-15-0-11-0,6768-81-6379,SNGL FAM SUB,3.39,AC,92000,0,92000,212700,30700,335400,83600,0,83600,187600,26000,297200,A2,AG/LTD,,,
2378,58-1-0-1-A,7716-26-4909,SNGL FAM SUB,2.58,AC,135000,0,135000,161400,0,296400,120600,0,120600,134100,0,254700,A2,AG/LTD,,,
2379,33-4-0-12-0,6798-62-3641,SNGL FAM SUB,2.15,AC,92600,0,92600,193800,10300,296700,82600,0,82600,161200,8400,252200,A2,AG/LTD,,,
2380,38-1-0-22-0,6707-88-0515,SNGL FAM SUB,1.63,AC,42300,0,42300,12200,700,55200,41500,0,41500,11900,700,54100,A1,AG/GEN,,,
2381,26-1-0-14-0,6719-03-3940,SNGL FAM SUB,1.806,AC,44800,0,44800,105100,500,150400,42800,0,42800,86300,500,129600,A1,AG/GEN,,,
2382,15-1-0-13-0,5880-74-8629,SNGL FAM SUB,15,AC,77100,0,77100,0,0,77100,75800,0,75800,0,0,75800,A1,AG/GEN,,,
2384,46-6-0-2-0,7716-18-3786,SNGL FAM SUB,10.5,AC,285200,0,285200,0,0,285200,254700,0,254700,0,0,254700,A2,AG/LTD,,,
2385,40-1-0-11-0,6727-82-1082,AG > 100 AC,181.286,AC,554700,471100,83600,0,0,554700,543900,466900,77000,0,0,543900,A1,AG/GEN,,,
2386,40-1-0-16-0,6726-99-0529,SNGL FAM SUB,13.76,AC,115400,103900,11500,0,6000,121400,113200,102300,10900,0,5000,118200,A1,AG/GEN,,,
2387,40-1-0-19-0,6726-88-9662,AG 20-100 AC,22.772,AC,165800,155300,10500,0,0,165800,162700,153000,9700,0,0,162700,A1,AG/GEN,,,
2388,57-1-0-32-A,7706-12-4508,SNGL FAM SUB,11.27,AC,378500,0,378500,551600,64400,994500,329500,0,329500,465700,58600,853800,A2,AG/LTD,,,
2389,58-22-A-4-0,7715-36-0894,SNGL FAM SUB,3.14,AC,383300,0,383300,759500,4200,1147000,351800,0,351800,695000,4000,1050800,A2,AG/LTD,,,
2390,8-1-0-2-0,5881-83-7131,AG 20-100 AC,36.98,AC,58400,39500,18900,0,0,58400,55500,39800,15700,0,0,55500,A1,AG/GEN,,,
2391,15-1-0-2-0,5881-80-2538,AG 20-100 AC,70.49,AC,144600,0,144600,0,0,144600,141000,0,141000,0,0,141000,A1,AG/GEN,,,
2392,15-1-0-5-0,5880-68-9129,AG 20-100 AC,41.407,AC,85000,0,85000,0,0,85000,82800,0,82800,0,0,82800,A1,AG/GEN,,,
2393,32-11-0-4-0,6778-88-6371,SNGL FAM SUB,5.25,AC,125300,0,125300,0,0,125300,112000,0,112000,0,0,112000,A2,AG/LTD,,,
2394,32-2-0-6-0,6778-89-6022,SNGL FAM SUB,3.8,AC,104400,0,104400,0,0,104400,93300,0,93300,0,0,93300,A2,AG/LTD,,,
2395,29-13-0-5-0,6748-42-4066,SNGL FAM SUB,1.51,AC,59100,0,59100,184100,6600,249800,54700,0,54700,142600,6400,203700,A1,AG/GEN,,,
2398,15-1-0-4-0,5880-79-9038,AG 20-100 AC,87.51,AC,179600,0,179600,0,0,179600,175000,0,175000,0,0,175000,A1,AG/GEN,,,
2399,15-1-0-37-0,5789-37-8606,AG > 100 AC,117.886,AC,255500,200700,54800,0,0,255500,250500,200300,50200,0,0,250500,A1,AG/GEN,,,
2405,24-1-0-1-0,5789-35-7984,AG 20-100 AC,36.546,AC,54800,36200,18600,0,0,54800,54800,39100,15700,0,0,54800,A1,AG/GEN,,,
2406,64-3-3-6-0,7724-83-5060,COMM & IND,1.077,AC,233900,0,233900,242500,17600,494000,216600,0,216600,233400,15700,465700,RO,RES/OF,,,
2408,63-1-0-157-0,7724-37-2124,SNGL FAM SUB,7.079,AC,203600,0,203600,150300,5500,359400,176900,0,176900,127400,5500,309800,A2,AG/LTD,,,
2409,63-1-0-158-0,7724-26-5693,SNGL FAM SUB,15.99,AC,372900,0,372900,0,0,372900,323900,0,323900,0,0,323900,A2,AG/LTD,,,
2410,63-1-0-159-0,7724-37-6423,SNGL FAM SUB,3.222,AC,130300,0,130300,0,0,130300,113300,0,113300,0,0,113300,A2,AG/LTD,,,
2411,27-1-0-20-0,6718-55-5480,AG 20-100 AC,43.03,AC,197900,107600,90300,0,0,197900,193600,105900,87700,0,0,193600,A1,AG/GEN,,,
2413,57-10-0-6-0,7705-76-1198,SNGL FAM SUB,7.39,AC,265000,0,265000,380200,28800,674000,240000,0,240000,360600,24500,625100,A2,AG/LTD,,,
2414,57-10-0-7-0,7705-66-9227,SNGL FAM SUB,4.086,AC,230000,0,230000,0,0,230000,210000,0,210000,0,0,210000,A2,AG/LTD,,,
2415,31-1-0-39-0,6769-81-2037,SNGL FAM SUB,7.72,AC,128700,125100,3600,0,0,128700,118300,115000,3300,0,0,118300,A2,AG/LTD,,,
2416,31-1-0-41-0,6769-91-1167,AG 20-100 AC,68.422,AC,832700,736500,96200,57800,3500,894000,744900,658900,86000,47200,3800,795900,A2,AG/LTD,,,
2417,67-11-C-3-0,7733-26-3997,SNGL FAM SUB,0,AC,265000,0,265000,958200,3300,1226500,220000,0,220000,765500,3500,989000,R1,RES/LTD,,,
2418,51-6-0-A-5,6735-43-6056,AG 20-100 AC,72.4,AC,74900,0,74900,368800,58200,501900,70400,0,70400,315500,54500,440400,A1,AG/GEN,,,
2419,59-1-0-1-0,7726-57-4138,MultiFamily,1.834,AC,1411800,0,1411800,15200,0,1427000,1283500,0,1283500,12000,0,1295500,R3,RES/GEN,,,
2420,58-3-B-4-0,7726-17-1021,SNGL FAM SUB,0,AC,88000,0,88000,251900,1500,341400,80000,0,80000,208500,1500,290000,RN,RESIDEN,,,
2421,58-8-0-3-C,7716-90-2857,SNGL FAM SUB,5.626,AC,213900,0,213900,146600,4200,364700,185900,0,185900,119000,4200,309100,A2,AG/LTD,,,
2423,64-16-0-A-0,7734-03-5267,SNGL FAM SUB,3.245,AC,193000,0,193000,334700,26000,553700,167900,0,167900,282000,21900,471800,A2,AG/LTD,,,
2424,63-9-0-1-A,7724-00-9600,SNGL FAM SUB,13.453,AC,515000,0,515000,0,0,515000,447700,0,447700,0,0,447700,R1A2,RES LTD,,,
2425,26-2-0-2-B,6709-90-4491,SNGL FAM SUB,12,AC,100400,0,100400,379000,49200,528600,98500,0,98500,331000,43800,473300,A2,AG/LTD,,,
2426,31-1-0-62-0,6779-56-6544,SNGL FAM SUB,0.2,AC,2000,0,2000,0,0,2000,1800,0,1800,0,0,1800,A2,AG/LTD,,,
2427,22-1-0-9-0,6769-78-7082,SNGL FAM SUB,3,AC,85300,23300,62000,104200,3300,192800,79100,23100,56000,86300,3300,168700,A2,AG/LTD,,,
2428,22-1-0-9-A,6769-78-5494,AG 20-100 AC,48.11,AC,514500,431300,83200,206000,17800,738300,475800,400600,75200,174700,14500,665000,A2,AG/LTD,,,
2429,28-9-0-4-0,6729-84-7195,SNGL FAM SUB,2.568,AC,58300,0,58300,144300,200,202800,56100,0,56100,118900,200,175200,A1,AG/GEN,,,
2430,54-4-0-9-0,6776-54-5248,SNGL FAM SUB,8.69,AC,147800,0,147800,251500,15300,414600,131800,0,131800,201400,14200,347400,A2,AG/LTD,,,
2431,46-1-0-77-A,7707-47-8679,SNGL FAM SUB,5,AC,162800,0,162800,174600,44100,381500,148000,0,148000,149500,40300,337800,A2,AG/LTD,,,
2432,13-3-0-3-0,6842-82-7888,SNGL FAM SUB,6.72,AC,70700,0,70700,170300,300,241300,69500,0,69500,148700,300,218500,A1,AG/GEN,,,
2433,57-20-D-3-0,7715-19-6480,SNGL FAM SUB,1.766,AC,315000,0,315000,223500,38500,577000,288800,0,288800,196000,33200,518000,A2,AG/LTD,,,
2434,29-10-0-E-0,6749-85-9986,SNGL FAM SUB,1.15,AC,55500,0,55500,131200,800,187500,51400,0,51400,108800,800,161000,A1,AG/GEN,,,
2435,29-10-0-I-0,6749-94-6839,SNGL FAM SUB,9,AC,125200,0,125200,0,0,125200,125100,0,125100,0,0,125100,A1,AG/GEN,,,
2436,31-1-0-47-0,6779-05-1126,SNGL FAM SUB,8.502,AC,154100,149800,4300,0,0,154100,137500,133800,3700,0,0,137500,A2,AG/LTD,,,
2437,5-13-0-23-0,6813-63-8723,SNGL FAM SUB,8.11,AC,65600,0,65600,269700,0,335300,64200,0,64200,228100,0,292300,A1,AG/GEN,,,
2438,50-5-0-17-A,6726-30-3153,SNGL FAM SUB,2.34,AC,43100,0,43100,0,36400,79500,40200,0,40200,0,33700,73900,A1,AG/GEN,,,
2439,50-5-0-17-B,6725-39-2094,SNGL FAM SUB,6.58,AC,39900,0,39900,0,0,39900,39200,0,39200,0,0,39200,A1,AG/GEN,,,
2440,4-4-0-1-0,6804-50-9617,AG 20-100 AC,20.58,AC,123900,0,123900,0,0,123900,121600,0,121600,0,0,121600,A1,AG/GEN,,,
2441,31-1-0-21-B,6768-56-3052,SNGL FAM SUB,8.7,AC,137700,0,137700,155100,22300,315100,127500,0,127500,117000,10500,255000,A2,AG/LTD,,,
2442,33-1-0-4-0,6798-12-4047,COMM & IND,52.16,AC,2027200,2003200,24000,0,0,2027200,1898800,1876600,22200,0,0,1898800,B1A2,BS AND,,,
2443,33-1-0-11-0,6798-13-9790,AG 20-100 AC,64.18,AC,2735800,2704400,31400,0,0,2735800,2574300,2546800,27500,0,0,2574300,B1A2,BS AND,,,
2445,31-1-0-11-A,6769-63-1589,SNGL FAM SUB,3.818,AC,95000,0,95000,112000,600,207600,85800,0,85800,92000,600,178400,A2,AG/LTD,,,
2446,46-21-A-9-0,7718-00-2677,SNGL FAM SUB,2.63,AC,132200,0,132200,196700,23600,352500,120100,0,120100,165800,21300,307200,A2,AG/LTD,,,
2447,32-10-1-25-0,6778-68-9848,SNGL FAM SUB,3.23,AC,99400,0,99400,214500,33900,347800,88900,0,88900,175500,28500,292900,A2,AG/LTD,,,
2448,5-1-0-56-A,6823-64-2010,SNGL FAM SUB,15,AC,120300,0,120300,163700,0,284000,117400,0,117400,141400,0,258800,A1,AG/GEN,,,
2449,64-12-H-1-0,7723-59-9521,SNGL FAM SUB,0,AC,77000,0,77000,141300,7000,225300,67000,0,67000,119900,7000,193900,R1,RES/LTD,,,
2450,55-16-0-7-0,6776-64-5505,SNGL FAM SUB,4.1,AC,130900,0,130900,262600,31000,424500,117000,0,117000,217900,25900,360800,A2,AG/LTD,,,
2451,31-16-0-1-0,6778-06-3108,SNGL FAM SUB,2.15,AC,81500,0,81500,193900,7900,283300,72700,0,72700,158400,7900,239000,A2,AG/LTD,,,
2455,41-2-0-25-0,6748-41-5154,SNGL FAM SUB,9.86,AC,132100,73700,58400,214800,11400,358300,127900,74200,53700,184400,11400,323700,A1,AG/GEN,,,
2456,41-2-0-26-0,6748-31-9421,SNGL FAM SUB,3.01,AC,73700,0,73700,193100,700,267500,67600,0,67600,165700,700,234000,A1,AG/GEN,,,
2458,30-1-0-42-A,6758-36-4687,SNGL FAM SUB,4.8,AC,89900,0,89900,162000,42800,294700,85600,0,85600,133800,34700,254100,A2,AG/LTD,,,
2459,46-16-0-D-0,7707-81-1008,SNGL FAM SUB,5.39,AC,196500,0,196500,227900,0,424400,175300,0,175300,199500,0,374800,A2,AG/LTD,,,
2463,32-10-2-15-0,6779-60-3193,SNGL FAM SUB,3.16,AC,98400,0,98400,210600,27600,336600,88000,0,88000,172300,24500,284800,A2,AG/LTD,,,
2464,31-1-0-73-0,6779-12-1646,AG 20-100 AC,47.11,AC,571700,310900,260800,553500,118100,1243300,508500,276200,232300,445200,106500,1060200,A2,AG/LTD,,,
2465,33-4-0-6-0,6798-53-9587,SNGL FAM SUB,2.13,AC,92300,0,92300,244900,23700,360900,82400,0,82400,210200,22800,315400,A2,AG/LTD,,,
2466,64-12-D-1-0,7724-50-4054,SNGL FAM SUB,0,AC,77000,0,77000,183100,16000,276100,67000,0,67000,157200,14300,238500,R1,RES/LTD,,,
2467,67-1-0-14-B,7733-36-8367,SNGL FAM SUB,0.915,AC,265000,0,265000,784800,69200,1119000,220000,0,220000,635200,63600,918800,R1,RES/LTD,,,
2468,50-5-0-32-0,6726-33-1684,SNGL FAM SUB,4.15,AC,53300,0,53300,289400,0,342700,51100,0,51100,202800,0,253900,A1,AG/GEN,,,
2469,47-1-0-34-0,7716-79-4463,COMM & IND,10.141,AC,3501200,0,3501200,0,0,3501200,3322100,0,3322100,0,0,3322100,B1,BUS/GEN,,,
2470,47-25-0-11-0,7727-00-3711,SNGL FAM SUB,1.29,AC,128900,0,128900,325100,0,454000,115100,0,115100,274700,0,389800,A2,AG/LTD,,,
2471,2-3-0-31-0,6824-32-5055,SNGL FAM SUB,5.3,AC,57300,0,57300,268900,0,326200,56100,0,56100,234700,0,290800,A1,AG/GEN,,,
2624,61-1-0-4-0,6784-97-5768,SNGL FAM SUB,1.5,AC,5100,0,5100,0,0,5100,4500,0,4500,0,0,4500,A2,AG/LTD,,,
2625,62-1-0-6-0,7704-21-9640,SNGL FAM SUB,1.25,AC,5100,0,5100,0,0,5100,4500,0,4500,0,0,4500,A2,AG/LTD,,,
2626,5-13-0-11-0,6813-55-9089,SNGL FAM SUB,8.138,AC,62100,0,62100,0,0,62100,60700,0,60700,0,0,60700,A1,AG/GEN,,,
2627,57-1-0-79-0,7706-52-0557,AG 20-100 AC,21.807,AC,696200,0,696200,768300,124700,1589200,606100,0,606100,647900,103800,1357800,A2,AG/LTD,,,
2628,46-14-0-5-0,7708-91-0349,SNGL FAM SUB,4.15,AC,148800,0,148800,147500,800,297100,135300,0,135300,123600,800,259700,A2,AG/LTD,,,
2784,17-1-0-89-0,6719-27-9382,SNGL FAM SUB,17.615,AC,125200,0,125200,83900,7800,216900,129400,0,129400,68800,7800,206000,A1,AG/GEN,,,
2785,51-7-0-B-0,6736-20-0197,SNGL FAM SUB,6.97,AC,75200,0,75200,90700,1600,167500,73800,0,73800,77500,1600,152900,A1,AG/GEN,,,
2786,51-2-0-5-A,6736-40-3822,SNGL FAM SUB,1.136,AC,35700,0,35700,194400,0,230100,35000,0,35000,170300,0,205300,A1,AG/GEN,,,
2787,29-1-0-123-0,6758-18-1168,SNGL FAM SUB,2.5,AC,25400,24200,1200,0,0,25400,24200,23100,1100,0,0,24200,A1,AG/GEN,,,
2788,51-11-0-B-0,6736-40-2482,SNGL FAM SUB,1.03,AC,35100,0,35100,93600,1000,129700,34400,0,34400,80000,1000,115400,A1,AG/GEN,,,
2789,57-1-0-56-0,7716-11-1269,SNGL FAM SUB,0.441,AC,3500,0,3500,0,0,3500,3200,0,3200,0,0,3200,A2,AG/LTD,,,
2790,57-1-0-56-A,7716-02-9328,AG 20-100 AC,28.233,AC,921500,0,921500,2297700,139100,3358300,841500,0,841500,2197200,131700,3170400,A2,AG/LTD,,,
2791,57-25-B-13-A,7716-13-1746,SNGL FAM SUB,2,AC,365000,0,365000,0,0,365000,335000,0,335000,0,0,335000,A2,AG/LTD,,,
2792,47-25-0-4-0,7717-90-8319,SNGL FAM SUB,1.12,AC,129800,0,129800,346300,1300,477400,115900,0,115900,290100,1400,407400,A2,AG/LTD,,,
2793,50-5-0-13-0,6726-41-0213,SNGL FAM SUB,8.78,AC,72700,0,72700,495300,17600,585600,69200,0,69200,457500,16600,543300,A1,AG/GEN,,,
2794,4-2-0-10-0,6814-31-3230,SNGL FAM SUB,3.43,AC,52600,0,52600,155900,1000,209500,51500,0,51500,131300,1000,183800,A1,AG/GEN,,,
2799,63-7-0-C-2,7723-18-1289,SNGL FAM SUB,5.853,AC,303300,0,303300,822500,46500,1172300,263700,0,263700,689100,44100,996900,R1A2,RES LTD,,,
2800,61-2-0-A-0,6795-32-3435,AG > 100 AC,178.92,AC,684600,0,684600,855600,184200,1724400,593600,0,593600,729900,162300,1485800,A2,AG/LTD,,,
2801,56-1-0-40-0,6795-34-0953,AG > 100 AC,122.53,AC,61500,0,61500,0,100,61600,52600,0,52600,0,100,52700,A2,AG/LTD,,,
2802,61-2-0-B-0,6794-29-7311,AG > 100 AC,154.557,AC,71300,0,71300,0,0,71300,65700,0,65700,0,0,65700,A2,AG/LTD,,,
2964,33-4-0-29-0,6798-53-7321,SNGL FAM SUB,5.23,AC,135100,0,135100,179900,2000,317000,120500,0,120500,147300,2000,269800,A2,AG/LTD,,,
2965,38-1-0-79-0,6707-74-0807,COMM & IND,4.51,AC,64900,0,64900,148200,0,213100,63100,0,63100,146900,0,210000,A1,AG/GEN,,,
2966,38-1-0-80-0,6707-75-2208,SNGL FAM SUB,1,AC,38800,0,38800,0,0,38800,38000,0,38000,0,0,38000,A1,AG/GEN,,,
2967,15-5-0-15-0,5789-58-2986,SNGL FAM SUB,8.35,AC,65300,0,65300,0,0,65300,67400,0,67400,0,0,67400,A1,AG/GEN,,,
2968,19-1-0-63-0,6830-62-3195,AG 20-100 AC,97.28,AC,582400,481600,100800,109600,3400,695400,547700,456700,91000,91000,3400,642100,A1,AG/GEN,,,
2472,4-3-0-5-0,6813-14-1534,SNGL FAM SUB,1.28,AC,44300,0,44300,188600,2200,235100,43400,0,43400,150400,2500,196300,A1,AG/GEN,,,
2473,4-3-0-6-0,6813-14-0609,SNGL FAM SUB,1.57,AC,46000,0,46000,167600,2500,216100,45000,0,45000,141600,2500,189100,A1,AG/GEN,,,
2474,5-7-0-30-0,6824-31-2533,SNGL FAM SUB,6.6,AC,63300,0,63300,218000,0,281300,61900,0,61900,185200,0,247100,A1,AG/GEN,,,
2475,5-1-0-69-0,6824-42-1180,AG 20-100 AC,35.082,AC,107600,91400,16200,0,0,107600,105400,90500,14900,0,0,105400,A1,AG/GEN,,,
2476,43-5-0-A-0,6776-29-4283,SNGL FAM SUB,3.84,AC,111000,0,111000,358300,27200,496500,99200,0,99200,299000,26800,425000,A2,AG/LTD,,,
2477,2-3-0-32-0,6824-32-4393,SNGL FAM SUB,3.7,AC,49900,0,49900,0,0,49900,48900,0,48900,0,0,48900,A1,AG/GEN,,,
2478,6-1-0-39-C,6822-89-6662,SNGL FAM SUB,4.45,AC,68500,0,68500,224200,22900,315600,66600,0,66600,193900,18800,279300,A1,AG/GEN,,,
2479,6-10-0-1-A,6822-99-2415,SNGL FAM SUB,7.68,AC,90100,0,90100,0,0,90100,87600,0,87600,0,0,87600,A1,AG/GEN,,,
2480,64-12-G-4-0,7723-59-5119,SNGL FAM SUB,0,AC,77000,0,77000,167400,1500,245900,67000,0,67000,145400,1600,214000,R1,RES/LTD,,,
2481,54-1-0-1-0,6766-66-4806,AG > 100 AC,223.874,AC,2360200,2252700,107500,0,3500,2363700,2110700,2015100,95600,0,3500,2114200,A2,AG/LTD,,,
2482,45-1-0-53-0,6797-04-8388,AG 20-100 AC,96.6,AC,1307500,1262800,44700,0,0,1307500,1171300,1130200,41100,0,0,1171300,A2,AG/LTD,,,
2483,45-1-0-60-0,6797-36-5857,AG > 100 AC,113.259,AC,1644400,1590000,54400,0,0,1644400,1468500,1420100,48400,0,0,1468500,A2,AG/LTD,,,
2484,45-6-0-8-A,6797-34-1856,SNGL FAM SUB,1.36,AC,10300,9700,600,0,0,10300,9200,8600,600,0,0,9200,A2,AG/LTD,,,
2485,58-1-0-2-0,7716-26-5002,SNGL FAM SUB,11.42,AC,260800,0,260800,172500,3000,436300,233000,0,233000,146700,3000,382700,A2,AG/LTD,,,
2486,58-1-0-3-0,7716-37-1104,SNGL FAM SUB,3.557,AC,144000,0,144000,67700,0,211700,128500,0,128500,58000,0,186500,A2,AG/LTD,,,
2487,58-1-0-12-0,7716-36-5407,SNGL FAM SUB,3.3,AC,128200,0,128200,0,0,128200,119000,0,119000,0,0,119000,A2,AG/LTD,,,
2488,6-5-0-B-0,6822-89-4246,SNGL FAM SUB,4.61,AC,69800,0,69800,253600,46500,369900,67900,0,67900,231200,39700,338800,A1,AG/GEN,,,
2489,6-1-0-26-0,6823-91-0162,AG 20-100 AC,25.2,AC,196200,184600,11600,0,0,196200,192400,181700,10700,0,0,192400,A1,AG/GEN,,,
2490,6-1-0-32-A,6823-80-6281,COMM & IND,2.05,AC,96900,0,96900,169700,0,266600,94100,0,94100,167300,0,261400,B1,BUS/GEN,,,
2491,6-5-0-A-0,6822-88-3981,SNGL FAM SUB,6.31,AC,78400,0,78400,412600,4500,495500,76300,0,76300,362700,4500,443500,A1,AG/GEN,,,
2492,6-10-0-2-0,6822-98-2659,SNGL FAM SUB,10.49,AC,91400,0,91400,0,0,91400,89100,0,89100,0,0,89100,A1,AG/GEN,,,
2493,5-1-0-44-0,6823-18-5128,SNGL FAM SUB,3.125,AC,55600,0,55600,0,0,55600,54600,0,54600,0,0,54600,A1,AG/GEN,,,
2494,6-1-0-29-0,6823-80-3571,SNGL FAM SUB,8,AC,80600,36700,43900,267700,15000,363300,78500,36500,42000,236900,15000,330400,A1,AG/GEN,,,
2495,6-1-0-32-T,6822-89-3977-9999,General Gov,7.37,AC,83400,0,83400,2791200,250200,3124800,81300,0,81300,2761500,219700,3062500,A1,AG/GEN,,,
2496,6-1-0-39-A,6822-89-9921,SNGL FAM SUB,2.09,AC,49200,0,49200,160000,0,209200,47700,0,47700,139700,0,187400,A1,AG/GEN,,,
2497,6-5-0-C-0,6822-99-0704,SNGL FAM SUB,0.2,AC,1600,0,1600,0,1200,2800,1500,0,1500,0,1200,2700,A1,AG/GEN,,,
2498,43-1-0-88-0,6776-27-8791,AG > 100 AC,170.58,AC,1562600,1411300,151300,127800,6300,1696700,1393300,1258300,135000,106100,6300,1505700,A2,AG/LTD,,,
2499,43-1-0-88-E,6776-09-2549,SNGL FAM SUB,12,AC,188900,183400,5500,0,0,188900,168200,163100,5100,0,0,168200,A2,AG/LTD,,,
2500,57-1-0-77-0,7706-73-8015,SNGL FAM SUB,11.47,AC,503800,0,503800,383500,37500,924800,437900,0,437900,322100,37500,797500,A2,AG/LTD,,,
2501,4-1-0-40-A,6803-88-9205,SNGL FAM SUB,6.04,AC,65400,0,65400,245300,46900,357600,64200,0,64200,216800,40300,321300,A1,AG/GEN,,,
2503,46-1-0-22-0,7707-05-6037,SNGL FAM SUB,1.526,AC,111000,0,111000,69500,900,181400,99100,0,99100,59300,900,159300,A2,AG/LTD,,,
2504,38-1-0-49-B,6706-38-9032,AG 20-100 AC,75.47,AC,188700,150200,38500,0,0,188700,188700,156200,32500,0,0,188700,A1,AG/GEN,,,
2505,41-1-0-15-0,6747-59-9661,SNGL FAM SUB,2.632,AC,65000,0,65000,183700,6800,255500,65200,0,65200,173800,6700,245700,A1,AG/GEN,,,
2506,41-1-0-16-0,6747-69-1554,SNGL FAM SUB,2.51,AC,63800,0,63800,195500,70300,329600,64100,0,64100,185900,62000,312000,A1,AG/GEN,,,
2507,42-11-0-2-A,6757-48-1681,SNGL FAM SUB,0.46,AC,47200,0,47200,123500,100,170800,43600,0,43600,101600,100,145300,A2,AG/LTD,,,
2510,26-1-0-44-0,6719-30-3774,SNGL FAM SUB,4.985,AC,63100,0,63100,152600,8200,223900,61900,0,61900,129200,7700,198800,A1,AG/GEN,,,
2511,12-1-0-2-A,6822-86-4404,SNGL FAM SUB,6.03,AC,77200,74300,2900,0,0,77200,75100,72500,2600,0,0,75100,A1,AG/GEN,,,
2512,42-5-0-2-0,6767-04-5813,MultiFamily,0.00001,AC,74300,0,74300,291600,6500,372400,71400,0,71400,267300,9000,347700,RO,RES/OF,,,
2513,42-5-0-3-0,6767-04-5725,SNGL FAM SUB,0.41,AC,55700,0,55700,0,0,55700,53600,0,53600,0,0,53600,RO,RES/OF,,,
2515,42-5-0-4-0,6767-04-5637,SNGL FAM SUB,0.00001,AC,70600,0,70600,0,0,70600,67800,0,67800,0,0,67800,RO,RES/OF,,,
2516,42-5-0-5-0,6767-04-5547,SNGL FAM SUB,0.00001,AC,70600,0,70600,0,0,70600,67800,0,67800,0,0,67800,RO,RES/OF,,,
2517,42-5-0-14-0,6767-04-2861,SNGL FAM SUB,0.56,AC,37200,0,37200,0,0,37200,35700,0,35700,0,0,35700,RO,RES/OF,,,
2518,44-7-0-B-0,6777-92-2067,SNGL FAM SUB,1.012,AC,70300,0,70300,103700,1000,175000,62800,0,62800,86100,1000,149900,A2,AG/LTD,,,
2519,42-1-0-82-0,6767-07-5977,SNGL FAM SUB,11.02,AC,243400,0,243400,238600,13500,495500,223400,0,223400,202500,13500,439400,A2,AG/LTD,,,
2520,63-12-0-4-B,7714-43-6025,SNGL FAM SUB,12.499,AC,488000,0,488000,838900,83500,1410400,424300,0,424300,723400,74300,1222000,A2,AG/LTD,,,
2521,42-1-0-2-0,6757-48-8964,SNGL FAM SUB,3.4,AC,85700,0,85700,0,0,85700,78700,0,78700,0,0,78700,A2,AG/LTD,,,
2522,42-1-0-2-A,6757-48-7906,SNGL FAM SUB,3.4,AC,85700,0,85700,0,0,85700,78700,0,78700,0,0,78700,A2,AG/LTD,,,
2523,42-1-0-82-A,6767-07-5679,SNGL FAM SUB,0.23,AC,3100,0,3100,0,0,3100,2800,0,2800,0,0,2800,A2,AG/LTD,,,
2524,26-1-0-44-A,6719-20-9810,SNGL FAM SUB,17.98,AC,133900,0,133900,0,0,133900,131400,0,131400,0,0,131400,A1,AG/GEN,,,
2525,6-10-0-4-0,6822-87-9270,AG 20-100 AC,20.94,AC,148500,138800,9700,0,0,148500,145100,136200,8900,0,0,145100,A1,AG/GEN,,,
2526,26-1-0-48-0,6719-30-6639,SNGL FAM SUB,9.48,AC,86300,0,86300,132000,46100,264400,84600,0,84600,115400,44000,244000,A1,AG/GEN,,,
2527,26-10-0-C-0,6719-11-6059,SNGL FAM SUB,1.3,AC,40600,0,40600,0,0,40600,39800,0,39800,0,0,39800,A1,AG/GEN,,,
2528,26-10-0-D-0,6719-10-6907,SNGL FAM SUB,1.22,AC,52700,0,52700,0,13300,66000,51200,0,51200,0,11700,62900,A1,AG/GEN,,,
2529,62-20-A-17-0,7714-15-2637,SNGL FAM SUB,0,AC,115000,0,115000,221300,700,337000,100000,0,100000,202700,700,303400,R1,RES/LTD,,,
2530,33-4-0-26-0,6798-52-4949,SNGL FAM SUB,4.07,AC,119100,0,119100,251400,36400,406900,106300,0,106300,210000,30500,346800,A2,AG/LTD,,,
2531,42-8-1-4-0,6767-18-2348,SNGL FAM SUB,0,AC,60000,0,60000,215100,37800,312900,55000,0,55000,180400,31700,267100,A2,AG/LTD,,,
2532,43-15-0-2-0,6768-90-0812,SNGL FAM SUB,3.69,AC,92000,0,92000,249300,1900,343200,83600,0,83600,216600,2000,302200,A2,AG/LTD,,,
2533,64-2-0-5-B,7733-08-0219,SNGL FAM SUB,1,AC,135500,0,135500,158700,9600,303800,117800,0,117800,134400,7500,259700,A2,AG/LTD,,,
2534,18-4-0-2-B,6729-18-4536,SNGL FAM SUB,7.34,AC,75800,0,75800,155100,7000,237900,72900,0,72900,131800,7000,211700,A1,AG/GEN,,,
2535,18-4-0-2-0,6729-19-4421,AG 20-100 AC,44.4,AC,244900,0,244900,238900,55100,538900,240900,0,240900,184800,50900,476600,A1,AG/GEN,,,
2537,26-1-0-37-B,6718-42-8632,SNGL FAM SUB,10,AC,64000,0,64000,0,0,64000,62800,0,62800,0,0,62800,A1,AG/GEN,,,
2538,42-16-B-2-0,6757-93-5582,SNGL FAM SUB,1.03,AC,81500,0,81500,197600,400,279500,74000,0,74000,184300,400,258700,R1,RES/LTD,,,
2539,67-1-0-9-0,7723-67-6752,AG 20-100 AC,44.792,AC,1545300,1524700,20600,0,0,1545300,1343800,1324800,19000,0,0,1343800,A2R1,AG LTD/,,,
2540,1-1-0-22-0,6804-85-1840,AG 20-100 AC,94.767,AC,459200,326500,132700,134700,8800,602700,450300,324800,125500,117800,9300,577400,A1,AG/GEN,,,
2541,5-1-0-52-0,6823-13-5330,SNGL FAM SUB,15.926,AC,100000,0,100000,0,0,100000,98100,0,98100,0,0,98100,A1,AG/GEN,,,
2542,5-1-0-62-0,6823-37-0481,SNGL FAM SUB,10.528,AC,90700,0,90700,0,0,90700,89000,0,89000,0,0,89000,A1,AG/GEN,,,
2543,5-1-0-63-0,6823-27-6475,SNGL FAM SUB,1.2,AC,40700,0,40700,0,0,40700,40000,0,40000,0,0,40000,A1,AG/GEN,,,
2544,5-11-0-1-0,6823-36-1991,SNGL FAM SUB,0.921,AC,36600,0,36600,0,0,36600,35900,0,35900,0,0,35900,A1,AG/GEN,,,
2545,5-11-0-2-0,6823-27-8087,SNGL FAM SUB,0.99,AC,39300,0,39300,0,0,39300,38600,0,38600,0,0,38600,A1,AG/GEN,,,
2546,5-11-0-3-0,6823-36-1755,SNGL FAM SUB,1.064,AC,40100,0,40100,0,0,40100,39400,0,39400,0,0,39400,A1,AG/GEN,,,
2547,5-11-0-4-0,6823-36-3567,SNGL FAM SUB,1.195,AC,47400,0,47400,0,0,47400,46600,0,46600,0,0,46600,A1,AG/GEN,,,
2548,5-1-0-29-0,6823-11-3998,AG 20-100 AC,37.58,AC,98300,0,98300,0,0,98300,96400,0,96400,0,0,96400,A1,AG/GEN,,,
2549,4-6-0-5-0,6813-53-2288,SNGL FAM SUB,8.25,AC,66100,0,66100,219200,14500,299800,64700,0,64700,198700,14500,277900,A1,AG/GEN,,,
2550,5-1-0-29-A,6823-00-9831,SNGL FAM SUB,12.22,AC,117200,0,117200,82900,2100,202200,115200,0,115200,75800,2100,193100,A1,AG/GEN,,,
2551,26-1-0-49-0,6719-30-9761,SNGL FAM SUB,1.865,AC,43600,0,43600,136000,1200,180800,42800,0,42800,114900,1300,159000,A1,AG/GEN,,,
2552,64-12-C-1-0,7724-50-9455,SNGL FAM SUB,0,AC,77000,0,77000,191400,9500,277900,67000,0,67000,164700,9500,241200,R1,RES/LTD,,,
2553,44-15-1-9-0,6786-07-6312,SNGL FAM SUB,15,AC,252600,0,252600,884200,42000,1178800,225000,0,225000,776600,36800,1038400,A2,AG/LTD,,,
2554,9-2-0-3-0,6802-22-8962,AG 20-100 AC,88.145,AC,180900,140300,40600,0,0,180900,176300,138800,37500,0,0,176300,A1,AG/GEN,,,
2555,41-1-0-4-0,6747-46-8531,AG > 100 AC,670.599,AC,2833500,2322500,511000,258900,31200,3123600,2774300,2284800,489500,225700,31200,3031200,A1,AG/GEN,,,
2556,48-2-F-1-0,7726-58-6058,SNGL FAM SUB,0,AC,130000,0,130000,166100,1200,297300,117000,0,117000,150000,1200,268200,R1,RES/LTD,,,
2557,38-1-0-97-0,6717-17-1407,SNGL FAM SUB,6.81,AC,71300,0,71300,0,0,71300,70000,0,70000,0,0,70000,A1,AG/GEN,,,
2558,38-1-0-6-0,6718-01-2143,SNGL FAM SUB,1,AC,38800,0,38800,500,0,39300,38000,0,38000,500,0,38500,A1,AG/GEN,,,
2560,38-1-0-43-0,6707-41-8859,SNGL FAM SUB,2.93,AC,49600,0,49600,91100,700,141400,48600,0,48600,75700,700,125000,A1,AG/GEN,,,
2561,38-1-0-43-A,6707-52-1251,SNGL FAM SUB,3.81,AC,54500,0,54500,8600,3500,66600,53500,0,53500,8400,3500,65400,A1,AG/GEN,,,
2562,38-1-0-8-0,6707-99-9949,SNGL FAM SUB,6,AC,66800,0,66800,7300,500,74600,65500,0,65500,7100,500,73100,A1,AG/GEN,,,
2563,57-10-0-34-0,7705-67-1685,SNGL FAM SUB,4.7,AC,230000,0,230000,385500,0,615500,210000,0,210000,361600,0,571600,A2,AG/LTD,,,
2564,40-8-0-B-0,6736-08-0098,SNGL FAM SUB,5.258,AC,72000,0,72000,0,0,72000,70700,0,70700,0,0,70700,A1,AG/GEN,,,
2565,52-1-0-1-A,6745-08-0655,AG 20-100 AC,40,AC,155800,136100,19700,0,0,155800,152000,134800,17200,0,0,152000,A1,AG/GEN,,,
2566,40-8-0-C-0,6736-07-1606,SNGL FAM SUB,11.004,AC,109900,0,109900,0,0,109900,108000,0,108000,0,0,108000,A1,AG/GEN,,,
2568,45-1-0-43-G,6786-97-3285,SNGL FAM SUB,12.79,AC,275600,0,275600,722200,4500,1002300,245900,0,245900,599600,4700,850200,A2,AG/LTD,,,
2569,51-1-0-1-0,6726-84-5768,SNGL FAM SUB,5.91,AC,49400,0,49400,0,0,49400,48500,0,48500,0,0,48500,A1,AG/GEN,,,
2570,51-1-0-2-0,6726-84-9587,SNGL FAM SUB,2,AC,12200,0,12200,0,0,12200,12000,0,12000,0,0,12000,A1,AG/GEN,,,
2571,51-1-0-18-0,6735-46-3636,AG 20-100 AC,46.55,AC,225600,181900,43700,0,0,225600,186200,166200,20000,0,0,186200,A1,AG/GEN,,,
2572,51-1-0-24-0,6735-57-7519,AG 20-100 AC,49.45,AC,202700,177900,24800,0,0,202700,197800,176500,21300,0,0,197800,A1,AG/GEN,,,
2573,51-1-0-25-A,6735-58-1409,SNGL FAM SUB,5.1,AC,63800,0,63800,149500,7800,221100,62600,0,62600,140600,8400,211600,A1,AG/GEN,,,
2574,51-1-0-26-0,6735-47-2917,AG 20-100 AC,44.46,AC,217000,156900,60100,0,7500,224500,204300,147600,56700,0,7500,211800,A1,AG/GEN,,,
2575,40-8-0-E-0,6736-06-8345,SNGL FAM SUB,2.617,AC,42100,0,42100,0,0,42100,41200,0,41200,0,0,41200,A1,AG/GEN,,,
2576,51-6-0-B-1,6735-77-2673,AG 20-100 AC,75.5,AC,271800,235900,35900,0,0,271800,264300,232100,32200,0,0,264300,A1,AG/GEN,,,
2577,57-20-E-2-0,7715-29-0019,SNGL FAM SUB,1.949,AC,365000,0,365000,889800,103800,1358600,335000,0,335000,840600,96900,1272500,A2,AG/LTD,,,
2578,64-1-0-52-0,7724-92-2622,COMM & IND,1.87,AC,622700,0,622700,2173100,100,2795900,576500,0,576500,2173100,100,2749700,B1,BUS/GEN,,,
2579,58-23-0-2-0,7716-86-7835,SNGL FAM SUB,4.714,AC,230800,0,230800,838500,2900,1072200,200800,0,200800,750300,2900,954000,A2,AG/LTD,,,
2580,64-19-E-8-0,7733-47-5879,SNGL FAM SUB,0,AC,265000,0,265000,467700,0,732700,220000,0,220000,403300,0,623300,R1,RES/LTD,,,
2582,20-1-0-91-B,6759-09-3123,SNGL FAM SUB,3.53,AC,78000,0,78000,8100,0,86100,74900,0,74900,8200,0,83100,A1,AG/GEN,,,
2583,20-1-0-91-C,6759-08-3782,SNGL FAM SUB,3.53,AC,78500,0,78500,10200,5500,94200,74900,0,74900,9600,5500,90000,A1,AG/GEN,,,
2584,20-1-0-91-D,6749-99-9681,SNGL FAM SUB,0.8,AC,6000,0,6000,0,0,6000,6600,0,6600,0,0,6600,A1,AG/GEN,,,
2586,42-23-0-9-0,6767-22-7106,SNGL FAM SUB,13.62,AC,136400,0,136400,340000,6800,483200,121500,0,121500,282600,6800,410900,A2,AG/LTD,,,
2587,10-1-0-35-B,6812-23-6101,SNGL FAM SUB,2.64,AC,46300,0,46300,210900,4900,262100,45400,0,45400,185000,3800,234200,A1,AG/GEN,,,
2588,38-1-0-7-0,6708-90-8299,SNGL FAM SUB,4.53,AC,58600,0,58600,23300,1900,83800,57400,0,57400,21100,1900,80400,A1,AG/GEN,,,
2590,2-3-0-16-0,6824-14-8479,SNGL FAM SUB,5.8,AC,59600,0,59600,136100,18400,214100,58300,0,58300,115600,15600,189500,A1,AG/GEN,,,
2591,46-23-0-37-0,7707-96-3044,SNGL FAM SUB,2.232,AC,165000,0,165000,241100,800,406900,150000,0,150000,203800,800,354600,A2,AG/LTD,,,
2592,64-1-0-78-A,7734-52-4821,COMM & IND,14.3,AC,482400,0,482400,0,4000,486400,446200,0,446200,0,4000,450200,B1,BUS/GEN,,,
2594,5-1-0-61-A,6823-45-6779,AG 20-100 AC,54.49,AC,338600,259600,79000,109100,1800,449500,332100,257600,74500,96900,1800,430800,A1,AG/GEN,,,
2595,5-1-0-74-A,6823-56-0259,State Exmm,0.25,AC,1900,0,1900,0,0,1900,1900,0,1900,0,0,1900,A1,AG/GEN,,,
2596,43-15-0-8-0,6768-91-4079,SNGL FAM SUB,3.25,AC,92000,0,92000,0,0,92000,83600,0,83600,0,0,83600,A2,AG/LTD,,,
2597,17-9-0-6-0,6810-04-7148,SNGL FAM SUB,0.7,AC,4200,0,4200,0,0,4200,3900,0,3900,0,0,3900,A1,AG/GEN,,,
2598,64-4-2-31-A,7724-93-5019,SNGL FAM SUB,0,AC,17200,0,17200,0,0,17200,15000,0,15000,0,0,15000,RN,RESIDEN,,,
2599,64-4-2-21-0,7724-94-6420,SNGL FAM SUB,0,AC,20200,0,20200,0,0,20200,17600,0,17600,0,0,17600,RN,RESIDEN,,,
2600,64-4-2-16-0,7724-94-4646,SNGL FAM SUB,0,AC,20200,0,20200,0,0,20200,17600,0,17600,0,0,17600,RN,RESIDEN,,,
2602,64-4-2-14-0,7724-94-4431,SNGL FAM SUB,0,AC,20200,0,20200,0,0,20200,17600,0,17600,0,0,17600,RN,RESIDEN,,,
2603,64-4-2-15-0,7724-94-4531,SNGL FAM SUB,0,AC,20200,0,20200,0,0,20200,17600,0,17600,0,0,17600,RN,RESIDEN,,,
2604,64-4-2-16-A,7724-94-4706,SNGL FAM SUB,0,AC,4000,0,4000,0,0,4000,3500,0,3500,0,0,3500,RN,RESIDEN,,,
2605,64-4-2-17-0,7724-94-6863,SNGL FAM SUB,0,AC,20200,0,20200,0,0,20200,17600,0,17600,0,0,17600,RN,RESIDEN,,,
2606,64-4-2-18-0,7724-94-6732,SNGL FAM SUB,0,AC,20200,0,20200,0,0,20200,17600,0,17600,0,0,17600,RN,RESIDEN,,,
2607,64-4-2-19-0,7724-94-6631,SNGL FAM SUB,0,AC,20200,0,20200,0,0,20200,17600,0,17600,0,0,17600,RN,RESIDEN,,,
2608,64-4-2-20-0,7724-94-6531,SNGL FAM SUB,0,AC,20200,0,20200,0,0,20200,17600,0,17600,0,0,17600,RN,RESIDEN,,,
2609,64-4-2-22-0,7724-94-6226,SNGL FAM SUB,0,AC,20200,0,20200,0,0,20200,17600,0,17600,0,0,17600,RN,RESIDEN,,,
2610,64-4-2-31-0,7724-93-6019,SNGL FAM SUB,0,AC,17200,0,17200,0,0,17200,15000,0,15000,0,0,15000,RN,RESIDEN,,,
2611,64-16-0-C-0,7734-03-7936,SNGL FAM SUB,1.924,AC,159200,0,159200,0,0,159200,138400,0,138400,0,0,138400,A2,AG/LTD,,,
2612,38-1-0-99-0,6707-86-3531,AG 20-100 AC,25.66,AC,112100,0,112100,0,0,112100,109700,0,109700,0,0,109700,A1,AG/GEN,,,
2613,38-1-0-99-A,6707-88-3532,SNGL FAM SUB,0.65,AC,2700,0,2700,0,0,2700,2600,0,2600,0,0,2600,A1,AG/GEN,,,
2614,55-1-0-3-0,6776-83-6990,SNGL FAM SUB,4.748,AC,139300,0,139300,571200,81800,792300,124400,0,124400,459500,68900,652800,A2,AG/LTD,,,
2615,20-1-0-29-0,6749-27-0841,SNGL FAM SUB,9,AC,35600,0,35600,0,0,35600,32400,0,32400,0,0,32400,A1,AG/GEN,,,
2616,20-1-0-30-0,6749-27-5452,SNGL FAM SUB,5.96,AC,24400,0,24400,0,0,24400,21500,0,21500,0,0,21500,A1,AG/GEN,,,
2617,45-18-0-6-0,6797-45-3704,SNGL FAM SUB,8.012,AC,240000,0,240000,178100,27100,445200,216000,0,216000,161300,2800,380100,A2,AG/LTD,,,
2618,16-2-0-G-0,5890-29-9218,AG 20-100 AC,26.24,AC,73200,0,73200,0,0,73200,69500,0,69500,0,0,69500,A1,AG/GEN,,,
2619,13-10-0-9-0,6841-75-5029,SNGL FAM SUB,11.14,AC,120200,0,120200,0,0,120200,118000,0,118000,0,0,118000,A1,AG/GEN,,,
2620,15-5-0-32-0,5789-79-5941,SNGL FAM SUB,8.12,AC,64400,0,64400,255700,15500,335600,62900,0,62900,225900,18100,306900,A1,AG/GEN,,,
2621,20-1-0-53-B,6841-70-1491,SNGL FAM SUB,2.501,AC,62900,0,62900,245200,2400,310500,61800,0,61800,215600,2400,279800,A1,AG/GEN,,,
2622,42-1-0-24-0,6766-17-5803,SNGL FAM SUB,3.07,AC,91400,0,91400,349700,0,441100,81600,0,81600,286400,0,368000,A2R3,AGRIC.R,,,
2623,53-1-0-1-0,6766-16-6093,AG 20-100 AC,27.86,AC,94700,0,94700,0,0,94700,83600,0,83600,0,0,83600,A1,AG/GEN,,,
2629,13-3-0-5-A,6842-73-9753,SNGL FAM SUB,4,AC,56900,0,56900,367500,1500,425900,55900,0,55900,326100,1500,383500,A1,AG/GEN,,,
2630,55-18-0-10-0,6776-96-3504,SNGL FAM SUB,10,AC,194300,0,194300,0,0,194300,173300,0,173300,0,0,173300,A2,AG/LTD,,,
2632,26-1-0-30-0,6708-73-4404,AG 20-100 AC,26.8,AC,96500,84100,12400,0,0,96500,93800,82400,11400,0,0,93800,A1,AG/GEN,,,
2634,55-1-0-30-0,6785-56-6958,SNGL FAM SUB,1,AC,70100,0,70100,0,0,70100,62600,0,62600,0,0,62600,A2,AG/LTD,,,
2635,55-1-0-34-0,6785-57-1373,SNGL FAM SUB,5.36,AC,142000,0,142000,629700,47400,819100,126700,0,126700,528400,40400,695500,A2,AG/LTD,,,
2639,58-21-C-4-0,7716-22-2872,SNGL FAM SUB,1.745,AC,310000,0,310000,246100,16900,573000,285000,0,285000,220400,16900,522300,R3,RES/GEN,,,
2640,33-4-0-2-0,6798-54-2030,SNGL FAM SUB,2.1,AC,91900,0,91900,159100,10900,261900,82000,0,82000,131200,10900,224100,A2,AG/LTD,,,
2641,5-8-0-A-0,6813-68-8001,SNGL FAM SUB,4.86,AC,59400,0,59400,0,100,59500,58300,0,58300,0,100,58400,A1,AG/GEN,,,
2642,26-1-0-35-A,6718-04-5021,SNGL FAM SUB,3.09,AC,50500,0,50500,159600,10100,220200,49500,0,49500,140800,9000,199300,A1,AG/GEN,,,
2643,26-1-0-35-B,6718-03-4838,SNGL FAM SUB,1.61,AC,9000,0,9000,0,0,9000,8900,0,8900,0,0,8900,A1,AG/GEN,,,
2644,58-18-G-4-0,7716-50-0410,SNGL FAM SUB,1.783,AC,310000,0,310000,1163300,0,1473300,285000,0,285000,1056700,0,1341700,A2,AG/LTD,,,
2645,58-21-D-1-0,7716-42-6506,SNGL FAM SUB,7.124,AC,365000,0,365000,1292900,45400,1703300,335000,0,335000,1204900,42200,1582100,R3,RES/GEN,,,
2646,47-1-0-43-0,7726-09-0678,COMM & IND,0.63,AC,168400,0,168400,0,15800,184200,153100,0,153100,0,14100,167200,M1,INDUS/L,,,
2647,47-25-0-2-0,7717-90-9020,SNGL FAM SUB,1.91,AC,141800,0,141800,338400,2300,482500,126600,0,126600,284100,2400,413100,A2,AG/LTD,,,
2648,58-18-G-1-0,7716-51-0106,SNGL FAM SUB,2.189,AC,310000,0,310000,486800,224900,1021700,285000,0,285000,446000,202900,933900,A2,AG/LTD,,,
2649,32-1-0-35-0,6778-76-6410,SNGL FAM SUB,1.51,AC,71400,0,71400,183900,1500,256800,63800,0,63800,150800,1500,216100,A2,AG/LTD,,,
2650,32-2-0-3-0,6778-76-7899,SNGL FAM SUB,3.63,AC,109100,0,109100,0,0,109100,103000,0,103000,0,0,103000,B1A2,BS AND,,,
2651,32-2-0-4-0,6778-77-5087,SNGL FAM SUB,2.82,AC,97900,0,97900,0,2500,100400,92600,0,92600,0,2500,95100,B1A2,BS AND,,,
2652,31-1-0-38-0,6769-70-7663,AG 20-100 AC,20,AC,229600,0,229600,447200,41700,718500,212800,0,212800,373900,38400,625100,A2,AG/LTD,,,
2653,63-2-0-7-0,7723-18-5935,SNGL FAM SUB,5.767,AC,260100,0,260100,18100,100,278300,226100,0,226100,15200,100,241400,R1A2,RES LTD,,,
2654,13-1-0-53-0,6831-99-1426,AG 20-100 AC,68.55,AC,364000,253400,110600,248600,50900,663500,361600,250400,111200,220200,45700,627500,A1,AG/GEN,,,
2655,39-1-0-96-0,6727-66-0763,AG > 100 AC,183.19,AC,596300,470400,125900,69200,2600,668100,584600,468800,115800,60300,2600,647500,A1,AG/GEN,,,
2656,63-2-0-1-B,7723-37-2691,SNGL FAM SUB,0.893,AC,145200,0,145200,66400,0,211600,126300,0,126300,56500,0,182800,R1,RES/LTD,,,
2657,44-17-0-2-0,6787-23-2700,SNGL FAM SUB,1.59,AC,79400,0,79400,79900,21900,181200,70900,0,70900,68100,18000,157000,A2,AG/LTD,,,
2658,63-2-0-1-0,7723-38-5212,SNGL FAM SUB,4.987,AC,275400,0,275400,0,0,275400,239500,0,239500,0,0,239500,R1A2,RES LTD,,,
2659,63-1-0-200-0,7723-38-8155,SNGL FAM SUB,1,AC,155800,0,155800,0,0,155800,135500,0,135500,0,0,135500,A2,AG/LTD,,,
2662,47-1-0-23-0,7716-47-4932,SNGL FAM SUB,12.54,AC,355200,0,355200,0,26900,382100,316900,0,316900,0,27500,344400,A2,AG/LTD,,,
2663,47-10-0-A-0,7716-58-0053,SNGL FAM SUB,13,AC,334200,0,334200,0,19500,353700,298400,0,298400,0,19500,317900,A2,AG/LTD,,,
2664,47-1-0-25-0,7716-57-1486,SNGL FAM SUB,8.87,AC,278400,0,278400,358700,0,637100,248900,0,248900,307600,0,556500,A2,AG/LTD,,,
2665,18-4-0-3-A,6820-10-1422,SNGL FAM SUB,3,AC,52000,0,52000,92600,300,144900,50000,0,50000,76200,300,126500,A1,AG/GEN,,,
2666,63-2-0-7-A,7723-18-1987,SNGL FAM SUB,0.953,AC,116200,0,116200,33500,1100,150800,101000,0,101000,29100,1100,131200,R1,RES/LTD,,,
2667,46-15-0-2-0,7707-81-9641,SNGL FAM SUB,5,AC,190200,0,190200,172600,700,363500,170000,0,170000,147900,700,318600,A2,AG/LTD,,,
2668,38-1-0-5-C,6708-91-6145,SNGL FAM SUB,12.8,AC,99000,0,99000,231600,15300,345900,97000,0,97000,208800,15300,321100,A1,AG/GEN,,,
2669,43-17-0-A-0,6767-91-6687,SNGL FAM SUB,1,AC,70100,0,70100,132000,1000,203100,62600,0,62600,108400,1000,172000,A2,AG/LTD,,,
2670,62-21-0-6-0,7714-07-3579,SNGL FAM SUB,8.34,AC,387000,0,387000,774200,19000,1180200,336500,0,336500,764200,27200,1127900,A2,AG/LTD,,,
2671,48-2-A-5-0,7726-67-6759,SNGL FAM SUB,0,AC,130000,0,130000,175500,0,305500,117000,0,117000,155600,0,272600,R1,RES/LTD,,,
2672,5-1-0-30-0,6823-02-4368,AG 20-100 AC,35.77,AC,139700,93300,46400,259000,42900,441600,137000,92800,44200,220100,58100,415200,A1,AG/GEN,,,
2673,5-1-0-30-B,6813-91-2738,AG 20-100 AC,28.68,AC,132600,118000,14600,0,0,132600,130000,117700,12300,0,0,130000,A1,AG/GEN,,,
2676,55-21-0-2-0,6776-82-5950,SNGL FAM SUB,2.61,AC,94400,0,94400,288800,1500,384700,84300,0,84300,238000,1500,323800,A2,AG/LTD,,,
2677,55-21-0-3-0,6776-82-4794,SNGL FAM SUB,3.25,AC,104100,0,104100,302200,1500,407800,93000,0,93000,243800,1500,338300,A2,AG/LTD,,,
2678,16-4-0-19-0,5890-46-3071,SNGL FAM SUB,3.67,AC,48400,0,48400,116800,500,165700,47300,0,47300,98200,500,146000,A1,AG/GEN,,,
2679,9-1-0-59-0,6801-06-1426,SNGL FAM SUB,3,AC,46000,0,46000,127500,200,173700,45000,0,45000,110200,200,155400,A1,AG/GEN,,,
2680,31-1-0-35-B,6768-77-7337,SNGL FAM SUB,3.3,AC,86100,0,86100,0,0,86100,82700,0,82700,0,0,82700,A2,AG/LTD,,,
2681,44-10-0-4-0,6787-53-3418,SNGL FAM SUB,2.1,AC,87500,0,87500,80900,100,168500,78100,0,78100,67000,100,145200,A2,AG/LTD,,,
2682,44-10-0-4-A,6787-54-7219,SNGL FAM SUB,3.85,AC,93600,0,93600,0,0,93600,83800,0,83800,0,0,83800,A2,AG/LTD,,,
2683,46-23-0-26-0,7707-73-9763,SNGL FAM SUB,5.7,AC,173300,0,173300,205300,600,379200,157500,0,157500,170800,600,328900,A2,AG/LTD,,,
2684,3-2-0-4-0,6803-24-6379,SNGL FAM SUB,2.37,AC,46600,0,46600,205500,0,252100,44900,0,44900,184200,0,229100,A1,AG/GEN,,,
2686,31-1-0-47-A,6769-95-5836,SNGL FAM SUB,2.5,AC,79400,0,79400,0,25400,104800,73100,0,73100,0,20200,93300,A2,AG/LTD,,,
2687,31-1-0-47-B,6769-95-4590,SNGL FAM SUB,1.77,AC,70500,0,70500,293200,20500,384200,64300,0,64300,244800,20500,329600,A2,AG/LTD,,,
2688,31-1-0-47-C,6769-95-7813,SNGL FAM SUB,1.5,AC,67200,0,67200,89300,7400,163900,61100,0,61100,75700,6900,143700,A2,AG/LTD,,,
2689,6-1-0-44-A,6832-17-1117,SNGL FAM SUB,8.59,AC,91700,0,91700,0,0,91700,89400,0,89400,0,0,89400,A1,AG/GEN,,,
2690,62-17-A-3-0,7714-05-2860,SNGL FAM SUB,0,AC,115000,0,115000,266500,0,381500,100000,0,100000,244100,0,344100,R1,RES/LTD,,,
2691,13-1-0-38-A,6841-94-6119,SNGL FAM SUB,3.68,AC,73100,0,73100,0,0,73100,71800,0,71800,0,0,71800,A1,AG/GEN,,,
2692,39-1-0-56-0,6717-62-4146,SNGL FAM SUB,3.75,AC,54200,0,54200,25700,2200,82100,53100,0,53100,20700,2200,76000,A1,AG/GEN,,,
2693,39-7-0-E-0,6717-62-9123,SNGL FAM SUB,3.69,AC,34500,0,34500,0,0,34500,33800,0,33800,0,0,33800,A1,AG/GEN,,,
2694,26-1-0-35-0,6708-84-1165,AG 20-100 AC,46.62,AC,212700,133800,78900,323000,30600,566300,207200,131100,76100,282100,27800,517100,A1,AG/GEN,,,
2695,26-1-0-35-R,6708-83-9143,SNGL FAM SUB,10.77,AC,88600,45300,43300,0,121300,209900,86900,44700,42200,0,109700,196600,A1,AG/GEN,,,
2696,26-1-0-35-V,6708-92-6656,SNGL FAM SUB,4.01,AC,11200,0,11200,0,0,11200,11000,0,11000,0,0,11000,A1,AG/GEN,,,
2697,57-10-0-30-0,7705-66-7931,SNGL FAM SUB,3.13,AC,230000,0,230000,409800,18500,658300,210000,0,210000,381400,15800,607200,A2,AG/LTD,,,
2698,55-14-0-21-0,6785-59-5902,SNGL FAM SUB,11.435,AC,214400,0,214400,680800,137000,1032200,191600,0,191600,550200,118600,860400,A2,AG/LTD,,,
2699,29-1-0-92-0,6759-16-0537,SNGL FAM SUB,5.542,AC,96200,0,96200,123000,0,219200,94900,0,94900,95600,0,190500,A1,AG/GEN,,,
2700,63-1-0-114-A,7715-52-9336,SNGL FAM SUB,3.29,AC,148200,0,148200,52200,400,200800,128800,0,128800,44900,400,174100,A2,AG/LTD,,,
2701,19-1-0-36-0,6830-09-9640,AG 20-100 AC,21.69,AC,163200,0,163200,5000,0,168200,157400,0,157400,5000,0,162400,A1,AG/GEN,,,
2702,19-1-0-40-0,6831-51-7969,SNGL FAM SUB,1,AC,44700,0,44700,0,0,44700,42500,0,42500,0,0,42500,A1,AG/GEN,,,
2703,22-1-0-7-0,6769-77-3884,SNGL FAM SUB,1.59,AC,68300,0,68300,0,0,68300,62200,0,62200,0,0,62200,A2,AG/LTD,,,
2704,67-2-B-7-0,7723-55-0904,SNGL FAM SUB,0,AC,184000,0,184000,227900,600,412500,160000,0,160000,189900,600,350500,R1,RES/LTD,,,
2705,19-1-0-36-C,6831-00-7803,SNGL FAM SUB,3.1,AC,54500,0,54500,136000,13700,204200,55900,0,55900,109200,10500,175600,A1,AG/GEN,,,
2706,26-1-0-13-B,6719-04-0017,SNGL FAM SUB,0.985,AC,39400,0,39400,89300,2100,130800,37400,0,37400,73600,2100,113100,A1,AG/GEN,,,
2707,27-1-0-6-0,6719-70-0986,SNGL FAM SUB,4,AC,57100,0,57100,0,200,57300,56000,0,56000,0,200,56200,A1,AG/GEN,,,
2708,28-1-0-8-0,6729-80-0864,AG 20-100 AC,30.279,AC,144200,0,144200,0,0,144200,142300,0,142300,0,0,142300,A1,AG/GEN,,,
2709,28-1-0-104-0,6738-56-9126,SNGL FAM SUB,16,AC,135900,0,135900,44500,1500,181900,132900,0,132900,40400,1500,174800,A1,AG/GEN,,,
2710,28-8-0-4-0,6729-81-4683,SNGL FAM SUB,3.455,AC,56900,0,56900,0,0,56900,56200,0,56200,0,0,56200,A1,AG/GEN,,,
2711,29-13-0-2-0,6748-42-8244,SNGL FAM SUB,1.5,AC,59000,0,59000,178300,4000,241300,54600,0,54600,145100,4000,203700,A1,AG/GEN,,,
2713,28-1-0-58-0,6738-29-1108,AG 20-100 AC,39.02,AC,192800,167000,25800,0,0,192800,192800,168400,24400,0,0,192800,A1,AG/GEN,,,
2714,45-1-0-72-E,6797-50-8471,SNGL FAM SUB,4,AC,130100,0,130100,0,0,130100,116100,0,116100,0,0,116100,A2,AG/LTD,,,
2715,45-1-0-72-F,6797-50-2390,SNGL FAM SUB,13.28,AC,276700,0,276700,283500,25900,586100,246900,0,246900,229400,21200,497500,A2,AG/LTD,,,
2716,19-1-0-10-0,6831-10-4025,SNGL FAM SUB,9,AC,81300,0,81300,0,0,81300,77100,0,77100,0,0,77100,A1,AG/GEN,,,
2717,19-1-0-36-A,6831-01-5251,SNGL FAM SUB,1.38,AC,42900,0,42900,165700,28200,236800,42500,0,42500,137900,24500,204900,A1,AG/GEN,,,
2718,19-1-0-36-D,6831-01-8172,SNGL FAM SUB,6.05,AC,72100,0,72100,0,0,72100,68300,0,68300,0,0,68300,A1,AG/GEN,,,
2719,58-4-E-10-0,7716-56-7150,SNGL FAM SUB,0,AC,20100,0,20100,0,0,20100,18300,0,18300,0,0,18300,A2,AG/LTD,,,
2720,58-4-E-11-0,7716-56-7063,SNGL FAM SUB,0,AC,77500,0,77500,369000,1900,448400,70500,0,70500,307600,1400,379500,A2,AG/LTD,,,
2721,58-4-E-12-0,7716-55-7976,SNGL FAM SUB,0,AC,20100,0,20100,0,0,20100,18300,0,18300,0,0,18300,A2,AG/LTD,,,
2722,58-4-E-13-0,7716-55-6948,SNGL FAM SUB,0,AC,10000,0,10000,0,0,10000,9100,0,9100,0,0,9100,A2,AG/LTD,,,
2723,31-19-0-C-0,6779-30-1407,SNGL FAM SUB,7.27,AC,135600,0,135600,255600,0,391200,121200,0,121200,209900,0,331100,A2,AG/LTD,,,
2724,58-1-0-38-0,7715-52-3867,SNGL FAM SUB,18.112,AC,446700,0,446700,4663900,93800,5204400,387800,0,387800,4037600,86400,4511800,A2,AG/LTD,,,
2725,63-20-0-2-0,7715-41-8750,SNGL FAM SUB,14.486,AC,401700,0,401700,240300,29600,671600,348800,0,348800,205100,24200,578100,A2,AG/LTD,,,
2726,39-6-0-8-0,6726-17-7873,SNGL FAM SUB,1,AC,38800,0,38800,154000,2700,195500,38000,0,38000,130700,2000,170700,A1,AG/GEN,,,
2727,55-15-0-18-0,6785-67-3874,SNGL FAM SUB,3.01,AC,114500,0,114500,266900,16900,398300,102100,0,102100,218400,16000,336500,A2,AG/LTD,,,
2728,46-1-0-98-0,7707-89-5969,SNGL FAM SUB,1.25,AC,98100,0,98100,107100,1000,206200,87600,0,87600,90000,1000,178600,A2,AG/LTD,,,
2729,55-1-0-79-0,6785-78-5963,SNGL FAM SUB,19.94,AC,305300,0,305300,0,0,305300,272300,0,272300,0,0,272300,A2,AG/LTD,,,
2730,55-1-0-88-A,6785-54-1829,SNGL FAM SUB,4.072,AC,116500,0,116500,323300,5000,444800,104100,0,104100,262600,5000,371700,A2,AG/LTD,,,
2731,26-1-0-35-P,6708-91-0960,SNGL FAM SUB,7.206,AC,73600,0,73600,173800,1400,248800,72100,0,72100,147100,1400,220600,A1,AG/GEN,,,
2732,67-1-0-20-B,7733-25-8140,SNGL FAM SUB,3.85,AC,282700,0,282700,325100,28700,636500,245700,0,245700,284900,24200,554800,A2,AG/LTD,,,
2733,20-1-0-31-0,6749-37-4574,SNGL FAM SUB,16.96,AC,116500,0,116500,4800,100,121400,114500,0,114500,4700,100,119300,A1,AG/GEN,,,
2734,20-1-0-32-0,6749-28-4569,AG 20-100 AC,48.4,AC,156700,0,156700,0,0,156700,150300,0,150300,0,0,150300,A1,AG/GEN,,,
2735,29-1-0-79-B,6749-66-4655,Roads,1.44,AC,0,0,0,0,0,0,0,0,0,0,0,0,A1,AG/GEN,,,
2736,26-7-0-1-0,6708-94-8295,SNGL FAM SUB,3.14,AC,50800,0,50800,129900,7900,188600,49800,0,49800,109700,7500,167000,A1,AG/GEN,,,
2737,63-1-0-23-0,7714-35-9699,SNGL FAM SUB,1.91,AC,139600,0,139600,774500,3800,917900,121400,0,121400,658900,3800,784100,R3,RES/GEN,,,
2738,58-21-C-7-0,7716-22-0175,SNGL FAM SUB,3.391,AC,365000,0,365000,365700,19800,750500,335000,0,335000,338200,17700,690900,R3,RES/GEN,,,
2739,39-1-0-52-0,6717-73-9049,AG 20-100 AC,26.37,AC,161700,0,161700,101400,15200,278300,158500,0,158500,88600,15200,262300,A1,AG/GEN,,,
2740,11-1-0-35-D,6821-24-0672,SNGL FAM SUB,2.87,AC,51200,0,51200,31000,3900,86100,50200,0,50200,28600,3000,81800,A1,AG/GEN,,,
2741,54-5-0-11-0,6766-63-7154,SNGL FAM SUB,6.847,AC,141500,0,141500,352100,0,493600,132000,0,132000,318700,0,450700,A2,AG/LTD,,,
2742,57-8-0-A-0,7706-16-8841,AG 20-100 AC,23.71,AC,639700,0,639700,382700,16300,1038700,555700,0,555700,322300,16000,894000,A2,AG/LTD,,,
2744,5-1-0-33-0,6813-84-2021,SNGL FAM SUB,2.39,AC,46800,0,46800,147500,16300,210600,46000,0,46000,127400,13000,186400,A1,AG/GEN,,,
2745,58-4-C-17-0,7716-56-1620,SNGL FAM SUB,0,AC,10000,0,10000,0,0,10000,9100,0,9100,0,0,9100,A2,AG/LTD,,,
2746,26-7-0-15-0,6718-04-1233,SNGL FAM SUB,1.47,AC,8200,0,8200,0,0,8200,8100,0,8100,0,0,8100,A1,AG/GEN,,,
2747,5-1-0-38-0,6813-98-9832,SNGL FAM SUB,1,AC,39700,0,39700,60100,0,99800,39000,0,39000,52900,0,91900,A1,AG/GEN,,,
2748,5-1-0-79-A,6823-64-1851,SNGL FAM SUB,2.3,AC,46300,0,46300,192900,4200,243400,45500,0,45500,171400,2400,219300,A1,AG/GEN,,,
2749,38-1-0-112-0,6717-29-4190,SNGL FAM SUB,3,AC,50000,0,50000,10000,0,60000,49000,0,49000,10000,0,59000,A1,AG/GEN,,,
2750,28-1-0-18-A,6728-97-0434,SNGL FAM SUB,1,AC,38800,0,38800,88600,0,127400,38000,0,38000,78700,0,116700,A1,AG/GEN,,,
2751,28-1-0-18-B,6728-97-0610,SNGL FAM SUB,0.5,AC,14600,0,14600,0,0,14600,14300,0,14300,0,0,14300,A1,AG/GEN,,,
2752,47-23-0-2-0,7717-23-6144,SNGL FAM SUB,2,AC,110000,0,110000,116900,36000,262900,98200,0,98200,98300,30800,227300,A2,AG/LTD,,,
2753,17-1-0-57-0,6810-37-1136,SNGL FAM SUB,0.71,AC,34400,0,34400,89500,100,124000,33700,0,33700,77900,100,111700,A1,AG/GEN,,,
2754,46-1-0-100-0,7707-89-5578,SNGL FAM SUB,7.08,AC,211600,116200,95400,244300,22000,477900,188900,103700,85200,204400,20100,413400,A2,AG/LTD,,,
2755,46-1-0-100-A,7707-99-0444,SNGL FAM SUB,2.25,AC,120900,27900,93000,144700,1500,267100,108000,25000,83000,119700,1500,229200,A2,AG/LTD,,,
2756,46-1-0-102-A,7707-99-2065,SNGL FAM SUB,7.79,AC,225500,221600,3900,0,0,225500,201300,197900,3400,0,0,201300,A2,AG/LTD,,,
2757,67-2-C-15-0,7723-54-6849,SNGL FAM SUB,0,AC,184000,0,184000,318900,500,503400,160000,0,160000,275300,500,435800,R1,RES/LTD,,,
2759,31-10-2-8-0,6779-50-6330,SNGL FAM SUB,3.23,AC,99400,0,99400,204700,32100,336200,88900,0,88900,168400,27400,284700,A2,AG/LTD,,,
2760,12-5-0-3-0,6832-35-0310,SNGL FAM SUB,3.27,AC,53000,0,53000,179000,2900,234900,50400,0,50400,159600,2900,212900,A1,AG/GEN,,,
2761,46-1-0-85-0,7718-01-6672,SNGL FAM SUB,1.96,AC,114300,0,114300,120300,2400,237000,102100,0,102100,101000,2400,205500,A2,AG/LTD,,,
2762,18-1-0-29-0,6729-28-3549,SNGL FAM SUB,1,AC,40000,0,40000,0,0,40000,38000,0,38000,0,0,38000,A1,AG/GEN,,,
2763,44-19-0-14-0,6778-81-5339,SNGL FAM SUB,5.19,AC,106400,0,106400,81900,2700,191000,94900,0,94900,78100,800,173800,A2,AG/LTD,,,
2764,44-19-0-15-0,6778-81-6635,SNGL FAM SUB,5.19,AC,106400,0,106400,199800,0,306200,94900,0,94900,165100,0,260000,A2,AG/LTD,,,
2765,54-2-0-15-0,6776-22-4364,SNGL FAM SUB,3.715,AC,91500,0,91500,257200,2000,350700,81600,0,81600,212800,2000,296400,A2,AG/LTD,,,
2766,17-7-0-B-0,6800-49-8708,AG 20-100 AC,21,AC,110600,0,110600,15500,0,126100,108000,0,108000,13500,0,121500,A1,AG/GEN,,,
2767,2-3-0-34-0,6824-32-0529,SNGL FAM SUB,3.89,AC,50800,0,50800,130500,1700,183000,49700,0,49700,110500,1700,161900,A1,AG/GEN,,,
2768,26-2-0-3-K,6709-82-2053,SNGL FAM SUB,9.322,AC,85800,0,85800,172500,0,258300,83800,0,83800,143400,0,227200,A1,AG/GEN,,,
2769,44-16-0-10-0,6787-39-7529,SNGL FAM SUB,3.04,AC,129000,0,129000,0,0,129000,115000,0,115000,0,0,115000,A2,AG/LTD,,,
2770,50-5-0-10-0,6726-42-6642,SNGL FAM SUB,8.58,AC,71800,0,71800,282900,1100,355800,68300,0,68300,249000,1100,318400,A1,AG/GEN,,,
2771,43-20-0-11-0,6768-52-2386,SNGL FAM SUB,3.15,AC,96800,0,96800,213700,2500,313000,88000,0,88000,187700,2700,278400,A2,AG/LTD,,,
2772,15-5-0-14-0,5789-58-4636,SNGL FAM SUB,8.3,AC,65100,0,65100,393700,1500,460300,63600,0,63600,350000,1500,415100,A1,AG/GEN,,,
2775,63-1-0-190-0,7724-02-2247,SNGL FAM SUB,6.221,AC,193800,0,193800,0,0,193800,168700,0,168700,0,0,168700,A2R3,AGRIC.R,,,
2776,15-1-0-27-0,5789-29-4745,SNGL FAM SUB,2,AC,25500,0,25500,0,0,25500,24500,0,24500,0,0,24500,A1,AG/GEN,,,
2777,58-18-G-6-0,7715-49-9717,SNGL FAM SUB,2.675,AC,310000,0,310000,407500,52400,769900,285000,0,285000,370700,48800,704500,A2,AG/LTD,,,
2778,58-1-0-80-0,7716-73-8750,SNGL FAM SUB,17.4,AC,551300,542400,8900,0,0,551300,424800,417300,7500,0,0,424800,A2,AG/LTD,,,
2779,58-17-0-A-0,7716-63-0207,SNGL FAM SUB,5.332,AC,229000,0,229000,560800,5800,795600,199300,0,199300,471900,4900,676100,A2,AG/LTD,,,
2780,58-17-0-A-1,7716-53-8499,SNGL FAM SUB,1,AC,115100,0,115100,104500,0,219600,100100,0,100100,88600,0,188700,A2,AG/LTD,,,
2781,58-17-0-B-0,7716-63-8387,SNGL FAM SUB,0.828,AC,102000,0,102000,15800,500,118300,88700,0,88700,15300,500,104500,A2,AG/LTD,,,
2782,58-17-0-C-0,7716-63-5242,SNGL FAM SUB,10.118,AC,354900,0,354900,341500,44100,740500,308900,0,308900,297000,41100,647000,A2,AG/LTD,,,
2783,27-1-0-36-0,6728-14-5774,AG 20-100 AC,50,AC,173400,0,173400,0,0,173400,169000,0,169000,0,0,169000,A1,AG/GEN,,,
2803,61-2-0-C-0,6795-10-9856,SNGL FAM SUB,2.96,AC,12100,0,12100,0,0,12100,10700,0,10700,0,0,10700,A2,AG/LTD,,,
2804,29-3-0-11-A,6749-62-5619,SNGL FAM SUB,3.37,AC,77100,0,77100,0,0,77100,72200,0,72200,0,0,72200,A1,AG/GEN,,,
2805,18-1-0-50-0,6820-17-2940,SNGL FAM SUB,1,AC,40000,0,40000,40700,1400,82100,38000,0,38000,33800,1400,73200,A1,AG/GEN,,,
2806,11-1-0-34-A,6821-13-4632,SNGL FAM SUB,2,AC,46000,0,46000,221900,0,267900,44500,0,44500,195800,0,240300,A1,AG/GEN,,,
2807,26-1-0-5-0,6709-86-2281,AG 20-100 AC,45,AC,201200,126100,75100,183700,12300,397200,196400,120600,75800,159100,10800,366300,A1,AG/GEN,,,
2808,26-1-0-5-B,6709-64-9965,AG 20-100 AC,33.82,AC,115100,99500,15600,0,0,115100,112500,98100,14400,0,0,112500,A1,AG/GEN,,,
2809,46-21-B-5-0,7708-90-4202,SNGL FAM SUB,2.77,AC,135200,0,135200,341000,15700,491900,122900,0,122900,287700,15300,425900,A2,AG/LTD,,,
2810,12-16-0-1-0,6822-91-0528,SNGL FAM SUB,6.31,AC,70700,0,70700,0,0,70700,68800,0,68800,0,0,68800,A1,AG/GEN,,,
2811,20-11-0-24-0,6841-91-5813,SNGL FAM SUB,2.03,AC,55900,0,55900,230100,37300,323300,52800,0,52800,225000,36400,314200,A1,AG/GEN,,,
2812,60-1-0-3-C,6774-98-0883,SNGL FAM SUB,0.001,AC,200,0,200,0,0,200,200,0,200,0,0,200,A2,AG/LTD,,,
2813,11-1-0-4-A,6822-04-5470,AG 20-100 AC,73.973,AC,301100,0,301100,438100,14800,754000,295700,0,295700,383400,14800,693900,A1,AG/GEN,,,
2814,31-12-0-5-0,6769-66-5878,SNGL FAM SUB,12.727,AC,184800,178600,6200,0,0,184800,171200,165800,5400,0,0,171200,A2,AG/LTD,,,
2815,46-1-0-53-C,7706-99-6427,SNGL FAM SUB,3.05,AC,145700,0,145700,84800,1300,231800,130200,0,130200,71400,1300,202900,A2,AG/LTD,,,
2816,63-1-0-96-0,7714-59-7981,SNGL FAM SUB,2.5,AC,139000,0,139000,354300,0,493300,120900,0,120900,300200,0,421100,A2,AG/LTD,,,
2817,31-20-0-4-0,6769-56-7017,SNGL FAM SUB,2.74,AC,81200,0,81200,0,0,81200,73200,0,73200,0,0,73200,A2,AG/LTD,,,
2818,58-7-0-2-0,7716-64-2795,SNGL FAM SUB,4.3,AC,175700,0,175700,0,0,175700,152700,0,152700,0,0,152700,A2,AG/LTD,,,
2819,57-2-0-1-0,7716-16-4307,SNGL FAM SUB,1.29,AC,105600,0,105600,407500,0,513100,94300,0,94300,336700,0,431000,A2,AG/LTD,,,
2820,2-1-0-9-D,6814-95-6514,AG 20-100 AC,30,AC,137900,0,137900,0,0,137900,135200,0,135200,0,0,135200,A1,AG/GEN,,,
2821,2-1-0-10-0,6824-04-6931,AG 20-100 AC,49.83,AC,232900,0,232900,12500,2400,247800,228500,0,228500,12500,2400,243400,A1,AG/GEN,,,
2822,58-1-0-9-0,7716-46-3938,SNGL FAM SUB,2.8,AC,130700,0,130700,0,0,130700,116700,0,116700,0,0,116700,A2,AG/LTD,,,
2823,58-1-0-10-0,7716-46-6947,SNGL FAM SUB,2.621,AC,127500,0,127500,111700,300,239500,113900,0,113900,93500,300,207700,A2,AG/LTD,,,
2824,58-1-0-10-A,7716-46-6563,SNGL FAM SUB,3,AC,133000,0,133000,166700,3900,303600,118800,0,118800,138400,3900,261100,A2,AG/LTD,,,
2825,58-4-B-5-0,7716-46-8493,SNGL FAM SUB,0,AC,10000,0,10000,0,0,10000,9100,0,9100,0,0,9100,A2,AG/LTD,,,
2826,31-20-0-5-0,6769-56-4298,SNGL FAM SUB,5.89,AC,111400,0,111400,0,0,111400,101100,0,101100,0,0,101100,A2,AG/LTD,,,
2827,46-1-0-53-B,7706-99-8324,SNGL FAM SUB,3.05,AC,172400,0,172400,267300,5900,445600,154000,0,154000,232700,5100,391800,A2,AG/LTD,,,
2828,31-20-0-3-0,6769-55-8964,SNGL FAM SUB,2.43,AC,77700,0,77700,103300,300,181300,70000,0,70000,85700,300,156000,A2,AG/LTD,,,
2829,32-1-0-11-A,6779-75-8279,SNGL FAM SUB,2.01,AC,78600,0,78600,90500,1000,170100,70200,0,70200,74500,1000,145700,A2,AG/LTD,,,
2830,57-2-0-15-A,7716-17-9084,SNGL FAM SUB,0.75,AC,85400,0,85400,141100,0,226500,76200,0,76200,117300,0,193500,A2,AG/LTD,,,
2831,10-1-0-33-A,6812-46-1786,SNGL FAM SUB,3.5,AC,50500,0,50500,0,0,50500,49000,0,49000,0,0,49000,A1,AG/GEN,,,
2832,10-5-0-1-0,6812-36-7758,SNGL FAM SUB,2,AC,44800,0,44800,156800,200,201800,44000,0,44000,138300,200,182500,A1,AG/GEN,,,
2833,45-1-0-104-B,6798-71-5067,SNGL FAM SUB,1,AC,59600,0,59600,106900,300,166800,53200,0,53200,87700,300,141200,A2,AG/LTD,,,
2834,46-19-0-1-0,7707-09-1976,SNGL FAM SUB,3.89,AC,158300,0,158300,0,0,158300,141500,0,141500,0,0,141500,A2,AG/LTD,,,
2835,46-19-0-2-0,7707-09-6911,SNGL FAM SUB,4.39,AC,150000,0,150000,499300,0,649300,134000,0,134000,425700,0,559700,A2,AG/LTD,,,
2836,46-18-0-B-1,7708-00-1317,SNGL FAM SUB,5,AC,181200,0,181200,285000,3200,469400,161700,0,161700,241700,3200,406600,A2,AG/LTD,,,
2837,5-5-0-D-0,6823-57-1109,SNGL FAM SUB,14.41,AC,106300,0,106300,0,0,106300,104400,0,104400,0,0,104400,A1,AG/GEN,,,
2838,45-1-0-103-0,6798-70-8815,SNGL FAM SUB,0.98,AC,48100,0,48100,50000,0,98100,42900,0,42900,41700,0,84600,A2,AG/LTD,,,
2839,65-1-0-5-0,7733-87-0885,SNGL FAM SUB,9.8,AC,40000,0,40000,0,0,40000,34700,0,34700,0,0,34700,A2,AG/LTD,,,
2840,63-1-0-178-A,7724-03-6028,SNGL FAM SUB,0.45,AC,87500,0,87500,44300,1000,132800,76100,0,76100,38000,1000,115100,R3,RES/GEN,,,
2841,67-3-G-2-0,7723-54-5073,SNGL FAM SUB,0,AC,184000,0,184000,338000,8500,530500,160000,0,160000,278600,8000,446600,R1,RES/LTD,,,
2842,58-1-0-11-0,7716-36-3751,SNGL FAM SUB,3.46,AC,130900,0,130900,231700,25300,387900,121400,0,121400,190000,17600,329000,A2,AG/LTD,,,
2843,58-1-0-8-0,7716-47-0133,SNGL FAM SUB,2.026,AC,166800,0,166800,751800,0,918600,145000,0,145000,625300,0,770300,A2,AG/LTD,,,
2844,57-2-0-15-0,7716-27-0085,SNGL FAM SUB,0.74,AC,84200,0,84200,177900,38800,300900,75200,0,75200,150000,33700,258900,A2,AG/LTD,,,
2845,5-1-0-30-A,6823-13-0255,SNGL FAM SUB,5.285,AC,61600,0,61600,1000,0,62600,60400,0,60400,1000,0,61400,A1,AG/GEN,,,
2846,6-1-0-4-F,6823-87-1610,SNGL FAM SUB,6,AC,65200,0,65200,339700,0,404900,64000,0,64000,293200,0,357200,A1,AG/GEN,,,
2847,6-1-0-4-D,6823-87-2848,SNGL FAM SUB,6,AC,65200,0,65200,0,0,65200,64000,0,64000,0,0,64000,A1,AG/GEN,,,
2848,57-2-0-13-0,7716-16-7918,SNGL FAM SUB,1.151,AC,102400,0,102400,71700,1000,175100,91500,0,91500,60400,1000,152900,A2,AG/LTD,,,
2849,46-1-0-57-0,7716-17-6227,Parsonage,3.392,AC,153500,0,153500,312600,40500,506600,137200,0,137200,267500,46600,451300,A2,AG/LTD,,,
2851,32-11-0-5-0,6778-88-9126,SNGL FAM SUB,6.25,AC,139700,0,139700,506300,30600,676600,124900,0,124900,418300,30300,573500,A2,AG/LTD,,,
2852,58-1-0-14-0,7716-36-3098,SNGL FAM SUB,3.3,AC,128200,0,128200,0,0,128200,119000,0,119000,0,0,119000,A2,AG/LTD,,,
2853,58-1-0-15-0,7716-35-3879,SNGL FAM SUB,3.3,AC,128200,0,128200,0,0,128200,119000,0,119000,0,0,119000,A2,AG/LTD,,,
2854,47-1-0-16-0,7716-27-2730,SNGL FAM SUB,5,AC,190200,0,190200,98800,4800,293800,170000,0,170000,83400,4800,258200,A2,AG/LTD,,,
2855,57-2-0-5-0,7716-26-0569,SNGL FAM SUB,2.968,AC,143900,0,143900,0,0,143900,128500,0,128500,0,0,128500,A2,AG/LTD,,,
2856,58-4-A-1-0,7716-47-8110,SNGL FAM SUB,0,AC,20100,0,20100,0,0,20100,18300,0,18300,0,0,18300,A2,AG/LTD,,,
2857,45-1-0-122-0,6797-77-9502,SNGL FAM SUB,1.02,AC,70400,0,70400,77600,0,148000,62800,0,62800,64200,0,127000,A2,AG/LTD,,,
2858,58-1-0-5-0,7716-37-5161,SNGL FAM SUB,3,AC,134200,0,134200,128000,100,262300,119800,0,119800,106800,100,226700,A2,AG/LTD,,,
2859,46-18-0-C-0,7708-00-2629,SNGL FAM SUB,3.8,AC,156200,0,156200,0,0,156200,139600,0,139600,0,0,139600,A2,AG/LTD,,,
2860,63-21-0-2-A,7715-82-8076,SNGL FAM SUB,2,AC,128800,0,128800,46100,1000,175900,112000,0,112000,39600,1000,152600,A2,AG/LTD,,,
2861,44-10-0-2-0,6787-53-2954,SNGL FAM SUB,4.84,AC,120800,0,120800,0,0,120800,107900,0,107900,0,0,107900,A2,AG/LTD,,,
2863,31-1-0-26-B,6768-94-1863,SNGL FAM SUB,2,AC,78500,0,78500,146400,20600,245500,70100,0,70100,118900,22500,211500,A2,AG/LTD,,,
2864,19-5-0-4-0,6739-19-7729,SNGL FAM SUB,1.448,AC,57400,0,57400,138000,1500,196900,54100,0,54100,115500,1500,171100,A1,AG/GEN,,,
2865,33-1-0-8-0,6798-46-8332,SNGL FAM SUB,1.36,AC,68300,0,68300,0,0,68300,60900,0,60900,0,0,60900,A2,AG/LTD,,,
2866,31-20-0-1-0,6769-65-1697,SNGL FAM SUB,1.467,AC,66800,0,66800,123700,0,190500,60200,0,60200,102800,0,163000,A2,AG/LTD,,,
2867,31-19-0-1-0,6779-40-2854,SNGL FAM SUB,1.83,AC,76100,0,76100,236000,28400,340500,67900,0,67900,193600,24600,286100,A2,AG/LTD,,,
2868,31-19-0-3-0,6779-30-6478,SNGL FAM SUB,2.43,AC,84700,0,84700,214500,3000,302200,75600,0,75600,175400,2100,253100,A2,AG/LTD,,,
2869,31-19-0-4-0,6779-30-4235,SNGL FAM SUB,4.43,AC,109400,0,109400,229000,1500,339900,97700,0,97700,187800,1500,287000,A2,AG/LTD,,,
2870,31-19-0-5-0,6778-29-9983,SNGL FAM SUB,6.144,AC,122700,0,122700,275900,17700,416300,109700,0,109700,225000,14400,349100,A2,AG/LTD,,,
2871,63-30-0-E-0,7715-60-6236,SNGL FAM SUB,1.57,AC,120000,0,120000,347200,0,467200,104400,0,104400,293500,0,397900,A2,AG/LTD,,,
2872,63-30-0-F-0,7715-60-6496,SNGL FAM SUB,2.51,AC,139200,0,139200,243600,0,382800,121000,0,121000,209100,0,330100,A2,AG/LTD,,,
2873,46-1-0-2-C,7708-00-8298,SNGL FAM SUB,3.22,AC,143000,0,143000,0,0,143000,127800,0,127800,0,0,127800,A2,AG/LTD,,,
2874,46-1-0-2-0,7708-10-1996,AG 20-100 AC,50.1,AC,927100,810500,116600,116000,0,1043100,828800,725200,103600,96900,0,925700,A2,AG/LTD,,,
2875,46-18-0-D-0,7708-01-0458,SNGL FAM SUB,13.41,AC,335600,0,335600,435700,0,771300,299700,0,299700,359500,0,659200,A2,AG/LTD,,,
2876,57-2-0-14-0,7716-16-8969,SNGL FAM SUB,1.262,AC,105000,0,105000,116300,17000,238300,93700,0,93700,97500,14400,205600,A2,AG/LTD,,,
2877,58-1-0-1-0,7716-27-2014,SNGL FAM SUB,2,AC,121800,0,121800,0,0,121800,108800,0,108800,0,0,108800,A2,AG/LTD,,,
2878,31-12-0-4-A,6769-66-0420,SNGL FAM SUB,9.224,AC,151500,0,151500,450300,37800,639600,140600,0,140600,391900,0,532500,A2,AG/LTD,,,
2879,46-1-0-53-A,7716-09-2221,SNGL FAM SUB,1.235,AC,104400,0,104400,134000,12200,250600,93200,0,93200,111900,11300,216400,A2,AG/LTD,,,
2880,32-1-0-59-0,6779-95-9237,SNGL FAM SUB,6.1,AC,125300,0,125300,1067700,0,1193000,111800,0,111800,890100,0,1001900,A2,AG/LTD,,,
2881,32-1-0-59-A,6789-05-1587,SNGL FAM SUB,5.13,AC,113700,0,113700,116200,5400,235300,101400,0,101400,99600,5400,206400,A2,AG/LTD,,,
2882,31-1-0-49-0,6769-75-5656,AG 20-100 AC,29.08,AC,283600,227200,56400,0,0,283600,257300,205400,51900,0,0,257300,A2,AG/LTD,,,
2883,45-1-0-43-D,6796-07-7413,SNGL FAM SUB,15.67,AC,321100,0,321100,752800,42000,1115900,286500,0,286500,606500,35100,928100,A2,AG/LTD,,,
2884,32-1-0-50-B,6778-92-6418,SNGL FAM SUB,10.45,AC,166200,0,166200,321000,18600,505800,147900,0,147900,287100,14800,449800,A2,AG/LTD,,,
2885,46-9-0-B-5,7707-77-9606,SNGL FAM SUB,6.24,AC,173600,0,173600,233100,3500,410200,157800,0,157800,200400,3500,361700,A2,AG/LTD,,,
2886,32-10-2-9-0,6779-50-8456,SNGL FAM SUB,3.27,AC,100000,0,100000,205000,15400,320400,89400,0,89400,170300,15000,274700,A2,AG/LTD,,,
2887,58-1-0-82-0,7716-65-1744,SNGL FAM SUB,3.49,AC,173900,0,173900,618900,43600,836400,151300,0,151300,520800,37500,709600,A2,AG/LTD,,,
2888,28-1-0-70-B,6739-05-2342,SNGL FAM SUB,3,AC,60800,0,60800,119100,0,179900,59300,0,59300,102500,0,161800,A1,AG/GEN,,,
2889,62-3-C-19-0,7714-04-5369,SNGL FAM SUB,0,AC,115000,0,115000,258200,17200,390400,100000,0,100000,241800,17200,359000,R1,RES/LTD,,,
2891,38-1-0-77-0,6707-93-1938,AG 20-100 AC,28.7,AC,87800,74600,13200,0,0,87800,86100,73900,12200,0,0,86100,A1,AG/GEN,,,
2892,38-1-0-78-0,6707-84-5245,AG 20-100 AC,30,AC,108000,94200,13800,0,0,108000,105000,92200,12800,0,0,105000,A1,AG/GEN,,,
2893,37-1-0-3-0,6707-81-5957,AG > 100 AC,957.06,AC,2361600,1788200,573400,290800,17000,2669400,2320400,1798800,521600,258200,17000,2595600,A1M2,AG/GEN,,,
2894,38-8-0-1-0,6706-79-5867,SNGL FAM SUB,6.188,AC,70400,0,70400,329400,0,399800,69100,0,69100,280000,0,349100,A1,AG/GEN,,,
2897,38-1-0-42-0,6707-52-3513,SNGL FAM SUB,4,AC,55600,53800,1800,0,0,55600,54500,52800,1700,0,0,54500,A1,AG/GEN,,,
2898,30-1-0-35-0,6758-04-2647,AG > 100 AC,139.42,AC,861200,795800,65400,0,0,861200,844500,785100,59400,0,0,844500,A1A2,AG GEN/,,,
2899,15-2-0-4-0,5789-87-1136,AG 20-100 AC,55.15,AC,149800,85000,64800,414300,14400,578500,110300,86700,23600,346500,12000,468800,A1,AG/GEN,,,
2900,24-1-0-4-0,5789-84-8551,AG > 100 AC,118,AC,177000,116800,60200,0,0,177000,177000,126300,50700,0,0,177000,A1,AG/GEN,,,
2901,15-5-0-37-0,5880-70-6872,SNGL FAM SUB,8.11,AC,64400,0,64400,0,0,64400,62900,0,62900,0,0,62900,A1,AG/GEN,,,
2902,15-5-0-38-0,5880-71-8022,SNGL FAM SUB,8.11,AC,64400,0,64400,0,0,64400,62900,0,62900,0,0,62900,A1,AG/GEN,,,
2903,38-1-0-41-A,6707-52-2911,SNGL FAM SUB,5.5,AC,64000,61500,2500,0,0,64000,62800,60500,2300,0,0,62800,A1,AG/GEN,,,
2904,41-1-0-7-A,6748-50-8905,SNGL FAM SUB,5.487,AC,95700,0,95700,0,0,95700,89400,0,89400,0,0,89400,A1,AG/GEN,,,
2905,41-1-0-7-B,6748-61-1349,SNGL FAM SUB,4.641,AC,88500,0,88500,0,0,88500,81900,0,81900,0,0,81900,A1,AG/GEN,,,
2906,41-2-0-22-0,6748-41-7659,SNGL FAM SUB,1.69,AC,60900,0,60900,177200,22700,260800,56400,0,56400,147000,18600,222000,A1,AG/GEN,,,
2907,18-1-0-43-0,6820-04-3461,AG 20-100 AC,29.97,AC,102200,85400,16800,0,10200,112400,104900,89100,15800,0,9800,114700,A1,AG/GEN,,,
2908,28-1-0-73-D,6739-16-7049,SNGL FAM SUB,3,AC,60800,0,60800,0,0,60800,60300,0,60300,0,0,60300,A1,AG/GEN,,,
2909,29-10-0-G-0,6749-96-2240,SNGL FAM SUB,1.15,AC,55500,0,55500,296000,2600,354100,51400,0,51400,247100,2600,301100,A1,AG/GEN,,,
2910,64-12-A-5-0,7724-50-8626,SNGL FAM SUB,0.53,AC,77000,0,77000,159600,1500,238100,67000,0,67000,135400,1500,203900,R1,RES/LTD,,,
2911,58-1-0-23-B,7716-54-7332,SNGL FAM SUB,1.26,AC,115200,0,115200,173600,1000,289800,100300,0,100300,148500,1000,249800,A2,AG/LTD,,,
2912,46-9-0-B-6,7707-87-7606,SNGL FAM SUB,1.42,AC,94000,0,94000,171400,600,266000,85500,0,85500,145000,700,231200,A2,AG/LTD,,,
2915,46-2-0-2-B,7707-73-5371,SNGL FAM SUB,3.05,AC,152300,0,152300,215600,900,368800,136100,0,136100,183400,900,320400,A2,AG/LTD,,,
2916,4-2-0-8-0,6814-10-6182,SNGL FAM SUB,2.44,AC,51100,0,51100,0,0,51100,50000,0,50000,0,0,50000,A1,AG/GEN,,,
2917,45-1-0-78-0,6797-72-4977,AG 20-100 AC,22.617,AC,388000,376800,11200,0,0,388000,347400,337700,9700,0,0,347400,A2,AG/LTD,,,
2919,57-18-0-2-0,7715-03-3050,SNGL FAM SUB,15,AC,561500,0,561500,710900,45700,1318100,488400,0,488400,592000,36500,1116900,A2,AG/LTD,,,
2921,54-5-0-18-0,6766-53-7918,SNGL FAM SUB,5.2,AC,134400,0,134400,260500,2800,397700,125400,0,125400,243600,2900,371900,A2,AG/LTD,,,
2922,46-23-0-43-0,7707-94-1490,Cmn Area/Open Spc,0.806,AC,0,0,0,0,0,0,0,0,0,0,0,0,A2,AG/LTD,,,
2924,55-14-0-A-0,6786-31-5160,Cmn Area/Open Spc,1.1,AC,0,0,0,0,0,0,0,0,0,0,0,0,A2,AG/LTD,,,
2928,58-7-0-1-0,7716-65-2069,SNGL FAM SUB,4.1,AC,171600,0,171600,0,5400,177000,149200,0,149200,0,4500,153700,A2,AG/LTD,,,
2929,47-1-0-75-0,7716-67-0366,SNGL FAM SUB,1.11,AC,102400,0,102400,202200,19200,323800,91400,0,91400,170300,19200,280900,A2,AG/LTD,,,
2933,58-4-H-16-0,7716-56-9243,SNGL FAM SUB,0,AC,20100,0,20100,0,0,20100,18300,0,18300,0,0,18300,A2,AG/LTD,,,
2934,58-4-H-34-0,7716-66-1035,SNGL FAM SUB,0,AC,10000,0,10000,0,0,10000,9100,0,9100,0,0,9100,A2,AG/LTD,,,
2937,58-4-H-1-0,7716-57-8203,SNGL FAM SUB,2.014,AC,110000,0,110000,439800,48400,598200,100000,0,100000,366000,39900,505900,A2,AG/LTD,,,
2941,4-2-0-15-0,6814-30-0614,SNGL FAM SUB,3,AC,50300,0,50300,223900,0,274200,49300,0,49300,185200,0,234500,A1,AG/GEN,,,
2942,4-2-0-18-0,6814-20-5129,SNGL FAM SUB,3.63,AC,53700,0,53700,0,0,53700,52500,0,52500,0,0,52500,A1,AG/GEN,,,
2943,4-2-0-22-0,6813-39-2961,SNGL FAM SUB,4.38,AC,57700,0,57700,226300,4900,288900,56500,0,56500,198400,0,254900,A1,AG/GEN,,,
2944,4-3-0-16-0,6803-82-6497,SNGL FAM SUB,3.48,AC,52900,0,52900,0,0,52900,51800,0,51800,0,0,51800,A1,AG/GEN,,,
2945,4-3-0-22-0,6813-03-4549,SNGL FAM SUB,4.37,AC,57600,0,57600,0,0,57600,56400,0,56400,0,0,56400,A1,AG/GEN,,,
2946,5-3-0-22-0,6824-20-7401,SNGL FAM SUB,5.16,AC,71500,0,71500,330900,4100,406500,70100,0,70100,288100,4700,362900,A1,AG/GEN,,,
2947,56-1-0-11-A,6795-19-2765,SNGL FAM SUB,15.85,AC,264700,120100,144600,690100,75200,1030000,236100,107200,128900,563100,74600,873800,A2,AG/LTD,,,
2948,32-1-0-21-0,6779-91-5566,SNGL FAM SUB,1,AC,64100,63600,500,0,0,64100,57200,56800,400,0,0,57200,A2,AG/LTD,,,
2949,12-1-0-5-0,6822-75-4741,SNGL FAM SUB,3,AC,53400,0,53400,0,0,53400,49900,0,49900,0,0,49900,A1,AG/GEN,,,
2950,29-3-0-5-0,6749-72-9835,SNGL FAM SUB,3.535,AC,78600,0,78600,202500,6600,287700,75000,0,75000,167900,6800,249700,A1,AG/GEN,,,
2951,32-1-0-7-0,6779-83-7779,SNGL FAM SUB,17.74,AC,273400,176800,96600,128000,4100,405500,244700,158800,85900,104400,4100,353200,A2,AG/LTD,,,
2952,32-1-0-8-0,6779-84-9534,SNGL FAM SUB,7,AC,150500,147200,3300,0,0,150500,134600,131600,3000,0,0,134600,A2,AG/LTD,,,
2953,32-1-0-9-0,6779-93-3489,SNGL FAM SUB,18,AC,219800,210700,9100,0,0,219800,195900,188100,7800,0,0,195900,A2,AG/LTD,,,
2954,32-1-0-20-0,6779-92-2363,AG 20-100 AC,44.9,AC,511900,489300,22600,0,1500,513400,458000,438700,19300,0,1500,459500,A2,AG/LTD,,,
2955,46-1-0-10-B,7707-09-9538,SNGL FAM SUB,1.14,AC,80900,0,80900,0,0,80900,72200,0,72200,0,0,72200,A2,AG/LTD,,,
2956,46-1-0-9-B,7707-19-6428,SNGL FAM SUB,1,AC,78500,0,78500,0,0,78500,70100,0,70100,0,0,70100,A2,AG/LTD,,,
2957,62-13-A-4-0,7714-05-4524,SNGL FAM SUB,0,AC,115000,0,115000,269900,2400,387300,100000,0,100000,246400,1700,348100,R1,RES/LTD,,,
2958,46-1-0-10-A,7707-19-3583,SNGL FAM SUB,1.13,AC,80700,0,80700,89600,1100,171400,72100,0,72100,76400,1100,149600,A2,AG/LTD,,,
2959,26-1-0-65-B,6719-14-1706,SNGL FAM SUB,1.93,AC,45600,0,45600,228600,31200,305400,43600,0,43600,190500,26000,260100,A1,AG/GEN,,,
2960,55-16-0-2-0,6776-73-0763,SNGL FAM SUB,3.9,AC,120900,0,120900,177200,11400,309500,108100,0,108100,144200,10300,262600,A2,AG/LTD,,,
2961,63-3-A-7-0,7714-81-8498,SNGL FAM SUB,0,AC,70000,0,70000,384400,600,455000,60000,0,60000,339700,600,400300,R1,RES/LTD,,,
2962,32-12-0-2-0,6779-93-9946,SNGL FAM SUB,13.99,AC,220000,149600,70400,31300,2800,254100,196200,133400,62800,26400,2000,224600,A2,AG/LTD,,,
2963,44-1-0-33-0,6787-13-4287,SNGL FAM SUB,2.35,AC,91400,0,91400,162000,14600,268000,81600,0,81600,132600,12300,226500,A2,AG/LTD,,,
2970,55-17-0-1-0,6785-46-5259,SNGL FAM SUB,3.258,AC,110100,0,110100,214200,41200,365500,98200,0,98200,175000,36200,309400,A2,AG/LTD,,,
2971,17-4-0-1-0,6810-33-6658,AG 20-100 AC,21.342,AC,111400,97500,13900,0,0,111400,109200,97100,12100,0,0,109200,A1,AG/GEN,,,
2972,17-4-0-3-A,6810-32-0727,SNGL FAM SUB,5.339,AC,65200,0,65200,256900,0,322100,61900,0,61900,210700,0,272600,A1,AG/GEN,,,
2973,27-1-0-76-B,6728-45-5925,SNGL FAM SUB,1,AC,38800,0,38800,76300,200,115300,38000,0,38000,65300,200,103500,A1,AG/GEN,,,
2974,9-1-0-77-E,5892-86-8551,SNGL FAM SUB,2.001,AC,42400,0,42400,152500,0,194900,41500,0,41500,132600,0,174100,A1,AG/GEN,,,
2975,17-4-0-4-0,6810-22-6679,SNGL FAM SUB,2.352,AC,48100,0,48100,210100,1000,259200,45400,0,45400,182300,1000,228700,A1,AG/GEN,,,
2976,27-1-0-12-A,6719-61-3190,SNGL FAM SUB,0.968,AC,37600,0,37600,141100,500,179200,36800,0,36800,120300,600,157700,A1,AG/GEN,,,
2977,17-4-0-2-0,6810-33-2160,SNGL FAM SUB,5.336,AC,65200,0,65200,0,0,65200,61800,0,61800,0,0,61800,A1,AG/GEN,,,
2978,54-5-0-5-0,6766-73-0833,SNGL FAM SUB,5.967,AC,141500,0,141500,437200,1900,580600,132000,0,132000,401500,2000,535500,A2,AG/LTD,,,
2979,46-1-0-30-0,7707-23-8949,SNGL FAM SUB,1.197,AC,103500,0,103500,84800,300,188600,92400,0,92400,72200,300,164900,RR,RES/RUR,,,
2980,42-16-B-9-0,6757-94-3483,SNGL FAM SUB,2,AC,112100,0,112100,162700,1200,276000,101800,0,101800,153200,1300,256300,R1,RES/LTD,,,
2982,10-7-0-A-1,6801-81-1741,SNGL FAM SUB,3,AC,48000,8300,39700,254100,21500,323600,47000,8100,38900,223100,20800,290900,A1,AG/GEN,,,
2983,32-12-0-5-0,6789-02-4652,SNGL FAM SUB,16.39,AC,230300,222700,7600,0,0,230300,204900,197900,7000,0,0,204900,A2,AG/LTD,,,
2984,12-16-0-2-0,6822-90-4630,SNGL FAM SUB,10,AC,91700,87000,4700,0,0,91700,90800,86500,4300,0,0,90800,A1,AG/GEN,,,
2985,12-1-0-17-A,6822-91-7005,AG 20-100 AC,29,AC,202500,149000,53500,340900,31900,575300,199100,147600,51500,283300,29300,511700,A1,AG/GEN,,,
2986,63-32-0-C-0,7723-08-9881,SNGL FAM SUB,1.838,AC,186900,0,186900,665500,0,852400,162500,0,162500,587300,0,749800,R1,RES/LTD,,,
2988,57-1-0-6-0,7706-44-1577,SNGL FAM SUB,10.08,AC,360700,355700,5000,0,0,360700,313900,309600,4300,0,0,313900,A2,AG/LTD,,,
2989,57-1-0-9-0,7706-43-1992,SNGL FAM SUB,19.09,AC,569400,412900,156500,402400,87600,1059400,495200,359000,136200,349000,50800,895000,A2,AG/LTD,,,
2990,57-1-0-10-0,7706-43-0556,SNGL FAM SUB,4.27,AC,209900,207900,2000,0,0,209900,182500,180700,1800,0,0,182500,A2,AG/LTD,,,
2991,39-1-0-88-B,6727-13-6001,SNGL FAM SUB,3.13,AC,51800,0,51800,0,7000,58800,50800,0,50800,0,7500,58300,A1,AG/GEN,,,
2992,58-1-0-51-0,7725-08-2521,SNGL FAM SUB,4.8,AC,185900,0,185900,144100,2500,332500,161600,0,161600,121800,2500,285900,A2,AG/LTD,,,
2993,57-1-0-74-0,7706-82-6454,AG 20-100 AC,20.698,AC,792600,576000,216600,495500,41000,1329100,688900,500600,188300,420200,34200,1143300,A2,AG/LTD,,,
2994,57-1-0-74-A,7706-82-1344,SNGL FAM SUB,0.85,AC,26600,26200,400,0,0,26600,23100,22700,400,0,0,23100,A2,AG/LTD,,,
2995,45-1-0-107-0,6798-61-1533,SNGL FAM SUB,1.05,AC,60300,0,60300,92000,5400,157700,53800,0,53800,76000,5400,135200,A2,AG/LTD,,,
2996,26-1-0-35-L,6708-93-5059,SNGL FAM SUB,3,AC,50000,0,50000,202600,36500,289100,49000,0,49000,180600,30000,259600,A1,AG/GEN,,,
2997,67-2-C-17-0,7723-55-5147,SNGL FAM SUB,0,AC,184000,0,184000,511000,0,695000,160000,0,160000,434000,0,594000,R1,RES/LTD,,,
2998,30-1-0-111-A,6759-84-4269,AG 20-100 AC,71.13,AC,576000,540100,35900,0,0,576000,537200,506700,30500,0,0,537200,A2,AG/LTD,,,
2999,19-11-0-1-0,6831-31-6095,AG 20-100 AC,21.65,AC,177100,0,177100,425100,0,602200,167600,0,167600,350700,0,518300,A1,AG/GEN,,,
3000,19-11-0-2-A,6831-31-7865,SNGL FAM SUB,16.227,AC,141900,0,141900,0,0,141900,136700,0,136700,0,0,136700,A1,AG/GEN,,,
3001,19-11-0-2-B,6831-41-6684,AG 20-100 AC,26.12,AC,155600,0,155600,0,0,155600,148900,0,148900,0,0,148900,A1,AG/GEN,,,
3002,19-11-0-3-0,6831-51-8846,SNGL FAM SUB,0.9,AC,44400,0,44400,219900,0,264300,42200,0,42200,199600,0,241800,A1,AG/GEN,,,
3003,55-14-0-1-0,6785-38-2931,AG 20-100 AC,24.16,AC,367100,0,367100,612400,40400,1019900,328100,0,328100,508500,39200,875800,A2,AG/LTD,,,
3005,55-14-0-4-0,6785-38-6055,SNGL FAM SUB,13.29,AC,238900,0,238900,885600,7900,1132400,213500,0,213500,719200,5500,938200,A2,AG/LTD,,,
3006,46-23-0-36-0,7707-95-2808,SNGL FAM SUB,2.152,AC,165000,0,165000,192300,0,357300,150000,0,150000,162500,0,312500,A2,AG/LTD,,,
3007,6-1-0-10-0,6823-74-6565,SNGL FAM SUB,3,AC,49900,0,49900,146700,30300,226900,49000,0,49000,129400,25600,204000,A1,AG/GEN,,,
3008,50-5-0-6-0,6726-54-2103,SNGL FAM SUB,13.9,AC,96200,0,96200,0,0,96200,92300,0,92300,0,0,92300,A1,AG/GEN,,,
3009,50-5-0-7-0,6726-53-1751,SNGL FAM SUB,11.79,AC,86500,0,86500,556100,0,642600,82800,0,82800,484700,0,567500,A1,AG/GEN,,,
3013,46-23-0-27-0,7707-84-1067,SNGL FAM SUB,2.009,AC,165000,0,165000,173700,1000,339700,150000,0,150000,144700,1000,295700,A2,AG/LTD,,,
3014,29-8-0-3-A,6759-07-5274,SNGL FAM SUB,1,AC,54000,0,54000,117100,500,171600,49900,0,49900,96800,500,147200,A1,AG/GEN,,,
3015,56-1-0-56-0,6796-56-0739,SNGL FAM SUB,0.96,AC,91100,90700,400,0,0,91100,79200,78800,400,0,0,79200,A2,AG/LTD,,,
3016,56-1-0-58-0,6796-66-6026,AG > 100 AC,104.25,AC,1501900,1342900,159000,60000,6800,1568700,1304600,1166100,138500,48900,6800,1360300,A2,AG/LTD,,,
3017,56-1-0-59-0,6796-45-9525,SNGL FAM SUB,18.6,AC,9400,0,9400,0,0,9400,8000,0,8000,0,0,8000,A2,AG/LTD,,,
3018,56-1-0-61-0,6796-54-6953,AG 20-100 AC,53.82,AC,502300,354500,147800,200000,92400,794700,436300,307700,128600,170600,80500,687400,A2,AG/LTD,,,
3019,56-1-0-62-0,6796-64-1228,SNGL FAM SUB,1,AC,4100,3600,500,0,0,4100,3600,3200,400,0,0,3600,A2,AG/LTD,,,
3020,56-1-0-65-0,6796-74-2538,AG 20-100 AC,55.9,AC,496900,469300,27600,0,0,496900,432600,408700,23900,0,0,432600,A2,AG/LTD,,,
3021,56-1-0-67-0,7706-06-2200,AG > 100 AC,136.69,AC,2224400,2157700,66700,0,0,2224400,1935100,1876600,58500,0,0,1935100,A2,AG/LTD,,,
3022,56-1-0-68-0,6796-85-6804,SNGL FAM SUB,6,AC,159000,156100,2900,0,0,159000,138300,135700,2600,0,0,138300,A2,AG/LTD,,,
3023,56-1-0-69-0,6796-84-6704,AG 20-100 AC,26,AC,400100,387000,13100,0,0,400100,348300,337100,11200,0,0,348300,A2,AG/LTD,,,
3024,56-1-0-71-0,6796-94-0202,AG 20-100 AC,22,AC,259300,248200,11100,0,0,259300,225600,216100,9500,0,0,225600,A2,AG/LTD,,,
3025,56-1-0-72-0,6796-73-9780,AG 20-100 AC,23.88,AC,328700,316700,12000,0,0,328700,286200,276000,10200,0,0,286200,A2,AG/LTD,,,
3026,38-1-0-5-A,6718-01-0556,SNGL FAM SUB,3,AC,50000,0,50000,142000,2100,194100,49000,0,49000,120100,2100,171200,A1,AG/GEN,,,
3027,38-1-0-5-B,6708-91-9395,SNGL FAM SUB,3.825,AC,54600,0,54600,0,0,54600,53500,0,53500,0,0,53500,A1,AG/GEN,,,
3028,17-6-0-Z-0,6800-75-2127,SNGL FAM SUB,18.67,AC,54600,0,54600,0,0,54600,54000,0,54000,0,0,54000,A1,AG/GEN,,,
3029,37-1-0-1-0,6707-36-0099,AG 20-100 AC,41.1,AC,99600,0,99600,0,0,99600,97800,0,97800,0,0,97800,A1,AG/GEN,,,
3030,38-1-0-36-0,6707-46-5291,AG 20-100 AC,25,AC,102500,0,102500,0,0,102500,100000,0,100000,0,0,100000,A1,AG/GEN,,,
3031,13-1-0-42-0,6841-75-0488,SNGL FAM SUB,4.88,AC,82700,0,82700,334900,45600,463200,81100,0,81100,288900,46000,416000,A1,AG/GEN,,,
3033,32-2-0-2-B,6778-86-5327,SNGL FAM SUB,10,AC,176600,0,176600,0,0,176600,158000,0,158000,0,0,158000,A2,AG/LTD,,,
3034,43-1-0-22-0,6767-65-4286,SNGL FAM SUB,11,AC,178100,0,178100,0,0,178100,159200,0,159200,0,0,159200,A2,AG/LTD,,,
3036,43-1-0-6-B,6767-47-1553,SNGL FAM SUB,0.98,AC,68700,0,68700,155300,0,224000,61300,0,61300,129200,0,190500,A2,AG/LTD,,,
3037,32-11-0-3-0,6778-88-4433,SNGL FAM SUB,5.25,AC,125300,0,125300,0,0,125300,112000,0,112000,0,0,112000,A2,AG/LTD,,,
3038,32-2-0-2-A,6778-85-3914,SNGL FAM SUB,1.23,AC,67400,0,67400,0,0,67400,60200,0,60200,0,0,60200,A2,AG/LTD,,,
3040,51-8-0-3-0,6735-49-0854,SNGL FAM SUB,3.43,AC,48500,0,48500,105100,800,154400,47600,0,47600,91800,800,140200,A1,AG/GEN,,,
3041,45-1-0-43-E,6796-06-6942,SNGL FAM SUB,15.69,AC,321400,0,321400,761700,26500,1109600,286800,0,286800,624600,22400,933800,A2,AG/LTD,,,
3042,58-1-0-72-T,7716-92-9194-9999,AG 20-100 AC,42.077,AC,2533000,2154500,378500,522700,446200,3501900,2217900,1873700,344200,445400,431200,3094500,A2,AG/LTD,,,
3043,67-13-C-5-0,7733-26-7816,SNGL FAM SUB,0,AC,265000,0,265000,371200,500,636700,220000,0,220000,325600,500,546100,R1,RES/LTD,,,
3044,6-9-0-11-0,6833-61-8343,SNGL FAM SUB,2.01,AC,42000,0,42000,30800,0,72800,41200,0,41200,25900,0,67100,A1,AG/GEN,,,
3045,18-1-0-41-0,6820-32-1076,AG 20-100 AC,76.59,AC,252100,177300,74800,321000,29000,602100,248700,178600,70100,272200,29000,549900,A1,AG/GEN,,,
3046,18-5-0-A-2,6820-43-3284,SNGL FAM SUB,9.47,AC,86500,82100,4400,0,0,86500,84600,80600,4000,0,0,84600,A1,AG/GEN,,,
3047,54-5-0-3-0,6766-64-7674,SNGL FAM SUB,5.232,AC,141500,0,141500,343000,2000,486500,132000,0,132000,310700,2100,444800,A2,AG/LTD,,,
3048,62-21-0-4-0,7714-08-4306,SNGL FAM SUB,8.01,AC,378700,0,378700,385400,11200,775300,329200,0,329200,356200,11200,696600,A2,AG/LTD,,,
3049,62-24-0-9-0,7714-07-0276,SNGL FAM SUB,2.01,AC,198000,0,198000,294000,0,492000,180000,0,180000,257800,0,437800,R1,RES/LTD,,,
3050,62-24-0-10-0,7714-07-3150,SNGL FAM SUB,3.12,AC,217800,0,217800,326400,2200,546400,198000,0,198000,284400,1500,483900,R1,RES/LTD,,,
3051,62-24-0-12-0,7714-06-0688,SNGL FAM SUB,2.06,AC,198000,0,198000,278600,17000,493600,180000,0,180000,244700,13900,438600,R1,RES/LTD,,,
3052,32-1-0-6-B,6779-95-5561,SNGL FAM SUB,1.66,AC,73600,0,73600,13300,1000,87900,65700,0,65700,14000,1000,80700,A2,AG/LTD,,,
3053,46-1-0-97-C,7707-99-3600,SNGL FAM SUB,1.393,AC,105300,0,105300,169500,1400,276200,95700,0,95700,144000,1400,241100,A2,AG/LTD,,,
3054,55-1-0-1-A,6776-83-0390,SNGL FAM SUB,8.987,AC,190700,0,190700,400600,20800,612100,170400,0,170400,336300,20800,527500,A2,AG/LTD,,,
3055,55-1-0-1-D,6776-73-6109,SNGL FAM SUB,3.97,AC,114900,0,114900,0,0,114900,102700,0,102700,0,0,102700,A2,AG/LTD,,,
3056,55-1-0-1-E,6776-73-7637,SNGL FAM SUB,3.26,AC,104200,0,104200,0,0,104200,93100,0,93100,0,0,93100,A2,AG/LTD,,,
3057,55-1-0-1-F,6776-83-1479,SNGL FAM SUB,0.29,AC,4400,0,4400,0,0,4400,3900,0,3900,0,0,3900,A2,AG/LTD,,,
3058,45-1-0-3-A,6798-00-3575,SNGL FAM SUB,0.99,AC,70100,0,70100,145700,5500,221300,62600,0,62600,122600,5500,190700,A2,AG/LTD,,,
3059,55-6-0-2-0,6785-26-5827,SNGL FAM SUB,2.82,AC,95200,0,95200,152600,1000,248800,85000,0,85000,125200,1000,211200,A2,AG/LTD,,,
3060,17-2-0-6-0,6810-47-3680,SNGL FAM SUB,5,AC,55300,0,55300,277800,1500,334600,52300,0,52300,223900,1500,277700,A1,AG/GEN,,,
3061,57-10-0-29-0,7705-96-1669,SNGL FAM SUB,4.1,AC,230000,0,230000,281100,3600,514700,210000,0,210000,259500,2600,472100,A2,AG/LTD,,,
3062,43-22-0-B-3,6766-87-8683,SNGL FAM SUB,6.35,AC,48100,0,48100,0,0,48100,42900,0,42900,0,0,42900,A2,AG/LTD,,,
3064,63-14-0-B-0,7714-73-4886,SNGL FAM SUB,19.24,AC,554800,0,554800,0,0,554800,504800,0,504800,0,0,504800,A2,AG/LTD,,,
3065,67-13-C-12-0,7733-36-4268,SNGL FAM SUB,0,AC,265000,0,265000,502500,600,768100,220000,0,220000,439000,600,659600,R1,RES/LTD,,,
3066,48-5-0-1-B,7738-01-0531,SNGL FAM SUB,2.97,AC,159100,0,159100,186100,0,345200,142000,0,142000,156600,0,298600,A2,AG/LTD,,,
3067,4-3-0-23-0,6813-04-7033,SNGL FAM SUB,3.34,AC,52100,0,52100,190200,0,242300,51000,0,51000,159600,0,210600,A1,AG/GEN,,,
3068,4-3-0-24-0,6813-04-9322,SNGL FAM SUB,3.41,AC,52500,0,52500,187300,3000,242800,51400,0,51400,157400,3000,211800,A1,AG/GEN,,,
3069,28-4-0-1-A,6739-00-8156,SNGL FAM SUB,1.1,AC,40800,0,40800,79300,2000,122100,40200,0,40200,66600,2000,108800,A1,AG/GEN,,,
3070,28-4-0-1-0,6739-10-0119,SNGL FAM SUB,2.34,AC,49900,0,49900,48100,0,98000,48600,0,48600,40900,0,89500,A1,AG/GEN,,,
3071,39-1-0-92-0,6727-24-0271,SNGL FAM SUB,9.77,AC,87900,0,87900,0,0,87900,86200,0,86200,0,0,86200,A1,AG/GEN,,,
3072,39-1-0-32-0,6727-13-1172,SNGL FAM SUB,5,AC,61200,0,61200,60800,200,122200,60000,0,60000,52700,200,112900,A1,AG/GEN,,,
3073,43-1-0-15-0,6767-37-9907,SNGL FAM SUB,1.973,AC,84100,0,84100,75400,13700,173200,75200,0,75200,53600,12300,141100,A2,AG/LTD,,,
3074,9-5-0-B-0,5892-44-5414,SNGL FAM SUB,2.22,AC,43200,0,43200,0,0,43200,42300,0,42300,0,0,42300,A1,AG/GEN,,,
3075,9-5-0-C-0,5892-43-3978,SNGL FAM SUB,3.32,AC,47200,0,47200,0,0,47200,45000,0,45000,0,0,45000,A1,AG/GEN,,,
3076,27-5-0-5-A,6728-67-1111,SNGL FAM SUB,2,AC,45400,0,45400,119900,100,165400,44500,0,44500,102100,100,146700,A1,AG/GEN,,,
3077,62-18-0-2-0,7704-74-1813,SNGL FAM SUB,3.27,AC,225400,0,225400,624900,3300,853600,200300,0,200300,557000,2800,760100,A2,AG/LTD,,,
3078,46-1-0-49-A,7707-61-1373,SNGL FAM SUB,0.25,AC,900,0,900,0,0,900,800,0,800,0,0,800,A2,AG/LTD,,,
3079,46-3-0-2-0,7707-61-2016,SNGL FAM SUB,5.1,AC,190000,0,190000,121200,4900,316100,169600,0,169600,105300,4900,279800,A2,AG/LTD,,,
3080,57-1-0-7-A,7706-53-0740,SNGL FAM SUB,4.63,AC,203900,0,203900,175600,5000,384500,177400,0,177400,148100,3500,329000,A2,AG/LTD,,,
3081,20-1-0-26-T,6749-09-7651-9999,AG 20-100 AC,56.36,AC,313700,180200,133500,0,12600,326300,299100,175800,123300,0,10600,309700,A1,AG/GEN,,,
3082,27-1-0-4-B,6719-72-4821,AG 20-100 AC,33.77,AC,176300,0,176300,570600,44400,791300,170700,0,170700,501900,21100,693700,A1,AG/GEN,,,
3083,62-18-0-14-0,7704-63-5315,SNGL FAM SUB,3.51,AC,231000,0,231000,380100,0,611100,200300,0,200300,341000,0,541300,A2,AG/LTD,,,
3084,56-1-0-64-0,6796-53-2200,SNGL FAM SUB,3.17,AC,152700,0,152700,236900,0,389600,132700,0,132700,202400,0,335100,A2,AG/LTD,,,
3086,42-16-B-10-0,6757-94-3538,SNGL FAM SUB,0.9,AC,91700,0,91700,0,500,92200,83300,0,83300,0,500,83800,R1,RES/LTD,,,
3087,42-16-D-6-0,6757-84-9423,SNGL FAM SUB,1.8,AC,110000,0,110000,287200,0,397200,99900,0,99900,277000,0,376900,R1,RES/LTD,,,
3088,42-16-D-6-A,6757-94-1039,SNGL FAM SUB,7,AC,16900,0,16900,0,0,16900,16100,0,16100,0,0,16100,R1,RES/LTD,,,
3089,42-16-C-2-0,6757-94-7680,SNGL FAM SUB,0.96,AC,81500,0,81500,0,0,81500,74000,0,74000,0,0,74000,R1,RES/LTD,,,
3090,42-16-C-3-0,6757-94-7763,SNGL FAM SUB,1.001,AC,81500,0,81500,226500,9900,317900,74000,0,74000,207200,8400,289600,R1,RES/LTD,,,
3091,57-1-0-7-B,7706-53-4955,SNGL FAM SUB,3.23,AC,167000,0,167000,138200,1000,306200,145400,0,145400,115600,1000,262000,A2,AG/LTD,,,
3092,6-1-0-4-B,6823-88-5517,SNGL FAM SUB,13.44,AC,98600,0,98600,272900,8700,380200,96700,0,96700,243700,6900,347300,A1,AG/GEN,,,
3093,14-2-0-5-B,6851-36-2425,SNGL FAM SUB,3.33,AC,69400,0,69400,65000,2000,136400,68000,0,68000,54000,2100,124100,A1,AG/GEN,,,
3094,65-1-0-7-0,7733-79-5132,SNGL FAM SUB,1.56,AC,10600,0,10600,0,0,10600,9200,0,9200,0,0,9200,A2R1,AG LTD/,,,
3095,27-1-0-51-A,6719-97-1269,AG 20-100 AC,34.92,AC,190700,107900,82800,400800,39500,631000,189100,105400,83700,325000,36000,550100,A1,AG/GEN,,,
3096,4-2-0-20-0,6813-29-3786,SNGL FAM SUB,3.8553,AC,54900,0,54900,318700,9700,383300,53700,0,53700,269900,8100,331700,A1,AG/GEN,,,
3097,6-4-0-B-0,6832-77-7709,Cmn Area/Open Spc,0,AC,0,0,0,0,0,0,0,0,0,0,0,0,A1,AG/GEN,,,
3098,6-4-0-C-0,6832-77-5895,Cmn Area/Open Spc,0,AC,0,0,0,0,0,0,0,0,0,0,0,0,A1,AG/GEN,,,
3099,12-8-0-B-0,6832-77-0080,Cmn Area/Open Spc,0,AC,0,0,0,0,0,0,0,0,0,0,0,0,A1,AG/GEN,,,
3100,12-8-0-C-0,6832-67-9048,Cmn Area/Open Spc,0,AC,0,0,0,0,0,0,0,0,0,0,0,0,A1,AG/GEN,,,
3101,12-8-0-11-0,6832-77-9533,SNGL FAM SUB,6.28,AC,95500,0,95500,376700,8800,481000,93600,0,93600,326900,6400,426900,A1,AG/GEN,,,
3103,9-1-0-84-A,5892-90-8426,SNGL FAM SUB,19.3,AC,46900,0,46900,0,0,46900,46100,0,46100,0,0,46100,A1,AG/GEN,,,
3104,46-14-0-8-0,7708-91-3576,SNGL FAM SUB,4.167,AC,149100,0,149100,424900,0,574000,135500,0,135500,357400,0,492900,A2,AG/LTD,,,
3105,55-14-0-22-0,6785-49-8920,SNGL FAM SUB,8.059,AC,169900,0,169900,707000,3500,880400,151800,0,151800,575900,3500,731200,A2,AG/LTD,,,
3106,58-22-A-3-0,7715-36-2891,SNGL FAM SUB,3.272,AC,383300,0,383300,462300,500,846100,351800,0,351800,420300,500,772600,A2,AG/LTD,,,
3107,15-5-0-36-0,5880-70-6508,SNGL FAM SUB,8.09,AC,64300,0,64300,0,0,64300,62800,0,62800,0,0,62800,A1,AG/GEN,,,
3108,55-14-0-20-0,6786-50-3670,SNGL FAM SUB,11.377,AC,213700,0,213700,471900,60800,746400,190900,0,190900,385100,56000,632000,A2,AG/LTD,,,
3109,67-10-0-26-0,7733-06-9695,SNGL FAM SUB,3.096,AC,340000,0,340000,658700,6500,1005200,285000,0,285000,536200,6700,827900,R1,RES/LTD,,,
3111,45-16-0-18-0,6798-52-4083,SNGL FAM SUB,1.97,AC,86300,0,86300,200200,4700,291200,77000,0,77000,163400,4400,244800,A2,AG/LTD,,,
3112,63-1-0-201-0,7723-37-7838,SNGL FAM SUB,9.029,AC,389800,0,389800,896500,3500,1289800,338900,0,338900,786200,3500,1128600,A2R1,AG LTD/,,,
3113,18-9-0-1-0,6729-39-8666,SNGL FAM SUB,2.11,AC,46700,0,46700,60600,300,107600,44700,0,44700,48100,200,93000,A1,AG/GEN,,,
3114,18-9-0-2-0,6729-49-1621,SNGL FAM SUB,2.26,AC,47600,0,47600,167300,500,215400,45600,0,45600,136100,500,182200,A1,AG/GEN,,,
3115,18-9-0-3-0,6729-39-8244,SNGL FAM SUB,8.59,AC,81900,0,81900,236700,13900,332500,79700,0,79700,192400,11800,283900,A1,AG/GEN,,,
3116,18-9-0-4-0,6729-38-6871,SNGL FAM SUB,8.48,AC,81300,0,81300,0,24000,105300,79100,0,79100,0,20900,100000,A1,AG/GEN,,,
3117,18-9-0-5-0,6729-38-5404,SNGL FAM SUB,9.66,AC,87500,0,87500,379100,2700,469300,85600,0,85600,309700,1900,397200,A1,AG/GEN,,,
3118,18-9-0-6-0,6729-38-3025,SNGL FAM SUB,8.85,AC,83300,0,83300,0,0,83300,81200,0,81200,0,0,81200,A1,AG/GEN,,,
3119,18-9-0-7-0,6729-37-1540,SNGL FAM SUB,8.33,AC,80500,0,80500,274400,0,354900,78300,0,78300,229800,0,308100,A1,AG/GEN,,,
3120,18-9-0-8-0,6729-37-4042,SNGL FAM SUB,11.7,AC,97800,0,97800,171700,8800,278300,96900,0,96900,141300,8100,246300,A1,AG/GEN,,,
3121,18-9-0-9-0,6729-37-8245,SNGL FAM SUB,8,AC,78600,0,78600,22600,600,101800,76500,0,76500,12300,600,89400,A1,AG/GEN,,,
3122,18-9-0-10-0,6729-47-1408,SNGL FAM SUB,8.6,AC,82000,0,82000,10600,2100,94700,79800,0,79800,10400,2100,92300,A1,AG/GEN,,,
3123,18-9-0-11-0,6729-47-3803,SNGL FAM SUB,8.5,AC,81400,0,81400,107600,1400,190400,79300,0,79300,83500,1400,164200,A1,AG/GEN,,,
3124,18-9-0-12-0,6729-48-6140,SNGL FAM SUB,12,AC,99400,0,99400,97200,12800,209400,98500,0,98500,78800,11700,189000,A1,AG/GEN,,,
3125,18-9-0-13-0,6729-48-8477,SNGL FAM SUB,11.9,AC,98900,0,98900,105800,5900,210600,98000,0,98000,84500,5900,188400,A1,AG/GEN,,,
3126,18-9-0-14-0,6729-48-5929,SNGL FAM SUB,8.03,AC,78800,0,78800,342900,1300,423000,76700,0,76700,282000,1300,360000,A1,AG/GEN,,,
3127,18-9-0-15-0,6729-49-8408,SNGL FAM SUB,2.41,AC,48500,0,48500,150300,0,198800,46500,0,46500,123900,0,170400,A1,AG/GEN,,,
3128,18-9-0-15-A,6729-49-3550,SNGL FAM SUB,2.24,AC,47400,0,47400,115900,1200,164500,45400,0,45400,89500,1200,136100,A1,AG/GEN,,,
3129,18-9-0-15-B,6729-49-5488,SNGL FAM SUB,2.16,AC,47000,0,47000,149100,3400,199500,45000,0,45000,121800,3400,170200,A1,AG/GEN,,,
3130,67-11-C-7-0,7733-26-8311,SNGL FAM SUB,0,AC,265000,0,265000,552200,37800,855000,220000,0,220000,497400,37100,754500,R1,RES/LTD,,,
3131,38-1-0-37-B,6707-55-1380,SNGL FAM SUB,8.01,AC,64900,0,64900,0,0,64900,63600,60200,3400,0,0,63600,A1,AG/GEN,,,
3132,67-13-C-4-0,7733-27-6040,SNGL FAM SUB,0,AC,265000,0,265000,617800,0,882800,220000,0,220000,531800,0,751800,R1,RES/LTD,,,
3133,31-1-0-85-0,6778-59-5001,SNGL FAM SUB,3.362,AC,98100,0,98100,58800,600,157500,87700,0,87700,49200,600,137500,A2,AG/LTD,,,
3134,31-1-0-85-A,6778-58-5448,SNGL FAM SUB,11.25,AC,181000,106400,74600,171200,22900,375100,161800,95300,66500,141400,20100,323300,A2,AG/LTD,,,
3135,11-1-0-7-0,6822-10-4696,SNGL FAM SUB,11.72,AC,87900,0,87900,0,0,87900,87500,0,87500,0,0,87500,A1,AG/GEN,,,
3136,11-1-0-11-0,6821-29-0050,SNGL FAM SUB,0.87,AC,35400,0,35400,181600,600,217600,34700,0,34700,159500,600,194800,A1,AG/GEN,,,
3137,2-3-0-26-0,6824-22-4299,SNGL FAM SUB,3.197,AC,47600,0,47600,233700,25400,306700,46600,0,46600,197700,23700,268000,A1,AG/GEN,,,
3138,5-1-0-50-A,6823-34-5316,SNGL FAM SUB,5,AC,51000,0,51000,77900,1500,130400,50200,0,50200,68100,1500,119800,A1,AG/GEN,,,
3139,11-1-0-11-A,6821-19-8159,SNGL FAM SUB,1,AC,38800,0,38800,160800,18900,218500,38000,0,38000,139800,17000,194800,A1,AG/GEN,,,
3140,20-1-0-61-0,6850-09-6920,AG 20-100 AC,59.97,AC,382200,302700,79500,1000,0,383200,374800,300500,74300,1000,0,375800,A1,AG/GEN,,,
3141,20-1-0-61-A,6850-19-4370,SNGL FAM SUB,2.83,AC,65800,64500,1300,0,0,65800,64600,63400,1200,0,0,64600,A1,AG/GEN,,,
3142,42-5-0-13-0,6767-04-3674,SNGL FAM SUB,0.54,AC,70000,0,70000,124200,200,194400,64000,0,64000,114000,200,178200,R3,RES/GEN,,,
3298,27-1-0-14-C,6718-59-8688,SNGL FAM SUB,0.44,AC,2500,0,2500,0,0,2500,2400,0,2400,0,0,2400,A1,AG/GEN,,,
3299,27-7-0-4-0,6718-68-5910,SNGL FAM SUB,18.69,AC,137900,0,137900,5000,0,142900,135300,0,135300,5000,0,140300,A1,AG/GEN,,,
3300,27-7-0-4-A,6718-69-2119,SNGL FAM SUB,5,AC,61200,0,61200,0,0,61200,60000,0,60000,0,0,60000,A1,AG/GEN,,,
3301,27-7-0-5-0,6718-58-8763,SNGL FAM SUB,11.5,AC,97600,0,97600,80000,1000,178600,95800,0,95800,68500,1000,165300,A1,AG/GEN,,,
3302,27-7-0-5-A,6718-58-4788,SNGL FAM SUB,1,AC,38800,0,38800,0,0,38800,38000,0,38000,0,0,38000,A1,AG/GEN,,,
3304,17-9-0-2-0,6810-04-3363,SNGL FAM SUB,2.438,AC,48600,0,48600,296900,0,345500,45900,0,45900,248000,0,293900,A1,AG/GEN,,,
3305,48-1-0-37-0,7727-81-1137,AG 20-100 AC,59.01,AC,1185500,1155900,29600,0,0,1185500,1059100,1033800,25300,0,0,1059100,A2,AG/LTD,,,
3306,48-1-0-37-A,7736-09-2723,AG 20-100 AC,43.4,AC,967400,945300,22100,0,3500,970900,864300,845600,18700,0,3500,867800,A2,AG/LTD,,,
3307,48-1-0-37-B,7727-90-2255,SNGL FAM SUB,2,AC,7200,6300,900,0,0,7200,6400,5500,900,0,0,6400,A2,AG/LTD,,,
3308,13-1-0-1-B,6841-19-5339,SNGL FAM SUB,2.34,AC,56500,0,56500,158900,3000,218400,55400,0,55400,139500,3000,197900,A1,AG/GEN,,,
3456,64-3-3-53-0,7724-73-9295,SNGL FAM SUB,0,AC,20200,0,20200,0,0,20200,17600,0,17600,0,0,17600,RN,RESIDEN,,,
3457,64-3-3-54-0,7724-83-1119,COMM & IND,0,AC,62200,0,62200,0,0,62200,56500,0,56500,0,0,56500,RN,RESIDEN,,,
3458,64-3-3-55-0,7724-83-2132,COMM & IND,0.45,AC,56000,0,56000,0,39300,95300,50900,0,50900,0,31400,82300,RN,RESIDEN,,,
3459,55-1-0-66-0,6786-73-2909,AG 20-100 AC,31.9,AC,481700,467000,14700,0,0,481700,430700,417100,13600,0,0,430700,A2,AG/LTD,,,
3460,55-1-0-70-A,6786-72-8899,SNGL FAM SUB,4.9,AC,106400,104100,2300,0,0,106400,95000,92900,2100,0,0,95000,A2,AG/LTD,,,
3461,55-1-0-70-B,6786-72-4957,SNGL FAM SUB,8.08,AC,150300,146500,3800,0,0,150300,134100,130700,3400,0,0,134100,A2,AG/LTD,,,
3462,55-1-0-75-0,6786-72-7203,SNGL FAM SUB,13.2,AC,254300,248200,6100,0,0,254300,227300,221700,5600,0,0,227300,A2,AG/LTD,,,
3463,56-1-0-1-A,6786-84-5261,AG 20-100 AC,20.72,AC,367900,358300,9600,0,0,367900,328800,320000,8800,0,0,328800,A2,AG/LTD,,,
3464,56-1-0-7-0,6796-02-0916,AG 20-100 AC,21.28,AC,249100,239200,9900,0,0,249100,222600,213500,9100,0,0,222600,A2,AG/LTD,,,
3465,56-1-0-8-0,6786-92-3834,SNGL FAM SUB,8.77,AC,144500,140400,4100,0,0,144500,129400,125600,3800,0,0,129400,A2,AG/LTD,,,
3143,20-1-0-66-0,6850-08-1264,AG 20-100 AC,86.84,AC,489400,446100,43300,0,6000,495400,479800,442600,37200,0,6000,485800,A1,AG/GEN,,,
3144,20-1-0-68-A,6850-07-0025,SNGL FAM SUB,19.98,AC,156000,146100,9900,0,0,156000,148100,139500,8600,0,0,148100,A1,AG/GEN,,,
3145,28-8-0-2-0,6729-71-8974,SNGL FAM SUB,3,AC,53800,0,53800,70400,3000,127200,51900,0,51900,62400,3000,117300,A1,AG/GEN,,,
3146,64-4-2-7-0,7724-93-4608,SNGL FAM SUB,0,AC,70000,0,70000,192500,500,263000,60000,0,60000,167100,500,227600,RN,RESIDEN,,,
3147,64-4-2-6-0,7724-93-3598,SNGL FAM SUB,0,AC,35000,0,35000,0,0,35000,30000,0,30000,0,0,30000,RN,RESIDEN,,,
3148,64-4-2-8-0,7724-93-4708,SNGL FAM SUB,0,AC,35000,0,35000,0,0,35000,30000,0,30000,0,0,30000,RN,RESIDEN,,,
3149,64-4-2-37-A,7724-93-5648,SNGL FAM SUB,0,AC,17200,0,17200,0,0,17200,15000,0,15000,0,0,15000,RN,RESIDEN,,,
3150,63-1-0-47-0,7714-34-7701,SNGL FAM SUB,1.526,AC,129200,0,129200,142100,3600,274900,112400,0,112400,123200,3600,239200,R3,RES/GEN,,,
3152,63-17-0-C-0,7714-34-7543,COMM & IND,1.646,AC,193400,0,193400,216400,0,409800,175700,0,175700,103900,57500,337100,RO,RES/OF,,,
3154,29-1-0-34-0,6748-43-7425,SNGL FAM SUB,1.85,AC,62500,0,62500,172100,3500,238100,57900,0,57900,124100,3700,185700,A1,AG/GEN,,,
3155,29-10-0-A-0,6749-85-4426,SNGL FAM SUB,1.15,AC,55500,0,55500,0,0,55500,51400,0,51400,0,0,51400,A1,AG/GEN,,,
3156,29-10-0-N-0,6749-85-9221,SNGL FAM SUB,9.01,AC,128000,0,128000,0,0,128000,125200,0,125200,0,0,125200,A1,AG/GEN,,,
3157,58-5-0-2-0,7726-44-4910,AG 20-100 AC,71.993,AC,3937700,3904500,33200,0,0,3937700,2425300,2394700,30600,0,0,2425300,A2,AG/LTD,,,
3159,46-12-0-3-0,7717-11-6689,SNGL FAM SUB,6,AC,159300,0,159300,457800,25700,642800,142400,0,142400,379500,25700,547600,A2,AG/LTD,,,
3160,14-2-0-4-A,6851-35-1864,SNGL FAM SUB,3.86,AC,71300,0,71300,131200,0,202500,69900,0,69900,112100,0,182000,A1,AG/GEN,,,
3161,45-1-0-78-C,6797-72-2681,SNGL FAM SUB,2.49,AC,100200,0,100200,112800,11000,224000,89500,0,89500,93200,10000,192700,A2,AG/LTD,,,
3162,45-1-0-78-D,6797-72-5455,SNGL FAM SUB,2.763,AC,103300,0,103300,193600,15100,312000,92300,0,92300,155800,12800,260900,A2,AG/LTD,,,
3163,67-2-C-19-0,7723-55-4467,SNGL FAM SUB,0,AC,184000,0,184000,294100,0,478100,160000,0,160000,253000,0,413000,R1,RES/LTD,,,
3164,4-1-0-31-0,6803-76-7621,SNGL FAM SUB,15.79,AC,121200,0,121200,0,0,121200,118900,0,118900,0,0,118900,A1,AG/GEN,,,
3165,20-1-0-7-0,6840-36-4506,SNGL FAM SUB,16.45,AC,172100,0,172100,177400,1500,351000,162700,0,162700,149400,1500,313600,A1,AG/GEN,,,
3166,4-1-0-30-0,6803-76-2153,SNGL FAM SUB,4,AC,55000,0,55000,0,0,55000,54000,0,54000,0,0,54000,A1,AG/GEN,,,
3167,28-1-0-39-0,6728-97-1082,SNGL FAM SUB,2,AC,45400,0,45400,0,0,45400,44500,0,44500,0,0,44500,A1,AG/GEN,,,
3168,18-1-0-69-0,6820-24-2341,AG 20-100 AC,97.76,AC,251700,206600,45100,0,100,251800,244400,202900,41500,0,100,244500,A1,AG/GEN,,,
3169,18-1-0-69-A,6820-43-3500,SNGL FAM SUB,1.25,AC,4500,3900,600,0,0,4500,4400,3900,500,0,0,4400,A1,AG/GEN,,,
3170,67-13-C-9-0,7733-36-2466,SNGL FAM SUB,0,AC,265000,0,265000,470300,3300,738600,220000,0,220000,370400,2300,592700,R1,RES/LTD,,,
3171,12-3-0-4-0,6831-07-9872,SNGL FAM SUB,18.57,AC,141300,0,141300,10200,200,151700,139600,0,139600,10200,200,150000,A1,AG/GEN,,,
3172,29-5-0-1-C,6749-74-0072,SNGL FAM SUB,1.72,AC,57900,0,57900,131100,500,189500,53700,0,53700,108400,500,162600,A1,AG/GEN,,,
3173,28-1-0-43-A,6738-17-8108,SNGL FAM SUB,0.75,AC,36800,0,36800,0,0,36800,37400,0,37400,0,0,37400,A1,AG/GEN,,,
3174,12-3-0-4-A,6831-08-5140,SNGL FAM SUB,1.01,AC,40100,0,40100,28000,600,68700,39600,0,39600,23900,600,64100,A1,AG/GEN,,,
3175,18-7-0-A-0,6810-98-6980,SNGL FAM SUB,2.14,AC,46800,0,46800,82700,2100,131600,44800,0,44800,71200,2100,118100,A1,AG/GEN,,,
3177,12-3-0-4-B,6831-17-1297,SNGL FAM SUB,3.52,AC,57300,0,57300,84600,200,142100,56600,0,56600,67500,200,124300,A1,AG/GEN,,,
3178,19-1-0-6-0,6821-91-8517,SNGL FAM SUB,10.06,AC,92000,0,92000,354400,30400,476800,82100,0,82100,294600,29000,405700,A1,AG/GEN,,,
3180,57-20-A-1-0,7706-92-3523,SNGL FAM SUB,9.953,AC,542400,0,542400,0,0,542400,497200,0,497200,0,0,497200,A2,AG/LTD,,,
3181,16-1-0-79-0,5799-98-0593,AG 20-100 AC,57.66,AC,111400,84800,26600,0,0,111400,108700,84200,24500,0,0,108700,A1,AG/GEN,,,
3182,18-6-0-7-0,6820-18-0624,SNGL FAM SUB,6.69,AC,72400,0,72400,167800,6600,246800,72100,0,72100,135800,5500,213400,A1,AG/GEN,,,
3183,17-1-0-84-0,6719-08-6844,SNGL FAM SUB,3.51,AC,54900,0,54900,114400,1200,170500,51800,0,51800,95000,1200,148000,A1,AG/GEN,,,
3184,29-17-0-4-B,6749-60-3403,SNGL FAM SUB,1.4,AC,58000,0,58000,174200,3900,236100,53700,0,53700,138100,300,192100,A1,AG/GEN,,,
3185,12-3-0-3-C,6831-08-6971,SNGL FAM SUB,1.21,AC,41600,0,41600,51600,1000,94200,41100,0,41100,43300,1000,85400,A1,AG/GEN,,,
3186,18-6-0-1-0,6810-99-8280,SNGL FAM SUB,2,AC,46000,0,46000,0,0,46000,43500,0,43500,0,0,43500,A1,AG/GEN,,,
3188,18-7-0-B-2,6810-98-8854,SNGL FAM SUB,1.45,AC,42700,0,42700,0,0,42700,40700,0,40700,0,0,40700,A1,AG/GEN,,,
3189,28-1-0-4-0,6729-84-0169,SNGL FAM SUB,4.022,AC,65600,0,65600,184400,2400,252400,61900,0,61900,152500,1700,216100,A1,AG/GEN,,,
3190,20-1-0-95-0,6759-17-5216,SNGL FAM SUB,2.17,AC,65700,0,65700,113700,8800,188200,62100,0,62100,91600,4500,158200,A1,AG/GEN,,,
3194,46-27-A-15-0,7707-84-1507,SNGL FAM SUB,3.102,AC,165000,0,165000,403100,19800,587900,150000,0,150000,336200,19800,506000,RR,RES/RUR,,,
3195,44-1-0-64-0,6786-56-2907,AG 20-100 AC,79.604,AC,1199900,1090800,109100,428600,34300,1662800,1074700,978400,96300,339300,12100,1426100,A2,AG/LTD,,,
3196,27-1-0-54-0,6729-25-9803,AG 20-100 AC,32.76,AC,124000,108900,15100,0,0,124000,126300,112400,13900,0,0,126300,A1,AG/GEN,,,
3197,58-1-0-74-0,7726-03-1109,SNGL FAM SUB,6.85,AC,311800,0,311800,102000,300,414100,271000,0,271000,87200,300,358500,A2,AG/LTD,,,
3198,58-1-0-74-A,7726-03-2553,SNGL FAM SUB,4,AC,212700,0,212700,505300,53300,771300,184900,0,184900,420000,46200,651100,A2,AG/LTD,,,
3199,63-1-0-81-A,7723-09-3689,SNGL FAM SUB,4.285,AC,257900,0,257900,1204800,168200,1630900,224200,0,224200,1044500,146000,1414700,R1,RES/LTD,,,
3200,63-19-0-A-0,7724-05-6241,SNGL FAM SUB,1.47,AC,207900,0,207900,1023100,40000,1271000,189000,0,189000,916200,35200,1140400,A2,AG/LTD,,,
3201,64-1-0-29-T,7723-49-6699-9999,AG > 100 AC,114.863,AC,4085100,3873600,211500,0,10000,4095100,3572700,3367200,205500,0,10000,3582700,A2R1,AG LTD/,,,
3202,64-1-0-31-0,7723-79-6894,AG 20-100 AC,87.93,AC,3288600,0,3288600,0,0,3288600,2857700,0,2857700,0,0,2857700,A2R1,AG LTD/,,,
3203,16-5-0-3-0,5890-45-4152,SNGL FAM SUB,1.63,AC,33300,0,33300,227200,0,260500,32600,0,32600,206200,0,238800,A1,AG/GEN,,,
3204,16-5-0-5-0,5890-45-5371,SNGL FAM SUB,2.31,AC,35700,0,35700,239200,0,274900,35000,0,35000,216500,0,251500,A1,AG/GEN,,,
3205,46-23-0-1-0,7717-15-1528,SNGL FAM SUB,1.897,AC,165000,0,165000,0,0,165000,150000,0,150000,0,0,150000,A2,AG/LTD,,,
3206,46-23-0-2-0,7717-05-9601,SNGL FAM SUB,2.023,AC,165000,0,165000,300900,40700,506600,150000,0,150000,254100,36400,440500,A2,AG/LTD,,,
3207,46-23-0-3-0,7717-05-6694,SNGL FAM SUB,2.055,AC,165000,0,165000,0,0,165000,150000,0,150000,0,0,150000,A2,AG/LTD,,,
3208,46-23-0-4-0,7717-05-4699,SNGL FAM SUB,2.241,AC,165000,0,165000,0,0,165000,150000,0,150000,0,0,150000,A2,AG/LTD,,,
3209,46-23-0-5-0,7717-05-2784,SNGL FAM SUB,2.827,AC,165000,0,165000,412300,89900,667200,150000,0,150000,347400,81000,578400,A2,AG/LTD,,,
3210,54-3-0-K-0,6776-34-1648,AG > 100 AC,112.626,AC,912100,766100,146000,219500,0,1131600,812200,680400,131800,185900,0,998100,A2,AG/LTD,,,
3211,45-1-0-21-C,6787-99-4726,SNGL FAM SUB,7.362,AC,168300,0,168300,0,0,168300,150600,0,150600,0,0,150600,A2,AG/LTD,,,
3212,67-11-B-4-0,7733-26-1655,SNGL FAM SUB,0,AC,265000,0,265000,758000,0,1023000,220000,0,220000,680800,0,900800,R1,RES/LTD,,,
3213,38-1-0-85-0,6707-85-3879,AG 20-100 AC,24.878,AC,89600,0,89600,0,0,89600,87100,0,87100,0,0,87100,A1,AG/GEN,,,
3214,38-1-0-89-0,6707-95-8519,SNGL FAM SUB,13.94,AC,106800,0,106800,303800,10100,420700,104700,0,104700,262200,10100,377000,A1,AG/GEN,,,
3215,67-4-0-2-0,7733-03-1948,SNGL FAM SUB,16.996,AC,774400,0,774400,1470300,103900,2348600,673000,0,673000,1248200,90500,2011700,A2,AG/LTD,,,
3216,67-4-0-3-A,7733-04-1827,SNGL FAM SUB,6.101,AC,339800,0,339800,0,0,339800,295400,0,295400,0,0,295400,A2,AG/LTD,,,
3217,46-1-0-70-B,7707-61-3594,SNGL FAM SUB,1.976,AC,121300,0,121300,253200,0,374500,108300,0,108300,230700,0,339000,RR,RES/RUR,,,
3218,46-1-0-70-C,7707-61-4487,MultiFamily,2.161,AC,125500,0,125500,599000,14800,739300,112100,0,112100,509200,14700,636000,RR,RES/RUR,,,
3219,64-19-E-3-0,7733-38-9193,SNGL FAM SUB,0,AC,251800,0,251800,476700,0,728500,209000,0,209000,402400,0,611400,R1,RES/LTD,,,
3220,7-3-0-4-0,6843-20-7109,Roads,0.41,AC,0,0,0,0,0,0,0,0,0,0,0,0,A1,AG/GEN,,,
3223,26-1-0-32-0,6708-62-9428,SNGL FAM SUB,5,AC,32100,0,32100,0,0,32100,31500,0,31500,0,0,31500,A1,AG/GEN,,,
3224,56-1-0-49-0,6796-42-2743,SNGL FAM SUB,5.87,AC,221200,0,221200,377400,7000,605600,192200,0,192200,325900,7000,525100,A2,AG/LTD,,,
3227,64-2-0-8-0,7723-98-4440,SNGL FAM SUB,7.67,AC,379100,0,379100,0,0,379100,329700,0,329700,0,0,329700,A2,AG/LTD,,,
3228,64-1-0-31-A,7723-97-2382,SNGL FAM SUB,1.16,AC,182100,0,182100,0,0,182100,158300,0,158300,0,0,158300,R1,RES/LTD,,,
3229,64-2-0-8-A,7723-97-5606,SNGL FAM SUB,2.5,AC,232200,0,232200,266400,8000,506600,201900,0,201900,228500,8000,438400,A2R1,AG LTD/,,,
3230,42-16-B-1-0,6757-93-7532,SNGL FAM SUB,1.294,AC,81500,0,81500,286500,0,368000,74000,0,74000,268000,0,342000,R1,RES/LTD,,,
3231,21-4-0-6-0,6759-48-5911,SNGL FAM SUB,5.18,AC,93200,0,93200,75900,0,169100,84600,0,84600,67400,0,152000,A2,AG/LTD,,,
3232,4-3-0-12-0,6803-93-9575,SNGL FAM SUB,4.04,AC,55900,0,55900,8500,700,65100,54700,0,54700,8600,600,63900,A1,AG/GEN,,,
3233,44-1-0-67-0,6786-67-9879,SNGL FAM SUB,0.94,AC,69200,0,69200,87500,1500,158200,61800,0,61800,72600,1500,135900,A2,AG/LTD,,,
3234,4-3-0-19-0,6803-92-4666,SNGL FAM SUB,3.69,AC,48600,0,48600,0,0,48600,47600,0,47600,0,0,47600,A1,AG/GEN,,,
3235,4-3-0-20-0,6803-92-6940,SNGL FAM SUB,3.45,AC,52700,0,52700,186800,2000,241500,51600,0,51600,176800,2000,230400,A1,AG/GEN,,,
3236,64-13-0-4-0,7733-07-5279,SNGL FAM SUB,5.005,AC,340000,0,340000,1239200,40300,1619500,285000,0,285000,1064900,34200,1384100,R1,RES/LTD,,,
3237,64-13-0-3-0,7733-07-9441,SNGL FAM SUB,3.554,AC,340000,0,340000,851500,18800,1210300,285000,0,285000,745000,18800,1048800,R1,RES/LTD,,,
3238,66-4-0-18-0,7723-33-4958,SNGL FAM SUB,3.85,AC,862500,0,862500,510900,0,1373400,750000,0,750000,503600,0,1253600,A2,AG/LTD,,,
3240,40-1-0-7-0,6737-49-2067,AG 20-100 AC,26.302,AC,185800,173700,12100,0,0,185800,181500,170300,11200,0,0,181500,A1,AG/GEN,,,
3241,40-1-0-10-0,6727-74-2337,AG > 100 AC,140.3,AC,429300,364600,64700,0,0,429300,420900,361300,59600,0,0,420900,A1,AG/GEN,,,
3242,40-1-0-14-A,6737-10-9106,SNGL FAM SUB,7.2,AC,90100,0,90100,0,0,90100,88600,0,88600,0,0,88600,A1,AG/GEN,,,
3243,40-1-0-37-0,6737-49-7813,AG 20-100 AC,31.006,AC,197100,182800,14300,0,0,197100,190900,177700,13200,0,0,190900,A1,AG/GEN,,,
3244,40-1-0-37-A,6737-39-2781,SNGL FAM SUB,12.414,AC,125100,119400,5700,0,0,125100,120700,115400,5300,0,0,120700,A1,AG/GEN,,,
3245,28-1-0-46-0,6738-62-6618,AG 20-100 AC,43.451,AC,174200,149700,24500,0,0,174200,170000,147700,22300,0,0,170000,A1,AG/GEN,,,
3246,40-1-0-2-0,6738-31-5048,SNGL FAM SUB,9.721,AC,112800,108300,4500,0,0,112800,109200,105100,4100,0,0,109200,A1,AG/GEN,,,
3247,40-1-0-3-0,6738-40-0906,SNGL FAM SUB,11.856,AC,126100,120600,5500,0,0,126100,123700,118700,5000,0,0,123700,A1,AG/GEN,,,
3248,40-1-0-5-0,6737-38-2989,SNGL FAM SUB,13.797,AC,135000,128600,6400,0,0,135000,129200,123300,5900,0,0,129200,A1,AG/GEN,,,
3249,40-1-0-6-0,6737-27-7778,AG 20-100 AC,37.399,AC,191800,174600,17200,0,0,191800,188800,172900,15900,0,0,188800,A1,AG/GEN,,,
3250,40-1-0-8-0,6737-37-6601,AG 20-100 AC,22.033,AC,150900,140700,10200,0,0,150900,147600,138200,9400,0,0,147600,A1,AG/GEN,,,
3251,40-1-0-27-0,6737-23-6343,AG 20-100 AC,41.83,AC,171500,152200,19300,0,0,171500,167300,149500,17800,0,0,167300,A1,AG/GEN,,,
3252,40-1-0-33-0,6738-40-9561,AG 20-100 AC,22.438,AC,164200,153900,10300,0,0,164200,161400,151900,9500,0,0,161400,A1,AG/GEN,,,
3253,40-1-0-33-A,6738-51-2152,AG 20-100 AC,22.483,AC,163300,152900,10400,0,0,163300,161600,152000,9600,0,0,161600,A1,AG/GEN,,,
3254,40-1-0-34-0,6738-20-0531,AG 20-100 AC,21.865,AC,160700,150600,10100,0,0,160700,158400,149100,9300,0,0,158400,A1,AG/GEN,,,
3255,40-3-0-A-0,6737-05-7148,AG > 100 AC,476.695,AC,1294100,975100,319000,112100,56400,1462600,1283500,983700,299800,100500,44800,1428800,A1,AG/GEN,,,
3256,40-1-0-25-0,6737-92-9114,AG > 100 AC,580.69,AC,2121400,1645800,475600,680200,93100,2894700,2094100,1660600,433500,615500,85600,2795200,A1,AG/GEN,,,
3257,29-1-0-38-0,6748-82-7508,AG > 100 AC,525.5,AC,2784200,2431000,353200,303000,0,3087200,2717600,2394900,322700,251400,0,2969000,A1A2,AG GEN/,,,
3258,30-11-0-1-0,6758-22-0022,SNGL FAM SUB,3,AC,73600,0,73600,167400,0,241000,70700,0,70700,138400,0,209100,A2,AG/LTD,,,
3259,30-11-0-2-0,6758-22-0189,SNGL FAM SUB,3,AC,73600,0,73600,0,0,73600,70700,0,70700,0,0,70700,A2,AG/LTD,,,
3260,30-11-0-9-0,6758-13-7446,SNGL FAM SUB,2.98,AC,73400,0,73400,0,0,73400,70500,0,70500,0,0,70500,A2,AG/LTD,,,
3261,30-11-0-10-0,6758-13-6279,SNGL FAM SUB,2.98,AC,73400,0,73400,0,0,73400,70500,0,70500,0,0,70500,A2,AG/LTD,,,
3262,41-1-0-5-0,6748-60-9201,AG 20-100 AC,52.25,AC,421600,397500,24100,0,0,421600,407600,385400,22200,0,0,407600,A1,AG/GEN,,,
3263,41-1-0-8-0,6747-97-0505,AG 20-100 AC,78.36,AC,242200,202700,39500,0,0,242200,224400,190700,33700,0,0,224400,A1A2,AG GEN/,,,
3264,41-1-0-8-B,6747-96-1633,SNGL FAM SUB,10,AC,30000,0,30000,0,0,30000,28000,0,28000,0,0,28000,A2M2,AG2 IND2,,,
3265,41-1-0-8-D,6748-80-0895,AG 20-100 AC,30,AC,274400,199600,74800,739400,123000,1136800,276100,206400,69700,631000,116800,1023900,A1,AG/GEN,,,
3266,41-1-0-8-E,6748-70-7258,SNGL FAM SUB,8.24,AC,119000,0,119000,0,0,119000,118000,0,118000,0,0,118000,A1,AG/GEN,,,
3267,41-1-0-8-F,6748-71-2131,SNGL FAM SUB,11.74,AC,147000,0,147000,0,0,147000,144400,0,144400,0,0,144400,A1,AG/GEN,,,
3268,41-1-0-8-G,6747-99-1707,AG 20-100 AC,45.39,AC,266000,242900,23100,0,189900,455900,242100,222600,19500,0,158200,400300,A1A2,AG GEN/,,,
3269,41-1-0-8-H,6747-99-9352,SNGL FAM SUB,5,AC,52100,0,52100,97900,0,150000,48600,0,48600,82600,0,131200,A2,AG/LTD,,,
3271,42-1-0-8-A,6757-07-7229,AG 20-100 AC,43.46,AC,130400,108500,21900,0,0,130400,121700,103000,18700,0,0,121700,A2,AG/LTD,,,
3272,54-3-0-A-0,6766-54-1685,AG 20-100 AC,46.28,AC,411900,0,411900,5332800,63300,5808000,367900,0,367900,4880600,65700,5314200,A2,AG/LTD,,,
3273,54-5-0-21-0,6766-64-1900,SNGL FAM SUB,5.517,AC,2500,0,2500,0,0,2500,2300,0,2300,0,0,2300,A2,AG/LTD,,,
3274,54-5-0-14-0,6766-53-7301,SNGL FAM SUB,10.039,AC,363200,0,363200,0,0,363200,337100,0,337100,0,0,337100,A2,AG/LTD,,,
3275,44-1-0-50-B,6787-33-3225,SNGL FAM SUB,1.7,AC,81200,0,81200,173500,23400,278100,72500,0,72500,141200,20200,233900,A2,AG/LTD,,,
3276,64-4-2-23-0,7724-94-6126,SNGL FAM SUB,0,AC,20200,0,20200,0,0,20200,17600,0,17600,0,0,17600,RN,RESIDEN,,,
3277,64-4-2-24-0,7724-94-6017,SNGL FAM SUB,0,AC,70000,0,70000,137300,900,208200,60000,0,60000,121100,900,182000,RN,RESIDEN,,,
3278,31-6-0-4-0,6778-52-8561,SNGL FAM SUB,2.044,AC,79100,0,79100,128100,32600,239800,70700,0,70700,97700,27500,195900,A2,AG/LTD,,,
3279,17-5-0-D-0,6719-58-3614,SNGL FAM SUB,5.02,AC,63600,0,63600,159300,29300,252200,62100,0,62100,129700,26700,218500,A1,AG/GEN,,,
3280,17-5-0-E-0,6719-58-5851,SNGL FAM SUB,5.02,AC,63600,0,63600,86900,500,151000,62100,0,62100,71300,500,133900,A1,AG/GEN,,,
3281,31-1-0-88-A,6778-55-4207,SNGL FAM SUB,3.54,AC,100700,0,100700,0,10400,111100,90000,0,90000,0,9300,99300,A2,AG/LTD,,,
3282,32-1-0-40-E,6778-75-3663,SNGL FAM SUB,19.209,AC,248000,0,248000,68900,5000,321900,221100,0,221100,64300,5000,290400,A2,AG/LTD,,,
3283,17-5-0-B-0,6719-58-0065,SNGL FAM SUB,5.02,AC,51800,0,51800,0,0,51800,50100,0,50100,0,0,50100,A1,AG/GEN,,,
3284,58-3-D-2-0,7726-26-2776,SNGL FAM SUB,0,AC,88000,0,88000,150100,100,238200,80000,0,80000,124800,100,204900,RN,RESIDEN,,,
3285,54-1-0-13-A,6776-01-7755,SNGL FAM SUB,2.02,AC,84800,0,84800,81700,1000,167500,75800,0,75800,69600,1000,146400,A2,AG/LTD,,,
3286,47-14-0-C-0,7728-01-9486,SNGL FAM SUB,4.364,AC,156200,0,156200,173900,3500,333600,139500,0,139500,146000,3200,288700,A2,AG/LTD,,,
3287,47-19-0-5-A,7728-11-2229,SNGL FAM SUB,0.22,AC,3700,0,3700,0,0,3700,3300,0,3300,0,0,3300,A2,AG/LTD,,,
3288,17-5-0-A-0,6719-47-7953,SNGL FAM SUB,3.825,AC,56700,0,56700,270200,20600,347500,55000,0,55000,231300,20400,306700,A1,AG/GEN,,,
3289,17-5-0-A-1,6719-47-4797,SNGL FAM SUB,1.2,AC,41200,0,41200,7400,300,48900,39200,0,39200,7400,300,46900,A1,AG/GEN,,,
3290,17-5-0-F-0,6719-58-5288,SNGL FAM SUB,0.41,AC,1200,0,1200,0,0,1200,1200,0,1200,0,0,1200,A1,AG/GEN,,,
3291,54-1-0-11-0,6776-02-7216,SNGL FAM SUB,1.67,AC,79700,0,79700,0,0,79700,71200,0,71200,0,0,71200,A2,AG/LTD,,,
3292,54-1-0-13-0,6776-01-5585,SNGL FAM SUB,5.57,AC,122200,0,122200,140100,6000,268300,109200,0,109200,115700,6000,230900,A2,AG/LTD,,,
3293,17-5-0-C-0,6719-58-0492,SNGL FAM SUB,5.02,AC,63600,0,63600,0,0,63600,62100,0,62100,0,0,62100,A1,AG/GEN,,,
3294,55-19-0-8-0,6776-85-8806,SNGL FAM SUB,2.661,AC,93000,0,93000,222000,0,315000,83000,0,83000,180200,0,263200,A2,AG/LTD,,,
3295,63-7-0-C-1,7723-17-6866,SNGL FAM SUB,4.133,AC,253500,0,253500,0,0,253500,220400,0,220400,0,0,220400,R1,RES/LTD,,,
3296,63-7-0-C-3,7723-07-8841,SNGL FAM SUB,3.41,AC,232500,0,232500,558600,89000,880100,202100,0,202100,477200,79500,758800,A2,AG/LTD,,,
3297,5-1-0-11-A,6813-76-2672,SNGL FAM SUB,2.11,AC,45400,0,45400,0,0,45400,44600,0,44600,0,0,44600,A1,AG/GEN,,,
3309,13-9-0-8-0,6841-64-5760,SNGL FAM SUB,4.27,AC,78000,0,78000,216000,4300,298300,76600,0,76600,194600,4300,275500,A1,AG/GEN,,,
3311,17-1-0-9-0,6800-55-0895,AG 20-100 AC,49.393,AC,136900,75500,61400,77800,600,215300,136500,77900,58600,77000,600,214100,A1,AG/GEN,,,
3313,16-2-0-A-0,5890-47-3565,AG 20-100 AC,49.88,AC,112600,88400,24200,0,4100,116700,112200,90900,21300,0,4100,116300,A1,AG/GEN,,,
3314,16-2-0-C-0,5890-57-5860,AG 20-100 AC,41.11,AC,121100,63400,57700,188700,23100,332900,128200,73100,55100,167400,23100,318700,A1,AG/GEN,,,
3315,16-1-0-12-A,5890-58-7295,SNGL FAM SUB,5,AC,53200,0,53200,265000,27300,345500,52000,0,52000,247000,32400,331400,A1,AG/GEN,,,
3316,45-1-0-88-0,6797-76-7279,SNGL FAM SUB,1.702,AC,87800,0,87800,162000,300,250100,78400,0,78400,136400,300,215100,A2,AG/LTD,,,
3317,16-4-0-9-0,5890-46-8001,SNGL FAM SUB,1.01,AC,38900,0,38900,102100,1200,142200,38100,0,38100,91500,1200,130800,A1,AG/GEN,,,
3318,16-4-0-20-0,5890-45-5933,SNGL FAM SUB,1.61,AC,31300,0,31300,0,0,31300,30300,0,30300,0,0,30300,A1,AG/GEN,,,
3319,9-1-0-22-0,5892-64-0093,SNGL FAM SUB,0.96,AC,37200,0,37200,141700,400,179300,36500,0,36500,122700,400,159600,A1,AG/GEN,,,
3320,2-1-0-9-0,6814-86-9026,COMM & IND,7.99,AC,277800,0,277800,76500,400,354700,269500,0,269500,61300,400,331200,B1A1,BS & AG,,,
3321,38-1-0-13-A,6707-89-8307,SNGL FAM SUB,1.333,AC,40700,0,40700,110300,500,151500,39800,0,39800,94000,500,134300,A1,AG/GEN,,,
3322,11-1-0-45-0,6822-30-6892,SNGL FAM SUB,2,AC,46000,0,46000,0,0,46000,44000,0,44000,0,0,44000,A1,AG/GEN,,,
3323,51-1-0-50-0,6736-42-7934,AG 20-100 AC,20.75,AC,115900,0,115900,5600,600,122100,113200,0,113200,4900,600,118700,A1,AG/GEN,,,
3324,51-2-0-6-0,6736-40-4383,SNGL FAM SUB,1.32,AC,36900,0,36900,7900,0,44800,36100,0,36100,7700,0,43800,A1,AG/GEN,,,
3325,45-18-0-17-0,6797-24-7284,SNGL FAM SUB,8.012,AC,200000,0,200000,356500,52900,609400,180000,0,180000,327100,44500,551600,A2,AG/LTD,,,
3326,29-3-0-11-B,6749-62-0614,SNGL FAM SUB,3.38,AC,69400,0,69400,0,0,69400,70300,0,70300,0,0,70300,A1,AG/GEN,,,
3327,51-8-0-1-0,6736-40-3115,SNGL FAM SUB,3.42,AC,49700,0,49700,79400,300,129400,48700,0,48700,68100,300,117100,A1,AG/GEN,,,
3328,51-1-0-8-0,6736-00-7962,SNGL FAM SUB,10,AC,97000,0,97000,647400,83800,828200,87500,0,87500,495900,69100,652500,A1,AG/GEN,,,
3329,51-8-0-4-0,6735-49-3742,SNGL FAM SUB,3.43,AC,48500,0,48500,0,13000,61500,47600,0,47600,0,11000,58600,A1,AG/GEN,,,
3330,38-1-0-19-B,6708-70-7073,SNGL FAM SUB,2,AC,43900,0,43900,124500,0,168400,43000,0,43000,99500,0,142500,A1,AG/GEN,,,
3331,63-3-C-19-0,7714-91-1878,SNGL FAM SUB,1,AC,70000,0,70000,321700,0,391700,60000,0,60000,282700,0,342700,R1,RES/LTD,,,
3332,63-3-B-C-0,7714-91-1927,SNGL FAM SUB,0.22,AC,5200,0,5200,0,0,5200,4600,0,4600,0,0,4600,R1,RES/LTD,,,
3333,51-8-0-6-0,6735-49-9507,SNGL FAM SUB,3.43,AC,48500,0,48500,0,0,48500,47600,0,47600,0,0,47600,A1,AG/GEN,,,
3334,29-3-0-11-0,6749-62-9783,SNGL FAM SUB,3.37,AC,77100,0,77100,232000,1500,310600,73400,0,73400,195700,1500,270600,A1,AG/GEN,,,
3335,51-1-0-27-A,6736-50-0139,SNGL FAM SUB,10,AC,85300,0,85300,0,0,85300,83700,0,83700,0,0,83700,A1,AG/GEN,,,
3336,15-4-0-5-0,5789-39-9901,SNGL FAM SUB,1.29,AC,39800,0,39800,0,0,39800,39000,0,39000,0,0,39000,A1,AG/GEN,,,
3338,17-1-0-49-0,6810-29-0295,AG 20-100 AC,20,AC,118600,0,118600,0,0,118600,114000,0,114000,0,0,114000,A1,AG/GEN,,,
3339,4-6-0-8-0,6813-54-3197,SNGL FAM SUB,8.14,AC,65700,0,65700,0,0,65700,64300,0,64300,0,0,64300,A1,AG/GEN,,,
3340,63-1-0-104-0,7715-41-3101,SNGL FAM SUB,3.92,AC,191900,0,191900,190000,28000,409900,167000,0,167000,161300,25600,353900,A2,AG/LTD,,,
3341,43-1-0-31-0,6767-41-6954,SNGL FAM SUB,2,AC,84500,0,84500,175000,1000,260500,75500,0,75500,143000,1000,219500,A2,AG/LTD,,,
3342,53-1-0-3-0,6766-35-4836,AG 20-100 AC,28.07,AC,446100,424600,21500,0,0,446100,397800,378200,19600,0,0,397800,A2,AG/LTD,,,
3343,44-1-0-52-C,6787-32-9827,SNGL FAM SUB,3,AC,97700,0,97700,119300,500,217500,87200,0,87200,97800,500,185500,A2,AG/LTD,,,
3344,12-1-0-26-C,6821-97-7416,SNGL FAM SUB,9.4,AC,81200,0,81200,112100,3500,196800,79000,0,79000,96900,3500,179400,A1,AG/GEN,,,
3346,33-4-0-10-0,6798-62-3978,SNGL FAM SUB,2.04,AC,91100,0,91100,174900,600,266600,81300,0,81300,143800,600,225700,A2,AG/LTD,,,
3347,45-9-0-D-0,6798-10-3315,SNGL FAM SUB,3.72,AC,107600,0,107600,154000,17500,279100,96100,0,96100,127500,14600,238200,A2,AG/LTD,,,
3348,67-2-D-1-0,7723-56-7120,SNGL FAM SUB,0,AC,184000,0,184000,338500,22700,545200,160000,0,160000,286000,18600,464600,R1,RES/LTD,,,
3349,46-1-0-76-G,7707-55-0328,SNGL FAM SUB,10.02,AC,221500,0,221500,384300,74000,679800,198000,0,198000,331900,63300,593200,A2,AG/LTD,,,
3350,62-17-C-2-0,7714-06-2255,SNGL FAM SUB,0,AC,115000,0,115000,215300,0,330300,100000,0,100000,195700,0,295700,R1,RES/LTD,,,
3351,30-1-0-117-0,6759-54-6960,SNGL FAM SUB,2,AC,62700,0,62700,0,0,62700,57200,0,57200,0,0,57200,A2,AG/LTD,,,
3352,20-11-0-2-0,6841-91-0187,SNGL FAM SUB,2.41,AC,62100,0,62100,148500,10400,221000,61000,0,61000,128400,11000,200400,A1,AG/GEN,,,
3353,58-3-A-11-0,7726-16-8553,SNGL FAM SUB,0,AC,88000,0,88000,174100,28300,290400,80000,0,80000,145100,24300,249400,RN,RESIDEN,,,
3354,14-3-0-14-0,6851-48-2402,SNGL FAM SUB,4.43,AC,75800,0,75800,208300,1700,285800,74300,0,74300,112500,800,187600,A1,AG/GEN,,,
3355,21-1-0-35-0,6759-38-0730,SNGL FAM SUB,1.793,AC,63800,0,63800,163200,1000,228000,58100,0,58100,138300,1000,197400,A1,AG/GEN,,,
3356,14-2-0-9-0,6851-25-2987,SNGL FAM SUB,4.23,AC,77500,0,77500,308200,0,385700,75900,0,75900,269200,0,345100,A1,AG/GEN,,,
3357,14-2-0-8-0,6851-25-1655,SNGL FAM SUB,3.58,AC,55200,0,55200,212800,0,268000,54100,0,54100,184000,0,238100,A1,AG/GEN,,,
3358,13-1-0-3-0,6842-76-0141,SNGL FAM SUB,13.14,AC,93800,0,93800,125200,1900,220900,93400,0,93400,122100,1900,217400,A1,AG/GEN,,,
3359,62-10-C-24-0,7714-04-1815,SNGL FAM SUB,0,AC,115000,0,115000,189400,0,304400,100000,0,100000,175700,0,275700,R1,RES/LTD,,,
3360,12-1-0-34-E,6831-04-4377,Non-Profit,1.03,AC,40200,0,40200,0,0,40200,39700,0,39700,0,0,39700,A1,AG/GEN,,,
3361,5-3-0-23-0,6824-20-7880,SNGL FAM SUB,3.44,AC,57900,0,57900,342700,18800,419400,56700,0,56700,290100,17600,364400,A1,AG/GEN,,,
3362,6-8-0-G-0,6833-83-6386,SNGL FAM SUB,4.16,,56400,0,56400,247000,4500,307900,55300,0,55300,208400,4500,268200,A1,AG/GEN,,,
3363,16-1-0-71-0,6800-03-6387,SNGL FAM SUB,1.06,AC,39100,0,39100,0,0,39100,38300,0,38300,0,0,38300,A1,AG/GEN,,,
3364,16-1-0-72-A,6800-03-1401,SNGL FAM SUB,11.21,AC,76200,0,76200,11600,0,87800,73700,0,73700,12200,0,85900,A1,AG/GEN,,,
3365,16-1-0-8-A,5891-60-7405,SNGL FAM SUB,1,AC,38800,0,38800,8400,700,47900,38000,0,38000,8800,700,47500,A1,AG/GEN,,,
3366,16-1-0-75-0,5890-92-9532,SNGL FAM SUB,11.417,AC,81000,0,81000,3000,7900,91900,79700,0,79700,3000,7900,90600,A1,AG/GEN,,,
3367,16-1-0-70-0,6800-03-8510,SNGL FAM SUB,1,AC,38800,0,38800,164500,2900,206200,38000,0,38000,143200,2600,183800,A1,AG/GEN,,,
3368,26-1-0-11-A,6719-05-0178,SNGL FAM SUB,3,AC,52000,0,52000,236400,1700,290100,50000,0,50000,204400,1700,256100,A1,AG/GEN,,,
3369,18-1-0-11-0,6810-66-3260,AG 20-100 AC,53.59,AC,246700,179000,67700,409000,11500,667200,248400,184500,63900,340500,10700,599600,A1,AG/GEN,,,
3370,16-5-0-6-0,5890-45-6543,SNGL FAM SUB,1.42,AC,40300,0,40300,120200,400,160900,39500,0,39500,106900,400,146800,A1,AG/GEN,,,
3371,31-16-0-6-0,6778-07-7505,SNGL FAM SUB,8.1,AC,152900,0,152900,386700,33800,573400,136700,0,136700,318000,33000,487700,A2,AG/LTD,,,
3372,41-1-0-6-0,6748-50-1855,SNGL FAM SUB,1.28,AC,56800,0,56800,148700,1500,207000,52500,0,52500,122000,1500,176000,A1,AG/GEN,,,
3373,62-10-C-23-0,7714-04-2623,SNGL FAM SUB,1.14,AC,115000,0,115000,239800,5300,360100,100000,0,100000,217100,5300,322400,R1,RES/LTD,,,
3374,51-1-0-16-0,6735-27-3449,SNGL FAM SUB,10.54,AC,92200,0,92200,0,0,92200,90500,0,90500,0,0,90500,A1,AG/GEN,,,
3375,20-29-0-1-0,6840-16-9679,SNGL FAM SUB,6.07,AC,84000,0,84000,247500,0,331500,76600,0,76600,200000,0,276600,A1,AG/GEN,,,
3377,28-8-0-1-0,6729-71-7687,SNGL FAM SUB,3.316,AC,56000,0,56000,77000,37500,170500,53900,0,53900,65500,34400,153800,A1,AG/GEN,,,
3378,56-1-0-14-0,6785-96-1354,AG 20-100 AC,38.44,AC,507400,0,507400,0,0,507400,453600,0,453600,0,0,453600,A2,AG/LTD,,,
3379,56-1-0-15-0,6785-86-9730,SNGL FAM SUB,9.09,AC,120000,0,120000,0,0,120000,107300,0,107300,0,0,107300,A2,AG/LTD,,,
3380,51-1-0-22-0,6735-76-6294,SNGL FAM SUB,17,AC,118700,0,118700,0,0,118700,116500,0,116500,0,0,116500,A1,AG/GEN,,,
3381,56-1-0-15-D,6785-85-7223,SNGL FAM SUB,3.82,AC,108400,0,108400,82600,0,191000,96900,0,96900,68200,0,165100,A2,AG/LTD,,,
3382,5-3-0-31-0,6824-10-9891,SNGL FAM SUB,4.42,AC,72300,0,72300,404700,5800,482800,70900,0,70900,353000,5200,429100,A1,AG/GEN,,,
3383,47-17-0-A-4A,7718-20-6783,SNGL FAM SUB,3.28,AC,137800,0,137800,161200,19400,318400,123100,0,123100,134300,16600,274000,A2,AG/LTD,,,
3384,46-12-0-2-0,7717-11-4214,SNGL FAM SUB,3.39,AC,153500,0,153500,515800,30900,700200,137200,0,137200,424600,26900,588700,A2,AG/LTD,,,
3385,5-7-0-27-0,6824-22-6114,SNGL FAM SUB,3.39,AC,48500,0,48500,318900,0,367400,47500,0,47500,273400,0,320900,A1,AG/GEN,,,
3386,2-1-0-18-0,6814-83-1534,SNGL FAM SUB,12.32,AC,94500,0,94500,0,200,94700,92800,0,92800,0,200,93000,A1,AG/GEN,,,
3387,2-1-0-18-A,6814-72-8955,SNGL FAM SUB,2.05,AC,45100,0,45100,12500,300,57900,44300,0,44300,12500,300,57100,A1,AG/GEN,,,
3388,2-1-0-18-C,6814-83-0139,SNGL FAM SUB,0.53,AC,3000,0,3000,0,0,3000,2900,0,2900,0,0,2900,A1,AG/GEN,,,
3389,62-4-E-14-0,7714-04-7762,SNGL FAM SUB,0,AC,115000,0,115000,282500,700,398200,100000,0,100000,256400,700,357100,R1,RES/LTD,,,
3390,14-2-0-19-0,6851-27-9145,SNGL FAM SUB,3.44,AC,70400,0,70400,147400,8800,226600,68900,0,68900,143000,7400,219300,A1,AG/GEN,,,
3391,1-1-0-11-0,6814-36-2788,SNGL FAM SUB,8.3,AC,76900,0,76900,12300,0,89200,75500,0,75500,12200,0,87700,A1,AG/GEN,,,
3392,1-1-0-10-0,6814-36-6835,SNGL FAM SUB,3.48,AC,52300,0,52300,179500,7000,238800,51400,0,51400,157100,7000,215500,A1,AG/GEN,,,
3393,1-1-0-13-0,6814-37-0323,SNGL FAM SUB,7.06,AC,67100,0,67100,241400,3100,311600,65900,0,65900,212900,3100,281900,A1,AG/GEN,,,
3395,4-1-0-58-0,6812-28-0171,AG 20-100 AC,33,AC,141500,94900,46600,138800,0,280300,138700,93900,44800,113100,0,251800,A1,AG/GEN,,,
3396,19-4-0-B-0,6830-27-8219,AG 20-100 AC,66.92,AC,406100,318500,87600,150400,60800,617300,392700,314500,78200,124600,56200,573500,A1,AG/GEN,,,
3397,20-1-0-19-0,6830-91-5800,AG 20-100 AC,27.4,AC,245900,179400,66500,245100,7500,498500,233000,171800,61200,203600,6200,442800,A1,AG/GEN,,,
3398,55-1-0-74-0,6786-71-4725,SNGL FAM SUB,1.501,AC,77700,0,77700,199000,200,276900,69400,0,69400,164000,200,233600,A2,AG/LTD,,,
3399,19-4-0-B-1,6830-26-4134,SNGL FAM SUB,4.84,AC,89500,0,89500,188800,47600,325900,86000,0,86000,160500,39200,285700,A1,AG/GEN,,,
3400,20-1-0-17-0,6840-03-1570,AG 20-100 AC,53.5,AC,420200,286900,133300,273900,34900,729000,407000,285200,121800,230700,35000,672700,A1,AG/GEN,,,
3402,19-2-0-B-0,6830-94-9008,SNGL FAM SUB,1.806,AC,8700,7900,800,0,0,8700,7700,6900,800,0,0,7700,A1,AG/GEN,,,
3403,20-1-0-17-A,6840-03-9318,SNGL FAM SUB,1.5,AC,11600,10900,700,0,0,11600,11000,10400,600,0,0,11000,A1,AG/GEN,,,
3404,17-1-0-39-0,6801-60-6929,SNGL FAM SUB,17.39,AC,94500,0,94500,0,3100,97600,91900,0,91900,0,2800,94700,A1,AG/GEN,,,
3405,19-2-0-A-0,6830-94-6120,AG 20-100 AC,38.05,AC,270700,199300,71400,3500,1300,275500,267000,206300,60700,3500,1300,271800,A1,AG/GEN,,,
3406,19-2-0-C-1,6830-83-9054,SNGL FAM SUB,3.003,AC,73200,0,73200,72200,21000,166400,70700,0,70700,64500,17400,152600,A1,AG/GEN,,,
3407,1-1-0-9-A,6814-46-1929,SNGL FAM SUB,1.845,AC,44000,0,44000,259800,1400,305200,43200,0,43200,231000,1400,275600,A1,AG/GEN,,,
3408,64-3-3-4-0,7724-82-2929,COMM & IND,0.5,AC,124400,0,124400,0,63900,188300,115200,0,115200,0,56800,172000,RN,RESIDEN,,,
3409,64-3-3-5-0,7724-83-3030,COMM & IND,0.57,AC,93100,0,93100,0,22000,115100,86200,0,86200,0,17400,103600,RN,RESIDEN,,,
3410,64-3-3-7-0,7724-83-5165,SNGL FAM SUB,0,AC,20200,0,20200,0,0,20200,17600,0,17600,0,0,17600,RN,RESIDEN,,,
3411,64-3-3-8-0,7724-83-5275,SNGL FAM SUB,0,AC,20200,0,20200,0,0,20200,17600,0,17600,0,0,17600,RN,RESIDEN,,,
3412,64-3-3-9-0,7724-83-5375,SNGL FAM SUB,0,AC,20200,0,20200,0,0,20200,17600,0,17600,0,0,17600,RN,RESIDEN,,,
3413,64-3-3-10-0,7724-83-5475,SNGL FAM SUB,0,AC,20200,0,20200,0,0,20200,17600,0,17600,0,0,17600,RN,RESIDEN,,,
3414,64-3-3-11-0,7724-83-5598,SNGL FAM SUB,0,AC,20200,0,20200,0,0,20200,17600,0,17600,0,0,17600,RN,RESIDEN,,,
3415,64-3-3-12-0,7724-83-7741,SNGL FAM SUB,0,AC,20200,0,20200,0,0,20200,17600,0,17600,0,0,17600,RN,RESIDEN,,,
3416,64-3-3-13-0,7724-83-7547,SNGL FAM SUB,0,AC,20200,0,20200,0,0,20200,17600,0,17600,0,0,17600,RN,RESIDEN,,,
3417,64-3-3-14-0,7724-83-7444,SNGL FAM SUB,0,AC,20200,0,20200,0,0,20200,17600,0,17600,0,0,17600,RN,RESIDEN,,,
3418,64-3-3-15-0,7724-83-7334,SNGL FAM SUB,0,AC,20200,0,20200,0,0,20200,17600,0,17600,0,0,17600,RN,RESIDEN,,,
3419,64-3-3-16-0,7724-83-7234,SNGL FAM SUB,0,AC,20200,0,20200,0,0,20200,17600,0,17600,0,0,17600,RN,RESIDEN,,,
3420,64-3-3-17-0,7724-83-7124,SNGL FAM SUB,0,AC,20200,0,20200,0,0,20200,17600,0,17600,0,0,17600,RN,RESIDEN,,,
3421,64-3-3-18-0,7724-83-3258,SNGL FAM SUB,0,AC,20200,0,20200,0,0,20200,17600,0,17600,0,0,17600,RN,RESIDEN,,,
3422,64-3-3-19-0,7724-83-3463,SNGL FAM SUB,0,AC,20200,0,20200,0,0,20200,17600,0,17600,0,0,17600,RN,RESIDEN,,,
3423,64-3-3-20-0,7724-83-3588,SNGL FAM SUB,0,AC,20200,0,20200,0,0,20200,17600,0,17600,0,0,17600,RN,RESIDEN,,,
3424,64-3-3-21-0,7724-83-4742,SNGL FAM SUB,0,AC,20200,0,20200,0,0,20200,17600,0,17600,0,0,17600,RN,RESIDEN,,,
3425,64-3-3-22-0,7724-83-5812,SNGL FAM SUB,0,AC,20200,0,20200,0,0,20200,17600,0,17600,0,0,17600,RN,RESIDEN,,,
3426,64-3-3-23-0,7724-83-6819,SNGL FAM SUB,0,AC,20200,0,20200,0,0,20200,17600,0,17600,0,0,17600,RN,RESIDEN,,,
3427,64-3-3-24-0,7724-83-7859,SNGL FAM SUB,0,AC,20200,0,20200,0,0,20200,17600,0,17600,0,0,17600,RN,RESIDEN,,,
3428,64-3-3-25-0,7724-83-7949,SNGL FAM SUB,0,AC,20200,0,20200,0,0,20200,17600,0,17600,0,0,17600,RN,RESIDEN,,,
3429,64-3-3-26-0,7724-84-7160,SNGL FAM SUB,0,AC,20200,0,20200,0,0,20200,17600,0,17600,0,0,17600,RN,RESIDEN,,,
3430,64-3-3-27-0,7724-84-7261,SNGL FAM SUB,0,AC,20200,0,20200,0,0,20200,17600,0,17600,0,0,17600,RN,RESIDEN,,,
3431,64-3-3-28-0,7724-84-7378,SNGL FAM SUB,0,AC,20200,0,20200,0,0,20200,17600,0,17600,0,0,17600,RN,RESIDEN,,,
3432,64-3-3-29-0,7724-84-7580,SNGL FAM SUB,0,AC,20200,0,20200,0,0,20200,17600,0,17600,0,0,17600,RN,RESIDEN,,,
3433,64-3-3-30-0,7724-83-2402,SNGL FAM SUB,0,AC,20200,0,20200,0,0,20200,17600,0,17600,0,0,17600,RN,RESIDEN,,,
3434,64-3-3-31-0,7724-83-2518,SNGL FAM SUB,0,AC,20200,0,20200,0,0,20200,17600,0,17600,0,0,17600,RN,RESIDEN,,,
3435,64-3-3-32-0,7724-83-2658,SNGL FAM SUB,0,AC,20200,0,20200,0,0,20200,17600,0,17600,0,0,17600,RN,RESIDEN,,,
3436,64-3-3-33-0,7724-83-2788,SNGL FAM SUB,0,AC,20200,0,20200,0,0,20200,17600,0,17600,0,0,17600,RN,RESIDEN,,,
3437,64-3-3-34-0,7724-83-3827,SNGL FAM SUB,0,AC,20200,0,20200,0,0,20200,17600,0,17600,0,0,17600,RN,RESIDEN,,,
3438,64-3-3-35-0,7724-83-3967,SNGL FAM SUB,0,AC,20200,0,20200,0,0,20200,17600,0,17600,0,0,17600,RN,RESIDEN,,,
3439,64-3-3-36-0,7724-84-4044,SNGL FAM SUB,0,AC,20200,0,20200,0,0,20200,17600,0,17600,0,0,17600,RN,RESIDEN,,,
3440,64-3-3-37-0,7724-84-5047,SNGL FAM SUB,0,AC,20200,0,20200,0,0,20200,17600,0,17600,0,0,17600,RN,RESIDEN,,,
3441,64-3-3-38-0,7724-84-6133,SNGL FAM SUB,0,AC,20200,0,20200,0,0,20200,17600,0,17600,0,0,17600,RN,RESIDEN,,,
3442,64-3-3-39-0,7724-84-6349,SNGL FAM SUB,0,AC,20200,0,20200,0,0,20200,17600,0,17600,0,0,17600,RN,RESIDEN,,,
3443,64-3-3-40-0,7724-84-5355,SNGL FAM SUB,0,AC,20200,0,20200,0,0,20200,17600,0,17600,0,0,17600,RN,RESIDEN,,,
3444,64-3-3-41-0,7724-84-4362,SNGL FAM SUB,0,AC,20200,0,20200,0,0,20200,17600,0,17600,0,0,17600,RN,RESIDEN,,,
3445,64-3-3-42-0,7724-84-3269,SNGL FAM SUB,0,AC,20200,0,20200,0,0,20200,17600,0,17600,0,0,17600,RN,RESIDEN,,,
3446,64-3-3-43-0,7724-84-2267,SNGL FAM SUB,0,AC,20200,0,20200,0,0,20200,17600,0,17600,0,0,17600,RN,RESIDEN,,,
3447,64-3-3-44-0,7724-84-2210,SNGL FAM SUB,0,AC,20200,0,20200,0,0,20200,17600,0,17600,0,0,17600,RN,RESIDEN,,,
3448,64-3-3-45-0,7724-84-1172,SNGL FAM SUB,0,AC,20200,0,20200,0,0,20200,17600,0,17600,0,0,17600,RN,RESIDEN,,,
3449,64-3-3-46-0,7724-84-1043,SNGL FAM SUB,0,AC,20200,0,20200,0,0,20200,17600,0,17600,0,0,17600,RN,RESIDEN,,,
3450,64-3-3-47-0,7724-83-1903,SNGL FAM SUB,0,AC,20200,0,20200,0,0,20200,17600,0,17600,0,0,17600,RN,RESIDEN,,,
3451,64-3-3-48-0,7724-83-0874,SNGL FAM SUB,0,AC,20200,0,20200,0,0,20200,17600,0,17600,0,0,17600,RN,RESIDEN,,,
3452,64-3-3-49-0,7724-83-0745,SNGL FAM SUB,0,AC,20200,0,20200,0,0,20200,17600,0,17600,0,0,17600,RN,RESIDEN,,,
3453,64-3-3-50-0,7724-83-0606,SNGL FAM SUB,0,AC,20200,0,20200,0,0,20200,17600,0,17600,0,0,17600,RN,RESIDEN,,,
3454,64-3-3-51-0,7724-73-9542,SNGL FAM SUB,0,AC,20200,0,20200,0,0,20200,17600,0,17600,0,0,17600,RN,RESIDEN,,,
3455,64-3-3-52-0,7724-73-9336,SNGL FAM SUB,0,AC,20200,0,20200,0,0,20200,17600,0,17600,0,0,17600,RN,RESIDEN,,,
3466,56-1-0-9-0,6786-82-7160,AG 20-100 AC,52.34,AC,685400,660200,25200,0,0,685400,610900,588500,22400,0,0,610900,A2,AG/LTD,,,
3467,63-1-0-78-0,7713-97-5415,SNGL FAM SUB,9.54,AC,404300,0,404300,1465800,0,1870100,351500,0,351500,1246500,0,1598000,A2,AG/LTD,,,
3468,63-1-0-79-0,7713-87-7169,SNGL FAM SUB,4.77,AC,271900,0,271900,0,0,271900,236400,0,236400,0,0,236400,A2,AG/LTD,,,
3469,63-1-0-78-A,7713-87-7427,SNGL FAM SUB,4.26,AC,257100,0,257100,0,0,257100,223600,0,223600,0,0,223600,A2,AG/LTD,,,
3470,46-1-0-71-0,7707-62-1118,SNGL FAM SUB,1.44,AC,109000,0,109000,126900,700,236600,97400,0,97400,105800,700,203900,RR,RES/RUR,,,
3471,58-3-A-17-0,7726-26-4385,SNGL FAM SUB,0,AC,88000,0,88000,188600,4200,280800,80000,0,80000,161700,4200,245900,RN,RESIDEN,,,
3472,64-12-B-12-0,7723-69-2985,SNGL FAM SUB,0,AC,77000,0,77000,159400,2500,238900,67000,0,67000,138200,2500,207700,R1,RES/LTD,,,
3473,54-2-0-13-0,6776-22-0734,SNGL FAM SUB,3.69,AC,91300,0,91300,324900,3900,420100,81400,0,81400,270700,2800,354900,A2,AG/LTD,,,
3474,60-7-0-A-0,6785-10-2478,SNGL FAM SUB,5.9,AC,255400,0,255400,1271500,145700,1672600,227800,0,227800,1036600,133500,1397900,A2,AG/LTD,,,
3475,55-7-0-1-A,6785-18-3070,SNGL FAM SUB,2,AC,96500,0,96500,278800,1500,376800,86100,0,86100,234600,1500,322200,A2,AG/LTD,,,
3476,7-3-0-1-0,6842-29-2718,SNGL FAM SUB,1.77,AC,46600,0,46600,178800,1000,226400,45200,0,45200,153900,1000,200100,A1,AG/GEN,,,
3477,55-12-0-C-1,6785-44-1362,AG 20-100 AC,22.163,AC,402300,392100,10200,0,0,402300,359500,350100,9400,0,0,359500,A2,AG/LTD,,,
3478,55-12-0-C-2,6785-43-1131,AG 20-100 AC,26.136,AC,414600,402600,12000,0,0,414600,371300,360200,11100,0,0,371300,A2,AG/LTD,,,
3479,17-1-0-14-A,6709-67-6729,SNGL FAM SUB,4.281,AC,57200,0,57200,166100,10700,234000,56000,0,56000,150000,10700,216700,A1,AG/GEN,,,
3480,17-1-0-14-B,6709-67-5945,SNGL FAM SUB,4.316,AC,57400,0,57400,0,0,57400,56200,0,56200,0,0,56200,A1,AG/GEN,,,
3481,6-1-0-55-0,6833-40-7503,AG 20-100 AC,68.03,AC,930100,898700,31400,0,0,930100,905400,876500,28900,0,0,905400,A1B1,AG GEN/,,,
3482,6-1-0-55-A,6833-21-9699,COMM & IND,3,AC,206700,205300,1400,0,0,206700,200800,199500,1300,0,0,200800,B1,BUS/GEN,,,
3484,20-3-0-1-A,6840-25-7657,SNGL FAM SUB,1.008,AC,40100,0,40100,0,0,40100,39600,0,39600,0,0,39600,A1,AG/GEN,,,
3485,26-2-0-3-N,6709-51-4099,AG > 100 AC,207.145,AC,626400,530900,95500,0,0,626400,621400,533400,88000,0,0,621400,A1,AG/GEN,,,
3486,45-16-0-16-0,6798-52-8153,SNGL FAM SUB,1.97,AC,86300,0,86300,220600,1800,308700,77000,0,77000,180100,1800,258900,A2,AG/LTD,,,
3487,55-16-0-11-0,6776-63-0635,SNGL FAM SUB,5.938,AC,151700,0,151700,322800,7500,482000,135600,0,135600,272000,6500,414100,A2,AG/LTD,,,
3488,55-15-0-5-0,6785-67-8224,SNGL FAM SUB,3.05,AC,115100,0,115100,267800,1500,384400,102700,0,102700,220500,1500,324700,A2,AG/LTD,,,
3489,64-16-0-B-0,7734-03-5686,SNGL FAM SUB,3.223,AC,192400,0,192400,240100,600,433100,167400,0,167400,203400,600,371400,A2,AG/LTD,,,
3490,3-2-0-2-0,6803-24-4201,SNGL FAM SUB,2.28,AC,46100,0,46100,105100,500,151700,44400,0,44400,91500,500,136400,A1,AG/GEN,,,
3491,38-1-0-4-0,6708-90-1519,SNGL FAM SUB,16.835,AC,119600,0,119600,0,0,119600,117200,0,117200,0,0,117200,A1,AG/GEN,,,
3492,38-1-0-10-0,6707-99-0969,SNGL FAM SUB,14.658,AC,108500,0,108500,0,0,108500,106300,0,106300,0,0,106300,A1,AG/GEN,,,
3493,38-1-0-11-0,6707-99-3129,SNGL FAM SUB,1,AC,38800,0,38800,100100,0,138900,38000,0,38000,87800,0,125800,A1,AG/GEN,,,
3494,38-1-0-13-0,6707-89-5697,SNGL FAM SUB,3.169,AC,49300,0,49300,347100,0,396400,48300,0,48300,290400,0,338700,A1,AG/GEN,,,
3495,38-2-0-1-0,6718-00-5779,SNGL FAM SUB,1.182,AC,39800,0,39800,184200,0,224000,39000,0,39000,160000,0,199000,A1,AG/GEN,,,
3496,63-1-0-154-0,7724-39-1039,SNGL FAM SUB,13.88,AC,332800,0,332800,138200,8000,479000,289100,0,289100,116400,8000,413500,A2,AG/LTD,,,
3497,63-1-0-155-0,7724-49-1010,AG 20-100 AC,80.46,AC,1866700,1602200,264500,0,0,1866700,1625300,1393400,231900,0,0,1625300,A2,AG/LTD,,,
3498,55-15-0-6-0,6785-66-6988,SNGL FAM SUB,3.09,AC,115700,0,115700,324500,2500,442700,103300,0,103300,273400,2500,379200,A2,AG/LTD,,,
3499,55-15-0-7-0,6785-66-5753,SNGL FAM SUB,3.48,AC,105400,0,105400,0,0,105400,94000,0,94000,0,0,94000,A2,AG/LTD,,,
3500,11-10-0-1-0,6821-45-5990,SNGL FAM SUB,17.439,AC,116700,0,116700,0,0,116700,114500,0,114500,0,0,114500,A1,AG/GEN,,,
3501,11-10-0-3-0,6821-35-0551,AG 20-100 AC,24.266,AC,112000,0,112000,0,100,112100,109200,0,109200,0,100,109300,A1,AG/GEN,,,
3502,11-11-0-2-0,6821-44-4761,SNGL FAM SUB,15.359,AC,108400,0,108400,0,0,108400,109800,0,109800,0,0,109800,A1,AG/GEN,,,
3503,11-11-0-3-0,6821-34-9671,SNGL FAM SUB,15.354,AC,116300,0,116300,0,0,116300,116900,0,116900,0,0,116900,A1,AG/GEN,,,
3504,11-11-0-4-0,6821-34-4544,SNGL FAM SUB,15.356,AC,116400,0,116400,0,0,116400,117000,0,117000,0,0,117000,A1,AG/GEN,,,
3505,31-10-2-4-0,6778-59-4947,SNGL FAM SUB,2.07,AC,82700,0,82700,219800,3000,305500,73900,0,73900,180500,3000,257400,A2,AG/LTD,,,
3506,11-10-0-2-0,6821-35-9706,SNGL FAM SUB,11,AC,94000,0,94000,97700,6500,198200,93000,0,93000,76800,12200,182000,A1,AG/GEN,,,
3507,16-1-0-80-0,5799-97-2889,SNGL FAM SUB,8,AC,20200,16500,3700,0,0,20200,20000,16600,3400,0,0,20000,A1,AG/GEN,,,
3508,16-1-0-81-0,6709-07-2707,AG 20-100 AC,22,AC,71600,61500,10100,0,0,71600,70500,61100,9400,0,0,70500,A1,AG/GEN,,,
3509,16-1-0-82-0,6709-17-1228,AG 20-100 AC,25,AC,73100,61000,12100,0,0,73100,72700,62000,10700,0,0,72700,A1,AG/GEN,,,
3510,16-1-0-83-0,6709-27-0052,AG 20-100 AC,21.66,AC,82000,71000,11000,0,0,82000,79300,70000,9300,0,0,79300,A1,AG/GEN,,,
3511,25-3-0-1-0,6709-25-6588,AG 20-100 AC,92,AC,185100,140900,44200,0,0,185100,184000,144700,39300,0,0,184000,A1,AG/GEN,,,
3512,26-1-0-3-0,6709-63-6321,AG 20-100 AC,32.56,AC,152800,97000,55800,157300,25300,335400,148500,97000,51500,130500,25300,304300,A1,AG/GEN,,,
3513,42-1-0-95-0,6767-13-3288,General Gov,2.888,AC,287900,0,287900,0,60400,348300,277000,0,277000,0,57300,334300,B1A2,BS AND,,,
3514,26-1-0-5-A,6709-53-6437,SNGL FAM SUB,5.3,AC,42500,0,42500,0,0,42500,40300,0,40300,0,0,40300,A1,AG/GEN,,,
3515,39-3-0-A-0,6727-12-4656,SNGL FAM SUB,2.84,AC,49100,0,49100,100200,900,150200,40600,0,40600,97000,900,138500,A1,AG/GEN,,,
3516,62-18-0-10-0,7704-64-2622,SNGL FAM SUB,3.31,AC,226300,0,226300,574300,0,800600,200300,0,200300,529000,0,729300,A2,AG/LTD,,,
3517,18-2-0-7-A,6811-90-9546,SNGL FAM SUB,1.47,AC,42800,0,42800,121800,0,164600,40800,0,40800,99700,0,140500,A1,AG/GEN,,,
3518,17-1-0-14-0,6709-54-0710,AG > 100 AC,136.951,AC,358800,253500,105300,114700,9200,482700,353900,259400,94500,102600,8500,465000,A1,AG/GEN,,,
3519,26-1-0-9-A,6709-96-6341,SNGL FAM SUB,1.11,AC,40700,0,40700,119800,1800,162300,38700,0,38700,98700,1800,139200,A1,AG/GEN,,,
3520,26-1-0-10-0,6709-95-9887,SNGL FAM SUB,1.19,AC,41100,0,41100,126900,2500,170500,39100,0,39100,103700,2500,145300,A1,AG/GEN,,,
3521,10-6-0-A-6,6801-65-2961,AG 20-100 AC,59.9,AC,161200,133100,28100,0,5300,166500,159300,133800,25500,0,5400,164700,A1,AG/GEN,,,
3522,17-1-0-68-A,6800-94-2421,AG 20-100 AC,31.8,AC,96100,0,96100,0,0,96100,95400,0,95400,0,0,95400,A1,AG/GEN,,,
3523,17-1-0-67-A,6810-14-7475,SNGL FAM SUB,7.091,AC,9800,0,9800,0,0,9800,9800,0,9800,0,0,9800,A1,AG/GEN,,,
3524,18-6-0-2-A,6810-99-8530,SNGL FAM SUB,2,AC,46000,0,46000,162800,100,208900,44000,0,44000,133500,100,177600,A1,AG/GEN,,,
3525,26-1-0-9-0,6709-95-6974,SNGL FAM SUB,7.2,AC,75100,0,75100,0,0,75100,75200,0,75200,0,0,75200,A1,AG/GEN,,,
3526,26-1-0-68-0,6709-96-8733,SNGL FAM SUB,5,AC,63500,0,63500,142800,0,206300,62000,0,62000,120400,0,182400,A1,AG/GEN,,,
3527,29-1-0-28-0,6748-42-2325,SNGL FAM SUB,0.61,AC,47800,0,47800,96400,43500,187700,44100,0,44100,86700,42700,173500,A1,AG/GEN,,,
3528,42-3-0-6-0,6767-04-9216,COMM & IND,1.295,AC,161700,0,161700,223000,28700,413400,155500,0,155500,212000,24300,391800,BN,BUS/NHD,,,
3530,26-1-0-11-0,6719-05-0438,SNGL FAM SUB,7.01,AC,74600,0,74600,0,0,74600,73600,0,73600,0,0,73600,A1,AG/GEN,,,
3531,29-1-0-29-A,6748-42-2500,SNGL FAM SUB,0.5,AC,5000,0,5000,0,0,5000,4700,0,4700,0,0,4700,A1,AG/GEN,,,
3532,11-1-0-38-0,6821-55-8029,AG 20-100 AC,89,AC,234800,0,234800,0,0,234800,231500,0,231500,0,0,231500,A1,AG/GEN,,,
3533,26-1-0-3-A,6709-53-3277,SNGL FAM SUB,5.557,AC,46300,0,46300,0,0,46300,44100,0,44100,0,0,44100,A1,AG/GEN,,,
3534,18-2-0-6-0,6821-00-2077,SNGL FAM SUB,4.78,AC,62200,0,62200,0,0,62200,60700,0,60700,0,0,60700,A1,AG/GEN,,,
3535,18-2-0-7-0,6821-00-4151,SNGL FAM SUB,3.31,AC,53800,0,53800,0,0,53800,50700,0,50700,0,0,50700,A1,AG/GEN,,,
3536,18-2-0-8-0,6821-00-3359,SNGL FAM SUB,4.78,AC,53300,0,53300,174100,34300,261700,51600,0,51600,145000,27700,224300,A1,AG/GEN,,,
3537,62-2-A-4-0,7704-93-7735,SNGL FAM SUB,0.87,AC,115000,0,115000,221600,21000,357600,100000,0,100000,202700,17300,320000,R1,RES/LTD,,,
3538,11-11-0-1-0,6821-44-9825,SNGL FAM SUB,15.356,AC,104400,0,104400,0,0,104400,104100,0,104100,0,0,104100,A1,AG/GEN,,,
3539,6-8-0-B-0,6833-82-3417,SNGL FAM SUB,2.62,AC,48200,0,48200,14000,100,62300,47300,0,47300,13700,100,61100,A1,AG/GEN,,,
3540,6-8-0-C-0,6833-82-3669,SNGL FAM SUB,2.76,AC,49000,0,49000,132100,1200,182300,48000,0,48000,104600,1200,153800,A1,AG/GEN,,,
3541,6-8-0-E-0,6833-83-1068,SNGL FAM SUB,3.15,AC,51100,0,51100,243800,900,295800,50000,0,50000,212000,900,262900,A1,AG/GEN,,,
3542,6-8-0-F-0,6833-83-4178,SNGL FAM SUB,3.94,AC,55300,0,55300,133300,3000,191600,54200,0,54200,108400,3000,165600,A1,AG/GEN,,,
3543,6-8-0-I-0,6833-83-9754,SNGL FAM SUB,2.61,AC,48200,0,48200,8200,500,56900,47200,0,47200,8000,500,55700,A1,AG/GEN,,,
3544,6-8-0-J-0,6833-93-1904,SNGL FAM SUB,2.14,AC,45700,0,45700,11400,2000,59100,44800,0,44800,11000,2000,57800,A1,AG/GEN,,,
3545,6-6-0-14-0,6833-81-8372,SNGL FAM SUB,3.26,AC,49700,0,49700,177500,37800,265000,46900,0,46900,155300,32400,234600,A1,AG/GEN,,,
3546,6-6-0-5-0,6833-80-6860,SNGL FAM SUB,3.04,AC,59500,0,59500,214200,1100,274800,58300,0,58300,189400,1300,249000,A1,AG/GEN,,,
3547,6-6-0-6-0,6833-80-8776,SNGL FAM SUB,3.01,AC,59300,0,59300,202400,0,261700,58100,0,58100,191900,0,250000,A1,AG/GEN,,,
3548,6-6-0-7-0,6833-90-0776,SNGL FAM SUB,3,AC,59200,0,59200,195100,1000,255300,58000,0,58000,164000,1000,223000,A1,AG/GEN,,,
3549,6-6-0-8-0,6833-90-3836,SNGL FAM SUB,4.5,AC,70800,0,70800,87800,1000,159600,69400,0,69400,72400,1000,142800,A1,AG/GEN,,,
3550,6-6-0-11-0,6833-81-1407,SNGL FAM SUB,3.1,AC,49200,0,49200,109100,19200,177500,46200,0,46200,89900,26300,162400,A1,AG/GEN,,,
3551,6-6-0-12-0,6833-81-3465,SNGL FAM SUB,3.15,AC,49200,0,49200,49400,4600,103200,46400,0,46400,47300,6000,99700,A1,AG/GEN,,,
3552,6-6-0-13-0,6833-81-6411,SNGL FAM SUB,3.15,AC,49200,0,49200,95700,1500,146400,46400,0,46400,78000,1500,125900,A1,AG/GEN,,,
3553,6-6-0-16-0,6833-91-4418,SNGL FAM SUB,4.41,AC,55000,0,55000,12800,3000,70800,52000,0,52000,13000,2700,67700,A1,AG/GEN,,,
3554,6-6-0-17-0,6833-91-5648,SNGL FAM SUB,4.13,AC,53700,0,53700,136300,1500,191500,50800,0,50800,126100,1500,178400,A1,AG/GEN,,,
3555,6-6-0-20-0,6833-92-6254,SNGL FAM SUB,3.15,AC,49200,0,49200,136900,0,186100,46400,0,46400,115000,0,161400,A1,AG/GEN,,,
3556,6-6-0-28-0,6833-94-7015,SNGL FAM SUB,7.05,AC,64300,0,64300,0,8400,72700,60200,0,60200,0,7700,67900,A1,AG/GEN,,,
3557,6-6-0-29-0,6833-93-5601,SNGL FAM SUB,5.4,AC,59500,0,59500,41500,18400,119400,52800,0,52800,38300,18800,109900,A1,AG/GEN,,,
3558,6-6-0-33-0,6833-92-0637,SNGL FAM SUB,6.55,AC,64800,0,64800,0,0,64800,58000,0,58000,0,0,58000,A1,AG/GEN,,,
3559,6-6-0-35-0,6833-82-9401,SNGL FAM SUB,3.18,AC,49300,0,49300,138000,0,187300,46500,0,46500,120500,0,167000,A1,AG/GEN,,,
3560,6-6-0-36-0,6833-82-8214,SNGL FAM SUB,3.18,AC,49300,0,49300,164900,23700,237900,46500,0,46500,130800,24800,202100,A1,AG/GEN,,,
3561,6-6-0-38-0,6833-81-6962,SNGL FAM SUB,3.21,AC,49400,0,49400,99200,1500,150100,46600,0,46600,81100,1500,129200,A1,AG/GEN,,,
3562,6-6-0-39-0,6833-81-3995,SNGL FAM SUB,3.35,AC,50100,0,50100,120500,2000,172600,47300,0,47300,100600,2000,149900,A1,AG/GEN,,,
3563,7-2-0-10-0,6833-90-6914,SNGL FAM SUB,4.51,AC,70900,0,70900,296200,15800,382900,69500,0,69500,261500,15100,346100,A1,AG/GEN,,,
3564,7-2-0-22-0,6833-92-7662,SNGL FAM SUB,3.23,AC,49500,0,49500,116200,1200,166900,46700,0,46700,95600,1200,143500,A1,AG/GEN,,,
3565,7-2-0-23-0,6833-92-8737,SNGL FAM SUB,3.12,AC,49000,0,49000,189200,3500,241700,46200,0,46200,171100,3500,220800,A1,AG/GEN,,,
3566,7-2-0-24-0,6833-92-9906,SNGL FAM SUB,3.13,AC,49100,0,49100,103100,1400,153600,46300,0,46300,82600,1400,130300,A1,AG/GEN,,,
3567,7-2-0-25-0,6833-93-9189,SNGL FAM SUB,3.16,AC,49200,0,49200,241300,30000,320500,46400,0,46400,216200,26900,289500,A1,AG/GEN,,,
3568,7-2-0-26-0,6843-03-1500,SNGL FAM SUB,4.51,AC,55400,0,55400,75100,1700,132200,52500,0,52500,62500,1700,116700,A1,AG/GEN,,,
3569,7-2-0-27-0,6843-04-1082,SNGL FAM SUB,6.89,AC,63600,0,63600,11100,800,75500,56900,0,56900,11900,1300,70100,A1,AG/GEN,,,
3570,12-1-0-45-A,6831-06-6470,SNGL FAM SUB,2.08,AC,48100,0,48100,10000,0,58100,47900,0,47900,10000,0,57900,A1,AG/GEN,,,
3571,57-20-C-12-0,7715-09-5973,SNGL FAM SUB,1.722,AC,315000,0,315000,440000,0,755000,288800,0,288800,415100,0,703900,A2,AG/LTD,,,
3572,32-10-1-23-0,6778-79-3125,SNGL FAM SUB,3.73,AC,106600,0,106600,315900,2500,425000,95300,0,95300,260700,2500,358500,A2,AG/LTD,,,
3573,32-10-2-10-0,6779-60-0691,SNGL FAM SUB,3.16,AC,98400,0,98400,234900,0,333300,88000,0,88000,199700,0,287700,A2,AG/LTD,,,
3574,4-1-0-43-A,6813-19-4721,SNGL FAM SUB,3.59,AC,52900,0,52900,184300,40400,277600,52000,0,52000,157600,37900,247500,A1,AG/GEN,,,
3575,29-1-0-66-0,6749-54-0226,SNGL FAM SUB,3.15,AC,93800,0,93800,91700,1900,187400,89000,0,89000,77700,1900,168600,A1,AG/GEN,,,
3576,44-1-0-72-0,6786-58-4812,SNGL FAM SUB,5,AC,130500,0,130500,26000,300,156800,116600,0,116600,22500,300,139400,A2,AG/LTD,,,
3577,55-16-0-1-0,6776-73-4919,SNGL FAM SUB,5.2,AC,140500,0,140500,425900,51800,618200,125600,0,125600,346100,44600,516300,A2,AG/LTD,,,
3578,32-10-1-12-0,6778-68-4660,SNGL FAM SUB,1.48,AC,74200,0,74200,189500,6200,269900,66300,0,66300,153100,4600,224000,A2,AG/LTD,,,
3579,57-25-B-9-0,7716-13-9431,SNGL FAM SUB,2.198,AC,335800,0,335800,275700,22600,634100,308200,0,308200,253600,19100,580900,A2,AG/LTD,,,
3580,33-4-0-7-0,6798-63-1466,SNGL FAM SUB,2.18,AC,93000,0,93000,188900,1000,282900,83000,0,83000,153700,1000,237700,A2,AG/LTD,,,
3581,13-13-0-9-0,6841-92-3683,SNGL FAM SUB,2,AC,58600,0,58600,131000,4000,193600,57500,0,57500,120800,4000,182300,A1,AG/GEN,,,
3582,32-10-1-5-0,6778-78-4615,SNGL FAM SUB,1.27,AC,71200,0,71200,199800,0,271000,63600,0,63600,166600,0,230200,A2,AG/LTD,,,
3583,28-1-0-97-0,6738-36-7338,SNGL FAM SUB,2.01,AC,54700,0,54700,197200,2900,254800,54800,0,54800,169300,2900,227000,A1,AG/GEN,,,
3584,57-21-0-1-0,7715-19-1831,SNGL FAM SUB,6.22,AC,365000,0,365000,1353200,57000,1775200,335000,0,335000,1244100,52000,1631100,A2,AG/LTD,,,
3586,57-21-0-3-0,7715-19-5803,SNGL FAM SUB,3.5,AC,346800,0,346800,777300,62700,1186800,318300,0,318300,738300,56800,1113400,A2,AG/LTD,,,
3587,57-21-0-3-A,7715-19-5565,Roads,0.616,AC,0,0,0,0,0,0,0,0,0,0,0,0,A2,AG/LTD,,,
3589,45-18-0-8-0,6797-45-9300,SNGL FAM SUB,9.161,AC,241500,0,241500,700400,11100,953000,217400,0,217400,634400,10200,862000,A2,AG/LTD,,,
3590,31-1-0-6-0,6769-64-7556,SNGL FAM SUB,11.437,AC,172000,0,172000,0,0,172000,158400,0,158400,0,0,158400,A2,AG/LTD,,,
3591,31-10-2-2-0,6778-59-5651,SNGL FAM SUB,2.2,AC,84600,0,84600,160500,200,245300,75600,0,75600,131200,200,207000,A2,AG/LTD,,,
3592,9-1-0-75-0,5892-85-6111,SNGL FAM SUB,1.83,AC,41800,0,41800,79500,500,121800,40900,0,40900,69500,500,110900,A1,AG/GEN,,,
3593,18-1-0-11-A,6810-67-3124,SNGL FAM SUB,16.27,AC,122400,0,122400,0,0,122400,122000,0,122000,0,0,122000,A1,AG/GEN,,,
3594,19-11-0-6-0,6830-49-7931,AG 20-100 AC,27.64,AC,199500,0,199500,0,0,199500,188400,0,188400,0,0,188400,A1,AG/GEN,,,
3595,28-1-0-59-C,6739-10-6515,SNGL FAM SUB,15.95,AC,124700,117300,7400,0,0,124700,124700,117900,6800,0,0,124700,A1,AG/GEN,,,
3596,28-2-0-1-0,6738-45-1516,SNGL FAM SUB,1.36,AC,7600,7000,600,0,0,7600,7800,7200,600,0,0,7800,A1,AG/GEN,,,
3598,28-1-0-49-0,6738-35-1167,AG 20-100 AC,48.44,AC,280700,258400,22300,0,0,280700,276100,255500,20600,0,0,276100,A1,AG/GEN,,,
3600,28-1-0-91-0,6739-21-7278,AG 20-100 AC,21,AC,127300,117600,9700,0,0,127300,123600,114700,8900,0,0,123600,A1,AG/GEN,,,
3601,28-1-0-92-0,6739-30-0163,AG 20-100 AC,37.91,AC,159200,141700,17500,0,0,159200,159200,143100,16100,0,0,159200,A1,AG/GEN,,,
3602,28-1-0-117-0,6739-40-2401,AG 20-100 AC,33.93,AC,126100,110500,15600,0,0,126100,122100,107700,14400,0,0,122100,A1,AG/GEN,,,
3603,12-15-0-A-0,6832-02-8557,SNGL FAM SUB,8.9,AC,93800,0,93800,0,15000,108800,91500,0,91500,0,13200,104700,A1,AG/GEN,,,
3604,12-15-0-C-0,6832-03-9797,SNGL FAM SUB,13.5,AC,92100,0,92100,0,0,92100,91700,0,91700,0,0,91700,A1,AG/GEN,,,
3605,28-1-0-48-0,6738-34-4344,AG 20-100 AC,25.84,AC,149700,137800,11900,0,0,149700,147300,136300,11000,0,0,147300,A1,AG/GEN,,,
3606,40-1-0-36-0,6738-31-7669,SNGL FAM SUB,7.375,AC,98100,0,98100,0,0,98100,96400,0,96400,0,0,96400,A1,AG/GEN,,,
3607,62-2-A-7-0,7704-94-3030,SNGL FAM SUB,0,AC,115000,0,115000,196300,400,311700,100000,0,100000,180900,400,281300,R1,RES/LTD,,,
3608,56-9-0-D-0,6786-70-9520,SNGL FAM SUB,6,AC,160000,0,160000,301000,1100,462100,142700,0,142700,257000,1100,400800,A2,AG/LTD,,,
3609,45-12-0-H-1,6798-51-6764,SNGL FAM SUB,1.29,AC,76900,0,76900,9200,900,87000,68700,0,68700,8700,700,78100,A2,AG/LTD,,,
3610,12-7-0-2-A,6821-87-7171,SNGL FAM SUB,5.01,AC,60300,0,60300,89000,20900,170200,58300,0,58300,74100,17600,150000,A1,AG/GEN,,,
3611,58-4-A-8-0,7716-57-3154,SNGL FAM SUB,0,AC,20100,0,20100,0,0,20100,18300,0,18300,0,0,18300,A2,AG/LTD,,,
3612,18-1-0-47-A,6810-86-5730,Vacant Land,32.05,AC,134200,0,134200,0,0,134200,134300,0,134300,0,0,134300,A1,AG/GEN,,,
3613,18-1-0-52-A,6810-99-4152,SNGL FAM SUB,2.24,AC,47400,0,47400,0,0,47400,45400,0,45400,0,0,45400,A1,AG/GEN,,,
3614,46-26-0-3-0,7707-67-2285,SNGL FAM SUB,4.745,AC,158600,0,158600,240800,3000,402400,144200,0,144200,201600,3000,348800,A2,AG/LTD,,,
3615,55-18-0-5-A,6786-05-3558,SNGL FAM SUB,3,AC,82800,0,82800,0,0,82800,74000,0,74000,0,0,74000,A2,AG/LTD,,,
3616,55-18-0-6-0,6786-05-3748,SNGL FAM SUB,5,AC,125300,0,125300,207200,4500,337000,111800,0,111800,170800,4500,287100,A2,AG/LTD,,,
3617,55-18-0-7-0,6786-06-3023,SNGL FAM SUB,5,AC,125300,0,125300,0,6000,131300,111800,0,111800,0,6000,117800,A2,AG/LTD,,,
3618,47-1-0-58-0,7718-51-7436,SNGL FAM SUB,1.788,AC,112400,0,112400,153800,9300,275500,100400,0,100400,127600,9300,237300,A2,AG/LTD,,,
3620,30-11-0-3-0,6758-22-1345,SNGL FAM SUB,3,AC,73600,0,73600,162100,32400,268100,70700,0,70700,135700,27100,233500,A2,AG/LTD,,,
3621,51-7-0-A-1,6736-10-7794,SNGL FAM SUB,1,AC,38800,0,38800,84000,100,122900,38000,0,38000,72000,100,110100,A1,AG/GEN,,,
3622,51-1-0-37-0,6736-22-0142,AG > 100 AC,102.917,AC,470700,383400,87300,211800,17200,699700,459500,378000,81500,184800,17200,661500,A1,AG/GEN,,,
3773,47-1-0-58-A,7718-51-6206,SNGL FAM SUB,5.76,AC,179900,0,179900,235600,30000,445500,160800,0,160800,197100,25300,383200,A2,AG/LTD,,,
3776,11-1-0-50-B,6822-50-7462,AG 20-100 AC,31.851,AC,172500,97500,75000,353100,105400,631000,139800,0,139800,319000,84600,543400,A1,AG/GEN,,,
3777,5-1-0-32-0,6813-93-4170,SNGL FAM SUB,17.66,AC,98700,0,98700,0,0,98700,96900,0,96900,0,0,96900,A1,AG/GEN,,,
3778,29-9-0-1-0,6748-97-5637,SNGL FAM SUB,6.688,AC,87200,0,87200,0,0,87200,81800,0,81800,0,0,81800,A1,AG/GEN,,,
3779,29-9-0-3-A,6748-88-8530,SNGL FAM SUB,1.954,AC,62600,0,62600,23700,0,86300,57300,0,57300,27100,0,84400,A1,AG/GEN,,,
3780,29-9-0-4-0,6748-88-3923,SNGL FAM SUB,2.328,AC,65900,0,65900,217700,0,283600,60900,0,60900,181900,0,242800,A1,AG/GEN,,,
3781,29-9-0-5-0,6748-89-6339,SNGL FAM SUB,4.795,AC,86200,0,86200,534800,0,621000,81400,0,81400,444300,0,525700,A1,AG/GEN,,,
3782,29-9-0-7-0,6748-89-5952,SNGL FAM SUB,3,AC,70800,0,70800,0,0,70800,65500,0,65500,0,0,65500,A1,AG/GEN,,,
3783,29-1-0-22-0,6738-94-9413,AG > 100 AC,167.432,AC,133300,0,133300,297300,600,431200,120900,0,120900,251300,600,372800,A1,AG/GEN,,,
3784,11-1-0-35-B,6821-24-0297,SNGL FAM SUB,3.774,AC,56400,0,56400,11300,600,68300,56000,0,56000,11100,600,67700,A1,AG/GEN,,,
3785,11-1-0-35-C,6821-24-1019,SNGL FAM SUB,2.493,AC,49000,0,49000,159000,0,208000,47700,0,47700,130700,0,178400,A1,AG/GEN,,,
3786,44-1-0-74-0,6787-72-9134,SNGL FAM SUB,5,AC,133300,0,133300,0,0,133300,119000,0,119000,0,0,119000,A2,AG/LTD,,,
3787,44-1-0-31-B,6787-12-5645,SNGL FAM SUB,1.18,AC,72900,0,72900,62200,3000,138100,65100,0,65100,51300,3000,119400,A2,AG/LTD,,,
3788,17-1-0-48-0,6810-28-6852,AG 20-100 AC,47.8,AC,227900,161300,66600,204200,168500,600600,225200,167100,58100,176500,150300,552000,A1,AG/GEN,,,
3789,17-1-0-47-D,6810-38-3560,AG 20-100 AC,25.52,AC,112100,62000,50100,896400,17300,1025800,111600,60500,51100,801000,18200,930800,A1,AG/GEN,,,
3945,56-1-0-13-0,6785-85-1864,SNGL FAM SUB,1.28,AC,74500,0,74500,188600,1000,264100,66500,0,66500,158600,1000,226100,A2,AG/LTD,,,
3946,62-2-B-10-0,7714-04-0048,SNGL FAM SUB,0,AC,115000,0,115000,275800,11300,402100,100000,0,100000,250900,11300,362200,R1,RES/LTD,,,
3947,26-11-0-3-0,6719-06-9225,SNGL FAM SUB,14.93,AC,120400,0,120400,81900,800,203100,118400,0,118400,68800,800,188000,A1,AG/GEN,,,
3961,11-1-0-51-0,6822-53-4392,SNGL FAM SUB,5,AC,78800,0,78800,186400,7700,272900,77400,0,77400,159700,9500,246600,A1,AG/GEN,,,
3963,11-1-0-21-0,6811-67-5153,SNGL FAM SUB,4.088,AC,56100,0,56100,101900,100,158100,55000,0,55000,85900,100,141000,A1,AG/GEN,,,
3964,45-1-0-91-A,6797-86-3567,SNGL FAM SUB,1,AC,76700,0,76700,110500,200,187400,68500,0,68500,90900,200,159600,A2,AG/LTD,,,
3965,39-1-0-7-0,6727-09-7619,SNGL FAM SUB,2,AC,9200,0,9200,0,0,9200,9000,0,9000,0,0,9000,A1,AG/GEN,,,
3966,11-1-0-19-0,6811-67-1159,SNGL FAM SUB,3.481,AC,52700,0,52700,0,0,52700,52200,0,52200,0,0,52200,A1,AG/GEN,,,
3967,13-9-0-1-0,6841-74-2459,SNGL FAM SUB,2,AC,58600,0,58600,180600,2800,242000,57500,0,57500,157100,1900,216500,A1,AG/GEN,,,
3968,13-9-0-2-0,6841-64-8176,SNGL FAM SUB,2.69,AC,64600,0,64600,213800,9200,287600,63400,0,63400,188500,6400,258300,A1,AG/GEN,,,
4122,14-2-0-11-B,6851-26-3378,SNGL FAM SUB,3.58,AC,58100,0,58100,124000,4200,186300,57800,0,57800,103100,4200,165100,A1,AG/GEN,,,
4123,67-13-C-8-0,7733-36-0479,SNGL FAM SUB,0,AC,265000,0,265000,548500,69400,882900,220000,0,220000,453600,65800,739400,R1,RES/LTD,,,
4124,13-1-0-50-A,6841-47-3072,SNGL FAM SUB,2.16,AC,60000,0,60000,167000,26700,253700,58900,0,58900,146500,24700,230100,A1,AG/GEN,,,
4125,5-1-0-15-C,6813-74-6468,SNGL FAM SUB,1,AC,39700,0,39700,101800,0,141500,39000,0,39000,88800,0,127800,A1,AG/GEN,,,
4128,5-1-0-15-A,6813-73-7145,SNGL FAM SUB,3.07,AC,50300,0,50300,221400,0,271700,49400,0,49400,205300,0,254700,A1,AG/GEN,,,
3623,51-1-0-36-0,6736-33-4355,AG 20-100 AC,46.36,AC,118200,96800,21400,0,0,118200,115900,96200,19700,0,0,115900,A1,AG/GEN,,,
3624,51-12-0-1-A,6736-30-6264,SNGL FAM SUB,0.72,AC,4400,0,4400,0,0,4400,4300,0,4300,0,0,4300,A1,AG/GEN,,,
3625,51-12-0-1-B,6735-39-6895,SNGL FAM SUB,2.02,AC,45000,0,45000,125300,300,170600,44100,0,44100,106100,300,150500,A1,AG/GEN,,,
3626,51-12-0-2-0,6735-39-5832,SNGL FAM SUB,3.64,AC,54900,0,54900,153600,13100,221600,53800,0,53800,133600,11100,198500,A1,AG/GEN,,,
3627,51-12-0-3-0,6735-39-3739,SNGL FAM SUB,3.56,AC,54400,0,54400,212100,700,267200,53400,0,53400,178900,700,233000,A1,AG/GEN,,,
3628,51-12-0-4-0,6735-39-1729,SNGL FAM SUB,3.12,AC,51700,0,51700,0,0,51700,50700,0,50700,0,0,50700,A1,AG/GEN,,,
3629,51-12-0-5-0,6735-29-7943,SNGL FAM SUB,2.54,AC,42400,0,42400,0,0,42400,41500,0,41500,0,0,41500,A1,AG/GEN,,,
3630,51-1-0-1-B,6726-96-0497,SNGL FAM SUB,1.5,AC,41900,0,41900,219200,23700,284800,41000,0,41000,191900,19000,251900,A1,AG/GEN,,,
3631,55-20-0-1-0,6785-45-5624,SNGL FAM SUB,10.06,AC,219500,0,219500,378600,30900,629000,196100,0,196100,314700,26100,536900,A2,AG/LTD,,,
3632,55-19-0-6-0,6776-85-4618,SNGL FAM SUB,2.178,AC,86400,0,86400,183200,1000,270600,77100,0,77100,149500,1000,227600,A2,AG/LTD,,,
3633,4-3-0-15-0,6803-92-0823,SNGL FAM SUB,3.42,AC,47300,0,47300,0,0,47300,46300,0,46300,0,0,46300,A1,AG/GEN,,,
3634,67-2-B-6-0,7723-56-0120,SNGL FAM SUB,0,AC,184000,0,184000,231600,2100,417700,160000,0,160000,195600,2100,357700,R1,RES/LTD,,,
3635,57-1-0-72-0,7706-83-7046,SNGL FAM SUB,2.5,AC,196000,0,196000,198000,200,394200,170400,0,170400,173300,200,343900,A2,AG/LTD,,,
3636,64-4-1-32-0,7724-82-8997,COMM & IND,0.402,AC,83300,0,83300,0,0,83300,77200,0,77200,0,0,77200,RN,RESIDEN,,,
3637,9-1-0-33-0,5892-53-0767,SNGL FAM SUB,2.746,AC,45100,0,45100,0,0,45100,43200,0,43200,0,0,43200,A1,AG/GEN,,,
3638,9-1-0-37-0,5892-43-8416,SNGL FAM SUB,5.481,AC,54900,0,54900,149000,1600,205500,51400,0,51400,119500,1800,172700,A1,AG/GEN,,,
3639,31-5-0-1-0,6769-52-0147,SNGL FAM SUB,0.866,AC,58100,0,58100,332500,28700,419300,52500,0,52500,274400,27300,354200,A2,AG/LTD,,,
3641,31-5-0-3-0,6769-52-2352,SNGL FAM SUB,2.75,AC,82400,0,82400,350400,22300,455100,74200,0,74200,287000,21000,382200,A2,AG/LTD,,,
3643,39-1-0-77-0,6726-27-7881,AG 20-100 AC,33.77,AC,205900,151300,54600,128200,28200,362300,201900,149900,52000,110100,24600,336600,A1,AG/GEN,,,
3644,39-1-0-78-0,6726-28-1426,SNGL FAM SUB,2.37,AC,60500,0,60500,81100,700,142300,59200,0,59200,71400,600,131200,A1,AG/GEN,,,
3645,30-1-0-66-0,6759-62-5644,SNGL FAM SUB,5.657,AC,91900,0,91900,303800,1500,397200,83800,0,83800,258800,1500,344100,A2,AG/LTD,,,
3646,63-1-0-176-A,7724-22-8641,MultiFamily,5.98,AC,536600,0,536600,0,0,536600,466600,0,466600,0,0,466600,R3,RES/GEN,,,
3647,67-3-F-3-0,7723-53-2931,SNGL FAM SUB,0,AC,184000,0,184000,363200,0,547200,160000,0,160000,308400,0,468400,R1,RES/LTD,,,
3648,47-22-0-C-0,7717-89-8942,SNGL FAM SUB,6.338,AC,189700,0,189700,291300,2000,483000,169500,0,169500,252700,2000,424200,A2,AG/LTD,,,
3649,47-22-0-B-0,7717-89-6606,SNGL FAM SUB,9.86,AC,249600,0,249600,0,38300,287900,223100,0,223100,0,35000,258100,A2,AG/LTD,,,
3650,47-22-0-F-0,7718-80-7956,SNGL FAM SUB,12.51,AC,294700,288500,6200,0,0,294700,263400,258100,5300,0,0,263400,A2,AG/LTD,,,
3651,47-22-0-D-0,7718-80-6201,SNGL FAM SUB,10,AC,252000,0,252000,256100,8100,516200,225200,0,225200,213400,8100,446700,A2,AG/LTD,,,
3652,46-1-0-33-0,7707-33-1797,SNGL FAM SUB,1.8,AC,117200,0,117200,83500,9900,210600,104700,0,104700,70500,9900,185100,RR,RES/RUR,,,
3653,47-22-0-A-0,7717-89-4412,SNGL FAM SUB,9.83,AC,249100,0,249100,77000,12100,338200,222600,0,222600,66200,12100,300900,A2,AG/LTD,,,
3654,39-1-0-63-0,6726-18-6689,SNGL FAM SUB,0.51,AC,25700,0,25700,53200,900,79800,25200,0,25200,46400,900,72500,A1,AG/GEN,,,
3655,39-1-0-15-B,6727-15-7414,SNGL FAM SUB,2,AC,44400,0,44400,161600,18800,224800,43500,0,43500,137800,16000,197300,A1,AG/GEN,,,
3656,39-1-0-63-A,6726-18-6577,SNGL FAM SUB,1.86,AC,43600,0,43600,154100,2200,199900,42700,0,42700,130200,2200,175100,A1,AG/GEN,,,
3657,39-1-0-63-B,6726-18-4850,SNGL FAM SUB,2.93,AC,49600,0,49600,70500,300,120400,48600,0,48600,60400,300,109300,A1,AG/GEN,,,
3658,64-12-B-8-0,7724-60-3435,SNGL FAM SUB,0,AC,77000,0,77000,243800,1600,322400,67000,0,67000,210900,1700,279600,R1,RES/LTD,,,
3659,50-1-0-1-A,6716-85-6537,SNGL FAM SUB,2.5,AC,28600,0,28600,0,0,28600,28000,0,28000,0,0,28000,A1,AG/GEN,,,
3660,46-27-B-5-0,7707-86-2457,SNGL FAM SUB,2,AC,165000,0,165000,300200,19400,484600,150000,0,150000,253900,14800,418700,RR,RES/RUR,,,
3661,47-26-0-1-0,7717-99-5973,SNGL FAM SUB,2.027,AC,106600,0,106600,158100,17500,282200,95200,0,95200,133800,14800,243800,A2,AG/LTD,,,
3662,45-1-0-55-0,6787-97-8022,SNGL FAM SUB,1.55,AC,78800,0,78800,259600,0,338400,70400,0,70400,212300,0,282700,A2,AG/LTD,,,
3663,15-1-0-19-A,5880-32-8064,SNGL FAM SUB,6.07,AC,35300,32500,2800,0,0,35300,34500,31900,2600,0,0,34500,A1,AG/GEN,,,
3664,15-1-0-20-0,5880-43-4318,AG 20-100 AC,88.08,AC,180700,108300,72400,0,0,180700,176200,107300,68900,0,0,176200,A1,AG/GEN,,,
3665,62-18-0-15-0,7704-63-8290,SNGL FAM SUB,3.66,AC,234500,0,234500,0,0,234500,200300,0,200300,0,0,200300,A2,AG/LTD,,,
3666,4-1-0-44-0,6813-38-9899,AG 20-100 AC,73.77,AC,166000,0,166000,0,0,166000,166000,0,166000,0,0,166000,A1,AG/GEN,,,
3667,4-1-0-44-A,6813-37-4768,AG 20-100 AC,22,AC,49500,0,49500,0,0,49500,49500,0,49500,0,0,49500,A1,AG/GEN,,,
3668,5-1-0-5-0,6813-57-1940,AG 20-100 AC,99,AC,222800,0,222800,0,0,222800,222800,0,222800,0,0,222800,A1,AG/GEN,,,
3669,5-1-0-9-0,6813-56-3720,AG 20-100 AC,60,AC,196500,0,196500,8800,1000,206300,192700,0,192700,8700,1000,202400,A1,AG/GEN,,,
3670,58-2-0-19-0,7726-36-2411,SNGL FAM SUB,0,AC,88000,0,88000,205000,200,293200,80000,0,80000,167600,200,247800,RN,RESIDEN,,,
3671,54-3-0-G-0,6776-04-6350,AG > 100 AC,102,AC,1093500,883900,209600,225600,100,1319200,977600,789000,188600,185200,100,1162900,A2,AG/LTD,,,
3672,63-14-0-A-MC,7714-84-3325,Cmn Area/Open Spc,6.181,AC,0,0,0,0,0,0,0,0,0,0,0,0,R3,RES/GEN,,,
3673,63-14-0-A-0,7714-64-8159,SNGL FAM SUB,8.447,AC,345000,0,345000,502400,0,847400,314300,0,314300,476000,0,790300,A2,AG/LTD,,,
3675,6-6-0-15-0,6833-91-1337,SNGL FAM SUB,3.35,AC,50100,0,50100,76100,8700,134900,47300,0,47300,67600,6700,121600,A1,AG/GEN,,,
3676,4-3-0-18-0,6803-92-2442,SNGL FAM SUB,4.25,AC,43100,0,43100,0,0,43100,42200,0,42200,0,0,42200,A1,AG/GEN,,,
3677,47-1-0-45-A,7727-01-6533,SNGL FAM SUB,3,AC,176000,0,176000,250500,100,426600,157000,0,157000,210400,100,367500,A2,AG/LTD,,,
3678,46-9-0-B-2B,7707-67-2962,SNGL FAM SUB,5.233,AC,156900,0,156900,202300,20100,379300,142700,0,142700,168600,18800,330100,A2,AG/LTD,,,
3679,67-2-B-9-0,7723-45-9684,SNGL FAM SUB,0,AC,184000,0,184000,254900,37100,476000,160000,0,160000,215200,31800,407000,R1,RES/LTD,,,
3680,56-8-0-1-0,6795-05-8831,SNGL FAM SUB,14.1,AC,351400,0,351400,992100,20200,1363700,313600,0,313600,812800,18700,1145100,A2,AG/LTD,,,
3681,55-1-0-76-C,6786-71-8392,SNGL FAM SUB,6.123,AC,46200,0,46200,0,0,46200,41300,0,41300,0,0,41300,A2,AG/LTD,,,
3683,56-4-0-A-3,6795-18-4354,AG 20-100 AC,66.09,AC,773400,742000,31400,0,0,773400,691400,663200,28200,0,0,691400,A2,AG/LTD,,,
3684,46-23-0-39-0,7707-96-7255,SNGL FAM SUB,2.715,AC,165000,0,165000,423800,1000,589800,150000,0,150000,365900,1000,516900,A2,AG/LTD,,,
3686,18-1-0-15-A,6810-64-1947,AG 20-100 AC,25,AC,109500,0,109500,0,0,109500,110000,0,110000,0,0,110000,A1,AG/GEN,,,
3687,29-1-0-56-0,6749-61-8434,AG 20-100 AC,21.21,AC,223800,0,223800,0,0,223800,217600,0,217600,0,0,217600,A1,AG/GEN,,,
3688,29-1-0-56-A,6749-61-6141,SNGL FAM SUB,0.57,AC,5700,0,5700,0,0,5700,5400,0,5400,0,0,5400,A1,AG/GEN,,,
3689,46-14-0-10-0,7718-01-3442,SNGL FAM SUB,3.49,AC,137900,0,137900,253900,47300,439100,125400,0,125400,207900,47600,380900,A2,AG/LTD,,,
3690,31-19-0-A-0,6779-41-0046,SNGL FAM SUB,2.5,AC,85700,0,85700,176900,7000,269600,76600,0,76600,144300,7000,227900,A2,AG/LTD,,,
3691,42-5-0-1-0,6767-04-4992,COMM & IND,0.518,AC,74300,0,74300,219400,5000,298700,71400,0,71400,207300,5100,283800,RO,RES/OF,,,
3692,42-5-0-15-0,6767-04-2951,SNGL FAM SUB,0.62,AC,46900,0,46900,0,0,46900,45100,0,45100,0,0,45100,RO,RES/OF,,,
3693,43-1-0-82-D,6767-92-4079,SNGL FAM SUB,1.725,AC,80500,0,80500,202300,3500,286300,72000,0,72000,167800,3500,243300,A2,AG/LTD,,,
3694,43-21-0-19-0,6767-42-2352,SNGL FAM SUB,2.159,AC,87600,0,87600,327100,1800,416500,78200,0,78200,268600,1800,348600,A2,AG/LTD,,,
3695,17-1-0-91-0,6810-20-0825,SNGL FAM SUB,2.85,AC,51100,0,51100,206500,0,257600,48200,0,48200,169300,0,217500,A1,AG/GEN,,,
3696,16-1-0-65-0,5890-85-6692,AG 20-100 AC,53.623,AC,112200,85600,26600,0,2200,114400,107200,84200,23000,0,2200,109400,A1,AG/GEN,,,
3697,16-1-0-66-0,5890-93-1139,AG 20-100 AC,71.614,AC,144500,111200,33300,0,0,144500,143200,112700,30500,0,0,143200,A1,AG/GEN,,,
3698,16-1-0-73-0,5890-83-2797,AG 20-100 AC,89.203,AC,183000,139400,43600,0,18800,201800,178400,140200,38200,0,18800,197200,A1,AG/GEN,,,
3699,16-1-0-88-0,6800-22-7275,State Exmm,62,AC,136500,0,136500,0,0,136500,128900,0,128900,0,0,128900,A1,AG/GEN,,,
3700,58-2-0-4-0,7726-26-8556,SNGL FAM SUB,0,AC,88000,0,88000,145500,12700,246200,80000,0,80000,120200,10700,210900,RN,RESIDEN,,,
3701,12-1-0-29-0,6821-76-1416,AG 20-100 AC,30,AC,133400,0,133400,0,0,133400,128200,0,128200,0,0,128200,A1,AG/GEN,,,
3702,12-1-0-41-D,6831-34-0114,SNGL FAM SUB,2,AC,51300,0,51300,172500,22800,246600,50500,0,50500,143300,18700,212500,A1,AG/GEN,,,
3703,12-3-0-1-A,6832-11-7779,SNGL FAM SUB,2.95,AC,56200,0,56200,109700,1500,167400,54600,0,54600,92100,1500,148200,A1,AG/GEN,,,
3704,12-20-0-A-0,6831-09-9219,SNGL FAM SUB,4.64,AC,69700,0,69700,0,0,69700,67900,0,67900,0,0,67900,A1,AG/GEN,,,
3705,45-1-0-33-0,6787-83-3347,SNGL FAM SUB,8.23,AC,161800,158000,3800,0,0,161800,144600,141100,3500,0,0,144600,A2,AG/LTD,,,
3706,21-1-0-55-0,6850-83-3077,SNGL FAM SUB,1.24,AC,57000,0,57000,5000,7600,69600,52400,0,52400,5000,5400,62800,A2,AG/LTD,,,
3707,47-1-0-50-A,7717-85-4856,SNGL FAM SUB,15.505,AC,407400,0,407400,163200,68200,638800,364200,0,364200,143200,63200,570600,A2,AG/LTD,,,
3708,6-6-0-30-0,6833-93-3361,SNGL FAM SUB,4.47,AC,55200,0,55200,26600,2100,83900,50500,0,50500,29900,2100,82500,A1,AG/GEN,,,
3709,33-1-0-7-A,6798-56-0414,SNGL FAM SUB,0.4,AC,5800,0,5800,0,0,5800,5200,0,5200,0,0,5200,A2,AG/LTD,,,
3710,17-6-0-Y-0,6800-84-1906,SNGL FAM SUB,18.67,AC,100200,0,100200,0,0,100200,98500,0,98500,0,0,98500,A1,AG/GEN,,,
3711,42-3-0-11-0,6767-04-8775,SNGL FAM SUB,0.69,AC,70000,0,70000,141500,16400,227900,65000,0,65000,118900,13900,197800,R3,RES/GEN,,,
3712,57-1-0-27-0,7706-11-2312,SNGL FAM SUB,3.08,AC,149600,0,149600,53000,1000,203600,130100,0,130100,45400,1000,176500,A2,AG/LTD,,,
3713,57-10-0-25-0,7705-86-0934,SNGL FAM SUB,5.49,AC,265000,0,265000,1372300,2000,1639300,240000,0,240000,1254800,0,1494800,A2,AG/LTD,,,
3714,57-10-0-18-0,7705-68-1894,SNGL FAM SUB,6.73,AC,265000,0,265000,782100,83500,1130600,240000,0,240000,711400,75900,1027300,A2,AG/LTD,,,
3715,30-1-0-100-B,6768-08-7277,SNGL FAM SUB,2.313,AC,70200,0,70200,210400,1000,281600,60500,0,60500,173900,1000,235400,A2,AG/LTD,,,
3716,21-7-0-34-0,6850-56-0619,SNGL FAM SUB,8.67,AC,89400,0,89400,282900,32200,404500,87400,0,87400,247600,28600,363600,A1,AG/GEN,,,
3717,63-2-0-4-0,7723-28-7136,SNGL FAM SUB,4.483,AC,189200,0,189200,197100,400,386700,164600,0,164600,167500,400,332500,R1A2,RES LTD,,,
3718,43-6-0-1-0,6767-64-5310,SNGL FAM SUB,2.64,AC,93700,0,93700,256300,0,350000,83800,0,83800,237500,0,321300,A2,AG/LTD,,,
3719,38-1-0-113-B,6717-28-9794,SNGL FAM SUB,2,AC,44400,0,44400,125200,0,169600,43500,0,43500,106400,0,149900,A1,AG/GEN,,,
3721,55-10-0-3-A,6785-69-0691,SNGL FAM SUB,0.99,AC,69400,0,69400,174900,11800,256100,62000,0,62000,142400,10100,214500,A2,AG/LTD,,,
3722,43-1-0-41-0,6767-63-0772,SNGL FAM SUB,0.5,AC,43800,0,43800,183200,28700,255700,39100,0,39100,155100,24000,218200,A2,AG/LTD,,,
3723,43-1-0-40-0,6767-63-2625,SNGL FAM SUB,0.75,AC,10800,0,10800,0,0,10800,9700,0,9700,0,0,9700,A2,AG/LTD,,,
3724,43-6-0-6-0,6767-73-7853,SNGL FAM SUB,6.54,AC,90100,0,90100,0,0,90100,80300,0,80300,0,0,80300,A2,AG/LTD,,,
3725,12-1-0-45-0,6831-05-9277,Cemetery,0.8,AC,100,0,100,0,0,100,100,0,100,0,0,100,A1,AG/GEN,,,
3727,58-3-A-24-0,7726-26-4875,SNGL FAM SUB,0,AC,88000,0,88000,167400,2300,257700,80000,0,80000,138800,2300,221100,RN,RESIDEN,,,
3728,45-15-0-2-0,6797-62-0404,SNGL FAM SUB,7.57,AC,175900,0,175900,0,46300,222200,148300,0,148300,0,39600,187900,A2,AG/LTD,,,
3729,45-15-0-7-0,6797-53-3091,SNGL FAM SUB,7.57,AC,175900,0,175900,0,0,175900,157200,0,157200,0,0,157200,A2,AG/LTD,,,
3730,55-10-0-3-0,6785-59-9255,SNGL FAM SUB,8.49,AC,183200,0,183200,87100,0,270300,163700,0,163700,71200,0,234900,A2,AG/LTD,,,
3731,28-1-0-52-0,6738-26-0753,SNGL FAM SUB,2.8,AC,61800,0,61800,101900,1600,165300,60500,0,60500,88200,1600,150300,A1,AG/GEN,,,
3732,28-1-0-55-A,6738-27-2355,SNGL FAM SUB,1.51,AC,27400,0,27400,0,0,27400,27900,0,27900,0,0,27900,A1,AG/GEN,,,
3733,28-1-0-57-0,6738-17-8750,SNGL FAM SUB,6.89,AC,83000,0,83000,0,0,83000,81200,0,81200,0,0,81200,A1,AG/GEN,,,
3734,12-1-0-34-K,6831-03-7681,SNGL FAM SUB,3.01,AC,53900,0,53900,0,0,53900,53200,0,53200,0,0,53200,A1,AG/GEN,,,
3735,12-1-0-35-0,6831-04-5567,SNGL FAM SUB,1,AC,40000,0,40000,89500,1000,130500,39500,0,39500,74300,1000,114800,A1,AG/GEN,,,
3736,14-3-0-6-0,6851-39-2277,SNGL FAM SUB,3.8,AC,73600,0,73600,146000,17500,237100,72100,0,72100,135000,18100,225200,A1,AG/GEN,,,
3737,43-1-0-59-0,6768-91-9519,SNGL FAM SUB,3.24,AC,92100,0,92100,406100,53600,551800,82300,0,82300,332500,50200,465000,A2,AG/LTD,,,
3738,43-1-0-59-A,6778-01-3360,SNGL FAM SUB,11.693,AC,166700,0,166700,0,0,166700,148600,0,148600,0,0,148600,A2,AG/LTD,,,
3739,43-1-0-59-B,6768-91-4611,SNGL FAM SUB,7,AC,124700,0,124700,0,3000,127700,111200,0,111200,0,3000,114200,A2,AG/LTD,,,
3741,43-8-0-B-0,6778-40-1574,SNGL FAM SUB,0.44,AC,5000,0,5000,0,0,5000,4500,0,4500,0,0,4500,A2,AG/LTD,,,
3742,43-8-0-C-0,6778-51-0598,SNGL FAM SUB,0.2,AC,2300,0,2300,0,0,2300,2000,0,2000,0,0,2000,A2,AG/LTD,,,
3743,18-1-0-39-0,6820-52-8323,AG 20-100 AC,49.69,AC,182500,0,182500,0,0,182500,183200,0,183200,0,0,183200,A1,AG/GEN,,,
3744,18-5-0-A-1,6820-60-0675,SNGL FAM SUB,2.81,AC,54900,0,54900,0,0,54900,52300,0,52300,0,0,52300,A1,AG/GEN,,,
3745,27-9-0-B-0,6719-63-4319,AG 20-100 AC,26.86,AC,175300,123400,51900,116300,11000,302600,173100,124100,49000,95100,10300,278500,A1,AG/GEN,,,
3746,54-2-0-10-0,6776-12-9270,SNGL FAM SUB,4.6,AC,100500,0,100500,307400,12000,419900,89600,0,89600,251900,9800,351300,A2,AG/LTD,,,
3747,45-1-0-33-A,6787-82-3956,SNGL FAM SUB,16.45,AC,292600,285000,7600,0,0,292600,261900,254900,7000,0,0,261900,A2,AG/LTD,,,
3748,16-4-0-1-0,5890-44-2911,SNGL FAM SUB,1.02,AC,38900,0,38900,159500,600,199000,38100,0,38100,137300,600,176000,A1,AG/GEN,,,
3749,42-19-0-3-0,6766-19-4168,SNGL FAM SUB,1,AC,68000,0,68000,249000,2500,319500,55100,0,55100,213300,2500,270900,R3,RES/GEN,,,
3750,12-1-0-26-D,6831-07-2389,SNGL FAM SUB,4,AC,60500,0,60500,471300,0,531800,59900,0,59900,396800,0,456700,A1,AG/GEN,,,
3751,44-16-0-17-0,6787-38-6669,SNGL FAM SUB,4.52,AC,129000,0,129000,206800,2000,337800,115000,0,115000,192400,2000,309400,A2,AG/LTD,,,
3752,44-16-0-18-0,6787-38-4868,SNGL FAM SUB,3.09,AC,129000,0,129000,165300,3900,298200,115000,0,115000,150600,4200,269800,A2,AG/LTD,,,
3753,47-1-0-12-B,7717-30-9494,SNGL FAM SUB,8,AC,358700,0,358700,0,0,358700,320200,0,320200,0,0,320200,A2,AG/LTD,,,
3754,33-1-0-13-0,6798-44-3098,AG 20-100 AC,26.53,AC,309600,197800,111800,335900,28300,673800,276700,177400,99300,271300,24000,572000,A2,AG/LTD,,,
3755,33-4-0-1-0,6798-54-0058,SNGL FAM SUB,2.048,AC,91200,0,91200,0,0,91200,81400,0,81400,0,0,81400,A2,AG/LTD,,,
3756,47-1-0-12-A,7717-40-5246,SNGL FAM SUB,8,AC,402500,0,402500,237100,6100,645700,359200,0,359200,199400,5800,564400,A2,AG/LTD,,,
3757,47-1-0-12-0,7717-40-1046,COMM & IND,3.1,AC,415600,0,415600,216600,37700,669900,377900,0,377900,194800,26100,598800,A2,AG/LTD,,,
3758,47-1-0-13-0,7716-39-8744,SNGL FAM SUB,5.904,AC,248600,0,248600,0,0,248600,221800,0,221800,0,0,221800,A2,AG/LTD,,,
3760,57-1-0-47-0,7715-05-5523,AG 20-100 AC,23.022,AC,865400,0,865400,368100,16000,1249500,752100,0,752100,314600,13900,1080600,A2,AG/LTD,,,
3762,30-1-0-111-0,6759-73-6408,SNGL FAM SUB,10,AC,171900,98300,73600,141800,5400,319100,152500,85500,67000,119700,5400,277600,R1,RES/LTD,,,
3763,55-16-0-5-0,6776-74-2486,SNGL FAM SUB,5.2,AC,133500,0,133500,358200,2100,493800,119300,0,119300,292300,2200,413800,A2,AG/LTD,,,
3764,4-2-0-11-0,6814-31-7100,SNGL FAM SUB,3.3,AC,51900,0,51900,156000,4900,212800,50800,0,50800,139000,3300,193100,A1,AG/GEN,,,
3765,43-15-0-6-0,6768-90-9922,SNGL FAM SUB,3.17,AC,92000,0,92000,217700,1800,311500,83600,0,83600,193200,2000,278800,A2,AG/LTD,,,
3766,20-1-0-52-0,6841-80-5890,SNGL FAM SUB,4.191,AC,77400,0,77400,172400,1000,250800,76000,0,76000,172500,1500,250000,A1,AG/GEN,,,
3767,21-5-0-2-0,6850-42-4757,SNGL FAM SUB,6.5,AC,120000,0,120000,551600,80800,752400,114000,0,114000,507600,74300,695900,R1,RES/LTD,,,
3768,42-16-A-5-0,6757-93-9998,SNGL FAM SUB,0.951,AC,81500,0,81500,226500,24600,332600,74000,0,74000,206100,21400,301500,R1,RES/LTD,,,
3769,55-10-0-4-0,6785-59-6519,SNGL FAM SUB,1.43,AC,77200,0,77200,20700,4000,101900,68900,0,68900,22800,4000,95700,A2,AG/LTD,,,
3770,31-1-0-43-A,6769-92-7972,SNGL FAM SUB,4,AC,109400,0,109400,247900,36000,393300,97700,0,97700,209000,29500,336200,A2,AG/LTD,,,
3771,31-1-0-43-B,6769-92-4609,SNGL FAM SUB,2.99,AC,94100,92700,1400,0,0,94100,84100,82800,1300,0,0,84100,A2,AG/LTD,,,
3772,31-1-0-43-C,6769-92-8693,SNGL FAM SUB,2.95,AC,93500,92100,1400,0,30100,123600,83500,82200,1300,0,26900,110400,A2,AG/LTD,,,
3790,32-10-1-15-0,6778-69-1043,SNGL FAM SUB,2.07,AC,82700,0,82700,180000,2500,265200,73900,0,73900,146200,2500,222600,A2,AG/LTD,,,
3791,16-1-0-3-0,5891-50-3999,SNGL FAM SUB,12.66,AC,67800,0,67800,102100,1500,171400,67200,0,67200,90000,1500,158700,A1,AG/GEN,,,
3792,43-1-0-64-C,6778-50-5765,SNGL FAM SUB,2.2,AC,79100,0,79100,40300,1400,120800,70600,0,70600,35600,1400,107600,A2,AG/LTD,,,
3793,32-3-0-1-0,6778-67-7187,SNGL FAM SUB,1.32,AC,68700,0,68700,136000,2500,207200,61300,0,61300,115800,2500,179600,A2,AG/LTD,,,
3794,32-3-0-2-0,6778-67-6243,SNGL FAM SUB,2.08,AC,79700,0,79700,0,0,79700,71100,0,71100,0,0,71100,A2,AG/LTD,,,
3795,32-3-0-3-0,6778-67-4391,SNGL FAM SUB,0.703,AC,10100,0,10100,0,0,10100,9100,0,9100,0,0,9100,A2,AG/LTD,,,
3796,31-1-0-91-0,6778-43-0048,SNGL FAM SUB,3.99,AC,107200,0,107200,179000,2000,288200,95800,0,95800,146400,2000,244200,A2,AG/LTD,,,
3797,31-1-0-94-A,6778-42-3752,SNGL FAM SUB,3.36,AC,98100,0,98100,180400,8000,286500,87600,0,87600,147900,8000,243500,A2,AG/LTD,,,
3798,31-1-0-92-0,6778-33-7734,SNGL FAM SUB,8.83,AC,158100,0,158100,258300,4500,420900,141000,0,141000,217900,4500,363400,A2,AG/LTD,,,
3799,31-1-0-93-0,6778-33-3493,SNGL FAM SUB,8.84,AC,158200,0,158200,207000,5900,371100,141100,0,141100,173600,5800,320500,A2,AG/LTD,,,
3800,45-16-0-19-0,6798-51-2988,SNGL FAM SUB,1.97,AC,86300,0,86300,248800,8400,343500,77000,0,77000,204800,8400,290200,A2,AG/LTD,,,
3801,31-6-0-3-0,6778-52-3366,SNGL FAM SUB,10.716,AC,169000,94800,74200,206700,15400,391100,150500,84500,66000,170100,15400,336000,A2,AG/LTD,,,
3802,32-1-0-62-0,6789-12-4223,AG > 100 AC,106.458,AC,1266300,1150500,115800,75200,32800,1374300,1132900,1030600,102300,62400,28500,1223800,A2,AG/LTD,,,
3803,31-1-0-89-A,6778-44-7383,SNGL FAM SUB,3.31,AC,97400,0,97400,197600,11100,306100,87000,0,87000,161800,10800,259600,A2,AG/LTD,,,
3804,32-1-0-36-0,6778-75-8914,SNGL FAM SUB,6.08,AC,137300,0,137300,496300,57000,690600,122700,0,122700,416400,50100,589200,A2,AG/LTD,,,
3805,32-1-0-40-0,6778-85-0546,SNGL FAM SUB,4.05,AC,108000,0,108000,368000,0,476000,96500,0,96500,311300,0,407800,A2,AG/LTD,,,
3806,44-19-0-7-0,6778-91-4794,SNGL FAM SUB,5.24,AC,112400,0,112400,149100,30700,292200,100400,0,100400,123100,26300,249800,A2,AG/LTD,,,
3807,31-1-0-94-0,6778-42-6857,SNGL FAM SUB,3.36,AC,98100,0,98100,181000,2000,281100,87600,0,87600,146600,2000,236200,A2,AG/LTD,,,
3808,32-1-0-63-0,6789-13-7143,SNGL FAM SUB,0.905,AC,63800,0,63800,148900,9900,222600,56900,0,56900,125900,8200,191000,A2,AG/LTD,,,
3809,32-1-0-62-A,6789-22-4511,SNGL FAM SUB,1.142,AC,66100,0,66100,12100,6900,85100,59000,0,59000,12200,5500,76700,A2,AG/LTD,,,
3812,31-1-0-104-0,6768-82-6024,SNGL FAM SUB,9.849,AC,165000,0,165000,144300,4000,313300,147500,0,147500,122100,4000,273600,A2,AG/LTD,,,
3813,31-1-0-104-A,6768-82-6352,SNGL FAM SUB,0.616,AC,7000,0,7000,0,0,7000,6300,0,6300,0,0,6300,A2,AG/LTD,,,
3814,43-1-0-57-C,6768-81-8597,SNGL FAM SUB,1.189,AC,14900,0,14900,0,0,14900,13300,0,13300,0,0,13300,A2,AG/LTD,,,
3815,32-8-0-3-0,6778-83-5087,SNGL FAM SUB,7.06,AC,133200,0,133200,110800,0,244000,119000,0,119000,85300,0,204300,A2,AG/LTD,,,
3816,32-3-0-4-0,6778-67-5532,SNGL FAM SUB,2.657,AC,88000,0,88000,285800,57800,431600,78600,0,78600,233300,47500,359400,A2,AG/LTD,,,
3817,32-3-0-5-0,6778-67-4656,SNGL FAM SUB,1.28,AC,68100,0,68100,0,0,68100,60800,0,60800,0,0,60800,A2,AG/LTD,,,
3818,32-3-0-6-0,6778-67-3775,SNGL FAM SUB,2.03,AC,78900,0,78900,0,0,78900,70500,0,70500,0,0,70500,A2,AG/LTD,,,
3819,31-1-0-90-0,6778-43-5717,SNGL FAM SUB,2.562,AC,86600,21700,64900,73200,6800,166600,77400,19500,57900,60900,5300,143600,A2,AG/LTD,,,
3820,44-1-0-2-0,6778-62-7253,SNGL FAM SUB,19.85,AC,254500,244600,9900,0,0,254500,226900,218400,8500,0,0,226900,A2,AG/LTD,,,
3821,32-8-0-1-0,6778-94-1100,SNGL FAM SUB,7.06,AC,139900,0,139900,140500,100,280500,125100,0,125100,118200,0,243300,A2,AG/LTD,,,
3822,31-1-0-100-B,6778-05-3381,SNGL FAM SUB,4.46,AC,107400,41500,65900,71500,11000,189900,96000,37300,58700,60300,11000,167300,A2,AG/LTD,,,
3823,31-1-0-100-C,6778-05-8813,SNGL FAM SUB,19.01,AC,269400,259900,9500,0,5000,274400,240900,232700,8200,0,5000,245900,A2,AG/LTD,,,
3824,15-5-0-16-0,5789-59-1275,SNGL FAM SUB,8.35,AC,65300,0,65300,350300,0,415600,63700,0,63700,306500,0,370200,A1,AG/GEN,,,
3825,32-1-0-18-0,6779-83-2202,SNGL FAM SUB,5.5,AC,128900,0,128900,43600,2700,175200,115300,0,115300,37000,2700,155000,A2,AG/LTD,,,
3826,16-1-0-4-0,5891-60-2910,SNGL FAM SUB,10.79,AC,69900,0,69900,0,6000,75900,67400,0,67400,0,5000,72400,A1,AG/GEN,,,
3827,31-6-0-5-0,6778-52-9360,SNGL FAM SUB,3,AC,92900,0,92900,168800,16300,278000,83000,0,83000,138800,13800,235600,A2,AG/LTD,,,
3828,16-1-0-4-A,5891-60-5520,SNGL FAM SUB,2.01,AC,42400,0,42400,85600,0,128000,41500,0,41500,74600,0,116100,A1,AG/GEN,,,
3829,31-1-0-100-0,6778-14-0401,AG 20-100 AC,43.28,AC,493400,472500,20900,0,47400,540800,441500,423000,18500,0,47400,488900,A2,AG/LTD,,,
3830,31-1-0-100-A,6768-95-9145,SNGL FAM SUB,2.03,AC,78900,0,78900,138800,9900,227600,70500,0,70500,116600,9900,197000,A2,AG/LTD,,,
3831,30-1-0-93-0,6768-04-2321,SNGL FAM SUB,3.1,AC,79500,0,79500,144900,0,224400,71700,0,71700,122100,0,193800,A2,AG/LTD,,,
3832,31-1-0-90-A,6778-44-1378,SNGL FAM SUB,3,AC,92900,0,92900,302700,4000,399600,83000,0,83000,244900,3600,331500,A2,AG/LTD,,,
3833,44-1-0-1-0,6778-61-1633,AG 20-100 AC,20.397,AC,253600,244200,9400,0,0,253600,226100,217400,8700,0,0,226100,A2,AG/LTD,,,
3834,31-1-0-88-0,6778-44-3729,SNGL FAM SUB,3.55,AC,100800,0,100800,158800,1000,260600,90100,0,90100,130500,1000,221600,A2,AG/LTD,,,
3835,32-8-0-4-0,6778-82-4691,SNGL FAM SUB,4.77,AC,107100,0,107100,237700,31400,376200,95700,0,95700,195300,28600,319600,A2,AG/LTD,,,
3836,32-8-0-2-0,6778-83-8500,SNGL FAM SUB,7.06,AC,133200,129700,3500,0,0,133200,119000,116000,3000,0,0,119000,A2,AG/LTD,,,
3837,32-1-0-40-B,6778-65-3192,SNGL FAM SUB,1.32,AC,68900,0,68900,0,0,68900,61500,0,61500,0,0,61500,A2,AG/LTD,,,
3838,32-7-0-1-0,6778-65-7482,SNGL FAM SUB,1.67,AC,73700,0,73700,141100,3500,218300,65800,0,65800,116100,3500,185400,A2,AG/LTD,,,
3839,32-7-0-2-0,6778-65-9541,SNGL FAM SUB,1.68,AC,73900,0,73900,0,0,73900,66000,0,66000,0,0,66000,A2,AG/LTD,,,
3840,32-1-0-40-A,6778-65-6221,SNGL FAM SUB,6.84,AC,137100,0,137100,246400,4500,388000,122600,0,122600,208000,4500,335100,A2,AG/LTD,,,
3841,67-20-0-46-0,7733-35-1827,SNGL FAM SUB,1.55,AC,309400,0,309400,584000,0,893400,259400,0,259400,465200,0,724600,R1,RES/LTD,,,
3842,13-7-0-4-0,6842-93-8522,SNGL FAM SUB,4.35,AC,72900,0,72900,64600,0,137500,72200,0,72200,57800,0,130000,A1,AG/GEN,,,
3844,21-1-0-61-0,6860-10-8218,SNGL FAM SUB,3,AC,75900,0,75900,188500,15000,279400,68700,0,68700,155600,12700,237000,A2,AG/LTD,,,
3845,21-1-0-59-A,6860-10-5556,SNGL FAM SUB,8.64,AC,138700,0,138700,251000,9000,398700,121700,0,121700,211000,9000,341700,A2,AG/LTD,,,
3846,21-1-0-59-0,6860-01-9164,AG 20-100 AC,20.04,AC,251000,231400,19600,0,0,251000,228900,211400,17500,0,0,228900,A2,AG/LTD,,,
3847,21-2-0-3-0,6769-08-8483,SNGL FAM SUB,17.01,AC,162500,0,162500,0,0,162500,149200,0,149200,0,0,149200,A2,AG/LTD,,,
3848,12-2-0-1-D,6831-05-2235,SNGL FAM SUB,1.45,AC,43400,0,43400,103200,1000,147600,43000,0,43000,85300,1000,129300,A1,AG/GEN,,,
3851,21-1-0-60-0,6860-20-0697,SNGL FAM SUB,2.6,AC,73600,0,73600,59300,1200,134100,66500,0,66500,50300,1200,118000,A2,AG/LTD,,,
3852,12-2-0-1-B,6831-04-3965,SNGL FAM SUB,0.88,AC,35200,0,35200,48500,0,83700,34800,0,34800,39800,0,74600,A1,AG/GEN,,,
3853,21-2-0-2-0,6769-08-2955,AG 20-100 AC,30.53,AC,239200,0,239200,0,0,239200,218200,0,218200,0,0,218200,A2,AG/LTD,,,
3855,47-9-0-2-0,7717-53-5232,AG > 100 AC,123.88,AC,3300200,3211800,88400,0,0,3300200,2943400,2866800,76600,0,0,2943400,A2,AG/LTD,,,
3856,38-1-0-119-0,6717-58-1080,SNGL FAM SUB,14.98,AC,117100,0,117100,0,0,117100,114900,0,114900,0,0,114900,A1,AG/GEN,,,
3857,47-3-0-B-1,7717-93-2871,SNGL FAM SUB,1,AC,123800,0,123800,146700,200,270700,110500,0,110500,121700,200,232400,A2,AG/LTD,,,
3858,55-1-0-37-A,6785-58-3872,SNGL FAM SUB,0.87,AC,61000,0,61000,0,0,61000,54500,0,54500,0,0,54500,A2,AG/LTD,,,
3859,39-8-0-B-0,6727-46-3125,AG > 100 AC,163.627,AC,575800,500400,75400,0,0,575800,564500,495000,69500,0,0,564500,A1,AG/GEN,,,
3860,62-2-A-6-0,7704-93-4934,SNGL FAM SUB,0,AC,115000,0,115000,237800,23200,376000,100000,0,100000,217100,19700,336800,R1,RES/LTD,,,
3861,46-1-0-106-0,7717-17-2759,SNGL FAM SUB,3.232,AC,142000,0,142000,252400,6800,401200,126700,0,126700,215600,5000,347300,A2,AG/LTD,,,
3862,26-1-0-29-A,6708-94-1162,SNGL FAM SUB,6.21,AC,68000,0,68000,250000,11800,329800,66700,0,66700,212100,11800,290600,A1,AG/GEN,,,
3863,28-1-0-5-0,6729-84-3120,SNGL FAM SUB,5.63,AC,78100,0,78100,0,0,78100,76200,0,76200,0,0,76200,A1,AG/GEN,,,
3864,27-8-0-C-0,6729-16-4399,SNGL FAM SUB,6.43,AC,71000,0,71000,0,0,71000,70600,0,70600,0,0,70600,A1,AG/GEN,,,
3865,30-1-0-29-A,6758-26-8044,SNGL FAM SUB,2.62,AC,70000,0,70000,149300,4500,223800,66700,0,66700,125100,2900,194700,A2,AG/LTD,,,
3866,64-12-G-3-0,7723-59-5229,SNGL FAM SUB,0,AC,77000,0,77000,214600,7600,299200,67000,0,67000,183900,7300,258200,R1,RES/LTD,,,
3867,57-10-0-19-0,7705-68-9645,SNGL FAM SUB,4.64,AC,230000,0,230000,534800,12900,777700,210000,0,210000,492200,11800,714000,A2,AG/LTD,,,
3868,58-4-C-3-0,7716-56-2706,SNGL FAM SUB,0,AC,10000,0,10000,0,0,10000,9100,0,9100,0,0,9100,A2,AG/LTD,,,
3869,58-4-C-4-0,7716-56-2787,SNGL FAM SUB,0,AC,77500,0,77500,82100,300,159900,70500,0,70500,69000,300,139800,A2,AG/LTD,,,
3870,58-4-C-5-0,7716-56-3759,SNGL FAM SUB,0,AC,20100,0,20100,0,0,20100,18300,0,18300,0,0,18300,A2,AG/LTD,,,
3871,31-10-2-6-0,6779-50-2234,SNGL FAM SUB,1.48,AC,74200,0,74200,226800,21300,322300,66300,0,66300,184600,18200,269100,A2,AG/LTD,,,
3872,38-1-0-38-0,6707-65-1000,SNGL FAM SUB,10,AC,84700,0,84700,12000,0,96700,83000,0,83000,12000,0,95000,A1,AG/GEN,,,
3873,38-1-0-3-0,6708-71-2732,SNGL FAM SUB,13.382,AC,89600,0,89600,0,0,89600,87500,0,87500,0,0,87500,A1,AG/GEN,,,
3874,38-1-0-2-0,6708-71-5287,SNGL FAM SUB,3,AC,50000,0,50000,151100,29600,230700,49000,0,49000,121900,25800,196700,A1,AG/GEN,,,
3875,64-4-2-9-0,7724-93-4808,SNGL FAM SUB,0,AC,70000,0,70000,196500,2500,269000,60000,0,60000,168000,2500,230500,RN,RESIDEN,,,
3876,39-1-0-15-A,6727-15-7767,SNGL FAM SUB,3,AC,50000,0,50000,123800,31800,205600,49000,0,49000,106000,27000,182000,A1,AG/GEN,,,
3877,67-2-C-20-0,7723-55-4663,SNGL FAM SUB,0,AC,184000,0,184000,334400,1100,519500,160000,0,160000,284300,1100,445400,R1,RES/LTD,,,
3878,28-1-0-31-A,6738-07-9671,SNGL FAM SUB,1.5,AC,43800,0,43800,219300,3000,266100,42900,0,42900,189700,3000,235600,A1,AG/GEN,,,
3879,28-1-0-31-0,6738-07-8309,SNGL FAM SUB,1.5,AC,43800,0,43800,90600,9000,143400,42900,0,42900,77500,9000,129400,A1,AG/GEN,,,
3880,58-1-0-77-A,7726-04-2381,SNGL FAM SUB,2.68,AC,169900,0,169900,125800,2000,297700,147700,0,147700,106300,2000,256000,A2,AG/LTD,,,
3881,10-5-0-2-0,6812-36-8918,SNGL FAM SUB,2,AC,44800,0,44800,124600,2700,172100,44000,0,44000,108100,2700,154800,A1,AG/GEN,,,
3882,57-1-0-31-0,7706-02-9507,SNGL FAM SUB,1,AC,94900,0,94900,25000,500,120400,82500,0,82500,21800,500,104800,A2,AG/LTD,,,
3883,57-3-0-2-A,7706-23-5217,SNGL FAM SUB,1,AC,108400,0,108400,119400,6000,233800,94300,0,94300,101800,6000,202100,A2,AG/LTD,,,
3884,57-1-0-44-0,7715-04-3635,AG 20-100 AC,20,AC,743700,554700,189000,846000,47100,1636800,646400,481900,164500,728900,45900,1421200,A2,AG/LTD,,,
3886,58-6-0-2-0,7726-12-6034,SNGL FAM SUB,2.89,AC,136200,0,136200,0,0,136200,118400,0,118400,0,0,118400,A2,AG/LTD,,,
3887,45-3-0-1-0,6797-39-0515,SNGL FAM SUB,9.124,AC,182200,0,182200,106800,46700,335700,162500,0,162500,88600,44900,296000,A2,AG/LTD,,,
3888,45-3-0-2-0,6797-39-7751,SNGL FAM SUB,8.461,AC,176100,0,176100,0,0,176100,157400,0,157400,0,0,157400,A2,AG/LTD,,,
3889,45-3-0-3-0,6798-30-9126,SNGL FAM SUB,8.315,AC,170700,0,170700,0,0,170700,152600,0,152600,0,0,152600,A2,AG/LTD,,,
3890,45-3-0-4-0,6798-40-0620,SNGL FAM SUB,8.289,AC,167100,0,167100,0,0,167100,149500,0,149500,0,0,149500,A2,AG/LTD,,,
3891,45-3-0-5-0,6798-41-1003,SNGL FAM SUB,8.162,AC,162400,0,162400,0,0,162400,145300,0,145300,0,0,145300,A2,AG/LTD,,,
3892,45-3-0-6-0,6798-31-3133,SNGL FAM SUB,8.089,AC,170900,0,170900,0,0,170900,152800,0,152800,0,0,152800,A2,AG/LTD,,,
3893,45-3-0-7-0,6798-30-2613,SNGL FAM SUB,8.3,AC,173800,0,173800,0,0,173800,155400,0,155400,0,0,155400,A2,AG/LTD,,,
3894,45-3-0-8-0,6798-30-1121,SNGL FAM SUB,8.344,AC,174400,0,174400,0,0,174400,155900,0,155900,0,0,155900,A2,AG/LTD,,,
3895,57-1-0-4-0,7706-53-5434,SNGL FAM SUB,1.347,AC,129800,0,129800,0,0,129800,112900,0,112900,0,0,112900,A2,AG/LTD,,,
3896,57-9-0-1-0,7706-43-7955,SNGL FAM SUB,2.17,AC,141500,0,141500,291000,3500,436000,123100,0,123100,245000,3500,371600,A2,AG/LTD,,,
3897,57-9-0-2-0,7706-43-8510,SNGL FAM SUB,2.11,AC,139800,0,139800,151800,2000,293600,121600,0,121600,127000,2000,250600,A2,AG/LTD,,,
3898,57-9-0-3-0,7706-53-4627,SNGL FAM SUB,2,AC,136700,0,136700,267400,1500,405600,118900,0,118900,223900,1500,344300,A2,AG/LTD,,,
3900,58-1-0-76-0,7726-03-5996,SNGL FAM SUB,1.03,AC,109500,0,109500,86000,2100,197600,95300,0,95300,73100,2100,170500,A2,AG/LTD,,,
3901,58-1-0-77-0,7726-04-3087,SNGL FAM SUB,4.44,AC,234300,0,234300,0,0,234300,203700,0,203700,0,0,203700,A2,AG/LTD,,,
3902,58-1-0-79-0,7716-93-5830,AG 20-100 AC,32.23,AC,943100,899000,44100,0,0,943100,819000,780300,38700,0,0,819000,A2,AG/LTD,,,
3904,58-1-0-75-0,7726-03-4788,SNGL FAM SUB,1.5,AC,126700,0,126700,0,800,127500,110200,0,110200,0,800,111000,A2,AG/LTD,,,
3905,58-1-0-28-A,7715-46-2133,SNGL FAM SUB,7.2,AC,278200,0,278200,0,0,278200,242100,0,242100,0,0,242100,A2,AG/LTD,,,
3906,62-1-0-22-0,7714-14-4099,COMM & IND,4.31,AC,277800,0,277800,344500,21200,643500,254000,0,254000,338200,18200,610400,B1,BUS/GEN,,,
3907,55-12-0-A-1,6785-54-9981,AG 20-100 AC,23.026,AC,360800,267500,93300,181200,83000,625000,322500,238900,83600,146800,78100,547400,A2,AG/LTD,,,
3908,55-12-0-A-2,6785-63-0908,SNGL FAM SUB,19.371,AC,299700,0,299700,478800,37900,816400,268400,0,268400,401500,32400,702300,A2,AG/LTD,,,
3909,48-1-0-16-0,7727-57-0549,SNGL FAM SUB,1.28,AC,108400,0,108400,108300,0,216700,96800,0,96800,90900,0,187700,A2,AG/LTD,,,
3910,57-3-0-2-0,7706-32-1431,SNGL FAM SUB,12.98,AC,437000,309000,128000,210900,63800,711700,380300,269100,111200,177700,59900,617900,A2,AG/LTD,,,
3911,64-1-0-64-0,7723-99-7628,SNGL FAM SUB,3.857,AC,255900,0,255900,69600,0,325500,222500,0,222500,59100,0,281600,A2,AG/LTD,,,
3912,63-1-0-20-0,7714-47-5357,SNGL FAM SUB,8,AC,303400,0,303400,202400,11600,517400,263900,0,263900,177900,11400,453200,R3,RES/GEN,,,
3913,63-11-0-A-3,7714-47-8093,SNGL FAM SUB,5.58,AC,214500,0,214500,0,0,214500,186600,0,186600,0,0,186600,R3,RES/GEN,,,
3914,58-1-0-73-0,7726-02-4802,SNGL FAM SUB,15.181,AC,844400,837100,7300,0,0,844400,734400,727900,6500,0,0,734400,A2,AG/LTD,,,
3917,63-1-0-198-0,7723-48-2471,SNGL FAM SUB,7.8,AC,301000,0,301000,0,0,301000,261700,0,261700,0,0,261700,A2,AG/LTD,,,
3919,56-1-0-85-0,6796-91-5903,SNGL FAM SUB,3.48,AC,138700,0,138700,67000,3000,208700,120500,0,120500,54500,3000,178000,A2,AG/LTD,,,
3920,63-1-0-48-0,7714-34-6888,SNGL FAM SUB,1.47,AC,127700,0,127700,229300,8700,365700,111100,0,111100,193900,9200,314200,R3,RES/GEN,,,
3922,1-1-0-9-C,6814-46-9352,SNGL FAM SUB,5.34,AC,64900,0,64900,0,0,64900,63800,0,63800,0,0,63800,A1,AG/GEN,,,
3923,19-10-0-B-0,6820-93-5392,SNGL FAM SUB,3.06,AC,61200,0,61200,11800,0,73000,57500,0,57500,11100,0,68600,A1,AG/GEN,,,
3924,58-1-0-79-A,7726-04-1688,Place of Worship,9.7,AC,426800,0,426800,192900,1100,620800,371000,0,371000,204000,1100,576100,A2,AG/LTD,,,
3925,32-10-2-16-0,6779-60-2020,SNGL FAM SUB,3.16,AC,98400,0,98400,194000,9000,301400,88000,0,88000,159100,8200,255300,A2,AG/LTD,,,
3926,43-20-0-26-0,6768-51-4835,SNGL FAM SUB,3.07,AC,96800,0,96800,191600,2500,290900,88000,0,88000,167100,2600,257700,A2,AG/LTD,,,
3927,63-20-0-1-0,7715-42-3231,SNGL FAM SUB,4.64,AC,196300,0,196300,441500,0,637800,170700,0,170700,371000,0,541700,A2,AG/LTD,,,
3930,46-23-0-38-0,7707-96-5220,SNGL FAM SUB,2.403,AC,165000,0,165000,273500,29500,468000,150000,0,150000,226900,24800,401700,A2,AG/LTD,,,
3931,63-1-0-24-0,7714-45-3442,SNGL FAM SUB,4.88,AC,219500,0,219500,156200,21000,396700,190900,0,190900,132400,19900,343200,R3,RES/GEN,,,
3932,63-18-0-1-A,7714-45-0278,SNGL FAM SUB,4.58,AC,211400,0,211400,0,0,211400,183900,0,183900,0,0,183900,R3,RES/GEN,,,
3933,64-2-0-6-0,7723-98-8523,SNGL FAM SUB,8.601,AC,385900,0,385900,0,0,385900,335400,0,335400,0,0,335400,R1,RES/LTD,,,
3934,57-1-0-23-0,7706-01-0677,SNGL FAM SUB,5.15,AC,201100,0,201100,42800,0,243900,175000,0,175000,37100,0,212100,A2,AG/LTD,,,
3935,47-8-0-B-0,7717-97-0446,SNGL FAM SUB,1,AC,99000,0,99000,130800,4900,234700,88400,0,88400,114300,4900,207600,A2,AG/LTD,,,
3936,47-8-0-B-1,7717-87-8541,SNGL FAM SUB,1,AC,99000,0,99000,0,0,99000,88400,0,88400,0,0,88400,A2,AG/LTD,,,
3937,66-4-0-12-0,7723-24-3829,SNGL FAM SUB,3.14,AC,672800,0,672800,0,0,672800,585000,0,585000,0,0,585000,A2,AG/LTD,,,
3938,21-5-0-1-0,6850-32-9737,SNGL FAM SUB,3.463,AC,100000,0,100000,296900,0,396900,90000,0,90000,265700,0,355700,A2,AG/LTD,,,
3939,55-15-0-3-0,6785-67-5498,SNGL FAM SUB,3,AC,114300,0,114300,284400,2300,401000,102000,0,102000,236500,1600,340100,A2,AG/LTD,,,
3940,58-4-C-13-0,7716-56-4679,SNGL FAM SUB,1,AC,92400,0,92400,171900,1000,265300,84000,0,84000,142300,1000,227300,A2,AG/LTD,,,
3941,14-3-0-5-0,6851-29-9146,SNGL FAM SUB,3.43,AC,70300,0,70300,121400,15800,207500,68800,0,68800,101700,16400,186900,A1,AG/GEN,,,
3942,55-1-0-10-0,6776-92-2037,SNGL FAM SUB,14.586,AC,209900,0,209900,235300,22300,467500,187100,0,187100,198200,19100,404400,A2,AG/LTD,,,
3943,56-1-0-15-B,6785-85-5106,SNGL FAM SUB,1.1,AC,71700,0,71700,186000,3600,261300,64000,0,64000,152800,3600,220400,A2,AG/LTD,,,
3944,28-1-0-63-A,6729-91-2552,SNGL FAM SUB,1.05,AC,40400,0,40400,74600,200,115200,39800,0,39800,62000,200,102000,A1,AG/GEN,,,
3969,64-12-B-22-0,7723-69-0786,SNGL FAM SUB,1.09,AC,134800,0,134800,159800,3000,297600,117300,0,117300,141100,3000,261400,R1,RES/LTD,,,
3972,11-1-0-20-0,6811-67-1159,SNGL FAM SUB,5.002,AC,71600,0,71600,143900,0,215500,64000,0,64000,141400,0,205400,A1,AG/GEN,,,
3973,6-1-0-5-0,6823-77-9211,SNGL FAM SUB,12.51,AC,100300,0,100300,0,0,100300,98400,0,98400,0,0,98400,A1,AG/GEN,,,
3974,42-1-0-55-0,6767-05-2668,SNGL FAM SUB,0,AC,70000,0,70000,184500,13100,267600,65000,0,65000,151700,10200,226900,R3,RES/GEN,,,
3975,40-1-0-26-0,6737-21-7319,AG 20-100 AC,24.27,AC,176400,119300,57100,252400,58300,487100,173200,118100,55100,214800,48800,436800,A1,AG/GEN,,,
3976,40-1-0-26-A,6737-20-3326,SNGL FAM SUB,4.59,AC,71600,0,71600,0,0,71600,70300,0,70300,0,0,70300,A1,AG/GEN,,,
3977,42-1-0-54-0,6767-05-2543,SNGL FAM SUB,1.001,AC,70000,0,70000,250500,33900,354400,65000,0,65000,205100,27700,297800,R3,RES/GEN,,,
3978,44-3-0-1-0,6777-71-8337,SNGL FAM SUB,1.93,AC,84800,0,84800,165200,6000,256000,75700,0,75700,134700,6000,216400,A2,AG/LTD,,,
3979,57-16-0-5-0,7706-15-6235,SNGL FAM SUB,5,AC,213600,0,213600,531300,0,744900,185900,0,185900,478700,0,664600,A2,AG/LTD,,,
3980,46-13-0-4-0,7717-06-8807,SNGL FAM SUB,1.22,AC,96100,0,96100,263500,26600,386200,85800,0,85800,221600,23400,330800,A2,AG/LTD,,,
3981,16-1-0-45-0,5890-55-2589,SNGL FAM SUB,3,AC,36300,0,36300,0,0,36300,34500,0,34500,0,0,34500,A1,AG/GEN,,,
3982,16-1-0-46-0,5890-55-8520,SNGL FAM SUB,5.445,AC,41100,38600,2500,0,0,41100,39600,0,39600,0,0,39600,A1,AG/GEN,,,
3983,16-1-0-47-0,5890-65-4232,SNGL FAM SUB,15.514,AC,56600,49400,7200,0,0,56600,55300,0,55300,0,0,55300,A1,AG/GEN,,,
3984,16-1-0-42-0,5890-55-1537,SNGL FAM SUB,7,AC,50700,47500,3200,0,0,50700,49500,0,49500,0,0,49500,A1,AG/GEN,,,
3985,64-4-2-5-0,7724-93-3498,SNGL FAM SUB,0,AC,70000,0,70000,209400,3500,282900,60000,0,60000,130900,3500,194400,RN,RESIDEN,,,
3986,64-4-2-4-0,7724-93-3389,SNGL FAM SUB,0,AC,52500,0,52500,0,0,52500,30000,0,30000,0,0,30000,RN,RESIDEN,,,
3987,64-4-2-36-0,7724-93-5588,SNGL FAM SUB,0,AC,20200,0,20200,0,0,20200,17600,0,17600,0,0,17600,RN,RESIDEN,,,
3989,29-1-0-77-0,6749-47-7166,AG 20-100 AC,40,AC,259200,0,259200,0,0,259200,258400,0,258400,0,0,258400,A1,AG/GEN,,,
3990,64-12-F-2-0,7723-59-2086,SNGL FAM SUB,0,AC,77000,0,77000,195200,28600,300800,67000,0,67000,177900,29900,274800,R1,RES/LTD,,,
3991,62-1-0-21-0,7714-14-6141,COMM & IND,2.84,AC,183200,0,183200,161900,3600,348700,167300,0,167300,154100,3400,324800,RO,RES/OF,,,
3992,6-1-0-60-C,6833-60-7341,SNGL FAM SUB,2.49,AC,52500,0,52500,170100,4000,226600,50900,0,50900,131300,3000,185200,A1,AG/GEN,,,
3993,55-21-0-4-0,6776-82-3646,SNGL FAM SUB,3.36,AC,105700,0,105700,172700,33100,311500,94500,0,94500,140800,26500,261800,A2,AG/LTD,,,
3994,19-10-0-A-0,6820-93-2272,SNGL FAM SUB,3.08,AC,61400,0,61400,94300,34400,190100,57600,0,57600,80100,29800,167500,A1,AG/GEN,,,
3995,19-1-0-14-C,6830-03-4464,SNGL FAM SUB,2.13,AC,62500,0,62500,150700,63300,276500,60500,0,60500,126600,64400,251500,A1,AG/GEN,,,
3996,17-7-0-C-0,6800-49-4471,AG 20-100 AC,21.01,AC,110600,0,110600,0,0,110600,108000,0,108000,0,0,108000,A1,AG/GEN,,,
3997,67-11-C-6-0,7733-26-6498,SNGL FAM SUB,0,AC,265000,0,265000,382200,2600,649800,220000,0,220000,348500,1800,570300,R1,RES/LTD,,,
3998,66-3-0-5-0,7723-35-9640,SNGL FAM SUB,3.53,AC,390000,0,390000,651600,83200,1124800,340000,0,340000,290500,37200,667700,R1,RES/LTD,,,
3999,16-2-0-E-0,5891-40-5132,AG 20-100 AC,26.24,AC,74200,62100,12100,0,0,74200,73300,62100,11200,0,0,73300,A1,AG/GEN,,,
4000,51-1-0-21-A,6735-31-4789,SNGL FAM SUB,1,AC,2600,0,2600,0,0,2600,2500,0,2500,0,0,2500,A1,AG/GEN,,,
4001,52-1-0-4-0,6746-11-8589,SNGL FAM SUB,2,AC,4100,0,4100,0,0,4100,4000,0,4000,0,0,4000,A1,AG/GEN,,,
4002,40-1-0-18-0,6726-77-7953,SNGL FAM SUB,15.17,AC,123300,0,123300,225200,4700,353200,120900,0,120900,191500,4700,317100,A1,AG/GEN,,,
4003,44-4-0-3-B,6787-13-9821,SNGL FAM SUB,1.1,AC,71700,0,71700,79100,0,150800,64000,0,64000,65100,0,129100,A2,AG/LTD,,,
4004,32-1-0-16-0,6779-83-1938,SNGL FAM SUB,0.84,AC,59200,0,59200,176100,700,236000,52900,0,52900,143500,700,197100,A2,AG/LTD,,,
4005,51-1-0-25-0,6736-60-7316,AG > 100 AC,136.9,AC,509200,413200,96000,29900,0,539100,499300,410900,88400,25400,0,524700,A1,AG/GEN,,,
4006,19-16-0-A-0,6830-43-8130,AG 20-100 AC,36.402,AC,264400,193100,71300,272500,32700,569600,251700,186700,65000,234200,28200,514100,A1,AG/GEN,,,
4007,43-1-0-82-C,6767-91-7585,SNGL FAM SUB,1.37,AC,75400,0,75400,110200,900,186500,67400,0,67400,92100,900,160400,A2,AG/LTD,,,
4008,47-11-0-2-0,7716-37-1788,SNGL FAM SUB,3.02,AC,133300,0,133300,132300,400,266000,119100,0,119100,110800,400,230300,A2,AG/LTD,,,
4009,39-1-0-29-0,6727-14-4348,SNGL FAM SUB,3.13,AC,50700,0,50700,120800,5300,176800,49700,0,49700,103200,5300,158200,A1,AG/GEN,,,
4010,30-4-0-1-0,6768-08-0963,SNGL FAM SUB,2.31,AC,70100,0,70100,102200,400,172700,63500,0,63500,84700,400,148600,A2,AG/LTD,,,
4011,44-4-0-3-0,6787-13-4860,SNGL FAM SUB,2.3,AC,88000,0,88000,0,0,88000,78600,0,78600,0,0,78600,A2,AG/LTD,,,
4012,12-1-0-31-C,6831-03-0058,SNGL FAM SUB,12.96,AC,111900,0,111900,142900,25600,280400,107700,0,107700,121400,23100,252200,A1,AG/GEN,,,
4013,39-1-0-75-A,6726-27-1594,SNGL FAM SUB,10.046,AC,89500,0,89500,0,0,89500,87800,0,87800,0,0,87800,A1,AG/GEN,,,
4014,51-1-0-4-0,6726-82-5836,SNGL FAM SUB,7.324,AC,74200,32200,42000,100100,2400,176700,72800,32100,40700,86000,2400,161200,A1,AG/GEN,,,
4015,19-4-0-A-2,6830-18-8349,AG 20-100 AC,59.852,AC,214400,186800,27600,0,0,214400,215500,190100,25400,0,0,215500,A1,AG/GEN,,,
4016,19-9-0-1-0,6830-16-7052,SNGL FAM SUB,3.908,AC,77200,0,77200,239100,28500,344800,72000,0,72000,199500,24000,295500,A1,AG/GEN,,,
4018,32-1-0-4-0,6779-85-4464,SNGL FAM SUB,0.5,AC,32100,0,32100,0,0,32100,28600,0,28600,0,0,28600,A2,AG/LTD,,,
4019,32-1-0-5-0,6779-85-6626,SNGL FAM SUB,4.5,AC,114500,0,114500,0,0,114500,102400,0,102400,0,0,102400,A2,AG/LTD,,,
4020,67-2-D-6-0,7723-55-7298,SNGL FAM SUB,0,AC,184000,0,184000,251400,23000,458400,160000,0,160000,210900,19700,390600,R1,RES/LTD,,,
4021,2-3-0-1-0,6824-43-2661,SNGL FAM SUB,3.66,AC,49700,0,49700,0,0,49700,48700,0,48700,0,0,48700,A1,AG/GEN,,,
4022,38-1-0-93-0,6707-96-7481,SNGL FAM SUB,8.58,AC,77500,73500,4000,0,0,77500,75900,72300,3600,0,0,75900,A1,AG/GEN,,,
4023,32-10-2-13-0,6779-60-9473,SNGL FAM SUB,7.73,AC,140000,0,140000,288400,33900,462300,124700,0,124700,241000,28400,394100,A2,AG/LTD,,,
4024,21-3-0-2-0,6860-01-4908,SNGL FAM SUB,3.5,AC,84200,0,84200,441900,0,526100,75900,0,75900,363600,0,439500,A2,AG/LTD,,,
4025,44-17-0-3-0,6787-23-4700,SNGL FAM SUB,1.84,AC,83400,0,83400,85900,1700,171000,74400,0,74400,68900,1700,145000,A2,AG/LTD,,,
4026,26-3-0-2-A,6719-11-2322,SNGL FAM SUB,1.22,AC,40100,0,40100,73000,10300,123400,39300,0,39300,62800,8700,110800,A1,AG/GEN,,,
4027,26-3-0-3-0,6719-11-4451,SNGL FAM SUB,0.004,AC,100,0,100,0,0,100,100,0,100,0,0,100,B1,BUS/GEN,,,
4028,27-1-0-31-A,6728-33-4283,SNGL FAM SUB,1.16,AC,39800,0,39800,105100,200,145100,39000,0,39000,89800,200,129000,A1,AG/GEN,,,
4029,32-1-0-6-0,6779-95-3402,SNGL FAM SUB,3.34,AC,97800,0,97800,52700,2000,152500,87400,0,87400,43600,2000,133000,A2,AG/LTD,,,
4030,58-2-0-11-0,7726-35-1995,SNGL FAM SUB,0,AC,88000,0,88000,0,0,88000,80000,0,80000,0,0,80000,RN,RESIDEN,,,
4031,58-2-0-12-0,7726-35-2829,SNGL FAM SUB,0,AC,20100,0,20100,0,0,20100,18300,0,18300,0,0,18300,RN,RESIDEN,,,
4032,58-2-0-12-A,7726-35-2844,SNGL FAM SUB,0,AC,20100,0,20100,0,118000,138100,18300,0,18300,0,100000,118300,RN,RESIDEN,,,
4033,58-2-0-13-0,7726-35-3705,SNGL FAM SUB,0,AC,88000,0,88000,260600,54400,403000,80000,0,80000,216900,44500,341400,RN,RESIDEN,,,
4034,45-1-0-110-0,6798-61-4390,SNGL FAM SUB,0.75,AC,52600,0,52600,108100,300,161000,47000,0,47000,89400,300,136700,A2,AG/LTD,,,
4035,45-1-0-111-A,6798-61-7151,SNGL FAM SUB,2,AC,73400,72400,1000,0,0,73400,65500,64600,900,0,0,65500,A2,AG/LTD,,,
4036,45-1-0-104-A,6798-71-6710,SNGL FAM SUB,19.12,AC,322600,312800,9800,0,0,322600,287900,279700,8200,0,0,287900,A2,AG/LTD,,,
4037,45-1-0-105-0,6798-61-6675,SNGL FAM SUB,3.011,AC,87400,26800,60600,11000,1600,100000,77900,23800,54100,10600,1600,90100,A2,AG/LTD,,,
4038,45-1-0-105-A,6798-61-3664,SNGL FAM SUB,2,AC,73400,0,73400,8900,1000,83300,65500,0,65500,9100,1000,75600,A2,AG/LTD,,,
4039,45-1-0-105-B,6798-61-8694,SNGL FAM SUB,2,AC,73400,72400,1000,0,12300,85700,65500,64600,900,0,10300,75800,A2,AG/LTD,,,
4040,45-1-0-108-0,6798-61-3432,SNGL FAM SUB,0.82,AC,57500,0,57500,9400,0,66900,51300,0,51300,8800,0,60100,A2,AG/LTD,,,
4041,45-1-0-111-0,6798-61-6212,SNGL FAM SUB,1,AC,59600,59100,500,0,2000,61600,53200,52800,400,0,2000,55200,A2,AG/LTD,,,
4042,16-2-0-A-1,5890-48-0686,AG 20-100 AC,24.85,AC,76700,64800,11900,0,200,76900,76200,65600,10600,0,200,76400,A1,AG/GEN,,,
4043,16-2-0-B-0,5890-48-2270,SNGL FAM SUB,3.15,AC,46500,0,46500,222300,6400,275200,44500,0,44500,194600,6400,245500,A1,AG/GEN,,,
4044,39-1-0-85-A,6726-78-4879,SNGL FAM SUB,2,AC,44400,0,44400,135800,5400,185600,43500,0,43500,116500,5600,165600,A1,AG/GEN,,,
4045,43-1-0-58-0,6768-81-1949,SNGL FAM SUB,1.86,AC,82500,0,82500,153200,2000,237700,73700,0,73700,128600,2000,204300,A2,AG/LTD,,,
4046,63-3-A-6-0,7714-81-9597,SNGL FAM SUB,0,AC,70000,0,70000,228100,0,298100,60000,0,60000,206300,0,266300,R1,RES/LTD,,,
4047,60-6-0-1-B,6785-10-8224,SNGL FAM SUB,7.2,AC,281600,277900,3700,0,14400,296000,251200,248100,3100,0,12000,263200,A2,AG/LTD,,,
4048,60-6-0-3-0,6785-20-1098,SNGL FAM SUB,4,AC,217000,0,217000,423000,59600,699600,193600,0,193600,345900,52100,591600,A2,AG/LTD,,,
4049,46-1-0-68-0,7707-80-9969,SNGL FAM SUB,4.744,AC,182100,0,182100,157300,103400,442800,162500,0,162500,132200,99400,394100,A2,AG/LTD,,,
4050,53-1-0-5-0,6766-26-3477,AG 20-100 AC,27.37,AC,429600,0,429600,0,0,429600,383000,0,383000,0,0,383000,A2,AG/LTD,,,
4051,63-32-0-B-0,7723-08-5934,SNGL FAM SUB,3.16,AC,225200,0,225200,420600,37700,683500,195800,0,195800,365100,34900,595800,R1,RES/LTD,,,
4052,58-3-B-6-0,7726-16-3877,SNGL FAM SUB,0,AC,88000,0,88000,197500,14000,299500,80000,0,80000,161600,14000,255600,RN,RESIDEN,,,
4053,46-23-0-19-0,7707-93-0710,SNGL FAM SUB,4.405,AC,181500,0,181500,203900,2500,387900,165000,0,165000,170100,2100,337200,A2,AG/LTD,,,
4054,41-1-0-6-D,6748-51-3718,SNGL FAM SUB,3.39,AC,77200,0,77200,155200,6300,238700,70900,0,70900,132100,6300,209300,A1,AG/GEN,,,
4056,58-6-0-1-0,7726-11-2940,SNGL FAM SUB,0.95,AC,92700,0,92700,59400,400,152500,80600,0,80600,51400,400,132400,A2,AG/LTD,,,
4057,47-1-0-49-0,7717-65-5546,SNGL FAM SUB,2.415,AC,24600,23500,1100,0,0,24600,22000,21000,1000,0,0,22000,A2,AG/LTD,,,
4058,47-1-0-50-0,7717-76-3598,AG 20-100 AC,81.93,AC,1429300,1192900,236400,200800,2300,1632400,1277700,1066700,211000,168400,2300,1448400,A2,AG/LTD,,,
4059,47-2-0-A-0,7717-78-4211,SNGL FAM SUB,18,AC,388000,379400,8600,0,0,388000,346800,339100,7700,0,0,346800,A2,AG/LTD,,,
4060,47-2-0-A-1,7717-77-1514,SNGL FAM SUB,10,AC,202500,197600,4900,0,0,202500,181000,176700,4300,0,0,181000,A2,AG/LTD,,,
4061,47-2-0-B-0,7717-87-0812,SNGL FAM SUB,17.4,AC,304400,296100,8300,0,0,304400,272000,264500,7500,0,0,272000,A2,AG/LTD,,,
4062,47-3-0-C-1,7717-96-2416,SNGL FAM SUB,2.03,AC,101700,0,101700,126100,1400,229200,90800,0,90800,109200,1400,201400,A2,AG/LTD,,,
4063,58-6-0-4-0,7726-12-1142,SNGL FAM SUB,1.15,AC,100700,0,100700,148300,18600,267600,87600,0,87600,127300,18600,233500,A2,AG/LTD,,,
4064,67-10-0-22-0,7733-06-9267,SNGL FAM SUB,2.4,AC,323000,0,323000,599100,11300,933400,270800,0,270800,472900,11800,755500,R1,RES/LTD,,,
4065,63-2-0-6-0,7723-18-8525,SNGL FAM SUB,7.755,AC,224900,0,224900,0,0,224900,195400,0,195400,0,0,195400,R1A2,RES LTD,,,
4066,45-1-0-20-A,6798-00-1340,SNGL FAM SUB,1.142,AC,72100,0,72100,227900,1000,301000,64400,0,64400,187300,1000,252700,A2,AG/LTD,,,
4067,10-1-0-20-0,6801-61-0777,SNGL FAM SUB,2.57,AC,46000,0,46000,97100,500,143600,45100,0,45100,85300,500,130900,A1,AG/GEN,,,
4068,5-1-0-74-0,6823-48-0844,SNGL FAM SUB,5.562,AC,63000,0,63000,99800,4000,166800,61800,0,61800,92200,4000,158000,A1,AG/GEN,,,
4069,62-20-A-18-0,7714-15-2786,SNGL FAM SUB,0,AC,115000,0,115000,219600,500,335100,100000,0,100000,200300,500,300800,R1,RES/LTD,,,
4070,17-2-0-2-0,6810-36-9945,SNGL FAM SUB,14.13,AC,110500,0,110500,169000,18400,297900,110200,0,110200,137300,16900,264400,A1,AG/GEN,,,
4071,42-1-0-42-A,6767-02-7640,COMM & IND,0.07,AC,52200,0,52200,87900,0,140100,50200,0,50200,81000,0,131200,B1,BUS/GEN,,,
4072,42-1-0-93-0,6767-14-2197,SNGL FAM SUB,2.43,AC,85600,0,85600,257700,0,343300,77500,0,77500,219900,0,297400,A2R3,AGRIC.R,,,
4073,5-16-0-1-0,6823-45-1260,SNGL FAM SUB,1.5,AC,42300,0,42300,217500,1500,261300,41500,0,41500,193700,1500,236700,A1,AG/GEN,,,
4074,10-1-0-29-B,6812-24-5979,SNGL FAM SUB,5,AC,57200,0,57200,0,38700,95900,56000,0,56000,0,34900,90900,A1,AG/GEN,,,
4075,11-9-0-C-0,6822-54-9256,SNGL FAM SUB,5.74,AC,63900,0,63900,163200,1400,228500,62700,0,62700,140600,1500,204800,A1,AG/GEN,,,
4076,42-16-B-11-0,6757-94-4747,SNGL FAM SUB,0.774,AC,73400,0,73400,165900,0,239300,66600,0,66600,152700,0,219300,R1,RES/LTD,,,
4077,42-16-B-12-0,6757-94-1794,SNGL FAM SUB,1.729,AC,102700,0,102700,185100,3300,291100,93200,0,93200,168900,3600,265700,R1,RES/LTD,,,
4079,4-1-0-48-F,6803-95-9891,SNGL FAM SUB,2.73,AC,48500,0,48500,125300,10500,184300,47700,0,47700,107600,10500,165800,A1,AG/GEN,,,
4080,4-1-0-48-G,6813-05-1636,SNGL FAM SUB,3.26,AC,51200,0,51200,0,0,51200,50300,0,50300,0,0,50300,A1,AG/GEN,,,
4081,58-18-G-5-0,7716-50-0104,SNGL FAM SUB,1.669,AC,310000,0,310000,539000,18600,867600,285000,0,285000,493900,17500,796400,A2,AG/LTD,,,
4082,42-20-0-C-2,6767-14-6742,SNGL FAM SUB,2,AC,80400,0,80400,308400,3000,391800,72300,0,72300,253800,3000,329100,A2,AG/LTD,,,
4085,12-1-0-52-A,6832-43-0174,AG 20-100 AC,73.4,AC,352300,269600,82700,763800,0,1116100,345400,266700,78700,694600,0,1040000,A1,AG/GEN,,,
4086,12-1-0-59-A,6832-44-6995,SNGL FAM SUB,7.29,AC,87000,0,87000,0,0,87000,86600,0,86600,0,0,86600,A1,AG/GEN,,,
4087,63-5-0-4-0,7724-14-9505,SNGL FAM SUB,1.08,AC,137400,0,137400,218700,17700,373800,119500,0,119500,183100,16700,319300,A2,AG/LTD,,,
4088,13-6-0-5-0,6841-83-0047,SNGL FAM SUB,5.62,AC,88300,0,88300,24400,800,113500,86600,0,86600,20900,800,108300,A1,AG/GEN,,,
4090,20-4-0-5-0,6841-81-7274,SNGL FAM SUB,0.4,AC,3500,0,3500,0,0,3500,3400,0,3400,0,0,3400,A1,AG/GEN,,,
4091,28-9-0-2-0,6729-83-6797,SNGL FAM SUB,3.013,AC,60900,0,60900,99900,1500,162300,59400,0,59400,82700,1500,143600,A1,AG/GEN,,,
4092,21-1-0-3-0,6850-39-5294,SNGL FAM SUB,2.4,AC,62000,0,62000,89000,8000,159000,60900,0,60900,77200,8000,146100,A1,AG/GEN,,,
4093,31-1-0-3-B,6769-65-7284,SNGL FAM SUB,3.41,AC,87200,0,87200,139900,2000,229100,79000,0,79000,115200,2000,196200,A2,AG/LTD,,,
4094,31-1-0-3-C,6769-65-4306,SNGL FAM SUB,2.918,AC,84300,0,84300,206300,1700,292300,76000,0,76000,170600,1700,248300,A2,AG/LTD,,,
4095,15-1-0-32-A,5789-17-9992,SNGL FAM SUB,1.36,AC,40100,0,40100,146300,1300,187700,39300,0,39300,126600,1300,167200,A1,AG/GEN,,,
4096,20-1-0-55-0,6851-02-7891,AG 20-100 AC,32.95,AC,293000,226900,66100,121000,31300,445300,287300,224600,62700,109100,28700,425100,A1,AG/GEN,,,
4097,64-19-E-7-0,7733-48-5037,SNGL FAM SUB,1.143,AC,265000,0,265000,448000,9700,722700,220000,0,220000,394900,10100,625000,R1,RES/LTD,,,
4098,5-12-0-1-0,6823-66-8187,SNGL FAM SUB,5,AC,60100,0,60100,203500,9300,272900,59000,0,59000,177500,8000,244500,A1,AG/GEN,,,
4099,31-1-0-3-A,6769-86-2026,SNGL FAM SUB,3,AC,85300,0,85300,214100,3800,303200,75900,0,75900,177200,2600,255700,A2,AG/LTD,,,
4100,20-7-0-2-0,6840-42-0428,SNGL FAM SUB,1.01,AC,54100,0,54100,0,4500,58600,50000,0,50000,0,3900,53900,A1,AG/GEN,,,
4101,20-7-0-1-0,6840-42-0696,SNGL FAM SUB,1,AC,54000,0,54000,0,1400,55400,49900,0,49900,0,1300,51200,A1,AG/GEN,,,
4102,29-1-0-39-0,6748-52-4584,SNGL FAM SUB,3.78,AC,80800,0,80800,125500,9700,216000,76000,0,76000,105000,10400,191400,A1,AG/GEN,,,
4103,18-3-0-2-0,6810-71-8332,AG 20-100 AC,90,AC,275400,233300,42100,0,0,275400,270000,231600,38400,0,0,270000,A1,AG/GEN,,,
4104,5-12-0-2-0,6823-76-0614,SNGL FAM SUB,5.12,AC,54600,0,54600,19400,0,74000,53600,0,53600,22200,0,75800,A1,AG/GEN,,,
4106,26-6-0-3-0,6708-92-8068,SNGL FAM SUB,3.655,AC,53700,0,53700,165400,27300,246400,52600,0,52600,142300,23700,218600,A1,AG/GEN,,,
4107,5-1-0-76-B,6823-65-5841,SNGL FAM SUB,5.148,AC,60900,0,60900,269200,34400,364500,59700,0,59700,232700,30200,322600,A1,AG/GEN,,,
4109,20-1-0-68-0,6840-87-2230,SNGL FAM SUB,5.84,AC,73900,0,73900,267700,3200,344800,72400,0,72400,232100,3000,307500,A1,AG/GEN,,,
4110,20-1-0-71-0,6840-96-3022,SNGL FAM SUB,16.6,AC,75600,67900,7700,0,0,75600,74700,67600,7100,0,0,74700,A1,AG/GEN,,,
4111,19-11-0-4-0,6831-51-2283,SNGL FAM SUB,15.33,AC,152500,0,152500,76000,18400,246900,227900,138100,89800,65500,18400,311800,A1,AG/GEN,,,
4112,55-14-0-23-0,6785-39-9676,SNGL FAM SUB,15.756,AC,271500,0,271500,1109100,159600,1540200,242600,0,242600,907600,151900,1302100,A2,AG/LTD,,,
4113,4-1-0-19-0,6802-48-9780,AG 20-100 AC,25,AC,50400,38900,11500,0,0,50400,50000,39400,10600,0,0,50000,A1,AG/GEN,,,
4114,4-1-0-20-A,6802-58-6146,SNGL FAM SUB,5,AC,10800,8500,2300,0,0,10800,10000,7900,2100,0,0,10000,A1,AG/GEN,,,
4115,6-1-0-49-0,6832-18-8798,SNGL FAM SUB,19.56,AC,146300,0,146300,248100,35600,430000,142900,0,142900,213800,32000,388700,A1,AG/GEN,,,
4118,51-1-0-26-C,6735-38-8534,SNGL FAM SUB,11.04,AC,95000,0,95000,135300,500,230800,93200,0,93200,114400,500,208100,A1,AG/GEN,,,
4119,51-1-0-26-A,6735-38-3606,SNGL FAM SUB,9.91,AC,88700,35700,53000,142300,8100,239100,87000,35400,51600,123700,8400,219100,A1,AG/GEN,,,
4120,43-1-0-7-C,6767-67-0784,SNGL FAM SUB,1.675,AC,79800,0,79800,152700,11900,244400,71300,0,71300,121600,11200,204100,A2,AG/LTD,,,
4121,14-2-0-10-0,6851-26-8576,SNGL FAM SUB,7.55,AC,85900,0,85900,0,0,85900,84200,0,84200,0,0,84200,A1,AG/GEN,,,
4130,7-1-0-7-0,6842-17-5052,AG 20-100 AC,59.575,AC,217000,189500,27500,0,0,217000,212800,187500,25300,0,0,212800,A1,AG/GEN,,,
4131,5-1-0-14-0,6813-73-7326,SNGL FAM SUB,1.87,AC,44100,0,44100,0,24400,68500,43400,0,43400,0,20800,64200,A1,AG/GEN,,,
4132,9-4-0-1-0,5892-71-4015,SNGL FAM SUB,1.02,AC,38900,0,38900,10600,300,49800,38100,0,38100,10500,300,48900,A1,AG/GEN,,,
4135,67-2-A-6-0,7723-56-9303,SNGL FAM SUB,0,AC,184000,0,184000,449300,12600,645900,160000,0,160000,371000,11200,542200,R1,RES/LTD,,,
4136,19-1-0-54-B,6830-65-1486,AG 20-100 AC,26,AC,203900,138000,65900,208000,5500,417400,192400,131800,60600,178200,5500,376100,A1,AG/GEN,,,
4137,4-1-0-38-0,6803-98-2323,SNGL FAM SUB,1.93,AC,44400,0,44400,138600,14200,197200,43700,0,43700,120900,12200,176800,A1,AG/GEN,,,
4139,64-4-2-32-0,7724-93-5169,SNGL FAM SUB,0,AC,20200,0,20200,0,4500,24700,17600,0,17600,0,2000,19600,RN,RESIDEN,,,
4140,64-4-2-33-0,7724-93-5268,SNGL FAM SUB,0,AC,70000,0,70000,162500,4100,236600,60000,0,60000,137400,4100,201500,RN,RESIDEN,,,
4141,56-1-0-76-0,6796-90-3034,AG 20-100 AC,22.36,AC,611800,425200,186600,586000,63600,1261400,531200,368900,162300,505500,54800,1091500,A2,AG/LTD,,,
4142,44-4-0-3-A,6787-13-8822,SNGL FAM SUB,1.04,AC,62000,0,62000,0,0,62000,55300,0,55300,0,0,55300,A2,AG/LTD,,,
4143,51-8-0-10-0,6735-49-7105,SNGL FAM SUB,3.43,AC,48500,0,48500,0,0,48500,47600,0,47600,0,0,47600,A1,AG/GEN,,,
4144,51-8-0-11-0,6735-49-9151,SNGL FAM SUB,3.44,AC,48600,0,48600,0,0,48600,47600,0,47600,0,0,47600,A1,AG/GEN,,,
4145,29-12-0-4-0,6748-78-0482,SNGL FAM SUB,1.375,AC,57800,0,57800,80000,500,138300,53400,0,53400,66800,500,120700,A1,AG/GEN,,,
4146,51-8-0-2-0,6736-30-9006,SNGL FAM SUB,2.77,AC,44800,0,44800,50400,1000,96200,43900,0,43900,43900,1000,88800,A1,AG/GEN,,,
4147,51-8-0-2-A,6736-30-8350,SNGL FAM SUB,0.65,AC,4000,0,4000,0,0,4000,3900,0,3900,0,0,3900,A1,AG/GEN,,,
4307,12-2-0-5-0,6821-94-8400,SNGL FAM SUB,5,AC,63000,0,63000,122700,0,185700,62300,0,62300,100500,1000,163800,A1,AG/GEN,,,
4308,12-1-0-41-B,6831-33-4977,SNGL FAM SUB,2.109,AC,52300,0,52300,143100,7800,203200,51600,0,51600,119000,6200,176800,A1,AG/GEN,,,
4309,20-1-0-44-A,6840-45-9139,SNGL FAM SUB,1,AC,47000,0,47000,0,0,47000,44700,0,44700,0,0,44700,A1,AG/GEN,,,
4310,30-1-0-60-B,6759-42-9403,SNGL FAM SUB,1.01,AC,54100,0,54100,108000,1500,163600,50000,0,50000,89400,1500,140900,A2,AG/LTD,,,
4311,43-21-0-22-0,6767-41-5733,SNGL FAM SUB,1.118,AC,71900,0,71900,276600,9200,357700,64200,0,64200,223700,8300,296200,A2,AG/LTD,,,
4312,7-1-0-5-0,6843-21-4016,SNGL FAM SUB,0.78,AC,31500,0,31500,0,2500,34000,30400,0,30400,0,2500,32900,A1,AG/GEN,,,
4313,29-10-0-D-0,6749-85-8855,SNGL FAM SUB,1.15,AC,55500,0,55500,293300,0,348800,51400,0,51400,251200,0,302600,A1,AG/GEN,,,
4314,5-1-0-43-0,6823-07-9753,SNGL FAM SUB,11.5,AC,87300,0,87300,0,0,87300,85700,0,85700,0,0,85700,A1,AG/GEN,,,
4315,38-3-0-10-A,6717-36-1999,SNGL FAM SUB,0.5,AC,7600,0,7600,0,0,7600,7400,0,7400,0,0,7400,A1,AG/GEN,,,
4316,38-3-0-4-0,6717-16-6305,AG 20-100 AC,20,AC,126000,0,126000,0,0,126000,133000,0,133000,0,0,133000,A1,AG/GEN,,,
4477,17-3-0-2-0,6709-39-6564,SNGL FAM SUB,4.411,AC,54500,0,54500,134800,0,189300,56800,0,56800,109800,0,166600,A1,AG/GEN,,,
4478,29-14-0-2-0,6749-51-2082,SNGL FAM SUB,2.78,AC,71500,0,71500,259100,0,330600,66600,0,66600,218100,0,284700,A1,AG/GEN,,,
4479,39-1-0-46-0,6727-12-0116,SNGL FAM SUB,2.51,AC,47300,0,47300,0,0,47300,46300,0,46300,0,0,46300,A1,AG/GEN,,,
4480,39-1-0-45-0,6727-12-3158,SNGL FAM SUB,1,AC,38800,0,38800,63200,800,102800,38000,0,38000,54800,800,93600,A1,AG/GEN,,,
4481,45-1-0-91-F,6797-86-9868,SNGL FAM SUB,5.828,AC,149600,0,149600,0,0,149600,133700,0,133700,0,0,133700,A2,AG/LTD,,,
4482,45-1-0-91-E,6797-86-8491,SNGL FAM SUB,1.649,AC,87000,0,87000,177200,23900,288100,77700,0,77700,145800,19800,243300,A2,AG/LTD,,,
4483,20-1-0-82-0,6840-61-0520,AG 20-100 AC,54.1,AC,473300,370500,102800,177800,10800,661900,460600,363600,97000,149800,10800,621200,A1,AG/GEN,,,
4484,48-5-0-2-0,7728-91-7877,SNGL FAM SUB,9.89,AC,349700,246300,103400,127900,11200,488800,312400,220100,92300,106700,11200,430300,A2,AG/LTD,,,
4485,17-1-0-76-0,6800-90-2804,AG > 100 AC,104.03,AC,265600,217600,48000,0,0,265600,260100,215900,44200,0,0,260100,A1,AG/GEN,,,
4486,57-1-0-30-B,7706-02-7280,SNGL FAM SUB,1,AC,94900,0,94900,119100,1500,215500,82500,0,82500,101500,1500,185500,A2,AG/LTD,,,
4487,45-15-0-3-0,6797-52-5409,SNGL FAM SUB,7.57,AC,175900,0,175900,448800,0,624700,157200,0,157200,375200,0,532400,A2,AG/LTD,,,
4488,55-1-0-16-0,6785-17-3025,SNGL FAM SUB,4.95,AC,124600,0,124600,84100,0,208700,111200,0,111200,70900,0,182100,A2,AG/LTD,,,
4490,26-1-0-64-0,6719-04-9187,SNGL FAM SUB,10.25,AC,90400,0,90400,136800,43300,270500,88900,0,88900,115500,38500,242900,A1,AG/GEN,,,
4491,28-1-0-18-0,6728-97-2433,SNGL FAM SUB,1.7,AC,43400,0,43400,91900,900,136200,42600,0,42600,79000,900,122500,A1,AG/GEN,,,
4492,38-1-0-25-B,6707-77-3789,SNGL FAM SUB,1.05,AC,39100,0,39100,114800,100,154000,38300,0,38300,98200,100,136600,A1,AG/GEN,,,
4148,51-8-0-9-0,6735-49-4201,SNGL FAM SUB,3.43,AC,48500,0,48500,70800,300,119600,47600,0,47600,69700,300,117600,A1,AG/GEN,,,
4149,12-1-0-45-B,6831-05-7058,SNGL FAM SUB,2,AC,47600,0,47600,162900,300,210800,47300,0,47300,135300,300,182900,A1,AG/GEN,,,
4150,46-1-0-56-A,7716-08-7253,SNGL FAM SUB,1,AC,92400,0,92400,76200,2600,171200,82500,0,82500,64100,2600,149200,A2,AG/LTD,,,
4151,51-1-0-30-0,6736-30-7428,SNGL FAM SUB,3.94,AC,51400,0,51400,0,0,51400,50400,0,50400,0,0,50400,A1,AG/GEN,,,
4152,18-1-0-64-A,6820-46-0662,SNGL FAM SUB,3.22,AC,53300,0,53300,229200,15900,298400,51300,0,51300,187800,15900,255000,A1,AG/GEN,,,
4153,46-15-0-1-0,7707-92-1221,SNGL FAM SUB,5,AC,187800,0,187800,94500,4800,287100,167600,0,167600,79600,4400,251600,A2,AG/LTD,,,
4154,12-1-0-10-0,6832-26-9653,SNGL FAM SUB,0.88,AC,5000,4600,400,0,0,5000,4900,4500,400,0,0,4900,A1,AG/GEN,,,
4155,12-1-0-11-0,6832-24-5250,AG > 100 AC,189.4,AC,927800,840500,87300,0,0,927800,906800,826300,80500,0,0,906800,A1,AG/GEN,,,
4156,38-1-0-90-0,6717-06-6039,SNGL FAM SUB,2.74,AC,48500,0,48500,97400,26100,172000,47600,0,47600,83600,22500,153700,A1,AG/GEN,,,
4157,32-1-0-54-0,6778-95-2074,SNGL FAM SUB,2.777,AC,89700,0,89700,144800,2500,237000,80100,0,80100,121900,2500,204500,A2,AG/LTD,,,
4158,45-1-0-125-A,6797-78-4447,SNGL FAM SUB,6.65,AC,128500,0,128500,103500,0,232000,114800,0,114800,86900,0,201700,A2,AG/LTD,,,
4159,45-1-0-125-B,6797-68-9579,SNGL FAM SUB,4,AC,98300,0,98300,132900,0,231200,87800,0,87800,108900,0,196700,A2,AG/LTD,,,
4160,47-1-0-26-0,7716-57-7650,SNGL FAM SUB,1,AC,99000,0,99000,182100,8800,289900,88400,0,88400,153800,8800,251000,A2,AG/LTD,,,
4163,44-17-0-4-0,6787-23-6605,SNGL FAM SUB,1.36,AC,75800,0,75800,131200,0,207000,67700,0,67700,100700,0,168400,A2,AG/LTD,,,
4164,44-17-0-6-0,6787-24-6011,SNGL FAM SUB,3.23,AC,96900,0,96900,82000,0,178900,86500,0,86500,58500,0,145000,A2,AG/LTD,,,
4165,58-1-0-41-0,7715-72-3445,SNGL FAM SUB,0.95,AC,109300,0,109300,105700,500,215500,95100,0,95100,91100,500,186700,A2,AG/LTD,,,
4166,56-7-0-3-0,6785-94-0741,SNGL FAM SUB,3,AC,100300,0,100300,0,8300,108600,89600,0,89600,0,7400,97000,A2,AG/LTD,,,
4167,58-4-H-46-0,7716-56-9939,SNGL FAM SUB,0,AC,77500,0,77500,100500,500,178500,70500,0,70500,84200,500,155200,A2,AG/LTD,,,
4168,58-4-H-47-0,7716-57-9017,SNGL FAM SUB,0,AC,20100,0,20100,0,0,20100,18300,0,18300,0,0,18300,A2,AG/LTD,,,
4169,39-4-0-4-0,6726-57-3748,SNGL FAM SUB,5.46,AC,66000,0,66000,130100,1300,197400,64800,0,64800,110000,1300,176100,A1,AG/GEN,,,
4170,17-1-0-104-0,6810-56-1698,SNGL FAM SUB,1.84,AC,45000,0,45000,166100,0,211100,42600,0,42600,135800,0,178400,A1,AG/GEN,,,
4171,17-1-0-106-0,6810-56-0972,SNGL FAM SUB,2.32,AC,47900,0,47900,187600,1500,237000,45300,0,45300,154400,1500,201200,A1,AG/GEN,,,
4172,17-1-0-107-0,6810-47-9166,SNGL FAM SUB,2.89,AC,51300,0,51300,0,0,51300,48400,0,48400,0,0,48400,A1,AG/GEN,,,
4173,43-1-0-5-E,6767-58-2284,SNGL FAM SUB,4.805,AC,117700,0,117700,134400,2800,254900,105200,0,105200,110200,2800,218200,A2,AG/LTD,,,
4174,58-22-A-15-0,7715-37-6994,SNGL FAM SUB,4.82,AC,480000,0,480000,0,0,480000,440000,0,440000,0,0,440000,A2,AG/LTD,,,
4175,18-1-0-10-0,6810-56-4930,SNGL FAM SUB,2,AC,46000,0,46000,48300,1400,95700,44000,0,44000,40500,1000,85500,A1,AG/GEN,,,
4176,31-1-0-24-0,6768-75-4864,AG 20-100 AC,48.7,AC,309000,0,309000,71800,5500,386300,279300,0,279300,60300,3200,342800,A2,AG/LTD,,,
4177,2-1-0-9-C,6824-05-3817,SNGL FAM SUB,3.449,AC,48200,0,48200,0,0,48200,47300,0,47300,0,0,47300,A1,AG/GEN,,,
4178,2-1-0-9-E,6814-96-0289,SNGL FAM SUB,2.874,AC,33600,0,33600,0,0,33600,32900,0,32900,0,0,32900,B1A1,BS & AG,,,
4179,2-1-0-9-A,6814-96-4334,COMM & IND,5.2,AC,120900,0,120900,93300,3200,217400,117300,0,117300,71500,3400,192200,A1B1,AG GEN/,,,
4180,57-1-0-28-A,7706-01-6478,SNGL FAM SUB,1.71,AC,113600,0,113600,159300,1000,273900,98800,0,98800,136600,1000,236400,A2,AG/LTD,,,
4182,43-1-0-57-0,6768-81-0184,SNGL FAM SUB,5.2,AC,130600,0,130600,31600,300,162500,116800,0,116800,26600,300,143700,A2,AG/LTD,,,
4183,58-1-0-4-0,7716-37-3153,SNGL FAM SUB,3,AC,134200,0,134200,77600,400,212200,119800,0,119800,65100,400,185300,A2,AG/LTD,,,
4184,7-1-0-14-0,6842-57-9781,AG 20-100 AC,68.6,AC,306500,215700,90800,226200,5700,538400,206100,137200,68900,150100,4700,360900,A1,AG/GEN,,,
4186,55-1-0-79-A,6785-79-3452,SNGL FAM SUB,5.06,AC,126100,0,126100,181100,7100,314300,112500,0,112500,147900,6700,267100,A2,AG/LTD,,,
4187,14-3-0-11-0,6851-48-0936,SNGL FAM SUB,3.21,AC,68300,0,68300,181600,29100,279000,66900,0,66900,153600,26000,246500,A1,AG/GEN,,,
4188,45-16-0-17-0,6798-52-6067,SNGL FAM SUB,1.97,AC,86300,0,86300,265900,1000,353200,77000,0,77000,217300,1000,295300,A2,AG/LTD,,,
4189,58-1-0-108-0,7725-08-8754,SNGL FAM SUB,1.46,AC,123600,0,123600,88600,4700,216900,107500,0,107500,75500,4000,187000,A2,AG/LTD,,,
4190,15-5-0-28-0,5789-78-6346,SNGL FAM SUB,8.16,AC,64600,0,64600,326200,0,390800,63100,0,63100,280800,0,343900,A1,AG/GEN,,,
4191,63-1-0-172-0,7724-41-2587,SNGL FAM SUB,0.095,AC,1900,0,1900,0,0,1900,1700,0,1700,0,0,1700,A2,AG/LTD,,,
4192,63-1-0-172-A,7724-41-4566,SNGL FAM SUB,6.34,AC,129300,0,129300,0,0,129300,112200,0,112200,0,0,112200,A2,AG/LTD,,,
4193,57-10-0-10-0,7705-66-1500,SNGL FAM SUB,3.44,AC,230000,0,230000,427900,0,657900,210000,0,210000,398700,0,608700,A2,AG/LTD,,,
4195,45-1-0-50-0,6796-47-5911,SNGL FAM SUB,3.86,AC,127900,0,127900,214500,12600,355000,114100,0,114100,176700,12600,303400,A2,AG/LTD,,,
4196,40-1-0-22-0,6726-97-1353,SNGL FAM SUB,12.86,AC,116200,66300,49900,192900,44800,353900,114200,66100,48100,166100,37700,318000,A1,AG/GEN,,,
4197,45-5-0-2-0,6797-68-7144,COMM & IND,5.77,AC,470300,0,470300,677400,51300,1199000,447800,0,447800,641800,51900,1141500,M1,INDUS/L,,,
4198,45-5-0-1-0,6797-68-2197,COMM & IND,4.03,AC,345800,0,345800,0,0,345800,329300,0,329300,0,0,329300,M1,INDUS/L,,,
4199,56-1-0-78-0,6796-72-2137,SNGL FAM SUB,4.547,AC,229900,0,229900,754500,30000,1014400,199800,0,199800,639100,30000,868900,A2,AG/LTD,,,
4201,42-1-0-90-C,6767-15-0438,SNGL FAM SUB,6.658,AC,171700,0,171700,372000,47200,590900,155400,0,155400,308500,40300,504200,A2R3,AGRIC.R,,,
4202,55-1-0-30-A,6785-56-7583,SNGL FAM SUB,1.63,AC,80500,0,80500,176700,0,257200,71900,0,71900,145000,0,216900,R2,RES/LTD,,,
4203,55-16-0-4-0,6776-64-9226,SNGL FAM SUB,4.3,AC,126900,0,126900,266700,11900,405500,113500,0,113500,222200,10600,346300,A2,AG/LTD,,,
4204,45-16-0-15-0,6798-62-1015,SNGL FAM SUB,2.09,AC,87900,0,87900,386700,25900,500500,78500,0,78500,329600,22700,430800,A2,AG/LTD,,,
4205,48-1-0-58-AT,7738-30-9741-9999,COMM & IND,15.14,AC,904200,0,904200,334100,348600,1586900,866500,0,866500,330100,322300,1518900,M2,INDUS/G,,,
4207,31-7-0-9-B,6779-55-4692,SNGL FAM SUB,2.4,AC,84300,0,84300,104500,1000,189800,75300,0,75300,80700,1000,157000,A2,AG/LTD,,,
4208,10-1-0-47-0,6811-02-4996,AG 20-100 AC,53,AC,110800,0,110800,0,0,110800,106000,0,106000,0,0,106000,A1,AG/GEN,,,
4209,16-1-0-57-0,6800-09-4939,AG 20-100 AC,45,AC,92300,0,92300,0,0,92300,90000,0,90000,0,0,90000,A1,AG/GEN,,,
4210,15-1-0-8-0,5890-11-0845,AG > 100 AC,384.28,AC,766500,465100,301400,0,46600,813100,745400,454000,291400,0,16900,762300,A1,AG/GEN,,,
4211,37-1-0-8-0,6706-39-4395,COMM & IND,2.25,AC,43900,0,43900,37000,0,80900,42500,0,42500,38500,0,81000,M2,INDUS/G,,,
4212,37-1-0-10-0,6706-39-4237,COMM & IND,0,AC,0,0,0,0,100,100,0,0,0,0,100,100,M2,INDUS/G,,,
4213,38-1-0-47-0,6707-50-4723,SNGL FAM SUB,2,AC,38100,37200,900,0,0,38100,37300,36400,900,0,0,37300,A1,AG/GEN,,,
4214,38-1-0-48-0,6707-40-9148,SNGL FAM SUB,14,AC,105100,98600,6500,0,0,105100,103000,97000,6000,0,0,103000,A1M2,AG/GEN,,,
4215,38-1-0-49-0,6707-40-3486,AG 20-100 AC,45.25,AC,185500,164600,20900,0,0,185500,181000,161800,19200,0,0,181000,A1M2,AG/GEN,,,
4216,38-1-0-49-A,6706-49-9430,AG 20-100 AC,46,AC,152400,113100,39300,0,0,152400,148800,111400,37400,0,0,148800,A1M2,AG/GEN,,,
4217,38-1-0-54-0,6706-59-5023,AG 20-100 AC,39.833,AC,163300,144900,18400,0,0,163300,159300,142400,16900,0,0,159300,A1,AG/GEN,,,
4218,30-1-0-115-B,6759-54-8714,SNGL FAM SUB,2.5,AC,66900,0,66900,43700,0,110600,60800,0,60800,36800,0,97600,A2,AG/LTD,,,
4219,63-21-0-2-0,7715-92-6033,SNGL FAM SUB,10,AC,313600,0,313600,0,0,313600,272500,0,272500,0,0,272500,A2,AG/LTD,,,
4220,63-16-0-1-0,7715-60-8681,SNGL FAM SUB,2.68,AC,149400,0,149400,139000,1200,289600,129900,0,129900,118800,1200,249900,A2,AG/LTD,,,
4221,58-21-A-8-0,7716-43-5724,SNGL FAM SUB,1.321,AC,310000,0,310000,583900,0,893900,285000,0,285000,532600,0,817600,A2,AG/LTD,,,
4222,63-1-0-106-0,7715-41-3723,SNGL FAM SUB,1.55,AC,129200,0,129200,175300,0,304500,112400,0,112400,147200,0,259600,A2,AG/LTD,,,
4223,56-1-0-18-0,6785-84-0473,SNGL FAM SUB,9.06,AC,191800,0,191800,0,0,191800,171400,0,171400,0,0,171400,A2,AG/LTD,,,
4224,63-33-0-1-0,7715-50-8984,SNGL FAM SUB,3.94,AC,168400,0,168400,219600,3200,391200,146300,0,146300,184700,3200,334200,A2,AG/LTD,,,
4225,63-1-0-107-0,7715-41-1688,SNGL FAM SUB,0.46,AC,88300,0,88300,161200,100,249600,76800,0,76800,136200,100,213100,A2,AG/LTD,,,
4226,63-1-0-96-A,7715-50-9113,SNGL FAM SUB,0.692,AC,90000,0,90000,128100,600,218700,78300,0,78300,114300,600,193200,A2,AG/LTD,,,
4227,63-1-0-132-0,7715-61-9755,SNGL FAM SUB,3.87,AC,166900,0,166900,202800,34400,404100,145100,0,145100,170500,29600,345200,A2,AG/LTD,,,
4228,63-1-0-97-0,7715-50-4025,SNGL FAM SUB,1.5,AC,118600,0,118600,101000,3800,223400,103200,0,103200,85700,3800,192700,A2,AG/LTD,,,
4229,63-1-0-130-0,7715-61-6870,SNGL FAM SUB,1.5,AC,113200,0,113200,188700,26000,327900,98500,0,98500,159700,22000,280200,A2,AG/LTD,,,
4230,15-1-0-17-0,5880-55-4957,SNGL FAM SUB,3.153,AC,41900,0,41900,37700,600,80200,41000,0,41000,31700,600,73300,A1,AG/GEN,,,
4231,48-3-D-4-0,7726-57-7540,SNGL FAM SUB,0,AC,130000,0,130000,174700,1500,306200,117000,0,117000,155500,1500,274000,R1,RES/LTD,,,
4234,1-1-0-22-B,6804-77-9235,SNGL FAM SUB,1.257,AC,41000,0,41000,113700,12400,167100,40300,0,40300,99300,8900,148500,A1,AG/GEN,,,
4235,1-2-0-1-C,6804-54-2282,SNGL FAM SUB,4.004,AC,55000,0,55000,318500,2000,375500,54000,0,54000,277700,2000,333700,A1,AG/GEN,,,
4236,67-10-0-14-0,7733-14-2967,SNGL FAM SUB,0,AC,340000,0,340000,478800,2400,821200,285000,0,285000,393900,2500,681400,R1,RES/LTD,,,
4237,39-1-0-66-A,6726-06-9509,SNGL FAM SUB,0.64,AC,31000,0,31000,88600,600,120200,30400,0,30400,75800,600,106800,A1,AG/GEN,,,
4238,39-1-0-68-C,6726-06-8760,SNGL FAM SUB,0.41,AC,2500,0,2500,0,0,2500,2500,0,2500,0,0,2500,A1,AG/GEN,,,
4239,18-5-0-A-0,6820-41-5629,AG 20-100 AC,37.1,AC,209300,151900,57400,281800,27900,519000,200200,146700,53500,235400,27900,463500,A1,AG/GEN,,,
4240,18-5-0-A-6,6820-42-7485,SNGL FAM SUB,10.13,AC,89800,84900,4900,0,0,89800,88200,83800,4400,0,0,88200,A1,AG/GEN,,,
4241,19-1-0-54-C,6830-35-2935,SNGL FAM SUB,10.577,AC,128400,69500,58900,406200,62100,596700,119800,65800,54000,334000,53000,506800,A1,AG/GEN,,,
4242,19-1-0-33-0,6830-45-1856,AG 20-100 AC,50.423,AC,394200,262900,131300,358400,11400,764000,375800,255300,120500,299400,11400,686600,A1,AG/GEN,,,
4243,12-1-0-16-0,6822-71-3556,AG 20-100 AC,71.56,AC,350400,313000,37400,0,18500,368900,343500,308700,34800,0,18700,362200,A1,AG/GEN,,,
4244,12-1-0-15-0,6822-81-3792,AG 20-100 AC,50,AC,292200,229300,62900,385200,11000,688400,286000,226200,59800,337300,11500,634800,A1,AG/GEN,,,
4245,19-1-0-45-0,6831-70-3102,AG 20-100 AC,83.717,AC,378200,338300,39900,0,32000,410200,291900,267900,24000,0,28800,320700,A1,AG/GEN,,,
4246,19-1-0-45-A,6831-70-4833,SNGL FAM SUB,2,AC,63800,9300,54500,207000,0,270800,59800,9500,50300,173700,0,233500,A1,AG/GEN,,,
4247,19-1-0-2-B,6821-81-5076,SNGL FAM SUB,3,AC,51100,0,51100,193100,1000,245200,50900,0,50900,160800,1000,212700,A1,AG/GEN,,,
4248,20-6-0-1-0,6840-71-5079,SNGL FAM SUB,4.01,AC,82300,0,82300,99200,900,182400,81200,0,81200,82100,900,164200,A1,AG/GEN,,,
4249,1-1-0-20-B,6804-77-9716,SNGL FAM SUB,3.38,AC,51800,0,51800,125000,2500,179300,50900,0,50900,108800,2500,162200,A1,AG/GEN,,,
4250,30-1-0-29-0,6758-26-3243,SNGL FAM SUB,4.37,AC,86100,0,86100,0,0,86100,81600,0,81600,0,0,81600,A1A2,AG GEN/,,,
4251,30-2-0-2-0,6758-35-9710,SNGL FAM SUB,6.448,AC,88900,0,88900,93600,500,183000,81600,0,81600,78400,500,160500,A2,AG/LTD,,,
4252,44-2-0-8-0,6787-73-5721,SNGL FAM SUB,1.74,AC,76800,0,76800,147100,2000,225900,68600,0,68600,126500,2000,197100,A2,AG/LTD,,,
4254,19-1-0-26-A,6739-18-8464,SNGL FAM SUB,1.01,AC,54100,0,54100,98700,0,152800,50000,0,50000,82400,0,132400,A1,AG/GEN,,,
4255,12-1-0-9-0,6832-16-7216,SNGL FAM SUB,15.97,AC,125800,0,125800,0,0,125800,122800,0,122800,0,0,122800,A1,AG/GEN,,,
4256,31-1-0-102-A,6768-82-8916,SNGL FAM SUB,2.74,AC,89200,0,89200,246000,15700,350900,79600,0,79600,212400,16100,308100,A2,AG/LTD,,,
4257,16-1-0-41-0,5890-44-6406,SNGL FAM SUB,12.05,AC,73400,0,73400,0,4000,77400,71200,0,71200,0,4000,75200,A1,AG/GEN,,,
4258,20-11-0-21-0,6841-91-5069,SNGL FAM SUB,2,AC,55600,0,55600,144500,1500,201600,52500,0,52500,133000,1500,187000,A1,AG/GEN,,,
4260,41-1-0-2-0,6748-20-3984,SNGL FAM SUB,8,AC,127700,0,127700,0,0,127700,124200,0,124200,0,0,124200,A1,AG/GEN,,,
4262,41-2-0-9-0,6748-31-6733,SNGL FAM SUB,2.47,AC,68600,0,68600,248000,500,317100,63700,0,63700,208500,500,272700,A1,AG/GEN,,,
4263,57-1-0-71-0,7706-93-3538,SNGL FAM SUB,8.287,AC,404200,0,404200,324600,281400,1010200,351300,0,351300,273600,242000,866900,A2,AG/LTD,,,
4264,45-1-0-104-0,6798-71-2353,SNGL FAM SUB,1.51,AC,66600,0,66600,106500,0,173100,59500,0,59500,82300,0,141800,A2,AG/LTD,,,
4265,32-10-1-26-0,6778-68-7764,SNGL FAM SUB,3.23,AC,99400,0,99400,324900,24600,448900,88900,0,88900,271400,23400,383700,A2,AG/LTD,,,
4266,45-1-0-73-C,6797-30-1438,SNGL FAM SUB,3.5,AC,122200,0,122200,280000,0,402200,109100,0,109100,231700,0,340800,A2,AG/LTD,,,
4267,51-1-0-34-0,6736-31-2839,AG 20-100 AC,48.07,AC,147100,0,147100,0,0,147100,144200,0,144200,0,0,144200,A1,AG/GEN,,,
4268,39-1-0-84-0,6726-67-4952,SNGL FAM SUB,2.59,AC,48500,0,48500,128300,47400,224200,47500,0,47500,103000,44800,195300,A1,AG/GEN,,,
4269,51-1-0-35-0,6736-22-4710,AG 20-100 AC,23.5,AC,111700,0,111700,0,0,111700,109000,0,109000,0,0,109000,A1,AG/GEN,,,
4273,12-13-0-A-0,6832-74-9059,AG 20-100 AC,90.79,AC,470300,427500,42800,0,59100,529400,461100,422400,38700,0,50400,511500,A1,AG/GEN,,,
4275,12-13-0-C-0,6832-70-3804,SNGL FAM SUB,0.475,AC,2700,0,2700,0,0,2700,2700,0,2700,0,0,2700,A1,AG/GEN,,,
4276,42-19-0-5-0,6766-18-7926,SNGL FAM SUB,2.07,AC,79300,0,79300,181300,1500,262100,67900,0,67900,154500,1500,223900,R3A2,RES GEN,,,
4277,42-16-A-6-0,6757-94-9192,SNGL FAM SUB,0.952,AC,81500,0,81500,259300,3200,344000,74000,0,74000,242300,3400,319700,R1,RES/LTD,,,
4278,28-1-0-95-C,6738-26-6896,SNGL FAM SUB,2,AC,55100,0,55100,8100,1000,64200,55200,0,55200,7900,1000,64100,A1,AG/GEN,,,
4279,18-1-0-7-0,6810-69-9545,SNGL FAM SUB,18.99,AC,139500,0,139500,177600,21400,338500,136900,0,136900,168600,21400,326900,A1,AG/GEN,,,
4280,48-1-0-22-B,7727-51-0108,AG 20-100 AC,24.984,AC,1119300,1107800,11500,0,0,1119300,999400,988800,10600,0,0,999400,A2,AG/LTD,,,
4281,27-1-0-5-0,6719-71-0908,AG 20-100 AC,65.36,AC,324000,0,324000,213300,42700,580000,316900,0,316900,186100,35900,538900,A1,AG/GEN,,,
4282,55-8-0-5-0,6786-60-0010,SNGL FAM SUB,0.97,AC,69400,0,69400,170200,35000,274600,61900,0,61900,139000,29800,230700,A2,AG/LTD,,,
4284,67-10-0-10-0,7733-05-5721,SNGL FAM SUB,2,AC,323000,0,323000,492400,40000,855400,270800,0,270800,436300,34500,741600,R1,RES/LTD,,,
4285,57-10-0-1-0,7705-96-0039,SNGL FAM SUB,5.244,AC,265000,0,265000,539200,50800,855000,240000,0,240000,491800,45000,776800,A2,AG/LTD,,,
4286,7-2-0-21-0,6833-92-7414,SNGL FAM SUB,3.15,AC,49200,0,49200,177800,1200,228200,46400,0,46400,175000,800,222200,A1,AG/GEN,,,
4287,45-5-0-3-0,6797-78-2013,COMM & IND,5.66,AC,461300,0,461300,714900,165600,1341800,439300,0,439300,673500,171100,1283900,M1,INDUS/L,,,
4288,39-5-0-2-0,6717-73-0617,SNGL FAM SUB,10,AC,89200,45800,43400,101200,100,190500,87500,45700,41800,88000,100,175600,A1,AG/GEN,,,
4289,26-1-0-44-B,6719-21-4146,SNGL FAM SUB,8.542,AC,84800,0,84800,9800,0,94600,83300,0,83300,9600,0,92900,A1,AG/GEN,,,
4290,57-10-0-11-0,7705-56-8640,SNGL FAM SUB,3.34,AC,230000,0,230000,421100,7300,658400,210000,0,210000,408000,7600,625600,A2,AG/LTD,,,
4291,43-1-0-54-0,6767-88-6970,SNGL FAM SUB,3,AC,98900,0,98900,211200,22600,332700,88400,0,88400,172300,18400,279100,A2,AG/LTD,,,
4292,13-1-0-36-A,6851-05-8285,AG 20-100 AC,29.55,AC,106600,93000,13600,0,0,106600,104500,91900,12600,0,0,104500,A1,AG/GEN,,,
4293,13-1-0-37-B,6841-94-8710,SNGL FAM SUB,2.09,AC,59400,58400,1000,0,0,59400,57200,56300,900,0,0,57200,A1,AG/GEN,,,
4294,13-1-0-38-0,6841-93-9502,SNGL FAM SUB,17.49,AC,172800,109900,62900,225000,37200,435000,169500,108500,61000,194800,33300,397600,A1,AG/GEN,,,
4297,13-1-0-36-0,6851-07-4228,SNGL FAM SUB,18.331,AC,153100,0,153100,145200,14700,313000,147500,0,147500,128700,27400,303600,A1,AG/GEN,,,
4298,7-3-0-2-0,6842-29-4945,SNGL FAM SUB,2,AC,48500,0,48500,179400,3900,231800,47000,0,47000,159800,2900,209700,A1,AG/GEN,,,
4299,58-1-0-100-0,7726-21-0517,AG 20-100 AC,23.9,AC,2108200,0,2108200,6274100,73600,8455900,1538300,0,1538300,5783800,49600,7371700,A2,AG/LTD,,,
4300,11-1-0-56-0,6822-75-0844,SNGL FAM SUB,2.2,AC,46100,0,46100,0,0,46100,44700,0,44700,0,0,44700,A1,AG/GEN,,,
4301,11-11-0-5-0,6821-24-8427,SNGL FAM SUB,15.356,AC,116400,0,116400,11100,200,127700,117000,0,117000,10600,200,127800,A1,AG/GEN,,,
4302,31-1-0-42-0,6769-91-6566,SNGL FAM SUB,11.2,AC,191600,0,191600,1000,0,192600,171400,0,171400,1000,0,172400,A2,AG/LTD,,,
4303,43-1-0-85-0,6777-02-7373,SNGL FAM SUB,2.6,AC,53300,0,53300,0,0,53300,47600,0,47600,0,0,47600,A2,AG/LTD,,,
4304,45-1-0-113-B,6797-69-6350,SNGL FAM SUB,13.348,AC,597700,0,597700,0,0,597700,179800,0,179800,0,0,179800,M2,INDUS/G,,,
4305,29-3-0-2-A,6749-72-4271,SNGL FAM SUB,1.55,AC,59500,0,59500,158500,0,218000,55300,0,55300,130000,0,185300,A1,AG/GEN,,,
4306,31-1-0-18-0,6768-68-0019,AG 20-100 AC,27,AC,289500,0,289500,0,0,289500,267300,0,267300,0,0,267300,A2,AG/LTD,,,
4317,30-1-0-115-0,6759-54-5280,SNGL FAM SUB,1.183,AC,56300,0,56300,99300,0,155600,51800,0,51800,82500,0,134300,A2,AG/LTD,,,
4318,29-3-0-10-B,6749-62-5488,SNGL FAM SUB,1.875,AC,62800,0,62800,120700,0,183500,58100,0,58100,100400,0,158500,A1,AG/GEN,,,
4320,62-2-B-4-0,7704-94-7059,SNGL FAM SUB,0,AC,115000,0,115000,208400,3300,326700,100000,0,100000,189500,2900,292400,R1,RES/LTD,,,
4321,13-1-0-37-0,6841-95-7262,SNGL FAM SUB,11.94,AC,138400,0,138400,0,0,138400,135700,0,135700,0,0,135700,A1,AG/GEN,,,
4322,29-18-0-3-0,6749-72-7451,SNGL FAM SUB,3,AC,73600,0,73600,122100,700,196400,68700,0,68700,102500,700,171900,A1,AG/GEN,,,
4323,42-1-0-65-0,6757-88-0488,General Gov,2,AC,251400,0,251400,116800,2500,370700,241700,0,241700,96100,2500,340300,B1,BUS/GEN,,,
4324,63-1-0-137-0,7715-71-8798,SNGL FAM SUB,2.7,AC,143100,0,143100,125200,900,269200,124400,0,124400,106500,900,231800,A2,AG/LTD,,,
4325,9-1-0-25-0,5892-54-7360,SNGL FAM SUB,2,AC,42400,0,42400,66100,2000,110500,41500,0,41500,58400,2000,101900,A1,AG/GEN,,,
4326,9-1-0-23-0,5892-64-1116,SNGL FAM SUB,3,AC,45600,0,45600,0,0,45600,44700,0,44700,0,0,44700,A1,AG/GEN,,,
4327,29-3-0-3-0,6749-72-4403,SNGL FAM SUB,2.35,AC,67400,0,67400,72600,10400,150400,63300,0,63300,60600,8700,132600,A1,AG/GEN,,,
4328,29-18-0-2-0,6749-82-1421,SNGL FAM SUB,3,AC,73600,0,73600,193400,0,267000,68700,0,68700,159300,0,228000,A1,AG/GEN,,,
4330,29-1-0-35-0,6748-54-0585,SNGL FAM SUB,3.5,AC,78300,0,78300,185100,100,263500,73400,0,73400,152300,100,225800,A1,AG/GEN,,,
4331,30-1-0-112-0,6759-64-6335,SNGL FAM SUB,10.37,AC,135100,0,135100,0,0,135100,124100,0,124100,0,0,124100,A1,AG/GEN,,,
4332,5-1-0-37-0,6823-07-4974,SNGL FAM SUB,2.84,AC,49100,0,49100,210100,1000,260200,48200,0,48200,182700,1000,231900,A1,AG/GEN,,,
4334,27-1-0-35-0,6728-24-6732,AG 20-100 AC,25,AC,127500,0,127500,0,0,127500,125000,0,125000,0,0,125000,A1,AG/GEN,,,
4335,29-3-0-10-0,6749-62-8496,SNGL FAM SUB,2.125,AC,65200,0,65200,161900,0,227100,61000,0,61000,134200,0,195200,A1,AG/GEN,,,
4336,29-3-0-10-A,6749-52-9389,SNGL FAM SUB,3.016,AC,71100,0,71100,81400,0,152500,66900,0,66900,66800,0,133700,A1,AG/GEN,,,
4337,9-1-0-21-0,5892-63-3922,SNGL FAM SUB,1.849,AC,41900,0,41900,51800,100,93800,41000,0,41000,45300,100,86400,A1,AG/GEN,,,
4338,6-1-0-18-B,6823-72-5862,SNGL FAM SUB,5,AC,98700,13800,84900,92600,11000,202300,156800,62600,94200,78100,11000,245900,A1,AG/GEN,,,
4339,30-1-0-60-0,6759-52-3974,SNGL FAM SUB,5.1,AC,88600,0,88600,1000,0,89600,83900,0,83900,1000,0,84900,A2,AG/LTD,,,
4340,30-1-0-61-0,6759-52-1432,SNGL FAM SUB,2.31,AC,61600,0,61600,0,0,61600,57200,0,57200,0,0,57200,A2,AG/LTD,,,
4341,30-9-0-2-0,6759-43-7150,SNGL FAM SUB,1.43,AC,58300,0,58300,169400,0,227700,54400,0,54400,143800,0,198200,A2,AG/LTD,,,
4342,30-1-0-9-0,6759-43-3640,AG 20-100 AC,20.47,AC,163800,0,163800,0,0,163800,160900,0,160900,0,0,160900,A1A2,AG GEN/,,,
4343,30-1-0-14-0,6759-42-4331,SNGL FAM SUB,2.32,AC,67100,0,67100,127300,1000,195400,63600,0,63600,105100,1000,169700,A2,AG/LTD,,,
4344,30-1-0-60-D,6759-52-0701,SNGL FAM SUB,1.08,AC,54800,0,54800,0,0,54800,50700,0,50700,0,0,50700,A2,AG/LTD,,,
4345,5-1-0-43-A,6823-08-7263,SNGL FAM SUB,2.834,AC,49100,0,49100,104300,2300,155700,48200,0,48200,90500,2300,141000,A1,AG/GEN,,,
4346,62-24-0-6-0,7704-97-6203,SNGL FAM SUB,3.44,AC,217800,0,217800,543900,0,761700,198000,0,198000,472700,0,670700,R1,RES/LTD,,,
4347,3-1-0-13-A,5892-76-8903,SNGL FAM SUB,10,AC,71800,0,71800,0,0,71800,69500,0,69500,0,0,69500,A1,AG/GEN,,,
4348,51-11-0-A-0,6736-40-0837,SNGL FAM SUB,3.78,AC,50500,0,50500,105800,500,156800,49500,0,49500,90700,500,140700,A1,AG/GEN,,,
4349,51-11-0-C-0,6736-40-0652,SNGL FAM SUB,1,AC,34900,0,34900,0,0,34900,34200,0,34200,0,0,34200,A1,AG/GEN,,,
4350,21-1-0-56-C,6850-83-7309,SNGL FAM SUB,1.14,AC,55700,0,55700,83800,100,139600,51400,0,51400,69900,100,121400,A2,AG/LTD,,,
4351,29-1-0-57-0,6749-51-4594,SNGL FAM SUB,2.16,AC,65600,0,65600,146700,1500,213800,60800,0,60800,121100,0,181900,A1,AG/GEN,,,
4352,29-1-0-57-A,6749-51-7509,SNGL FAM SUB,2.45,AC,68400,0,68400,182600,0,251000,63500,0,63500,153400,0,216900,A1,AG/GEN,,,
4353,30-9-0-1-0,6759-43-8258,SNGL FAM SUB,1.9,AC,63500,0,63500,0,24300,87800,59700,0,59700,0,24300,84000,A2,AG/LTD,,,
4354,9-6-0-1-0,5891-88-2773,SNGL FAM SUB,2,AC,42400,0,42400,113400,1200,157000,41500,0,41500,99800,1500,142800,A1,AG/GEN,,,
4356,30-1-0-10-A,6759-53-0319,SNGL FAM SUB,1.95,AC,63500,0,63500,231000,3500,298000,59800,0,59800,193900,3500,257200,A2,AG/LTD,,,
4357,29-18-0-1-0,6749-82-5434,SNGL FAM SUB,4.63,AC,96500,0,96500,399500,25200,521200,91500,0,91500,340000,21900,453400,A1,AG/GEN,,,
4358,5-3-0-13-0,6823-19-4328,SNGL FAM SUB,3.21,AC,56600,0,56600,263400,0,320000,55400,0,55400,224700,0,280100,A1,AG/GEN,,,
4360,33-4-0-22-0,6798-42-2810,SNGL FAM SUB,6.15,AC,132900,0,132900,399000,18700,550600,118600,0,118600,324300,16400,459300,A2,AG/LTD,,,
4361,44-1-0-49-0,6787-43-5530,SNGL FAM SUB,3,AC,101700,0,101700,279400,1500,382600,90800,0,90800,226900,1500,319200,A2,AG/LTD,,,
4362,43-1-0-5-B,6767-58-4076,SNGL FAM SUB,1,AC,70100,0,70100,78300,0,148400,62600,0,62600,64500,0,127100,A2,AG/LTD,,,
4363,45-9-0-A-0,6798-00-8465,SNGL FAM SUB,3.935,AC,110600,0,110600,200300,54900,365800,98700,0,98700,164700,49800,313200,A2,AG/LTD,,,
4364,45-9-0-B-0,6798-11-0112,SNGL FAM SUB,3.511,AC,103200,0,103200,0,0,103200,92200,0,92200,0,0,92200,A2,AG/LTD,,,
4365,31-1-0-35-0,6768-77-9911,SNGL FAM SUB,3.3,AC,88900,0,88900,0,0,88900,82700,0,82700,0,0,82700,A2,AG/LTD,,,
4366,31-1-0-35-A,6768-77-8624,SNGL FAM SUB,4.39,AC,97400,0,97400,264500,0,361900,88700,0,88700,222400,0,311100,A2,AG/LTD,,,
4367,21-1-0-57-0,6850-82-9595,SNGL FAM SUB,6.189,AC,113600,0,113600,0,0,113600,98700,0,98700,0,0,98700,A2,AG/LTD,,,
4368,21-6-0-2-0,6850-92-6382,SNGL FAM SUB,1.69,AC,62600,0,62600,195400,3100,261100,57100,0,57100,162700,3100,222900,A2,AG/LTD,,,
4369,21-6-0-3-0,6850-92-7173,SNGL FAM SUB,2.313,AC,70200,0,70200,154400,1000,225600,63600,0,63600,126800,1000,191400,A2,AG/LTD,,,
4370,64-1-0-78-B,7734-42-8784,COMM & IND,1.07,AC,261600,0,261600,136600,5800,404000,242200,0,242200,133200,4900,380300,B1,BUS/GEN,,,
4371,13-6-0-4-0,6841-72-4386,AG 20-100 AC,22.45,AC,174700,0,174700,140700,12400,327800,171400,0,171400,126000,10900,308300,A1,AG/GEN,,,
4373,20-4-0-4-0,6841-81-7108,SNGL FAM SUB,0.4,AC,3300,0,3300,0,0,3300,3200,0,3200,0,0,3200,A1,AG/GEN,,,
4374,45-1-0-131-0,6797-39-5175,SNGL FAM SUB,2.17,AC,86200,0,86200,184600,25300,296100,77000,0,77000,151500,22200,250700,A2,AG/LTD,,,
4375,67-3-E-13-0,7723-64-1062,Cmn Area/Open Spc,0,AC,0,0,0,0,0,0,0,0,0,0,0,0,R1,RES/LTD,,,
4376,54-1-0-5-0,6776-21-2809,COMM & IND,3.77,AC,170900,0,170900,271600,1500,444000,158300,0,158300,264500,1500,424300,A2,AG/LTD,,,
4377,17-1-0-47-0,6810-27-9941,SNGL FAM SUB,3,AC,50000,48500,1500,0,5700,55700,49000,47700,1300,0,5700,54700,A1,AG/GEN,,,
4378,31-1-0-51-0,6769-87-2066,SNGL FAM SUB,0.75,AC,45800,0,45800,184100,1800,231700,41300,0,41300,152600,1800,195700,A2,AG/LTD,,,
4379,64-11-0-B-0,7724-51-3893,SNGL FAM SUB,4,AC,193000,0,193000,45500,4000,242500,167800,0,167800,39800,4000,211600,R1,RES/LTD,,,
4380,44-16-0-14-C,6787-49-5030,SNGL FAM SUB,3.01,AC,129000,0,129000,220500,10400,359900,115000,0,115000,200100,10000,325100,A2,AG/LTD,,,
4381,21-1-0-25-0,6759-28-4078,COMM & IND,1.672,AC,98500,0,98500,61000,100,159600,95600,0,95600,68100,100,163800,B1,BUS/GEN,,,
4385,42-1-0-73-A,6758-90-2681,SNGL FAM SUB,1.96,AC,65900,0,65900,161300,0,227200,61400,0,61400,136000,0,197400,A2,AG/LTD,,,
4386,42-4-0-1-0,6767-12-3473,COMM & IND,0.95,AC,64600,0,64600,0,1000,65600,62200,0,62200,0,1000,63200,B1A2,BS AND,,,
4388,42-4-0-4-0,6767-22-0019,SNGL FAM SUB,3.48,AC,98000,0,98000,262700,0,360700,87300,0,87300,220300,0,307600,A2,AG/LTD,,,
4389,42-4-0-5-0,6767-22-0305,SNGL FAM SUB,3.47,AC,97900,0,97900,287100,3000,388000,87200,0,87200,244000,3000,334200,A2,AG/LTD,,,
4390,31-9-0-3-0,6768-78-0063,SNGL FAM SUB,2.671,AC,81400,0,81400,0,0,81400,79100,0,79100,9700,0,88800,A2,AG/LTD,,,
4391,64-15-C-1-0,7733-27-5406,SNGL FAM SUB,0,AC,265000,0,265000,1222500,63200,1550700,220000,0,220000,997100,56900,1274000,R1,RES/LTD,,,
4392,64-15-C-2-0,7733-27-5340,SNGL FAM SUB,0,AC,265000,0,265000,663300,500,928800,220000,0,220000,575000,500,795500,R1,RES/LTD,,,
4393,62-4-D-13-0,7714-04-9963,SNGL FAM SUB,0,AC,115000,0,115000,338600,300,453900,100000,0,100000,306200,300,406500,R1,RES/LTD,,,
4394,9-1-0-74-0,5892-94-2637,AG 20-100 AC,28.081,AC,107000,93800,13200,0,0,107000,105700,93700,12000,0,0,105700,A1,AG/GEN,,,
4395,42-1-0-60-B,6757-66-7564,SNGL FAM SUB,5.62,AC,116300,0,116300,498700,3000,618000,101000,0,101000,424200,3000,528200,A2,AG/LTD,,,
4396,42-1-0-60-E,6757-76-6973,SNGL FAM SUB,11.58,AC,163600,158300,5300,0,0,163600,148100,143200,4900,0,0,148100,A2,AG/LTD,,,
4397,30-2-0-3-A,6758-35-3630,SNGL FAM SUB,2.008,AC,64100,0,64100,0,0,64100,60400,0,60400,0,0,60400,A2,AG/LTD,,,
4398,42-1-0-60-0,6757-67-1671,AG 20-100 AC,53.86,AC,613600,588800,24800,0,0,613600,560100,537200,22900,0,0,560100,A2,AG/LTD,,,
4400,42-1-0-62-0,6757-87-3328,COMM & IND,24.83,AC,425100,0,425100,0,338500,763600,409200,0,409200,0,310600,719800,A2,AG/LTD,,,
4404,42-1-0-43-0,6767-02-1403,COMM & IND,12.08,AC,395000,0,395000,0,189500,584500,379300,0,379300,0,171800,551100,RMH,RES/MH,,,
4405,21-1-0-10-0,6850-54-6589,SNGL FAM SUB,8.6,AC,114700,0,114700,204100,2500,321300,101600,0,101600,174500,2500,278600,A1A2,AG GEN/,,,
4406,21-1-0-11-A,6850-54-8810,SNGL FAM SUB,11.4,AC,133700,0,133700,188700,0,322400,120600,0,120600,158900,0,279500,A1A2,AG GEN/,,,
4407,42-14-0-A-0,6767-02-9446,General Gov,0.12,AC,63600,0,63600,270100,0,333700,61200,0,61200,262900,0,324100,B1,BUS/GEN,,,
4408,51-1-0-33-0,6736-32-6487,SNGL FAM SUB,7.04,AC,53200,0,53200,0,0,53200,52200,0,52200,0,0,52200,A1,AG/GEN,,,
4409,51-3-0-A-0,6736-41-8514,SNGL FAM SUB,1.317,AC,36700,0,36700,240000,1900,278600,35900,0,35900,207800,2000,245700,A1,AG/GEN,,,
4410,51-3-0-C-0,6736-41-6126,SNGL FAM SUB,1.317,AC,36700,0,36700,191900,0,228600,35900,0,35900,162300,0,198200,A1,AG/GEN,,,
4411,42-1-0-60-A,6757-67-2038,AG 20-100 AC,21.89,AC,264300,193700,70600,355100,19100,638500,212800,143600,69200,296000,17600,526400,A2,AG/LTD,,,
4412,42-1-0-60-D,6757-75-9854,AG 20-100 AC,40.39,AC,385000,298800,86200,288100,10600,683700,347800,270800,77000,242900,8800,599500,A2,AG/LTD,,,
4413,38-1-0-29-0,6707-76-0640,SNGL FAM SUB,0.65,AC,25200,0,25200,10700,0,35900,24700,0,24700,9200,0,33900,A1,AG/GEN,,,
4414,28-7-0-C-0,6729-94-5746,SNGL FAM SUB,1.08,AC,47600,0,47600,112700,500,160800,45300,0,45300,94000,500,139800,A1,AG/GEN,,,
4415,7-1-0-2-0,6843-12-5663,SNGL FAM SUB,1.036,AC,34600,0,34600,0,0,34600,33400,0,33400,0,0,33400,A1,AG/GEN,,,
4416,29-3-0-29-A,6749-33-6345,SNGL FAM SUB,1.55,AC,52000,0,52000,110800,400,163200,49000,0,49000,91700,400,141100,A1,AG/GEN,,,
4417,27-5-0-2-A,6728-67-7469,SNGL FAM SUB,1.036,AC,39000,0,39000,95300,300,134600,38200,0,38200,81400,300,119900,A1,AG/GEN,,,
4418,29-3-0-25-0,6749-43-7592,SNGL FAM SUB,4.68,AC,78300,0,78300,0,0,78300,73400,0,73400,0,0,73400,A1,AG/GEN,,,
4419,29-1-0-12-0,6749-04-9882,AG 20-100 AC,20.68,AC,153300,143800,9500,0,0,153300,149900,141100,8800,0,0,149900,A1,AG/GEN,,,
4420,29-3-0-29-0,6749-33-7687,SNGL FAM SUB,5.02,AC,81000,0,81000,106800,500,188300,76100,0,76100,88200,500,164800,A1,AG/GEN,,,
4421,57-2-0-12-0,7716-16-5947,SNGL FAM SUB,1.04,AC,99900,0,99900,203800,7500,311200,89200,0,89200,169800,7500,266500,A2,AG/LTD,,,
4422,29-3-0-26-0,6749-43-5569,SNGL FAM SUB,3.88,AC,71900,0,71900,114000,0,185900,67200,0,67200,89800,0,157000,A1,AG/GEN,,,
4423,21-1-0-50-0,6850-63-7919,SNGL FAM SUB,2.24,AC,69300,0,69300,129800,5000,204100,62800,0,62800,107200,5000,175000,A2,AG/LTD,,,
4424,21-1-0-51-0,6850-64-8204,SNGL FAM SUB,1.9,AC,65200,0,65200,0,0,65200,59300,0,59300,0,0,59300,A2,AG/LTD,,,
4425,21-1-0-49-0,6850-63-9672,SNGL FAM SUB,2.39,AC,71100,0,71100,197000,11500,279600,64400,0,64400,163000,11000,238400,A2,AG/LTD,,,
4426,28-1-0-77-B,6739-26-6710,SNGL FAM SUB,2,AC,54200,0,54200,122700,800,177700,52100,0,52100,102100,800,155000,A1,AG/GEN,,,
4427,29-5-0-1-A,6749-73-2734,SNGL FAM SUB,2.05,AC,63400,0,63400,187600,1000,252000,60300,0,60300,155200,1000,216500,A1,AG/GEN,,,
4429,29-3-0-8-0,6749-61-3939,SNGL FAM SUB,7.34,AC,111500,0,111500,0,0,111500,109500,0,109500,0,0,109500,A1,AG/GEN,,,
4430,1-1-0-27-0,6804-92-5654,AG 20-100 AC,76.77,AC,207400,141700,65700,270700,112300,590400,205000,144200,60800,268000,91400,564400,A1,AG/GEN,,,
4433,39-1-0-16-0,6717-96-8193,AG 20-100 AC,66.5,AC,229800,199100,30700,0,0,229800,223400,195100,28300,0,0,223400,A1,AG/GEN,,,
4434,39-1-0-24-0,6717-94-1349,AG 20-100 AC,24.25,AC,155000,143800,11200,0,0,155000,151900,141600,10300,0,0,151900,A1,AG/GEN,,,
4435,44-9-0-1-0,6786-38-4715,SNGL FAM SUB,5,AC,117000,0,117000,118300,2000,237300,104400,0,104400,95800,2000,202200,A2,AG/LTD,,,
4437,44-9-0-2-A,6786-38-5289,SNGL FAM SUB,1.472,AC,77200,0,77200,216700,23000,316900,69000,0,69000,182300,19400,270700,A2,AG/LTD,,,
4438,39-1-0-66-0,6726-07-4464,AG 20-100 AC,50,AC,198900,175800,23100,0,0,198900,194000,172700,21300,0,0,194000,A1,AG/GEN,,,
4439,44-16-0-6-0,6788-30-3202,SNGL FAM SUB,3.13,AC,129000,0,129000,201300,1500,331800,115000,0,115000,181100,1500,297600,A2,AG/LTD,,,
4440,44-16-0-7-0,6788-30-3092,SNGL FAM SUB,3.26,AC,129000,0,129000,231700,3600,364300,115000,0,115000,209900,3400,328300,A2,AG/LTD,,,
4441,64-12-G-5-0,7723-59-5019,SNGL FAM SUB,0,AC,77000,0,77000,166400,800,244200,67000,0,67000,145900,800,213700,R1,RES/LTD,,,
4442,26-4-0-A-1,6719-32-1223,SNGL FAM SUB,16.74,AC,126900,0,126900,0,0,126900,124600,0,124600,0,0,124600,A1,AG/GEN,,,
4443,26-4-0-A-2,6719-31-4984,SNGL FAM SUB,5,AC,63200,0,63200,0,0,63200,62000,0,62000,0,0,62000,A1,AG/GEN,,,
4444,26-4-0-A-3,6719-31-8986,SNGL FAM SUB,12.67,AC,104200,0,104200,0,0,104200,102200,0,102200,0,0,102200,A1,AG/GEN,,,
4445,30-1-0-76-B,6758-96-1553,SNGL FAM SUB,3.75,AC,87200,0,87200,255300,3000,345500,78500,0,78500,212400,3000,293900,A2,AG/LTD,,,
4446,44-19-0-13-0,6778-81-4146,SNGL FAM SUB,5.23,AC,106800,0,106800,17900,1000,125700,95300,0,95300,19700,1000,116000,A2,AG/LTD,,,
4447,57-20-D-2-0,7715-19-3387,SNGL FAM SUB,2.005,AC,315000,0,315000,429900,49800,794700,288800,0,288800,376900,56800,722500,A2,AG/LTD,,,
4448,21-3-0-3-0,6860-01-7736,SNGL FAM SUB,3.23,AC,81000,0,81000,180200,27300,288500,73100,0,73100,149600,23200,245900,A2,AG/LTD,,,
4449,28-1-0-63-B,6729-91-3698,SNGL FAM SUB,8,AC,86300,0,86300,89800,4100,180200,82900,0,82900,73100,4200,160200,A1,AG/GEN,,,
4450,55-2-0-4-0,6785-35-9258,SNGL FAM SUB,2.08,AC,100500,0,100500,164600,15300,280400,89700,0,89700,136100,13200,239000,R1,RES/LTD,,,
4451,31-1-0-25-0,6768-73-7504,Other Religious,107.12,AC,1432000,0,1432000,161100,1010600,2603700,1280600,0,1280600,167800,917300,2365700,A2,AG/LTD,,,
4452,31-1-0-25-A,6768-73-4595,Vacant Land,0.75,AC,7600,0,7600,0,0,7600,6800,0,6800,0,0,6800,A2,AG/LTD,,,
4453,68-1-0-1-B,7733-84-8906,SNGL FAM SUB,0.45,AC,3100,0,3100,0,0,3100,2700,0,2700,0,0,2700,A2,AG/LTD,,,
4454,38-1-0-50-0,6707-50-4098,SNGL FAM SUB,10,AC,65300,0,65300,0,0,65300,64000,0,64000,0,0,64000,A1,AG/GEN,,,
4455,48-1-0-2-0,7728-92-4181,SNGL FAM SUB,2.25,AC,131800,0,131800,223100,2200,357100,117700,0,117700,188300,2200,308200,A2,AG/LTD,,,
4458,46-28-0-E-0,7717-09-2304,SNGL FAM SUB,1.501,AC,103800,0,103800,232900,700,337400,92700,0,92700,196000,700,289400,A2,AG/LTD,,,
4459,21-1-0-56-B,6850-83-3878,SNGL FAM SUB,3.41,AC,83200,0,83200,311400,0,394600,75000,0,75000,274400,0,349400,A2,AG/LTD,,,
4460,21-1-0-56-E,6850-83-8231,SNGL FAM SUB,1.09,AC,55100,0,55100,231000,4800,290900,50800,0,50800,195800,4300,250900,A2,AG/LTD,,,
4461,5-1-0-42-0,6823-18-8220,SNGL FAM SUB,0.25,AC,1900,0,1900,0,0,1900,1900,0,1900,0,0,1900,A1,AG/GEN,,,
4462,29-8-0-2-0,6749-97-8453,SNGL FAM SUB,10.89,AC,140200,0,140200,0,0,140200,147800,0,147800,0,0,147800,A1,AG/GEN,,,
4463,29-10-0-F-0,6749-96-1017,SNGL FAM SUB,1.15,AC,55500,0,55500,0,0,55500,51400,0,51400,0,0,51400,A1,AG/GEN,,,
4464,29-10-0-J-0,6749-94-7333,SNGL FAM SUB,9.01,AC,111800,0,111800,0,0,111800,120200,0,120200,0,0,120200,A1,AG/GEN,,,
4465,55-1-0-20-0,6785-26-0880,SNGL FAM SUB,0.81,AC,56800,0,56800,49600,200,106600,50700,0,50700,41000,200,91900,A2,AG/LTD,,,
4466,32-12-0-1-0,6779-94-7690,SNGL FAM SUB,13.05,AC,172600,0,172600,416800,0,589400,153900,0,153900,348900,0,502800,A2,AG/LTD,,,
4467,47-1-0-68-0,7717-98-9768,SNGL FAM SUB,3.46,AC,117600,0,117600,116200,2000,235800,105000,0,105000,96900,2000,203900,RR,RES/RUR,,,
4468,38-1-0-18-0,6708-70-8530,SNGL FAM SUB,12.5,AC,97500,0,97500,0,0,97500,95500,0,95500,0,0,95500,A1,AG/GEN,,,
4469,38-1-0-15-0,6708-80-3087,SNGL FAM SUB,1,AC,38800,0,38800,78400,200,117400,38000,0,38000,67200,200,105400,A1,AG/GEN,,,
4470,47-1-0-112-A,7728-31-3320,SNGL FAM SUB,17.535,AC,363600,355500,8100,0,0,363600,324900,317400,7500,0,0,324900,A2,AG/LTD,,,
4471,47-5-0-B-0,7728-21-7619,SNGL FAM SUB,10.3,AC,257100,252400,4700,0,0,257100,229800,225400,4400,0,0,229800,A2,AG/LTD,,,
4472,48-1-0-55-B,7737-09-5798,SNGL FAM SUB,5.17,AC,216300,0,216300,156800,700,373800,193000,0,193000,132800,700,326500,A2,AG/LTD,,,
4473,44-29-0-4-0,6777-71-4457,SNGL FAM SUB,11.595,AC,210000,0,210000,178000,2000,390000,187600,0,187600,144300,2000,333900,A2,AG/LTD,,,
4474,67-11-B-2-0,7733-27-0016,SNGL FAM SUB,0,AC,265000,0,265000,636100,42300,943400,220000,0,220000,570500,38800,829300,R1,RES/LTD,,,
4475,38-1-0-74-0,6707-94-6541,SNGL FAM SUB,12.1,AC,89900,0,89900,0,0,89900,88000,0,88000,0,0,88000,A1,AG/GEN,,,
4476,38-1-0-14-0,6707-89-3864,SNGL FAM SUB,1.875,AC,43700,0,43700,78000,0,121700,42800,0,42800,67700,200,110700,A1,AG/GEN,,,
4493,55-10-0-2-0,6785-69-1759,SNGL FAM SUB,1.06,AC,71000,0,71000,68600,0,139600,63400,0,63400,56900,0,120300,A2,AG/LTD,,,
4494,10-1-0-29-A,6812-35-0493,SNGL FAM SUB,5.83,AC,61000,0,61000,0,0,61000,59700,0,59700,0,0,59700,A1,AG/GEN,,,
4495,10-1-0-35-A,6812-44-5983,SNGL FAM SUB,8.23,AC,76600,0,76600,184100,0,260700,75200,0,75200,158000,0,233200,A1,AG/GEN,,,
4496,51-7-0-B-2,6735-29-3901,SNGL FAM SUB,1.1,AC,39400,0,39400,125800,7600,172800,38600,0,38600,107400,5600,151600,A1,AG/GEN,,,
4497,17-3-0-2-A,6800-40-0053,SNGL FAM SUB,1.56,AC,41900,0,41900,90600,0,132500,41100,0,41100,74500,0,115600,A1,AG/GEN,,,
4498,28-4-0-3-0,6739-00-6380,SNGL FAM SUB,1,AC,40000,0,40000,81700,400,122100,39500,0,39500,66100,400,106000,A1,AG/GEN,,,
4499,44-19-0-16-0,6778-81-7967,SNGL FAM SUB,5.26,AC,107100,0,107100,0,0,107100,95500,0,95500,0,0,95500,A2,AG/LTD,,,
4500,48-1-0-69-0,7727-98-9471,COMM & IND,110.45,AC,3186700,0,3186700,0,0,3186700,3035300,0,3035300,0,0,3035300,M2,INDUS/G,,,
4501,48-1-0-55-0,7738-00-6204,AG 20-100 AC,21.516,AC,704900,0,704900,251800,0,956700,628700,0,628700,227500,0,856200,A2,AG/LTD,,,
4502,63-1-0-12-0,7715-30-6853,SNGL FAM SUB,2.514,AC,154900,0,154900,730300,0,885200,134800,0,134800,632600,0,767400,A2,AG/LTD,,,
4504,6-6-0-18-0,6833-91-5848,SNGL FAM SUB,3.11,AC,49000,0,49000,113100,0,162100,46200,0,46200,90100,0,136300,A1,AG/GEN,,,
4505,6-6-0-19-0,6833-92-5057,SNGL FAM SUB,3.45,AC,50500,0,50500,99100,1000,150600,47700,0,47700,97500,1000,146200,A1,AG/GEN,,,
4506,60-8-0-A-0,6784-28-5600,SNGL FAM SUB,11.23,AC,310900,0,310900,0,0,310900,277700,0,277700,0,0,277700,A2,AG/LTD,,,
4507,38-1-0-19-A,6707-89-0858,SNGL FAM SUB,2,AC,43900,0,43900,70600,100,114600,43000,0,43000,58800,100,101900,A1,AG/GEN,,,
4508,63-1-0-12-A,7715-30-7616,SNGL FAM SUB,2.421,AC,152500,0,152500,700600,0,853100,132600,0,132600,612700,0,745300,A2,AG/LTD,,,
4509,45-1-0-3-0,6798-01-3113,COMM & IND,23.308,AC,1471700,0,1471700,0,0,1471700,1363000,0,1363000,0,0,1363000,B1,BUS/GEN,,,
4510,16-1-0-69-0,6800-04-4080,SNGL FAM SUB,14,AC,86900,0,86900,0,0,86900,83500,0,83500,0,0,83500,A1,AG/GEN,,,
4511,16-1-0-68-0,6800-04-6682,SNGL FAM SUB,16,AC,99500,0,99500,0,0,99500,98000,0,98000,0,0,98000,A1,AG/GEN,,,
4512,16-1-0-69-A,6800-03-8700,SNGL FAM SUB,2,AC,43400,0,43400,8500,500,52400,42500,0,42500,8500,500,51500,A1,AG/GEN,,,
4513,4-6-0-2-0,6813-43-4165,SNGL FAM SUB,8.11,AC,65600,0,65600,175600,2000,243200,64200,0,64200,157700,2000,223900,A1,AG/GEN,,,
4514,5-1-0-18-0,6813-71-3646,AG > 100 AC,109.64,AC,430600,376100,54500,2000,61000,493600,422100,375100,47000,2000,51000,475100,A1,AG/GEN,,,
4515,10-1-0-31-0,6812-07-0386,AG > 100 AC,154.02,AC,387300,316100,71200,0,0,387300,385100,319600,65500,0,0,385100,A1,AG/GEN,,,
4516,10-1-0-32-0,6812-36-1600,SNGL FAM SUB,7.14,AC,67900,21200,46700,178200,0,246100,66600,20900,45700,158300,0,224900,A1,AG/GEN,,,
4517,21-1-0-15-0,6850-43-6103,SNGL FAM SUB,16.256,AC,155300,0,155300,15000,0,170300,143900,0,143900,15000,0,158900,A2,AG/LTD,,,
4518,18-4-0-3-E,6820-01-6675,SNGL FAM SUB,12,AC,99400,0,99400,238300,30300,368000,98500,0,98500,200300,26400,325200,A1,AG/GEN,,,
4519,63-1-0-105-0,7715-41-3485,SNGL FAM SUB,7.42,AC,281600,0,281600,424500,0,706100,245100,0,245100,353700,0,598800,A2,AG/LTD,,,
4520,4-1-0-49-A,6803-94-2658,SNGL FAM SUB,18.92,AC,76600,0,76600,0,0,76600,75200,0,75200,0,0,75200,A1,AG/GEN,,,
4521,30-1-0-104-C,6758-99-4287,SNGL FAM SUB,1.54,AC,60700,0,60700,161800,9500,232000,55500,0,55500,134200,8900,198600,A2,AG/LTD,,,
4523,38-1-0-17-0,6708-80-1164,SNGL FAM SUB,1,AC,38800,0,38800,30000,200,69000,38000,0,38000,26500,200,64700,A1,AG/GEN,,,
4524,1-4-0-2-A,6814-03-8119,SNGL FAM SUB,12.68,AC,88800,83000,5800,0,0,88800,87200,81800,5400,0,0,87200,A1,AG/GEN,,,
4525,10-1-0-30-0,6812-04-4834,AG > 100 AC,118,AC,236700,179700,57000,0,56700,293400,236000,185600,50400,0,50100,286100,A1,AG/GEN,,,
4526,58-15-0-1-A,7716-85-3697,SNGL FAM SUB,10,AC,348700,0,348700,313000,700,662400,303300,0,303300,262300,700,566300,A2,AG/LTD,,,
4528,42-1-0-32-0,6767-01-6328,SNGL FAM SUB,0.46,AC,65000,0,65000,212800,0,277800,60000,0,60000,173900,0,233900,R3,RES/GEN,,,
4529,26-1-0-15-C,6709-93-7512,SNGL FAM SUB,2.953,AC,51700,0,51700,89900,1000,142600,49700,0,49700,73700,1000,124400,A1,AG/GEN,,,
4530,5-1-0-8-0,6813-77-8177,SNGL FAM SUB,3.409,AC,52000,0,52000,88800,1000,141800,51000,0,51000,78400,1000,130400,A1,AG/GEN,,,
4531,9-4-0-6-0,5892-70-5063,SNGL FAM SUB,1.01,AC,38900,0,38900,122700,800,162400,38100,0,38100,106200,800,145100,A1,AG/GEN,,,
4532,51-7-0-B-1,6735-29-4749,SNGL FAM SUB,1,AC,38800,0,38800,172100,800,211700,38000,0,38000,147900,800,186700,A1,AG/GEN,,,
4533,5-1-0-7-A,6813-76-8962,SNGL FAM SUB,2.47,AC,47200,0,47200,135200,23500,205900,46400,0,46400,120600,19800,186800,A1,AG/GEN,,,
4534,39-1-0-46-D,6727-11-1920,SNGL FAM SUB,2.61,AC,47800,0,47800,141300,2000,191100,46900,0,46900,120100,2000,169000,A1,AG/GEN,,,
4535,39-1-0-45-A,6727-11-4954,SNGL FAM SUB,1.27,AC,40300,0,40300,70000,200,110500,39500,0,39500,57700,200,97400,A1,AG/GEN,,,
4536,41-2-0-16-0,6748-40-2828,SNGL FAM SUB,1.83,AC,62300,0,62300,246200,3000,311500,57700,0,57700,202500,3000,263200,A1,AG/GEN,,,
4537,20-1-0-57-0,6851-11-3640,SNGL FAM SUB,1,AC,49900,0,49900,0,0,49900,49000,0,49000,0,0,49000,A1,AG/GEN,,,
4538,20-1-0-58-0,6851-11-3722,SNGL FAM SUB,1.59,AC,55000,0,55000,138300,9100,202400,54000,0,54000,120900,5500,180400,A1,AG/GEN,,,
4539,27-1-0-69-0,6728-68-3604,AG 20-100 AC,49.429,AC,305500,196000,109500,385700,79300,770500,298900,193200,105700,334800,77000,710700,A1,AG/GEN,,,
4540,39-6-0-9-0,6726-18-7070,SNGL FAM SUB,1,AC,38800,0,38800,0,0,38800,38000,0,38000,0,0,38000,A1,AG/GEN,,,
4541,39-6-0-10-0,6726-18-7166,SNGL FAM SUB,1,AC,38800,0,38800,139600,0,178400,38000,0,38000,122700,0,160700,A1,AG/GEN,,,
4542,44-1-0-20-0,6777-91-7931,SNGL FAM SUB,1.186,AC,73000,0,73000,161800,31100,265900,65200,0,65200,136900,24100,226200,A2,AG/LTD,,,
4543,10-1-0-2-0,6802-77-5228,AG 20-100 AC,30,AC,167700,99600,68100,355300,12000,535000,168500,101900,66600,311300,12000,491800,A1,AG/GEN,,,
4545,56-1-0-1-B,6786-84-4877,SNGL FAM SUB,1,AC,70100,0,70100,145300,1200,216600,62600,0,62600,119000,1200,182800,A2,AG/LTD,,,
4546,62-9-0-5-0,7714-19-7914,SNGL FAM SUB,7.993,AC,378200,0,378200,841100,92300,1311600,328800,0,328800,770800,83800,1183400,A2,AG/LTD,,,
4547,38-1-0-16-0,6708-80-3427,SNGL FAM SUB,5.05,AC,61500,0,61500,4300,0,65800,60300,0,60300,4600,0,64900,A1,AG/GEN,,,
4548,46-28-0-A-0,7717-09-8161,General Gov,0.643,AC,10900,0,10900,0,0,10900,9800,0,9800,0,0,9800,A2,AG/LTD,,,
4549,46-28-0-C-0,7717-09-4176,SNGL FAM SUB,4.093,AC,161100,0,161100,156700,17200,335000,143700,0,143700,130600,14600,288900,A2,AG/LTD,,,
4550,46-28-0-D-0,7717-09-4427,SNGL FAM SUB,1.501,AC,103800,0,103800,242000,2200,348000,92700,0,92700,203400,2200,298300,A2,AG/LTD,,,
4551,28-1-0-52-A,6738-16-9337,SNGL FAM SUB,2,AC,55100,0,55100,92800,1000,148900,54200,0,54200,80100,1000,135300,A1,AG/GEN,,,
4553,2-3-0-2-0,6824-43-0656,SNGL FAM SUB,3.49,AC,49000,0,49000,0,0,49000,47900,0,47900,0,0,47900,A1,AG/GEN,,,
4554,2-3-0-3-0,6824-33-8750,SNGL FAM SUB,3.92,AC,50900,0,50900,0,0,50900,49800,0,49800,0,0,49800,A1,AG/GEN,,,
4555,10-1-0-29-C,6812-25-5334,SNGL FAM SUB,3,AC,48000,0,48000,181500,2600,232100,46000,0,46000,160900,2700,209600,A1,AG/GEN,,,
4556,56-1-0-74-0,6796-92-2319,SNGL FAM SUB,3.48,AC,138700,0,138700,257600,66000,462300,120500,0,120500,223900,57100,401500,A2,AG/LTD,,,
4557,5-1-0-2-A,6814-71-7137,SNGL FAM SUB,5,AC,60100,0,60100,133600,2000,195700,59000,0,59000,116200,2000,177200,A1,AG/GEN,,,
4558,10-1-0-34-0,6812-45-0311,SNGL FAM SUB,6.88,AC,66700,0,66700,112500,1200,180400,65500,0,65500,97900,1200,164600,A1,AG/GEN,,,
4559,10-1-0-35-0,6812-33-5961,AG 20-100 AC,76.559,AC,238500,201700,36800,0,0,238500,229700,197000,32700,0,0,229700,A1,AG/GEN,,,
4560,17-1-0-11-0,6709-49-3226,SNGL FAM SUB,5.3,AC,62900,0,62900,102200,1300,166400,61700,0,61700,88700,1300,151700,A1,AG/GEN,,,
4561,47-8-0-A-0,7717-87-9236,SNGL FAM SUB,2,AC,141900,0,141900,178300,2900,323100,126700,0,126700,153100,2300,282100,A2,AG/LTD,,,
4562,63-1-0-91-0,7714-84-6047,SNGL FAM SUB,4.371,AC,207600,0,207600,552400,102800,862800,189200,0,189200,536700,88800,814700,A2,AG/LTD,,,
4563,5-1-0-25-0,6813-91-5092,SNGL FAM SUB,6.1,AC,65700,0,65700,288000,0,353700,64500,0,64500,245200,0,309700,A1,AG/GEN,,,
4564,55-1-0-17-0,6785-16-5771,SNGL FAM SUB,1.75,AC,80500,0,80500,30700,1300,112500,71800,0,71800,26000,1300,99100,A2,AG/LTD,,,
4565,46-25-0-2-0,7708-42-4900,SNGL FAM SUB,10.2,AC,239600,0,239600,0,1000,240600,214100,0,214100,0,1000,215100,A2,AG/LTD,,,
4566,38-1-0-37-0,6707-44-9976,AG 20-100 AC,26.2,AC,143100,0,143100,0,0,143100,140100,0,140100,0,0,140100,A1,AG/GEN,,,
4567,38-1-0-28-0,6707-76-0740,SNGL FAM SUB,0.5,AC,24300,0,24300,110600,300,135200,23800,0,23800,94000,300,118100,A1,AG/GEN,,,
4568,45-15-0-6-0,6797-53-7241,SNGL FAM SUB,7.58,AC,176100,0,176100,0,0,176100,157300,0,157300,0,0,157300,A2,AG/LTD,,,
4569,38-1-0-105-A,6717-18-4022,SNGL FAM SUB,1.002,AC,38900,0,38900,62200,200,101300,38100,0,38100,53300,200,91600,A1,AG/GEN,,,
4570,5-13-0-12-0,6813-55-9453,SNGL FAM SUB,8.57,AC,63400,0,63400,303700,5500,372600,62100,0,62100,257100,5500,324700,A1,AG/GEN,,,
4572,55-14-0-6-0,6785-48-7202,SNGL FAM SUB,8.87,AC,180600,0,180600,502300,71500,754400,161400,0,161400,411400,62300,635100,A2,AG/LTD,,,
4573,12-1-0-37-0,6831-23-8118,SNGL FAM SUB,8.72,AC,94400,0,94400,464600,33400,592400,86700,0,86700,383800,31000,501500,A1,AG/GEN,,,
4574,46-4-0-2-0,7708-42-8295,AG 20-100 AC,30.2,AC,606300,500300,106000,13900,1000,621200,540900,446000,94900,11700,1000,553600,A2,AG/LTD,,,
4576,46-25-0-3-0,7708-42-4692,SNGL FAM SUB,12.24,AC,283500,277400,6100,0,0,283500,253300,248000,5300,0,0,253300,A2,AG/LTD,,,
4577,46-4-0-2-A,7708-51-1524,SNGL FAM SUB,3.01,AC,138200,0,138200,159000,2100,299300,123500,0,123500,131700,2100,257300,A2,AG/LTD,,,
4578,39-1-0-46-C,6727-11-3606,SNGL FAM SUB,3.59,AC,53300,0,53300,28800,0,82100,52200,0,52200,24000,0,76200,A1,AG/GEN,,,
4579,38-1-0-102-0,6707-98-2458,SNGL FAM SUB,5,AC,61200,0,61200,108900,4800,174900,60000,0,60000,98000,4800,162800,A1,AG/GEN,,,
4580,41-2-0-12-0,6748-31-2194,SNGL FAM SUB,2.29,AC,66800,0,66800,0,0,66800,62000,0,62000,0,0,62000,A1,AG/GEN,,,
4581,46-23-0-7-0,7707-95-7778,SNGL FAM SUB,2.057,AC,165000,0,165000,417700,0,582700,150000,0,150000,349000,0,499000,A2,AG/LTD,,,
4582,29-3-0-6-A,6749-73-8191,SNGL FAM SUB,3,AC,73600,0,73600,88300,200,162100,69700,0,69700,72900,200,142800,A1,AG/GEN,,,
4583,50-1-0-2-0,6726-06-3107,SNGL FAM SUB,1.31,AC,40700,0,40700,52100,200,93000,39900,0,39900,45200,200,85300,A1,AG/GEN,,,
4584,1-2-0-1-A,6804-64-0664,SNGL FAM SUB,1.08,AC,5500,0,5500,0,0,5500,5400,0,5400,0,0,5400,A1,AG/GEN,,,
4585,1-2-0-1-B,6804-64-2808,SNGL FAM SUB,5,AC,60100,0,60100,69000,14600,143700,59000,0,59000,61400,10100,130500,A1,AG/GEN,,,
4586,39-1-0-47-0,6727-11-4189,SNGL FAM SUB,2.67,AC,48200,0,48200,84200,600,133000,47200,0,47200,71800,600,119600,A1,AG/GEN,,,
4588,47-1-0-65-0,7717-98-4665,SNGL FAM SUB,1.082,AC,90500,0,90500,96500,1700,188700,80800,0,80800,80800,1700,163300,A2,AG/LTD,,,
4589,58-4-A-19-0,7716-56-0955,SNGL FAM SUB,0,AC,10000,0,10000,0,0,10000,9100,0,9100,0,0,9100,A2,AG/LTD,,,
4590,58-23-0-5-0,7716-96-5814,SNGL FAM SUB,3,AC,192600,0,192600,303700,200,496500,167500,0,167500,259600,200,427300,A2,AG/LTD,,,
4591,28-1-0-38-0,6728-97-3044,SNGL FAM SUB,1.04,AC,39100,0,39100,100200,200,139500,38300,0,38300,92800,200,131300,A1,AG/GEN,,,
4592,62-7-0-E-0,7705-90-4052,SNGL FAM SUB,8.01,AC,387700,0,387700,493100,0,880800,337300,0,337300,441600,0,778900,A2,AG/LTD,,,
4593,64-2-0-5-A,7733-07-0938,SNGL FAM SUB,1.432,AC,150400,0,150400,253300,10200,413900,130800,0,130800,212600,10300,353700,A2R1,AG LTD/,,,
4594,67-10-0-28-0,7733-17-2020,SNGL FAM SUB,2.2,AC,323000,0,323000,776900,46000,1145900,270800,0,270800,607500,43500,921800,R1,RES/LTD,,,
4595,21-4-0-5-0,6759-48-6480,SNGL FAM SUB,3.21,AC,80800,0,80800,132600,0,213400,72900,0,72900,107700,0,180600,A2,AG/LTD,,,
4596,29-1-0-30-0,6748-42-9617,SNGL FAM SUB,3.14,AC,74900,0,74900,387000,10400,472300,70000,0,70000,318000,8500,396500,A1,AG/GEN,,,
4597,58-3-A-21-0,7726-26-6535,SNGL FAM SUB,0,AC,88000,0,88000,226400,1700,316100,80000,0,80000,188900,1700,270600,RN,RESIDEN,,,
4598,62-18-0-22-0,7704-73-3121,SNGL FAM SUB,3.66,AC,234500,0,234500,680100,35600,950200,200300,0,200300,609000,36500,845800,A2,AG/LTD,,,
4599,32-1-0-30-0,6778-77-4437,SNGL FAM SUB,6.94,AC,213800,0,213800,0,0,213800,201800,0,201800,0,0,201800,B1A2,BS AND,,,
4600,21-1-0-15-A,6850-53-6417,SNGL FAM SUB,2,AC,66400,0,66400,126200,19600,212200,60300,0,60300,105200,16700,182200,A2,AG/LTD,,,
4601,58-4-B-3-0,7716-46-8589,SNGL FAM SUB,0,AC,10000,0,10000,0,0,10000,9100,0,9100,0,0,9100,A2,AG/LTD,,,
4602,30-1-0-101-0,6768-29-1294,AG 20-100 AC,23.03,AC,97900,87200,10700,0,0,97900,90200,80400,9800,0,0,90200,A2,AG/LTD,,,
4603,56-1-0-41-0,6795-94-6941,AG 20-100 AC,27.67,AC,772500,542100,230400,601000,37900,1411400,672200,471600,200600,588500,31900,1292600,A2,AG/LTD,,,
4604,43-17-0-C-0,6767-91-5921,SNGL FAM SUB,1.19,AC,72800,0,72800,143000,500,216300,65100,0,65100,117100,500,182700,A2,AG/LTD,,,
4605,51-1-0-3-0,6726-83-0607,AG 20-100 AC,77.2,AC,329400,255100,74300,24700,6200,360300,321500,251100,70400,21600,6200,349300,A1,AG/GEN,,,
4606,55-15-0-20-0,6785-57-9552,SNGL FAM SUB,3.07,AC,115400,0,115400,339500,2500,457400,103000,0,103000,279300,2500,384800,A2,AG/LTD,,,
4607,42-3-0-5-0,6767-04-9121,SNGL FAM SUB,0.685,AC,70000,0,70000,175700,15300,261000,65000,0,65000,145300,12800,223100,R3,RES/GEN,,,
4608,57-10-0-21-0,7705-77-1796,SNGL FAM SUB,3.45,AC,230000,0,230000,432800,23800,686600,210000,0,210000,428500,24600,663100,A2,AG/LTD,,,
4609,13-10-0-2-0,6841-85-6296,SNGL FAM SUB,3.91,AC,75100,0,75100,136500,1500,213100,73700,0,73700,119500,1500,194700,A1,AG/GEN,,,
4610,17-1-0-22-0,6709-68-2904,SNGL FAM SUB,1.47,AC,41400,0,41400,64300,100,105800,40600,0,40600,56100,100,96800,A1,AG/GEN,,,
4612,20-1-0-50-A,6840-49-5461,SNGL FAM SUB,7,AC,98800,0,98800,575700,0,674500,87100,0,87100,459100,0,546200,A1,AG/GEN,,,
4613,20-1-0-50-B,6840-59-1475,SNGL FAM SUB,3,AC,67200,0,67200,217600,28800,313600,66000,0,66000,187700,24600,278300,A1,AG/GEN,,,
4614,42-1-0-10-A,6757-35-9920,SNGL FAM SUB,0.811,AC,54700,0,54700,260200,500,315400,50600,0,50600,214300,500,265400,A2,AG/LTD,,,
4615,50-1-0-17-0,6726-51-7836,AG > 100 AC,257.77,AC,793300,670200,123100,0,1600,794900,777600,667600,110000,0,1600,779200,A1,AG/GEN,,,
4616,29-1-0-3-0,6749-26-3340,AG 20-100 AC,77.66,AC,386200,350400,35800,0,0,386200,371300,338300,33000,0,0,371300,A1,AG/GEN,,,
4617,29-1-0-78-0,6749-56-3342,AG 20-100 AC,20.412,AC,163300,153900,9400,0,0,163300,160900,152200,8700,0,0,160900,A1,AG/GEN,,,
4618,29-17-0-4-C,6749-61-2028,SNGL FAM SUB,1,AC,54000,0,54000,110600,500,165100,49900,0,49900,91300,500,141700,A1,AG/GEN,,,
4620,55-15-0-8-0,6785-66-8595,SNGL FAM SUB,2.71,AC,93200,0,93200,274300,3000,370500,83100,0,83100,225400,3000,311500,A2,AG/LTD,,,
4621,44-15-1-17-0,6776-87-7427,SNGL FAM SUB,10.87,AC,184900,0,184900,919600,29400,1133900,164700,0,164700,781300,24900,970900,A2,AG/LTD,,,
4622,20-1-0-50-0,6840-59-9475,SNGL FAM SUB,10,AC,112300,0,112300,159500,31500,303300,110200,0,110200,137000,26900,274100,A1,AG/GEN,,,
4623,12-14-0-B-0,6821-98-1740,SNGL FAM SUB,14.48,AC,92900,0,92900,0,0,92900,88000,0,88000,0,0,88000,A1,AG/GEN,,,
4624,26-9-0-E-0,6719-34-6827,SNGL FAM SUB,14.99,AC,114700,0,114700,0,0,114700,114900,0,114900,0,0,114900,A1,AG/GEN,,,
4625,13-8-0-2-0,6842-90-8730,SNGL FAM SUB,1.502,AC,54300,0,54300,216900,0,271200,53300,0,53300,203100,0,256400,A1,AG/GEN,,,
4626,50-1-0-22-0,6726-71-6217,AG 20-100 AC,71.194,AC,291900,259100,32800,0,0,291900,284800,254500,30300,0,0,284800,A1,AG/GEN,,,
4627,30-1-0-101-A,6769-20-0877,SNGL FAM SUB,5.74,AC,112000,0,112000,0,0,112000,107000,0,107000,0,0,107000,A2,AG/LTD,,,
4628,67-17-0-C-0,7733-12-5902,SNGL FAM SUB,5.02,AC,326400,0,326400,296800,0,623200,283800,0,283800,251900,0,535700,A2,AG/LTD,,,
4629,5-1-0-85-0,6823-73-1110,AG 20-100 AC,20.56,AC,157600,107700,49900,89300,13400,260300,154000,106600,47400,81400,13500,248900,A1,AG/GEN,,,
4630,57-20-C-3-0,7716-00-3577,SNGL FAM SUB,2.105,AC,315000,0,315000,298100,30500,643600,288800,0,288800,277300,27700,593800,A2,AG/LTD,,,
4631,50-5-0-26-0,6726-32-6577,SNGL FAM SUB,8.27,AC,70300,0,70300,273000,3600,346900,66900,0,66900,235500,3400,305800,A1,AG/GEN,,,
4634,67-17-0-E-0,7733-02-6981,SNGL FAM SUB,5.24,AC,334700,0,334700,1044500,54500,1433700,290900,0,290900,865700,51900,1208500,A2,AG/LTD,,,
4635,18-4-0-4-B,6820-30-5301,SNGL FAM SUB,6.03,AC,68700,0,68700,161800,400,230900,68200,0,68200,133200,400,201800,A1,AG/GEN,,,
4638,58-15-0-2-0,7716-96-2113,SNGL FAM SUB,3,AC,192600,0,192600,156900,29000,378500,167500,0,167500,133300,27500,328300,A2,AG/LTD,,,
4639,9-1-0-86-A,6801-07-9732,AG 20-100 AC,50.13,AC,102900,79800,23100,0,0,102900,97300,76000,21300,0,0,97300,A1,AG/GEN,,,
4640,9-1-0-86-B,6801-29-4222,AG > 100 AC,100.42,AC,175200,124000,51200,0,0,175200,169900,126700,43200,0,0,169900,A1,AG/GEN,,,
4641,6-1-0-6-0,6823-85-0829,SNGL FAM SUB,1.5,AC,42300,0,42300,128500,0,170800,4100,0,4100,117200,0,121300,A1,AG/GEN,,,
4642,6-1-0-57-T,6833-25-6154-9999,AG > 100 AC,350.9,AC,1890700,1425300,465400,0,0,1890700,1859600,1406700,452900,0,0,1859600,A1,AG/GEN,,,
4643,20-1-0-91-0,6759-09-1645,SNGL FAM SUB,3.6,AC,78700,0,78700,111200,3000,192900,76900,0,76900,92900,3000,172800,A1,AG/GEN,,,
4644,15-5-0-30-0,5789-79-6371,SNGL FAM SUB,8.17,AC,64600,0,64600,171300,31600,267500,63100,0,63100,148000,26200,237300,A1,AG/GEN,,,
4645,32-10-1-14-0,6778-68-2867,SNGL FAM SUB,1.92,AC,80500,0,80500,193700,23400,297600,72000,0,72000,158500,20000,250500,A2,AG/LTD,,,
4646,64-4-1-9-0,7724-93-1878,SNGL FAM SUB,0,AC,70000,0,70000,152000,500,222500,60000,0,60000,131700,500,192200,RN,RESIDEN,,,
4647,41-2-0-10-0,6748-31-4435,SNGL FAM SUB,4.96,AC,91300,0,91300,263200,600,355100,87100,0,87100,223900,600,311600,A1,AG/GEN,,,
4649,1-1-0-5-0,6815-00-3187,AG > 100 AC,101.7,AC,417500,370600,46900,0,0,417500,409300,366100,43200,0,0,409300,A1,AG/GEN,,,
4650,45-18-0-33-0,6797-54-1291,SNGL FAM SUB,4.439,AC,200000,0,200000,382100,5800,587900,180000,0,180000,349700,4900,534600,A2,AG/LTD,,,
4651,14-2-0-20-0,6851-37-1504,SNGL FAM SUB,3.4,AC,70000,0,70000,243600,0,313600,68600,0,68600,216100,0,284700,A1,AG/GEN,,,
4653,30-1-0-56-0,6759-51-1296,SNGL FAM SUB,8.87,AC,103100,0,103100,256300,3200,362600,95600,0,95600,217000,2500,315100,A2,AG/LTD,,,
4654,58-10-0-5-0,7725-04-2383,SNGL FAM SUB,15.54,AC,507500,0,507500,105000,1900,614400,441100,0,441100,90700,1900,533700,A2,AG/LTD,,,
4655,67-13-B-8-0,7733-36-5776,SNGL FAM SUB,0,AC,265000,0,265000,699400,51500,1015900,220000,0,220000,573200,52100,845300,R1,RES/LTD,,,
4656,68-1-0-1-A,7733-84-5879,SNGL FAM SUB,1.12,AC,7600,0,7600,0,0,7600,6600,0,6600,0,0,6600,A2,AG/LTD,,,
4657,57-1-0-75-C,7706-74-2509,SNGL FAM SUB,17.29,AC,637100,0,637100,623500,111400,1372000,553800,0,553800,532400,97800,1184000,A2,AG/LTD,,,
4658,18-4-0-4-0,6820-11-3111,SNGL FAM SUB,5.86,AC,67800,0,67800,85800,18700,172300,64700,0,64700,68700,15700,149100,A1,AG/GEN,,,
4659,18-4-0-4-H,6820-20-8464,SNGL FAM SUB,5.312,AC,65100,0,65100,0,0,65100,63900,0,63900,0,0,63900,A1,AG/GEN,,,
4660,57-5-0-1-0,7706-34-1518,AG 20-100 AC,49.52,AC,1284200,0,1284200,0,152200,1436400,1116700,0,1116700,0,131800,1248500,A2,AG/LTD,,,
4661,29-1-0-59-0,6749-30-9981,AG 20-100 AC,61.36,AC,433800,350700,83100,268600,9800,712200,424100,348400,75700,250800,15900,690800,A1,AG/GEN,,,
4662,57-10-0-3-0,7705-86-2263,SNGL FAM SUB,4.36,AC,230000,0,230000,537700,98800,866500,210000,0,210000,492600,87600,790200,A2,AG/LTD,,,
4663,62-9-0-2-0,7714-18-6834,SNGL FAM SUB,11.92,AC,538000,0,538000,606300,2900,1147200,467700,0,467700,558900,3000,1029600,A2,AG/LTD,,,
4830,1-1-0-24-0,6804-46-9145,AG 20-100 AC,31.319,AC,144500,122800,21700,0,0,144500,141700,121100,20600,0,0,141700,A1,AG/GEN,,,
4831,1-1-0-24-B,6804-45-7418,AG 20-100 AC,40,AC,199800,113000,86800,180800,29000,409600,196000,111600,84400,156500,26800,379300,A1,AG/GEN,,,
4832,46-23-0-40-0,7717-06-0543,SNGL FAM SUB,10.303,AC,173300,0,173300,280400,16100,469800,157500,0,157500,235600,13600,406700,A2,AG/LTD,,,
4833,46-21-A-1-0,7708-90-1117,SNGL FAM SUB,2.723,AC,134200,0,134200,234300,1400,369900,121900,0,121900,195900,1400,319200,A2,AG/LTD,,,
4834,10-1-0-28-A,6812-22-5689,SNGL FAM SUB,7.874,AC,70400,0,70400,248800,16300,335500,68900,0,68900,232000,16300,317200,A1,AG/GEN,,,
4835,32-4-0-1-0,6779-56-8330,SNGL FAM SUB,4.4,AC,106600,0,106600,160500,4400,271500,95300,0,95300,133800,4400,233500,A2,AG/LTD,,,
4836,47-1-0-21-0,7716-38-9065,SNGL FAM SUB,12.17,AC,347000,0,347000,190300,64000,601300,309600,0,309600,158500,54500,522600,A2,AG/LTD,,,
4837,58-15-0-3-0,7716-96-3562,SNGL FAM SUB,5,AC,237200,0,237200,321600,13900,572700,206300,0,206300,276300,14400,497000,A2,AG/LTD,,,
4838,63-5-0-1-0,7724-24-2131,SNGL FAM SUB,0.967,AC,131000,0,131000,169600,300,300900,113900,0,113900,147700,300,261900,A2,AG/LTD,,,
4839,57-26-0-3-0,7706-51-1615,SNGL FAM SUB,4.62,AC,254000,0,254000,88900,0,342900,220800,0,220800,78200,0,299000,A2,AG/LTD,,,
4996,48-1-0-42-A,7727-57-1003,COMM & IND,1.379,AC,175400,0,175400,38200,1700,215300,167000,0,167000,32300,1700,201000,M2,INDUS/G,,,
4997,48-1-0-17-T,7727-47-6594,SNGL FAM SUB,5.584,AC,356500,0,356500,73600,3800,433900,329800,0,329800,62500,3800,396100,A2,AG/LTD,,,
4998,29-1-0-126-0,6748-99-0085,SNGL FAM SUB,3.88,AC,78900,0,78900,171800,3700,254400,72400,0,72400,141700,0,214100,A1,AG/GEN,,,
4999,58-18-E-5-0,7715-29-7027,SNGL FAM SUB,2.418,AC,448200,0,448200,1632500,30800,2111500,410400,0,410400,1505800,27200,1943400,A2,AG/LTD,,,
5000,51-1-0-51-0,6736-41-1787,SNGL FAM SUB,3,AC,46100,0,46100,0,0,46100,45200,0,45200,0,0,45200,A1,AG/GEN,,,
5001,45-1-0-95-0,6797-88-8337,SNGL FAM SUB,0.83,AC,64000,0,64000,92100,5400,161500,57200,0,57200,78900,0,136100,A2,AG/LTD,,,
5002,45-1-0-116-B,6797-88-6448,SNGL FAM SUB,1,AC,70100,0,70100,143200,1500,214800,62600,0,62600,120200,1500,184300,A2,AG/LTD,,,
5003,58-4-C-14-0,7716-56-3663,SNGL FAM SUB,0,AC,10000,0,10000,0,0,10000,9100,0,9100,0,0,9100,A2,AG/LTD,,,
5004,43-20-0-4-0,6768-72-1111,SNGL FAM SUB,3.32,AC,96800,0,96800,446900,3000,546700,88000,0,88000,390200,2800,481000,A2,AG/LTD,,,
5005,47-26-0-3-0,7727-09-0697,SNGL FAM SUB,8.36,AC,214200,0,214200,238800,1000,454000,191500,0,191500,202100,1000,394600,A2,AG/LTD,,,
5006,62-18-0-5-0,7704-74-5040,SNGL FAM SUB,3.04,AC,220000,0,220000,309600,4100,533700,200300,0,200300,284700,4200,489200,A2,AG/LTD,,,
5007,26-1-0-37-A,6718-41-3654,SNGL FAM SUB,12.49,AC,91600,0,91600,257100,0,348700,89800,0,89800,223700,0,313500,A1,AG/GEN,,,
5008,46-22-0-B-0,7706-98-1816,SNGL FAM SUB,10.028,AC,345700,0,345700,593000,14700,953400,308500,0,308500,523900,13400,845800,A2,AG/LTD,,,
5009,14-2-0-23-0,6851-28-8603,SNGL FAM SUB,4.75,AC,78400,0,78400,80100,5600,164100,76800,0,76800,78100,5800,160700,A1,AG/GEN,,,
5010,12-1-0-50-A,6832-31-9326,SNGL FAM SUB,2.08,AC,49100,0,49100,163300,22500,234900,47600,0,47600,146500,19300,213400,A1,AG/GEN,,,
4664,67-10-0-24-0,7733-15-9952,SNGL FAM SUB,15.01,AC,612000,0,612000,1407200,180900,2200100,513000,0,513000,1205100,157800,1875900,R1,RES/LTD,,,
4665,67-10-0-24-B,7733-25-4864,SNGL FAM SUB,0.27,AC,13000,0,13000,0,0,13000,10800,0,10800,0,0,10800,R1,RES/LTD,,,
4666,47-17-0-A-5,7718-20-6180,SNGL FAM SUB,4.97,AC,166500,0,166500,202200,800,369500,148700,0,148700,169600,800,319100,A2,AG/LTD,,,
4667,15-5-0-5-0,5789-66-3856,SNGL FAM SUB,8.01,AC,67500,0,67500,401800,0,469300,66000,0,66000,355800,0,421800,A1,AG/GEN,,,
4668,24-2-0-5-A,5789-65-1124,SNGL FAM SUB,9.21,AC,23000,0,23000,0,0,23000,23000,0,23000,0,0,23000,A1,AG/GEN,,,
4669,2-1-0-29-0,6814-63-9398,SNGL FAM SUB,1.48,AC,42100,0,42100,0,0,42100,41400,0,41400,0,0,41400,A1,AG/GEN,,,
4670,2-3-0-36-0,6824-33-5042,SNGL FAM SUB,4.31,AC,52700,0,52700,0,0,52700,51600,0,51600,0,0,51600,A1,AG/GEN,,,
4671,48-2-E-1-0,7726-68-6574,SNGL FAM SUB,0,AC,130000,0,130000,471700,0,601700,117000,0,117000,449300,0,566300,R1,RES/LTD,,,
4672,58-24-0-1-0,7716-61-1875,SNGL FAM SUB,17.15,AC,546600,365100,181500,790600,18200,1355400,475800,318000,157800,570000,17700,1063500,A2,AG/LTD,,,
4673,64-1-0-49-0,7734-02-3517,COMM & IND,0.39,AC,129900,0,129900,146000,5700,281600,120200,0,120200,143600,3800,267600,B1A2,BS AND,,,
4674,42-3-0-13-0,6767-04-8924,SNGL FAM SUB,0.688,AC,70000,0,70000,202800,10900,283700,65000,0,65000,169000,8900,242900,R3,RES/GEN,,,
4675,57-1-0-34-D,7706-40-6780,SNGL FAM SUB,11.49,AC,424900,0,424900,563600,18900,1007400,369800,0,369800,469700,15400,854900,A2,AG/LTD,,,
4676,57-1-0-35-A,7705-38-7825,SNGL FAM SUB,10,AC,400600,0,400600,402500,2000,805100,348700,0,348700,338900,2000,689600,A2,AG/LTD,,,
4677,15-5-0-8-0,5789-56-5602,SNGL FAM SUB,8.01,AC,67500,0,67500,197300,8900,273700,66000,0,66000,168200,6200,240400,A1,AG/GEN,,,
4678,24-2-0-8-B,5789-55-1442,SNGL FAM SUB,10.47,AC,26200,0,26200,0,0,26200,26200,0,26200,0,0,26200,A1,AG/GEN,,,
4679,24-2-0-8-A,5789-55-4323,SNGL FAM SUB,8.01,AC,20000,0,20000,0,0,20000,20000,0,20000,0,0,20000,A1,AG/GEN,,,
4680,57-16-0-2-0,7706-15-9954,SNGL FAM SUB,5,AC,213600,0,213600,238400,37500,489500,185900,0,185900,205500,31700,423100,A2,AG/LTD,,,
4681,31-15-0-4-0,6779-46-3051,SNGL FAM SUB,4.002,AC,98300,0,98300,82400,22600,203300,87800,0,87800,67100,19500,174400,A2,AG/LTD,,,
4682,21-4-0-8-0,6759-48-2084,SNGL FAM SUB,5.04,AC,109700,0,109700,151900,3000,264600,99400,0,99400,124300,2100,225800,A2,AG/LTD,,,
4685,46-1-0-9-0,7707-18-3110,AG 20-100 AC,53.9,AC,1054200,853700,200500,134300,69800,1258300,940600,762800,177800,111400,68700,1120700,A2,AG/LTD,,,
4686,44-1-0-44-0,6787-56-8667,SNGL FAM SUB,5,AC,72100,0,72100,229200,14000,315300,64300,0,64300,187200,14000,265500,A2,AG/LTD,,,
4687,58-1-0-103-0,7726-20-9246,SNGL FAM SUB,7.7,AC,226100,0,226100,0,0,226100,213200,0,213200,0,0,213200,A2,AG/LTD,,,
4689,44-1-0-42-A,6787-57-5684,AG > 100 AC,116.49,AC,126600,0,126600,369500,15000,511100,112000,0,112000,302500,15000,429500,A2,AG/LTD,,,
4693,44-16-0-15-0,6787-48-2295,SNGL FAM SUB,6.777,AC,148400,0,148400,638900,0,787300,132300,0,132300,574100,0,706400,A2,AG/LTD,,,
4695,45-1-0-27-A,6787-97-4825,SNGL FAM SUB,1.77,AC,82300,0,82300,155500,2000,239800,73500,0,73500,130400,2000,205900,A2,AG/LTD,,,
4696,46-43-0-1-0,7707-91-4324,SNGL FAM SUB,5.787,AC,223000,0,223000,0,0,223000,199400,0,199400,0,0,199400,A2,AG/LTD,,,
4697,57-1-0-7-0,7706-44-7725,AG 20-100 AC,29.77,AC,777900,0,777900,0,0,777900,675600,0,675600,0,0,675600,A2,AG/LTD,,,
4698,57-1-0-8-0,7706-55-4253,SNGL FAM SUB,12.2,AC,368000,0,368000,0,0,368000,320500,0,320500,0,0,320500,A2,AG/LTD,,,
4700,57-1-0-51-0,7715-18-2068,SNGL FAM SUB,13.689,AC,490300,0,490300,1426900,128000,2045200,426500,0,426500,1183800,115500,1725800,A2,AG/LTD,,,
4701,57-1-0-52-0,7715-08-0692,SNGL FAM SUB,5.026,AC,275000,0,275000,154500,11000,440500,239100,0,239100,131200,11000,381300,A2,AG/LTD,,,
4702,57-11-0-2-0,7715-18-5080,SNGL FAM SUB,4.931,AC,258700,0,258700,334500,9700,602900,225000,0,225000,285600,9900,520500,A2,AG/LTD,,,
4703,19-1-0-16-A,6820-81-3230,SNGL FAM SUB,16.28,AC,44600,0,44600,0,0,44600,40200,0,40200,0,0,40200,A1,AG/GEN,,,
4704,19-1-0-19-0,6820-90-3786,AG 20-100 AC,28.39,AC,170200,0,170200,333900,0,504100,148500,0,148500,285500,0,434000,A1,AG/GEN,,,
4705,58-3-A-4-0,7726-16-1712,SNGL FAM SUB,0,AC,88000,0,88000,148800,700,237500,80000,0,80000,124000,700,204700,RN,RESIDEN,,,
4707,5-14-0-1-0,6823-69-7823,SNGL FAM SUB,7.871,AC,71000,0,71000,117100,5600,193700,69700,0,69700,95700,6000,171400,A1,AG/GEN,,,
4708,39-1-0-49-B,6717-82-8105,SNGL FAM SUB,15.56,AC,120300,0,120300,150200,44800,315300,118100,0,118100,127000,38800,283900,A1,AG/GEN,,,
4709,57-10-0-33-0,7705-67-0381,SNGL FAM SUB,3.71,AC,230000,0,230000,0,0,230000,210000,0,210000,0,0,210000,A2,AG/LTD,,,
4710,30-1-0-71-0,6759-80-6401,SNGL FAM SUB,2.03,AC,66800,0,66800,172600,1500,240900,60600,0,60600,142600,1600,204800,A2,AG/LTD,,,
4711,67-10-0-19-0,7733-05-9464,SNGL FAM SUB,2.09,AC,340000,0,340000,1177800,0,1517800,285000,0,285000,766200,0,1051200,R1,RES/LTD,,,
4712,43-15-0-10-0,6768-81-9253,SNGL FAM SUB,3.18,AC,92000,0,92000,261400,0,353400,83600,0,83600,228600,0,312200,A2,AG/LTD,,,
4713,32-1-0-26-0,6778-68-7082,SNGL FAM SUB,0.51,AC,49000,0,49000,156600,2500,208100,43800,0,43800,128900,2500,175200,A2,AG/LTD,,,
4714,32-5-0-C-0,6778-87-2320,SNGL FAM SUB,3,AC,92900,0,92900,172000,24200,289100,83000,0,83000,141900,20100,245000,A2,AG/LTD,,,
4715,48-1-0-19-0,7727-46-2246,SNGL FAM SUB,1.3,AC,109100,0,109100,126500,7600,243200,97400,0,97400,105300,7600,210300,A2,AG/LTD,,,
4716,67-2-A-5-0,7723-56-7345,SNGL FAM SUB,0,AC,184000,0,184000,338600,1200,523800,160000,0,160000,284300,1200,445500,R1,RES/LTD,,,
4717,12-16-0-3-0,6822-90-3481,SNGL FAM SUB,10,AC,91700,0,91700,0,0,91700,90800,0,90800,0,0,90800,A1,AG/GEN,,,
4718,14-2-0-11-A,6851-26-4778,SNGL FAM SUB,4.03,AC,75700,0,75700,174300,800,250800,74100,0,74100,148300,800,223200,A1,AG/GEN,,,
4719,4-1-0-20-0,6802-47-9471,AG 20-100 AC,43.148,AC,88500,67900,20600,0,0,88500,86300,67900,18400,0,0,86300,A1,AG/GEN,,,
4720,10-1-0-7-0,6802-55-6011,AG > 100 AC,173.406,AC,572500,421900,150600,864500,7700,1444700,563600,441100,122500,798900,7700,1370200,A1,AG/GEN,,,
4721,18-1-0-49-0,6810-97-1600,AG 20-100 AC,26.88,AC,200000,107900,92100,692400,36500,928900,200400,113700,86700,579900,28200,808500,A1,AG/GEN,,,
4724,63-1-0-3-0,7715-21-3685,SNGL FAM SUB,3,AC,166300,0,166300,365200,1600,533100,144700,0,144700,310600,1600,456900,A2,AG/LTD,,,
4725,31-11-0-2-0,6779-40-1454,SNGL FAM SUB,6.27,AC,124200,0,124200,316300,0,440500,111000,0,111000,255800,0,366800,A2,AG/LTD,,,
4726,31-1-0-26-C,6768-94-2624,SNGL FAM SUB,1,AC,64100,0,64100,66100,0,130200,57200,0,57200,53000,0,110200,A2,AG/LTD,,,
4727,42-1-0-69-0,6757-89-8980,General Gov,6.256,AC,91400,0,91400,0,0,91400,83600,0,83600,0,0,83600,A2,AG/LTD,,,
4728,43-1-0-5-D,6767-58-6966,SNGL FAM SUB,3,AC,86900,0,86900,64300,4000,155200,77600,0,77600,53500,4000,135100,A2,AG/LTD,,,
4729,31-1-0-26-A,6768-94-1469,SNGL FAM SUB,1,AC,64100,0,64100,108900,0,173000,57200,0,57200,92000,0,149200,A2,AG/LTD,,,
4730,30-1-0-84-A,6758-93-7184,SNGL FAM SUB,1,AC,54000,0,54000,173900,28200,256100,49900,0,49900,147800,24300,222000,A2,AG/LTD,,,
4731,30-1-0-83-0,6758-93-1239,SNGL FAM SUB,7,AC,102200,98600,3600,0,0,102200,93800,90800,3000,0,0,93800,A2,AG/LTD,,,
4732,30-1-0-82-0,6758-83-4804,AG 20-100 AC,50,AC,347200,324100,23100,0,0,347200,310000,288700,21300,0,0,310000,A2,AG/LTD,,,
4733,28-1-0-77-A,6739-26-6390,SNGL FAM SUB,1.01,AC,47100,0,47100,135400,0,182500,44800,0,44800,112200,0,157000,A1,AG/GEN,,,
4734,1-1-0-17-A,6814-09-4169,SNGL FAM SUB,3.12,AC,50500,0,50500,156200,1800,208500,49600,0,49600,101600,500,151700,A1,AG/GEN,,,
4735,30-1-0-84-0,6758-93-6239,SNGL FAM SUB,2.4,AC,71200,0,71200,198500,8300,278000,64500,0,64500,172700,6900,244100,A2,AG/LTD,,,
4736,30-1-0-34-0,6758-25-8395,SNGL FAM SUB,1.01,AC,54100,0,54100,111000,1000,166100,50000,0,50000,92300,1000,143300,A2,AG/LTD,,,
4738,58-22-A-2-0,7715-36-5942,SNGL FAM SUB,2.763,AC,383300,0,383300,839300,0,1222600,351800,0,351800,772500,0,1124300,A2,AG/LTD,,,
4739,30-1-0-116-0,6759-54-7842,SNGL FAM SUB,2.615,AC,67800,0,67800,70700,0,138500,61700,0,61700,58500,0,120200,A2,AG/LTD,,,
4740,10-1-0-11-A,6801-34-6731,SNGL FAM SUB,5.25,AC,58400,55700,2700,0,0,58400,57100,54800,2300,0,0,57100,A1,AG/GEN,,,
4741,10-2-0-1-0,6801-45-6893,AG 20-100 AC,27.74,AC,119900,68500,51400,43300,700,163900,118200,68800,49400,39000,700,157900,A1,AG/GEN,,,
4746,58-21-C-3-0,7716-22-3986,SNGL FAM SUB,1.565,AC,310000,0,310000,261100,800,571900,285000,0,285000,231800,800,517600,R3,RES/GEN,,,
4747,64-15-A-1-0,7733-37-1634,SNGL FAM SUB,0,AC,265000,0,265000,702300,15300,982600,220000,0,220000,559300,14900,794200,R1,RES/LTD,,,
4748,20-11-0-1-0,6841-90-2712,SNGL FAM SUB,7.67,AC,98700,0,98700,0,0,98700,96900,0,96900,0,0,96900,A1,AG/GEN,,,
4749,4-1-0-66-0,6813-22-9380,SNGL FAM SUB,10.18,AC,86500,0,86500,135200,4000,225700,84900,0,84900,118200,4000,207100,A1,AG/GEN,,,
4750,5-3-0-6-0,6823-29-1416,SNGL FAM SUB,3.34,AC,57300,0,57300,131800,1800,190900,56100,0,56100,110600,2500,169200,A1,AG/GEN,,,
4751,43-20-0-6-0,6768-62-5321,SNGL FAM SUB,3.59,AC,96800,0,96800,176900,2400,276100,88000,0,88000,153800,2300,244100,A2,AG/LTD,,,
4752,43-20-0-7-0,6768-62-2385,SNGL FAM SUB,3.39,AC,96800,0,96800,137400,2500,236700,88000,0,88000,120700,2500,211200,A2,AG/LTD,,,
4753,9-1-0-77-F,5892-86-6747,SNGL FAM SUB,2,AC,42400,0,42400,95200,300,137900,41500,0,41500,82900,300,124700,A1,AG/GEN,,,
4754,18-4-0-3-0,6820-00-0760,AG 20-100 AC,22.82,AC,137200,0,137200,308900,63800,509900,147100,0,147100,234100,75000,456200,A1,AG/GEN,,,
4755,55-1-0-36-D,6785-57-5792,SNGL FAM SUB,2.62,AC,96800,0,96800,192800,5200,294800,86400,0,86400,156900,5000,248300,A2,AG/LTD,,,
4756,55-1-0-36-C,6785-57-5982,SNGL FAM SUB,2.18,AC,89600,0,89600,262700,18900,371200,79900,0,79900,213800,17600,311300,A2,AG/LTD,,,
4757,44-1-0-44-A,6787-65-0731,AG 20-100 AC,23.64,AC,10900,0,10900,0,0,10900,10000,0,10000,0,0,10000,A2,AG/LTD,,,
4758,44-1-0-44-B,6787-76-6135,SNGL FAM SUB,9.31,AC,4300,0,4300,0,0,4300,4000,0,4000,0,0,4000,A2,AG/LTD,,,
4759,44-1-0-75-0,6787-60-5681,AG > 100 AC,145.18,AC,73200,0,73200,0,42600,115800,62400,0,62400,0,42600,105000,A2,AG/LTD,,,
4760,45-1-0-26-0,6787-87-5882,SNGL FAM SUB,17.683,AC,8200,0,8200,0,0,8200,7500,0,7500,0,0,7500,A2,AG/LTD,,,
4761,45-1-0-28-0,6787-86-6822,AG 20-100 AC,59.919,AC,30100,0,30100,0,0,30100,25700,0,25700,0,0,25700,A2,AG/LTD,,,
4762,45-1-0-30-0,6787-85-6401,AG 20-100 AC,50.19,AC,92800,0,92800,226500,41500,360800,83500,0,83500,182200,36400,302100,A2,AG/LTD,,,
4770,45-1-0-54-0,6797-16-1040,AG > 100 AC,144.05,AC,142600,0,142600,119500,100,262200,129300,0,129300,99300,100,228700,A2,AG/LTD,,,
4772,44-1-0-43-0,6787-66-9955,AG 20-100 AC,57.53,AC,237400,0,237400,821800,285200,1344400,211200,0,211200,666600,250000,1127800,A2,AG/LTD,,,
4773,12-2-0-2-0,6821-84-3719,AG 20-100 AC,39.25,AC,219500,0,219500,95800,3000,318300,219300,0,219300,79600,3000,301900,A1,AG/GEN,,,
4774,29-1-0-71-0,6749-64-8150,SNGL FAM SUB,2,AC,57000,0,57000,106800,500,164300,53500,0,53500,88100,500,142100,A1,AG/GEN,,,
4775,56-1-0-53-0,6796-36-1500,SNGL FAM SUB,3.25,AC,119800,0,119800,131700,1500,253000,106900,0,106900,109200,1500,217600,A2,AG/LTD,,,
4776,62-13-A-2-0,7714-05-2510,SNGL FAM SUB,0,AC,115000,0,115000,251000,0,366000,100000,0,100000,230100,0,330100,R1,RES/LTD,,,
4777,55-15-0-12-0,6785-77-4307,SNGL FAM SUB,3.02,AC,114600,0,114600,211300,8000,333900,102300,0,102300,174100,8000,284400,A2,AG/LTD,,,
4778,64-1-0-79-0,7733-58-3728,SNGL FAM SUB,1.84,AC,207500,0,207500,809700,53700,1070900,180400,0,180400,667900,6000,854300,R1,RES/LTD,,,
4779,58-21-B-1-0,7716-33-1961,SNGL FAM SUB,1.398,AC,310000,0,310000,438800,11000,759800,285000,0,285000,395600,9500,690100,A2,AG/LTD,,,
4780,32-11-0-6-0,6778-97-1996,SNGL FAM SUB,5.25,AC,125300,0,125300,0,0,125300,112000,0,112000,0,0,112000,A2,AG/LTD,,,
4781,67-2-D-25-0,7723-56-8098,SNGL FAM SUB,0,AC,184000,0,184000,319000,2700,505700,160000,0,160000,266400,2800,429200,R1,RES/LTD,,,
4782,39-1-0-43-0,6727-12-0773,SNGL FAM SUB,3,AC,50000,0,50000,205800,1200,257000,49000,0,49000,174700,1200,224900,A1,AG/GEN,,,
4783,39-1-0-44-0,6727-12-1410,SNGL FAM SUB,3.372,AC,52100,0,52100,0,900,53000,51000,0,51000,0,900,51900,A1,AG/GEN,,,
4784,29-16-0-F-0,6749-66-2392,SNGL FAM SUB,5.27,AC,93900,0,93900,0,0,93900,90000,0,90000,0,0,90000,A1,AG/GEN,,,
4785,18-4-0-3-D,6820-00-8988,SNGL FAM SUB,6,AC,68500,0,68500,132300,1600,202400,65500,0,65500,111800,1600,178900,A1,AG/GEN,,,
4786,64-12-A-4-0,7724-50-8794,SNGL FAM SUB,0,AC,77000,0,77000,174700,1500,253200,67000,0,67000,158400,1500,226900,R1,RES/LTD,,,
4787,30-1-0-8-0,6759-54-0095,SNGL FAM SUB,8.5,AC,137200,0,137200,82300,0,219500,127900,0,127900,69700,0,197600,A2,AG/LTD,,,
4788,13-8-0-1-0,6842-90-9805,SNGL FAM SUB,1.515,AC,54400,0,54400,192900,0,247300,53400,0,53400,172500,0,225900,A1,AG/GEN,,,
4789,39-1-0-80-0,6726-37-4588,AG 20-100 AC,20,AC,135700,0,135700,244300,3900,383900,133000,0,133000,207400,3700,344100,A1,AG/GEN,,,
4790,43-1-0-26-0,6767-53-6232,SNGL FAM SUB,1,AC,64100,0,64100,0,0,64100,57200,0,57200,0,0,57200,A2,AG/LTD,,,
4791,31-1-0-26-0,6768-84-9700,SNGL FAM SUB,2,AC,77900,0,77900,0,0,77900,69500,0,69500,0,0,69500,A2,AG/LTD,,,
4792,30-1-0-90-A,6768-21-4854,SNGL FAM SUB,1.5,AC,14700,0,14700,0,0,14700,12500,0,12500,0,0,12500,A2,AG/LTD,,,
4793,43-1-0-27-0,6767-53-5018,SNGL FAM SUB,1,AC,64100,0,64100,111800,1600,177500,57200,0,57200,92600,1600,151400,A2,AG/LTD,,,
4794,30-1-0-85-0,6758-92-4994,SNGL FAM SUB,6,AC,111700,0,111700,68100,3300,183100,101900,0,101900,57100,3300,162300,A2,AG/LTD,,,
4796,32-1-0-14-0,6779-63-6541,SNGL FAM SUB,3.84,AC,94800,0,94800,0,0,94800,84500,0,84500,0,0,84500,A2,AG/LTD,,,
4797,42-1-0-75-0,6758-91-1497,General Gov,8.338,AC,155800,0,155800,0,0,155800,150100,0,150100,0,0,150100,A2,AG/LTD,,,
4798,30-1-0-58-B,6759-51-0953,SNGL FAM SUB,4.69,AC,88900,0,88900,81300,0,170200,84600,0,84600,67800,0,152400,A2,AG/LTD,,,
4799,29-1-0-127-0,6748-98-4327,SNGL FAM SUB,6,AC,95400,0,95400,0,0,95400,91400,0,91400,0,0,91400,A1,AG/GEN,,,
4800,43-1-0-5-A,6767-58-6129,SNGL FAM SUB,2,AC,84500,0,84500,97800,1500,183800,75500,0,75500,80200,1500,157200,A2,AG/LTD,,,
4802,29-1-0-132-0,6748-97-7128,SNGL FAM SUB,2,AC,49500,0,49500,0,0,49500,45200,0,45200,0,0,45200,A1,AG/GEN,,,
4803,30-1-0-90-0,6768-21-5939,AG 20-100 AC,30.4,AC,205800,191300,14500,0,0,205800,197900,184900,13000,0,0,197900,A2,AG/LTD,,,
4804,44-16-0-9-0,6787-39-5638,SNGL FAM SUB,3.32,AC,135500,0,135500,352700,69300,557500,120800,0,120800,309500,41600,471900,A2,AG/LTD,,,
4805,50-5-0-31-0,6726-33-2954,SNGL FAM SUB,8.19,AC,75500,0,75500,487100,0,562600,72900,0,72900,369700,0,442600,A1,AG/GEN,,,
4806,12-10-0-A-0,6831-44-5008,SNGL FAM SUB,10.091,AC,115300,0,115300,225500,5700,346500,106500,0,106500,194300,6000,306800,A1,AG/GEN,,,
4807,58-22-A-11-0,7715-37-1437,SNGL FAM SUB,3.736,AC,346800,0,346800,490700,0,837500,318300,0,318300,460700,0,779000,A2,AG/LTD,,,
4808,6-1-0-19-A,6823-71-5533,COMM & IND,1.82,AC,85900,0,85900,244700,51100,381700,83400,0,83400,247600,37700,368700,B1,BUS/GEN,,,
4809,5-1-0-54-A,6822-18-0333,AG 20-100 AC,60.24,AC,240400,0,240400,273700,0,514100,235800,0,235800,237400,0,473200,A1,AG/GEN,,,
4810,5-1-0-54-B,6822-07-8876,SNGL FAM SUB,3,AC,49900,0,49900,309700,21400,381000,49000,0,49000,273000,21400,343400,A1,AG/GEN,,,
4811,55-1-0-50-0,6785-49-9235,SNGL FAM SUB,13.39,AC,257200,180800,76400,187200,60500,504900,229900,162000,67900,156800,60500,447200,A2,AG/LTD,,,
4812,30-1-0-23-0,6759-40-3566,SNGL FAM SUB,2.4,AC,67900,0,67900,90800,1200,159900,64500,0,64500,75700,1200,141400,A2,AG/LTD,,,
4813,39-6-0-2-0,6726-17-4007,SNGL FAM SUB,1,AC,38800,0,38800,83600,6000,128400,38000,0,38000,71100,6000,115100,A1,AG/GEN,,,
4814,42-20-0-C-1,6767-14-4723,SNGL FAM SUB,2.25,AC,83400,0,83400,332600,14500,430500,75300,0,75300,276500,14500,366300,A2,AG/LTD,,,
4815,15-5-0-24-0,5789-68-7574,SNGL FAM SUB,14.03,AC,76700,0,76700,135700,15800,228200,77100,0,77100,116800,15800,209700,A1,AG/GEN,,,
4816,4-6-0-7-0,6813-44-8251,SNGL FAM SUB,8.25,AC,66100,0,66100,0,0,66100,64700,0,64700,0,0,64700,A1,AG/GEN,,,
4817,31-1-0-20-0,6768-46-6568,AG 20-100 AC,33.98,AC,455300,305900,149400,741200,7700,1204200,410800,287000,123800,625000,7200,1043000,A2,AG/LTD,,,
4818,38-3-0-9-0,6717-26-7479,AG 20-100 AC,24,AC,136800,125700,11100,0,0,136800,133900,123700,10200,0,0,133900,A1,AG/GEN,,,
4819,55-2-0-2-0,6785-45-0638,SNGL FAM SUB,1.26,AC,87000,0,87000,402300,0,489300,77600,0,77600,336300,0,413900,R1,RES/LTD,,,
4820,31-2-0-1-0,6768-48-3941,AG > 100 AC,107.063,AC,888500,839100,49400,0,0,888500,836400,790300,46100,0,0,836400,A2,AG/LTD,,,
4821,31-1-0-19-0,6768-46-0763,SNGL FAM SUB,11.24,AC,191900,0,191900,0,0,191900,178000,0,178000,0,0,178000,RP,"RURAL,P",,,
4822,31-1-0-19-B,6768-36-7425,SNGL FAM SUB,5.66,AC,126000,0,126000,0,0,126000,111000,0,111000,0,0,111000,RP,"RURAL,P",,,
4823,32-10-2-11-0,6779-61-6132,SNGL FAM SUB,8.78,AC,151300,0,151300,278900,18700,448900,134800,0,134800,234800,16600,386200,A2,AG/LTD,,,
4824,6-1-0-8-0,6823-93-5796,SNGL FAM SUB,13.69,AC,84100,0,84100,0,0,84100,82600,0,82600,0,0,82600,A1,AG/GEN,,,
4825,6-1-0-8-A,6823-94-7060,SNGL FAM SUB,1.52,AC,3400,0,3400,0,0,3400,3400,0,3400,0,0,3400,A1,AG/GEN,,,
4826,4-4-0-A-0,6803-59-6289,SNGL FAM SUB,0.42,AC,1800,0,1800,0,0,1800,1800,0,1800,0,0,1800,A1,AG/GEN,,,
4827,4-4-0-4-0,6803-69-6971,SNGL FAM SUB,13.72,AC,98800,0,98800,194500,2500,295800,97000,0,97000,169100,2500,268600,A1,AG/GEN,,,
4828,29-1-0-37-B,6748-53-5770,SNGL FAM SUB,15.21,AC,180000,172500,7500,0,0,180000,174900,168400,6500,0,0,174900,A1,AG/GEN,,,
4829,31-19-0-2-0,6779-30-9677,SNGL FAM SUB,2.43,AC,84700,0,84700,250900,37900,373500,75600,0,75600,205200,32100,312900,A2,AG/LTD,,,
4840,57-26-0-1-0,7706-61-2703,SNGL FAM SUB,8.52,AC,309600,0,309600,0,0,309600,269400,0,269400,0,0,269400,A2,AG/LTD,,,
4841,57-26-0-5-0,7706-50-7940,SNGL FAM SUB,11.729,AC,431200,0,431200,756100,1800,1189100,375300,0,375300,677500,1600,1054400,A2,AG/LTD,,,
4842,57-17-0-1-0,7706-24-1300,SNGL FAM SUB,4.6,AC,203100,0,203100,345900,39500,588500,176700,0,176700,292400,33000,502100,A2,AG/LTD,,,
4843,46-1-0-73-D,7707-62-3779,MultiFamily,3,AC,144600,0,144600,432700,1600,578900,129200,0,129200,377500,1600,508300,A2RR,AG& RUR,,,
4844,11-1-0-50-0,6822-52-8020,AG > 100 AC,148.224,AC,442500,374200,68300,0,0,442500,488100,417500,70600,0,0,488100,A1,AG/GEN,,,
4846,42-1-0-18-0,6757-71-3153,AG > 100 AC,100.042,AC,912700,706100,206600,675200,74500,1662400,822200,638500,183700,561200,66500,1449900,A2,AG/LTD,,,
4847,57-1-0-81-0,7706-42-0433,AG 20-100 AC,40.39,AC,1134600,913900,220700,767500,0,1902100,987000,795500,191500,681900,0,1668900,A2,AG/LTD,,,
4848,42-1-0-39-0,6767-02-7375,COMM & IND,0.13,AC,52200,0,52200,150400,0,202600,50200,0,50200,136900,0,187100,B1,BUS/GEN,,,
4849,21-4-0-7-0,6759-48-3446,SNGL FAM SUB,3.24,AC,81200,0,81200,168900,1500,251600,73200,0,73200,145300,1500,220000,A2,AG/LTD,,,
4850,57-10-0-23-0,7705-76-2827,SNGL FAM SUB,4.52,AC,230000,0,230000,501600,1600,733200,210000,0,210000,461100,1700,672800,A2,AG/LTD,,,
4851,21-1-0-64-0,6759-57-8340,AG > 100 AC,125.13,AC,1337300,0,1337300,279600,48500,1665400,1183300,0,1183300,238000,44700,1466000,R1,RES/LTD,,,
4852,51-1-0-38-0,6736-12-0071,SNGL FAM SUB,19,AC,134600,0,134600,9200,8500,152300,132100,0,132100,8900,8500,149500,A1,AG/GEN,,,
4853,51-1-0-38-A,6736-01-5976,SNGL FAM SUB,3,AC,50000,0,50000,0,0,50000,49000,0,49000,0,0,49000,A1,AG/GEN,,,
4854,46-1-0-94-0,7717-09-2676,SNGL FAM SUB,1.044,AC,93100,0,93100,144200,31500,268800,83200,0,83200,119800,25500,228500,A2,AG/LTD,,,
4855,6-1-0-62-0,6832-79-5338,AG > 100 AC,103.92,AC,894300,726200,168100,953100,16500,1863900,888900,733400,155500,959800,15500,1864200,A1,AG/GEN,,,
4856,6-6-0-1-0,6833-70-8900,SNGL FAM SUB,3.04,AC,59500,0,59500,390800,6000,456300,58300,0,58300,382600,4200,445100,A1,AG/GEN,,,
4857,6-6-0-2-0,6833-80-0923,SNGL FAM SUB,3.06,AC,59700,0,59700,490100,0,549800,58500,0,58500,438800,0,497300,A1,AG/GEN,,,
4858,6-6-0-3-0,6833-80-2859,SNGL FAM SUB,3.01,AC,59300,0,59300,364900,62300,486500,58100,0,58100,332400,51500,442000,A1,AG/GEN,,,
4859,47-21-0-4-0,7726-19-0645,COMM & IND,1.09,AC,307200,0,307200,187800,5200,500200,279300,0,279300,179000,4100,462400,B1,BUS/GEN,,,
4861,45-18-0-34-0,6797-54-3636,SNGL FAM SUB,5.25,AC,200000,0,200000,295500,0,495500,180000,0,180000,270300,0,450300,A2,AG/LTD,,,
4862,21-1-0-31-0,6759-37-2597,SNGL FAM SUB,2.26,AC,69500,0,69500,137400,500,207400,63000,0,63000,119000,500,182500,A1,AG/GEN,,,
4863,54-5-0-13-0,6766-62-0944,SNGL FAM SUB,7.004,AC,283300,0,283300,404200,0,687500,262800,0,262800,368400,0,631200,A2,AG/LTD,,,
4864,42-1-0-53-0,6767-05-3424,SNGL FAM SUB,0,AC,70000,0,70000,184200,0,254200,65000,0,65000,148800,0,213800,R3,RES/GEN,,,
4865,42-6-0-3-0,6767-03-9248,COMM & IND,0.282,AC,69000,0,69000,330800,0,399800,66300,0,66300,307900,0,374200,B1,BUS/GEN,,,
4866,42-6-0-3-A,6767-03-8391,COMM & IND,0.06,AC,9000,0,9000,0,0,9000,8700,0,8700,0,0,8700,B1,BUS/GEN,,,
4867,55-18-0-9-0,6786-06-1550,SNGL FAM SUB,5,AC,125300,0,125300,426900,13000,565200,111800,0,111800,356100,13000,480900,A2,AG/LTD,,,
4868,51-1-0-38-B,6736-01-6540,SNGL FAM SUB,9,AC,83600,0,83600,0,0,83600,82000,0,82000,0,0,82000,A1,AG/GEN,,,
4869,64-1-0-30-0,7723-58-7550,SNGL FAM SUB,10.51,AC,477600,0,477600,0,0,477600,415100,0,415100,0,0,415100,R1,RES/LTD,,,
4870,12-10-0-C-0,6831-53-2787,SNGL FAM SUB,10.185,AC,115800,0,115800,163800,15500,295100,107200,0,107200,139300,15500,262000,A1,AG/GEN,,,
4871,44-16-0-4-0,6788-20-9761,SNGL FAM SUB,1.65,AC,116100,0,116100,240300,1400,357800,103500,0,103500,218400,1400,323300,A2,AG/LTD,,,
4872,55-18-0-8-0,6786-06-3206,SNGL FAM SUB,5,AC,125300,0,125300,1076900,3100,1205300,111800,0,111800,871100,3400,986300,A2,AG/LTD,,,
4873,30-12-0-4-0,6758-99-9258,COMM & IND,1.26,AC,110400,0,110400,169000,0,279400,107100,0,107100,162800,0,269900,M1,INDUS/L,,,
4874,5-13-0-20-0,6813-64-4857,SNGL FAM SUB,8.388,AC,61100,0,61100,235400,48900,345400,59900,0,59900,210400,43200,313500,A1,AG/GEN,,,
4875,20-5-0-F-0,6840-17-0069,SNGL FAM SUB,3,AC,73200,0,73200,144400,11200,228800,66500,0,66500,124100,10400,201000,A1,AG/GEN,,,
4877,50-5-0-15-0,6726-30-6465,SNGL FAM SUB,8.39,AC,70900,0,70900,0,0,70900,67500,0,67500,0,0,67500,A1,AG/GEN,,,
4878,4-1-0-1-0,6804-41-7204,AG 20-100 AC,60.739,AC,289400,221300,68100,244400,12500,546300,287000,220600,66400,213100,12500,512600,A1,AG/GEN,,,
4879,1-1-0-26-0,6804-72-5286,AG > 100 AC,146,AC,328500,261200,67300,0,0,328500,328500,266400,62100,0,0,328500,A1,AG/GEN,,,
4880,47-1-0-78-0,7716-88-0351,COMM & IND,19.429,AC,6763000,0,6763000,0,15000,6778000,6148300,0,6148300,0,15100,6163400,B1,BUS/GEN,,,
4881,41-2-0-17-0,6748-40-4731,SNGL FAM SUB,1.56,AC,59600,0,59600,160100,1800,221500,55200,0,55200,137700,1800,194700,A1,AG/GEN,,,
4882,21-3-0-3-A,6860-01-5603,SNGL FAM SUB,3.134,AC,79900,0,79900,118300,31300,229500,72100,0,72100,98000,27300,197400,A2,AG/LTD,,,
4883,29-3-0-19-0,6749-63-3535,SNGL FAM SUB,1.957,AC,55600,0,55600,34800,600,91000,52200,0,52200,30200,600,83000,A1,AG/GEN,,,
4884,32-5-0-B-0,6778-86-0972,SNGL FAM SUB,3,AC,92900,0,92900,144800,17100,254800,83000,0,83000,120500,11900,215400,A2,AG/LTD,,,
4885,44-16-0-22-0,6787-29-7773,SNGL FAM SUB,4.73,AC,129000,0,129000,240400,47800,417200,115000,0,115000,218300,41700,375000,A2,AG/LTD,,,
4886,58-2-0-5-0,7726-26-9407,SNGL FAM SUB,0.43,AC,88000,0,88000,170500,200,258700,80000,0,80000,142900,200,223100,RN,RESIDEN,,,
4887,43-1-0-77-0,6777-03-4083,SNGL FAM SUB,10,AC,149800,145200,4600,0,0,149800,133400,129100,4300,0,0,133400,A2,AG/LTD,,,
4888,43-1-0-82-0,6777-02-0109,AG 20-100 AC,23.83,AC,316700,305700,11000,0,0,316700,281800,271700,10100,0,0,281800,A2,AG/LTD,,,
4890,17-9-0-1-0,6810-04-8382,SNGL FAM SUB,2.18,AC,47100,0,47100,203900,5500,256500,44500,0,44500,168400,5500,218400,A1,AG/GEN,,,
4891,16-4-0-22-0,5890-46-1586,SNGL FAM SUB,3.67,AC,48400,0,48400,10000,1400,59800,47300,0,47300,9800,1200,58300,A1,AG/GEN,,,
4892,17-1-0-3-0,6801-50-9671,SNGL FAM SUB,3.13,AC,48600,0,48600,14100,900,63600,47600,0,47600,14000,900,62500,A1,AG/GEN,,,
4893,17-1-0-4-0,6801-50-7249,SNGL FAM SUB,0.77,AC,29900,0,29900,57500,8300,95700,29300,0,29300,51100,7100,87500,A1,AG/GEN,,,
4894,17-1-0-2-0,6801-50-5698,SNGL FAM SUB,1.42,AC,40700,0,40700,136100,19100,195900,39900,0,39900,118100,19100,177100,A1,AG/GEN,,,
4895,17-1-0-6-0,6801-50-1637,SNGL FAM SUB,5.55,AC,57800,0,57800,0,0,57800,56200,0,56200,0,0,56200,A1,AG/GEN,,,
4896,17-8-0-1-0,6801-50-1974,SNGL FAM SUB,5,AC,57200,0,57200,0,0,57200,54000,0,54000,0,0,54000,A1,AG/GEN,,,
4897,9-1-0-27-A,5892-44-8743,SNGL FAM SUB,1.51,AC,40600,0,40600,78700,300,119600,39800,0,39800,68600,300,108700,A1,AG/GEN,,,
4898,48-6-0-2-0,7738-12-2280,SNGL FAM SUB,1.436,AC,107600,0,107600,135900,1000,244500,99600,0,99600,116500,1000,217100,A2,AG/LTD,,,
4899,19-1-0-23-0,6739-09-3132,AG > 100 AC,130.46,AC,475900,409400,66500,0,0,475900,469700,413600,56100,0,0,469700,A1,AG/GEN,,,
4900,19-5-0-8-A,6830-10-5509,SNGL FAM SUB,0.34,AC,2600,0,2600,0,0,2600,2100,0,2100,0,0,2100,A1,AG/GEN,,,
4901,19-1-0-24-0,6739-17-2185,AG 20-100 AC,20.05,AC,176400,166600,9800,0,0,176400,168000,159400,8600,0,0,168000,A1,AG/GEN,,,
4902,19-1-0-24-A,6739-07-9502,SNGL FAM SUB,13.28,AC,134700,127900,6800,0,0,134700,126000,120300,5700,0,0,126000,A1,AG/GEN,,,
4903,19-1-0-28-0,6739-28-4965,SNGL FAM SUB,8.14,AC,101100,43500,57600,97400,40400,238900,94200,41200,53000,76700,34000,204900,A1,AG/GEN,,,
4904,19-1-0-29-0,6830-20-2696,AG 20-100 AC,38.265,AC,256500,183500,73000,87000,4000,347500,251700,185800,65900,72600,4000,328300,A1,AG/GEN,,,
4905,19-1-0-68-0,6830-30-9879,AG 20-100 AC,51.87,AC,286400,194500,91900,591000,33200,910600,276100,191900,84200,493700,30200,800000,A1,AG/GEN,,,
4906,19-5-0-1-0,6739-19-8413,SNGL FAM SUB,1.469,AC,57600,0,57600,0,0,57600,54300,0,54300,0,0,54300,A1,AG/GEN,,,
4907,19-5-0-6-0,6830-10-6058,SNGL FAM SUB,1.188,AC,55400,0,55400,129200,4800,189400,51700,0,51700,107100,4800,163600,A1,AG/GEN,,,
4908,19-6-0-A-0,6739-28-3217,SNGL FAM SUB,8.89,AC,105100,47100,58000,8700,0,113800,98800,45500,53300,8300,0,107100,A1,AG/GEN,,,
4909,29-1-0-1-0,6749-06-4798,AG 20-100 AC,52.363,AC,277300,253200,24100,0,0,277300,298500,276200,22300,0,0,298500,A1,AG/GEN,,,
4910,29-1-0-10-0,6749-15-4428,AG 20-100 AC,25.73,AC,149600,137700,11900,0,0,149600,149200,138300,10900,0,0,149200,A1,AG/GEN,,,
4911,48-1-0-13-AT,7727-69-2401-9999,COMM & IND,7.25,AC,1127700,0,1127700,1701200,316500,3145400,1074200,0,1074200,1565800,234000,2874000,M2,INDUS/G,,,
4912,48-1-0-13-B,7727-69-2845,COMM & IND,1.75,AC,222700,0,222700,0,0,222700,212200,0,212200,0,0,212200,M2,INDUS/G,,,
4913,48-1-0-13-C,7727-59-8024,COMM & IND,6.325,AC,983800,0,983800,91800,1600,1077200,937200,0,937200,84500,1200,1022900,M2,INDUS/G,,,
4914,19-1-0-69-0,6739-47-2484,AG > 100 AC,125.54,AC,458000,394000,64000,0,153300,611300,451900,397900,54000,0,145100,597000,A1,AG/GEN,,,
4915,28-1-0-79-0,6739-45-4823,AG 20-100 AC,33.8,AC,159200,142000,17200,0,0,159200,158900,144400,14500,0,0,158900,A1,AG/GEN,,,
4916,28-1-0-80-0,6739-44-1887,AG 20-100 AC,44.25,AC,300800,231700,69100,145600,28600,475000,291200,227900,63300,122400,28600,442200,A1,AG/GEN,,,
4917,28-1-0-121-0,6739-85-3546,AG > 100 AC,112.5,AC,391500,334100,57400,0,0,391500,376400,328000,48400,0,0,376400,A1,AG/GEN,,,
4918,55-14-0-12-0,6785-19-9441,SNGL FAM SUB,14.3,AC,252300,0,252300,667500,15100,934900,211300,0,211300,568600,62900,842800,A2,AG/LTD,,,
4919,55-14-0-13-0,6785-29-6831,AG 20-100 AC,26.989,AC,402600,0,402600,874400,78300,1355300,430200,0,430200,711700,21300,1163200,A2,AG/LTD,,,
4920,58-21-D-5-0,7716-31-5990,SNGL FAM SUB,7.324,AC,398400,0,398400,851200,0,1249600,364800,0,364800,774800,0,1139600,R3,RES/GEN,,,
4922,58-21-A-3-0,7716-53-3233,SNGL FAM SUB,4.096,AC,365000,0,365000,639200,0,1004200,335000,0,335000,591600,0,926600,A2,AG/LTD,,,
4923,17-1-0-39-A,6801-61-5516,SNGL FAM SUB,2.773,AC,47000,0,47000,190000,0,237000,46000,0,46000,166000,0,212000,A1,AG/GEN,,,
4924,46-1-0-73-A,7707-62-5095,SNGL FAM SUB,2.48,AC,132700,0,132700,251700,600,385000,118600,0,118600,217400,600,336600,RR,RES/RUR,,,
4925,22-1-0-10-0,6769-88-5116,AG 20-100 AC,23.737,AC,290000,0,290000,380500,106700,777200,268800,0,268800,320400,95900,685100,A2,AG/LTD,,,
4926,67-2-D-7-0,7723-55-8133,SNGL FAM SUB,0,AC,184000,0,184000,336000,5500,525500,160000,0,160000,283400,5200,448600,R1,RES/LTD,,,
4927,58-2-0-9-0,7726-36-0192,SNGL FAM SUB,0,AC,88000,0,88000,0,0,88000,80000,0,80000,0,0,80000,RN,RESIDEN,,,
4928,43-20-0-19-0,6768-31-7295,SNGL FAM SUB,5.73,AC,110000,0,110000,230100,900,341000,100000,0,100000,204700,900,305600,A2,AG/LTD,,,
4929,46-13-0-5-0,7717-06-9779,SNGL FAM SUB,1.18,AC,95500,0,95500,213600,22900,332000,85200,0,85200,178900,19500,283600,A2,AG/LTD,,,
4930,33-4-0-33-0,6798-52-4405,SNGL FAM SUB,3.29,AC,108300,0,108300,260200,1500,370000,96700,0,96700,211800,1500,310000,A2,AG/LTD,,,
4931,9-4-0-5-0,5892-70-5227,SNGL FAM SUB,1.01,AC,38900,0,38900,92200,1900,133000,38100,0,38100,80400,2000,120500,A1,AG/GEN,,,
4932,57-17-0-7-0,7706-14-6456,SNGL FAM SUB,3.01,AC,161300,0,161300,241800,1000,404100,140300,0,140300,205800,1000,347100,A2,AG/LTD,,,
4933,26-1-0-35-T,6708-93-0455,SNGL FAM SUB,2.57,AC,47600,43500,4100,0,12300,59900,46600,42600,4000,0,10400,57000,A1,AG/GEN,,,
4934,26-1-0-35-Q,6708-93-0270,SNGL FAM SUB,3,AC,50000,43500,6500,0,1600,51600,49000,42600,6400,0,1600,50600,A1,AG/GEN,,,
4935,12-11-0-3-0,6832-00-9653,SNGL FAM SUB,10.05,AC,112200,0,112200,261100,21100,394400,110100,0,110100,229100,18700,357900,A1,AG/GEN,,,
4936,32-1-0-69-0,6788-47-4813,AG > 100 AC,151.41,AC,1025900,956100,69800,0,0,1025900,913300,849000,64300,0,0,913300,A2,AG/LTD,,,
4937,20-1-0-75-0,6850-16-5436,SNGL FAM SUB,13.3,AC,120200,0,120200,119100,3500,242800,116300,0,116300,97900,3500,217700,A1,AG/GEN,,,
4938,48-3-H-4-0,7726-57-1317,COMM & IND,2.702,AC,2033600,0,2033600,0,0,2033600,241200,0,241200,0,0,241200,BN,BUS/NHD,,,
4942,10-1-0-5-0,6802-64-8256,SNGL FAM SUB,10,AC,48500,43900,4600,0,0,48500,45000,40700,4300,0,0,45000,A1,AG/GEN,,,
4944,43-1-0-55-0,6767-89-7112,SNGL FAM SUB,4.6,AC,121900,0,121900,18200,2900,143000,109000,0,109000,20200,2700,131900,A2,AG/LTD,,,
4945,55-1-0-11-0,6776-93-0640,SNGL FAM SUB,2.018,AC,85500,0,85500,190200,8600,284300,76300,0,76300,154300,7800,238400,A2,AG/LTD,,,
4946,55-2-0-1-0,6785-45-0910,SNGL FAM SUB,1.353,AC,75900,0,75900,114000,2500,192400,67800,0,67800,96500,2500,166800,R1,RES/LTD,,,
4947,55-17-0-5-0,6785-46-1726,SNGL FAM SUB,3.45,AC,151800,0,151800,450200,0,602000,135500,0,135500,372400,0,507900,A2,AG/LTD,,,
4948,42-1-0-58-0,6757-86-9405,AG 20-100 AC,25.945,AC,908100,0,908100,0,0,908100,1013700,0,1013700,154900,26600,1195200,R3,RES/GEN,,,
4951,30-1-0-79-0,6758-52-4956,SNGL FAM SUB,5.994,AC,130000,0,130000,506100,0,636100,112500,0,112500,467700,0,580200,A2,AG/LTD,,,
4952,42-1-0-61-0,6757-78-6090,SNGL FAM SUB,2.94,AC,91600,90200,1400,0,0,91600,78400,77100,1300,0,0,78400,A2,AG/LTD,,,
4953,42-11-0-3-T,6758-70-7265-9999,Public Schools,104.35,AC,2671600,0,2671600,47256900,1200800,51129300,2575900,0,2575900,42210300,835000,45621200,A2,AG/LTD,,,
4954,39-1-0-69-0,6726-16-5752,SNGL FAM SUB,2.38,AC,47200,0,47200,64000,600,111800,46300,0,46300,55400,600,102300,A1,AG/GEN,,,
4956,38-1-0-113-0,6717-39-0202,SNGL FAM SUB,11.5,AC,92400,0,92400,68000,0,160400,90500,0,90500,58200,0,148700,A1,AG/GEN,,,
4957,22-1-0-10-A,6769-87-5851,SNGL FAM SUB,3.04,AC,85800,0,85800,265600,1500,352900,79600,0,79600,227900,1500,309000,A2,AG/LTD,,,
4958,40-1-0-17-0,6726-89-0528,AG 20-100 AC,30.73,AC,165800,107800,58000,58300,0,224100,161900,106200,55700,50000,0,211900,A1,AG/GEN,,,
4960,9-1-0-89-0,6801-26-2148,SNGL FAM SUB,11.62,AC,72200,0,72200,283200,7300,362700,69900,0,69900,253100,6100,329100,A1,AG/GEN,,,
4961,17-1-0-52-0,6810-18-1281,AG 20-100 AC,20,AC,102600,0,102600,33600,900,137100,101200,0,101200,29100,900,131200,A1,AG/GEN,,,
4962,2-1-0-25-0,6814-72-4886,SNGL FAM SUB,0.61,AC,3400,0,3400,0,0,3400,3400,0,3400,0,0,3400,A1,AG/GEN,,,
4963,29-1-0-117-A,6748-99-5445,SNGL FAM SUB,2.189,AC,64700,0,64700,12800,0,77500,59200,0,59200,11400,0,70600,A1,AG/GEN,,,
4964,28-1-0-23-0,6738-08-3000,SNGL FAM SUB,2.18,AC,48800,0,48800,109000,2300,160100,46800,0,46800,85500,2300,134600,A1,AG/GEN,,,
4965,46-1-0-2-B,7708-00-7865,SNGL FAM SUB,5,AC,162800,0,162800,320400,20200,503400,145300,0,145300,264000,17100,426400,A2,AG/LTD,,,
4966,28-7-0-A-1,6729-94-4661,SNGL FAM SUB,1,AC,47000,0,47000,156300,8300,211600,44700,0,44700,114900,6500,166100,A1,AG/GEN,,,
4967,28-1-0-22-A,6728-98-9004,SNGL FAM SUB,3.18,AC,52100,0,52100,147200,800,200100,51100,0,51100,126600,800,178500,A1,AG/GEN,,,
4968,29-14-0-4-0,6749-41-9528,SNGL FAM SUB,2.957,AC,73200,0,73200,268700,0,341900,68300,0,68300,225800,0,294100,A1,AG/GEN,,,
4969,28-1-0-32-A,6738-17-2927,SNGL FAM SUB,1.5,AC,43800,0,43800,122800,500,167100,42900,0,42900,101800,500,145200,A1,AG/GEN,,,
4970,27-6-0-3-A,6728-57-4799,SNGL FAM SUB,1.22,AC,40300,0,40300,126500,0,166800,39400,0,39400,109400,0,148800,A1,AG/GEN,,,
4971,27-6-0-3-0,6728-56-4869,SNGL FAM SUB,10.59,AC,92500,0,92500,221300,400,314200,90700,0,90700,193700,400,284800,A1,AG/GEN,,,
4972,28-8-0-3-0,6729-81-4854,SNGL FAM SUB,3.45,AC,56900,0,56900,65000,1100,123000,54700,0,54700,60200,1100,116000,A1,AG/GEN,,,
4973,26-1-0-11-B,6719-04-1901,SNGL FAM SUB,3,AC,52000,0,52000,259500,9300,320800,50000,0,50000,215500,9300,274800,A1,AG/GEN,,,
4974,13-5-0-4-0,6841-76-7261,SNGL FAM SUB,13.33,AC,149000,0,149000,324600,16200,489800,146100,0,146100,273400,31700,451200,A1,AG/GEN,,,
4975,13-1-0-48-0,6841-46-8302,SNGL FAM SUB,15.99,AC,147400,0,147400,101000,3800,252200,144600,0,144600,86800,3800,235200,A1,AG/GEN,,,
4976,13-1-0-24-0,6841-66-9743,SNGL FAM SUB,6,AC,91100,0,91100,0,0,91100,89400,0,89400,0,0,89400,A1,AG/GEN,,,
4977,20-1-0-59-0,6851-01-7681,SNGL FAM SUB,4.017,AC,76000,0,76000,0,0,76000,74600,0,74600,0,0,74600,A1,AG/GEN,,,
4978,20-1-0-60-0,6851-00-5805,SNGL FAM SUB,7.034,AC,96600,0,96600,0,3500,100100,92400,0,92400,0,3500,95900,A1,AG/GEN,,,
4979,20-1-0-59-A,6851-01-8274,SNGL FAM SUB,3.949,AC,75500,0,75500,175500,5800,256800,74100,0,74100,163000,5000,242100,A1,AG/GEN,,,
4980,13-1-0-23-A,6841-76-3434,SNGL FAM SUB,8.3,AC,108800,0,108800,303300,43200,455300,106700,0,106700,275700,39800,422200,A1,AG/GEN,,,
4981,20-1-0-54-0,6851-01-4403,SNGL FAM SUB,5.432,AC,83100,0,83100,0,0,83100,81600,0,81600,0,0,81600,A1,AG/GEN,,,
4982,20-11-0-28-0,6841-91-6307,Cmn Area/Open Spc,3,AC,0,0,0,0,0,0,0,0,0,0,0,0,A1,AG/GEN,,,
4986,30-1-0-76-0,6758-87-7481,AG 20-100 AC,62.454,AC,685200,547400,137800,157300,3000,845500,627600,551400,76200,138900,1000,767500,A2,AG/LTD,,,
4987,44-1-0-25-0,6777-81-9920,SNGL FAM SUB,3.35,AC,126500,0,126500,123000,4800,254300,95700,0,95700,69200,4500,169400,A2,AG/LTD,,,
4988,44-3-0-3-0,6777-81-2672,SNGL FAM SUB,3.99,AC,111400,0,111400,547300,0,658700,99400,0,99400,455300,0,554700,A2,AG/LTD,,,
4989,6-1-0-56-0,6833-40-5882,SNGL FAM SUB,2.52,AC,52700,0,52700,0,0,52700,51200,0,51200,0,0,51200,A1,AG/GEN,,,
4990,6-1-0-56-A,6833-40-8882,SNGL FAM SUB,2.47,AC,52300,0,52300,0,0,52300,50800,0,50800,0,0,50800,A1,AG/GEN,,,
4991,64-1-0-83-0,7733-37-7259,SNGL FAM SUB,0.697,AC,265000,0,265000,440800,0,705800,220000,0,220000,401400,0,621400,R1,RES/LTD,,,
4992,64-15-A-7-0,7733-37-5362,SNGL FAM SUB,0,AC,265000,0,265000,700600,0,965600,220000,0,220000,688800,0,908800,R1,RES/LTD,,,
4993,38-1-0-59-0,6707-80-9191,AG 20-100 AC,49.16,AC,201600,0,201600,0,0,201600,196600,0,196600,0,0,196600,A1,AG/GEN,,,
4994,32-1-0-40-C,6778-64-1947,SNGL FAM SUB,8,AC,148100,0,148100,246000,29400,423500,132100,0,132100,206400,24900,363400,A2,AG/LTD,,,
4995,48-1-0-69-A,7727-97-5929,COMM & IND,0,AC,0,0,0,454200,0,454200,0,0,0,450200,0,450200,A2,AG/LTD,,,
5011,12-1-0-50-B,6832-30-7944,SNGL FAM SUB,4.42,AC,63500,0,63500,0,0,63500,61800,0,61800,0,0,61800,A1,AG/GEN,,,
5012,16-4-0-11-0,5890-46-8360,SNGL FAM SUB,1.01,AC,38900,0,38900,168000,7000,213900,38100,0,38100,151600,7000,196700,A1,AG/GEN,,,
5013,18-1-0-15-0,6810-74-2833,SNGL FAM SUB,15.74,AC,118100,0,118100,96500,4800,219400,119100,0,119100,78700,4800,202600,A1,AG/GEN,,,
5014,56-1-0-44-A,6795-59-7726,AG 20-100 AC,36.17,AC,796100,502300,293800,648400,97400,1541900,692300,436100,256200,589600,98800,1380700,A2,AG/LTD,,,
5015,32-1-0-46-C,6778-85-6003,SNGL FAM SUB,0.83,AC,58500,0,58500,166900,27900,253300,52200,0,52200,140000,22800,215000,A2,AG/LTD,,,
5016,46-1-0-86-A,7718-01-1789,SNGL FAM SUB,4.882,AC,160700,0,160700,171400,1500,333600,143400,0,143400,142600,1500,287500,A2,AG/LTD,,,
5017,26-1-0-34-A,6708-82-7401,SNGL FAM SUB,6.213,AC,70600,0,70600,140500,26300,237400,69300,0,69300,118700,22200,210200,A1,AG/GEN,,,
5018,28-1-0-100-0,6738-45-9494,SNGL FAM SUB,3,AC,63200,0,63200,140700,2400,206300,63000,0,63000,121200,2400,186600,A1,AG/GEN,,,
5019,19-1-0-36-E,6831-01-4559,SNGL FAM SUB,1,AC,40000,0,40000,96700,2000,138700,39500,0,39500,79900,2000,121400,A1,AG/GEN,,,
5023,29-1-0-91-0,6759-16-2800,SNGL FAM SUB,4.9,AC,90700,0,90700,107400,4000,202100,88500,0,88500,89400,4000,181900,A1,AG/GEN,,,
5025,31-18-0-8-0,6769-42-4040,SNGL FAM SUB,2.254,AC,95200,0,95200,315600,800,411600,91000,0,91000,287800,800,379600,A2,AG/LTD,,,
5026,21-6-0-1-0,6850-92-5348,SNGL FAM SUB,2,AC,66400,0,66400,49700,0,116100,60300,0,60300,41500,0,101800,A2,AG/LTD,,,
5027,33-1-0-10-0,6798-55-2678,SNGL FAM SUB,2.95,AC,97000,0,97000,519600,41300,657900,86600,0,86600,428900,34300,549800,A2,AG/LTD,,,
5028,42-4-0-2-0,6767-12-5378,SNGL FAM SUB,1.51,AC,74300,0,74300,0,0,74300,66400,0,66400,0,0,66400,A2,AG/LTD,,,
5029,28-1-0-96-0,6738-36-7878,SNGL FAM SUB,11.12,AC,118500,0,118500,230000,0,348500,116200,0,116200,199600,0,315800,A1,AG/GEN,,,
5030,19-1-0-18-0,6830-01-2284,AG 20-100 AC,25,AC,96700,85200,11500,0,0,96700,90000,79400,10600,0,0,90000,A1,AG/GEN,,,
5031,58-3-A-25-0,7726-26-4907,SNGL FAM SUB,0,AC,88000,0,88000,0,0,88000,80000,0,80000,0,0,80000,RN,RESIDEN,,,
5032,10-1-0-24-0,6801-84-6143,AG > 100 AC,103.6,AC,319700,231200,88500,309800,5200,634700,318800,234700,84100,272100,13500,604400,A1,AG/GEN,,,
5033,10-7-0-A-0,6801-71-8847,SNGL FAM SUB,6.23,AC,62900,60000,2900,0,0,62900,61500,58900,2600,0,0,61500,A1,AG/GEN,,,
5034,57-17-0-4-0,7706-13-7514,SNGL FAM SUB,3,AC,161000,0,161000,243800,7700,412500,140100,0,140100,204600,6600,351300,A2,AG/LTD,,,
5035,27-1-0-58-0,6729-74-0843,AG 20-100 AC,55.306,AC,210100,184600,25500,0,0,210100,199100,175600,23500,0,0,199100,A1,AG/GEN,,,
5036,29-1-0-7-A,6749-25-4378,SNGL FAM SUB,2,AC,23500,0,23500,0,0,23500,21300,0,21300,0,0,21300,A1,AG/GEN,,,
5037,45-1-0-71-0,6797-64-8274,SNGL FAM SUB,1.51,AC,84800,0,84800,171400,34000,290200,75700,0,75700,142000,32200,249900,A2,AG/LTD,,,
5038,17-1-0-62-0,6810-46-1069,SNGL FAM SUB,2,AC,44000,0,44000,173000,41100,258100,43500,0,43500,144400,36300,224200,A1,AG/GEN,,,
5039,18-1-0-40-0,6820-21-6052,SNGL FAM SUB,14,AC,74800,0,74800,0,0,74800,77000,0,77000,0,0,77000,A1,AG/GEN,,,
5041,58-1-0-21-0,7716-55-7044,SNGL FAM SUB,3.88,AC,160300,0,160300,284100,3500,447900,139300,0,139300,240100,3500,382900,A2,AG/LTD,,,
5042,39-6-0-1-0,6726-17-2060,SNGL FAM SUB,1,AC,38800,0,38800,178100,82900,299800,38000,0,38000,152700,74800,265500,A1,AG/GEN,,,
5043,39-6-0-13-A,6726-17-7733,Roads,0.5,AC,0,0,0,0,0,0,0,0,0,0,0,0,A1,AG/GEN,,,
5044,30-1-0-30-0,6758-25-8841,SNGL FAM SUB,1.91,AC,63100,0,63100,199300,1500,263900,59400,0,59400,164500,1500,225400,A2,AG/LTD,,,
5045,44-13-0-D-0,6787-62-8628,SNGL FAM SUB,12.57,AC,222800,0,222800,0,0,222800,199100,0,199100,0,0,199100,A2,AG/LTD,,,
5046,15-1-0-40-0,5789-49-0404,SNGL FAM SUB,5.341,AC,54400,0,54400,89900,6900,151200,53200,0,53200,78600,5400,137200,A1,AG/GEN,,,
5047,10-1-0-22-0,6801-73-9056,SNGL FAM SUB,16.52,AC,93800,86200,7600,0,0,93800,92300,85300,7000,0,0,92300,A1,AG/GEN,,,
5048,4-1-0-60-0,6812-47-9624,AG 20-100 AC,29.2,AC,126700,81600,45100,98400,2500,227600,124200,80900,43300,87300,2500,214000,A1,AG/GEN,,,
5049,4-1-0-68-A,6813-33-3051,SNGL FAM SUB,1,AC,39700,0,39700,3500,0,43200,39000,0,39000,3500,0,42500,A1,AG/GEN,,,
5050,47-4-0-1-0,7727-34-5828,SNGL FAM SUB,8.93,AC,935000,0,935000,98400,18700,1052100,890600,0,890600,84900,18100,993600,B1A2,BS AND,,,
5051,17-2-0-1-0,6810-36-8782,SNGL FAM SUB,5.91,AC,58200,0,58200,0,0,58200,55600,0,55600,0,0,55600,A1,AG/GEN,,,
5052,17-1-0-59-0,6810-36-1692,SNGL FAM SUB,8.05,AC,78300,0,78300,0,0,78300,76800,0,76800,0,0,76800,A1,AG/GEN,,,
5053,29-1-0-72-0,6749-64-5114,SNGL FAM SUB,2,AC,57000,0,57000,149600,2500,209100,53500,0,53500,123300,2500,179300,A1,AG/GEN,,,
5054,29-1-0-73-0,6749-64-4402,SNGL FAM SUB,2,AC,57000,0,57000,166300,0,223300,53000,0,53000,137000,0,190000,A1,AG/GEN,,,
5055,32-1-0-11-0,6779-75-4517,SNGL FAM SUB,5.37,AC,113900,0,113900,47700,1000,162600,101800,0,101800,40000,1000,142800,A2,AG/LTD,,,
5056,30-1-0-36-0,6758-23-7742,SNGL FAM SUB,9,AC,135900,0,135900,0,0,135900,129100,0,129100,0,0,129100,A2,AG/LTD,,,
5058,57-1-0-14-A,7706-23-3403,SNGL FAM SUB,0.491,AC,74500,0,74500,145100,0,219600,64800,0,64800,122400,0,187200,A2,AG/LTD,,,
5059,31-20-0-2-0,6769-65-0820,SNGL FAM SUB,2.25,AC,75700,0,75700,79300,0,155000,68100,0,68100,65800,0,133900,A2,AG/LTD,,,
5060,5-3-0-24-0,6824-21-5118,SNGL FAM SUB,3.78,AC,57700,0,57700,0,0,57700,56500,0,56500,0,0,56500,A1,AG/GEN,,,
5061,68-1-0-2-B,7733-86-2936,SNGL FAM SUB,1,AC,6800,0,6800,0,0,6800,5900,0,5900,0,0,5900,A2,AG/LTD,,,
5062,48-1-0-22-A,7727-52-6548,COMM & IND,17.299,AC,1067200,0,1067200,1275300,7100,2349600,1016600,0,1016600,412200,0,1428800,M2,INDUS/G,,,
5063,47-19-0-6-0,7728-20-3085,AG > 100 AC,100.67,AC,1402300,1252500,149800,39900,80000,1522200,1249100,1117800,131300,41400,70100,1360600,A2,AG/LTD,,,
5084,48-2-B-6-0,7726-68-7360,SNGL FAM SUB,0,AC,130000,0,130000,411600,29800,571400,117000,0,117000,392600,27800,537400,R1,RES/LTD,,,
5085,48-2-E-2-0,7726-68-5541,SNGL FAM SUB,0,AC,130000,0,130000,374300,1800,506100,117000,0,117000,356500,1800,475300,R1,RES/LTD,,,
5086,48-2-A-2-0,7726-67-2618,SNGL FAM SUB,0.565,AC,130000,0,130000,442400,800,573200,117000,0,117000,422000,800,539800,R1,RES/LTD,,,
5087,48-2-A-4-0,7726-67-4733,SNGL FAM SUB,0.551,AC,130000,0,130000,415700,0,545700,117000,0,117000,394000,0,511000,R1,RES/LTD,,,
5088,48-2-A-6-0,7726-67-7883,SNGL FAM SUB,0,AC,130000,0,130000,532800,106300,769100,117000,0,117000,507400,98600,723000,R1,RES/LTD,,,
5089,48-2-B-2-0,7726-68-7019,SNGL FAM SUB,0.597,AC,130000,0,130000,726800,0,856800,117000,0,117000,693700,0,810700,R1,RES/LTD,,,
5090,48-2-B-4-0,7726-68-5215,SNGL FAM SUB,0,AC,130000,0,130000,345100,0,475100,117000,0,117000,328800,0,445800,R1,RES/LTD,,,
5091,48-2-C-1-0,7726-57-7884,SNGL FAM SUB,0.631,AC,130000,0,130000,369400,0,499400,117000,0,117000,351900,0,468900,R1,RES/LTD,,,
5092,48-2-C-2-0,7726-57-8976,SNGL FAM SUB,0.568,AC,130000,0,130000,377300,0,507300,117000,0,117000,358800,0,475800,R1,RES/LTD,,,
5093,48-2-C-4-0,7726-68-0160,SNGL FAM SUB,0.587,AC,130000,0,130000,476800,0,606800,117000,0,117000,460700,0,577700,R1,RES/LTD,,,
5094,48-2-C-6-0,7726-68-1196,SNGL FAM SUB,0.659,AC,130000,0,130000,540400,3800,674200,117000,0,117000,514500,3400,634900,R1,RES/LTD,,,
5095,48-2-C-7-0,7726-68-4021,SNGL FAM SUB,0.611,AC,130000,0,130000,657200,0,787200,117000,0,117000,639400,0,756400,R1,RES/LTD,,,
5096,48-2-C-10-0,7726-67-0869,SNGL FAM SUB,0.579,AC,130000,0,130000,0,0,130000,117000,0,117000,0,0,117000,R1,RES/LTD,,,
5097,48-2-F-5-0,7726-68-2421,SNGL FAM SUB,0,AC,130000,0,130000,404700,0,534700,117000,0,117000,388800,0,505800,R1,RES/LTD,,,
5098,48-3-D-2-0,7726-57-4679,SNGL FAM SUB,0,AC,130000,0,130000,424200,0,554200,117000,0,117000,403000,0,520000,R1,RES/LTD,,,
5102,47-1-0-80-B,7716-87-9980,COMM & IND,15.667,AC,3271100,3130200,140900,229700,37100,3537900,2973900,2846300,127600,183900,32400,3190200,B1A2,BS AND,,,
5106,57-1-0-79-A,7706-52-4992,SNGL FAM SUB,5.14,AC,242000,0,242000,0,0,242000,210300,0,210300,0,0,210300,A2,AG/LTD,,,
5107,57-1-0-79-C,7706-52-6689,SNGL FAM SUB,3,AC,162200,0,162200,163700,3500,329400,141100,0,141100,138700,3500,283300,A2,AG/LTD,,,
5108,56-1-0-48-0,6796-42-7631,AG 20-100 AC,27.062,AC,664800,529600,135200,137100,3000,804900,577500,460300,117200,116500,3000,697000,A2,AG/LTD,,,
5109,5-1-0-36-D,6813-95-4857,AG 20-100 AC,31.44,AC,81100,66600,14500,0,0,81100,79500,66100,13400,0,0,79500,A1,AG/GEN,,,
5110,41-1-0-6-B,6748-51-1204,SNGL FAM SUB,2.11,AC,65100,0,65100,216700,24500,306300,60300,0,60300,183100,21900,265300,A1,AG/GEN,,,
5111,41-1-0-6-C,6748-51-5459,SNGL FAM SUB,11.501,AC,150500,0,150500,352400,71400,574300,142300,0,142300,297300,60300,499900,A1,AG/GEN,,,
5112,32-10-1-16-0,6778-69-0138,SNGL FAM SUB,1.48,AC,74200,0,74200,158000,14600,246800,66300,0,66300,139600,13900,219800,A2,AG/LTD,,,
5113,62-3-D-7-0,7714-04-8218,SNGL FAM SUB,0,AC,115000,0,115000,0,0,115000,100000,0,100000,0,0,100000,R1,RES/LTD,,,
5114,66-5-0-1-0,7723-35-1793,SNGL FAM SUB,4.318,AC,320600,0,320600,0,0,320600,355000,0,355000,0,0,355000,A2,AG/LTD,,,
5115,66-5-0-2-0,7723-35-4593,SNGL FAM SUB,5.052,AC,517500,0,517500,1335400,13800,1866700,450000,0,450000,1274800,12800,1737600,A2,AG/LTD,,,
5116,67-13-C-3-0,7733-27-5195,SNGL FAM SUB,0,AC,265000,0,265000,731300,0,996300,220000,0,220000,647100,0,867100,R1,RES/LTD,,,
5117,62-1-0-35-0,7715-10-1811,SNGL FAM SUB,6.81,AC,356100,0,356100,261000,12500,629600,309800,0,309800,225100,10200,545100,A2,AG/LTD,,,
5120,29-10-0-H-0,6749-95-4413,SNGL FAM SUB,4.46,AC,86900,0,86900,271000,1600,359500,84200,0,84200,234000,1600,319800,A1,AG/GEN,,,
5121,57-12-0-1-0,7706-04-9453,SNGL FAM SUB,9.51,AC,332200,0,332200,241400,9200,582800,289200,0,289200,202400,9300,500900,A2,AG/LTD,,,
5122,46-21-B-3-0,7718-00-0020,SNGL FAM SUB,2.57,AC,130900,0,130900,253300,23000,407200,118900,0,118900,212900,21400,353200,A2,AG/LTD,,,
5123,46-1-0-97-D,7717-09-0654,SNGL FAM SUB,1.945,AC,117300,0,117300,185800,1300,304400,106600,0,106600,157400,1300,265300,A2,AG/LTD,,,
5124,46-21-B-8-0,7718-00-1217,SNGL FAM SUB,2.4,AC,127200,0,127200,404300,1000,532500,115600,0,115600,343200,1000,459800,A2,AG/LTD,,,
5125,66-4-0-17-0,7723-34-3256,SNGL FAM SUB,4.261,AC,862500,0,862500,2687100,0,3549600,750000,0,750000,2514300,0,3264300,A2,AG/LTD,,,
5126,54-2-0-1-0,6776-12-0555,SNGL FAM SUB,6.172,AC,116300,0,116300,277100,22700,416100,103700,0,103700,227800,20200,351700,A2,AG/LTD,,,
5127,13-9-0-5-0,6841-73-5837,SNGL FAM SUB,4.78,AC,81900,0,81900,178000,2000,261900,80400,0,80400,153600,2000,236000,A1,AG/GEN,,,
5128,9-1-0-38-0,5892-43-5122,SNGL FAM SUB,7,AC,57400,0,57400,0,0,57400,56000,0,56000,0,0,56000,A1,AG/GEN,,,
5129,9-5-0-E-0,5892-43-6715,SNGL FAM SUB,3.41,AC,47500,0,47500,0,0,47500,45200,0,45200,0,0,45200,A1,AG/GEN,,,
5130,46-6-0-3-0,7716-17-5804,Place of Worship,5.7,AC,203300,0,203300,1757800,78200,2039300,181500,0,181500,1677600,74600,1933700,A2,AG/LTD,,,
5131,45-1-0-27-0,6787-97-3694,SNGL FAM SUB,1.51,AC,78200,0,78200,111700,300,190200,69800,0,69800,92700,300,162800,A2,AG/LTD,,,
5132,45-1-0-124-0,6797-77-1108,SNGL FAM SUB,2.98,AC,116100,0,116100,100400,1300,217800,103800,0,103800,83200,1300,188300,A2,AG/LTD,,,
5134,31-1-0-43-D,6769-92-5379,SNGL FAM SUB,4.39,AC,115300,0,115300,246600,9000,370900,103000,0,103000,206100,9000,318100,A2,AG/LTD,,,
5136,31-1-0-83-0,6778-18-8632,AG > 100 AC,109.22,AC,1188300,931700,256600,687100,89200,1964600,1057900,828900,229000,559700,79800,1697400,A2,AG/LTD,,,
5137,62-2-A-2-0,7714-03-0603,SNGL FAM SUB,0,AC,115000,0,115000,191400,13500,319900,100000,0,100000,177200,13500,290700,R1,RES/LTD,,,
5139,6-3-0-9-0,6832-47-6657,SNGL FAM SUB,4.52,AC,86200,0,86200,0,0,86200,84600,0,84600,0,0,84600,A1,AG/GEN,,,
5140,6-3-0-10-0,6832-47-6905,SNGL FAM SUB,4.03,AC,71500,0,71500,309700,2500,383700,70100,0,70100,261800,2500,334400,A1,AG/GEN,,,
5141,6-3-0-12-0,6832-58-0029,SNGL FAM SUB,3.08,AC,59800,0,59800,225000,2000,286800,58600,0,58600,199500,2000,260100,A1,AG/GEN,,,
5142,6-3-0-13-0,6832-57-2830,SNGL FAM SUB,3.09,AC,59900,0,59900,281500,75800,417200,58700,0,58700,247700,66800,373200,A1,AG/GEN,,,
5144,12-6-0-2-0,6832-46-2077,SNGL FAM SUB,6.87,AC,89200,0,89200,291100,2200,382500,87400,0,87400,262500,1500,351400,A1,AG/GEN,,,
5145,12-6-0-3-0,6832-46-4178,SNGL FAM SUB,4.21,AC,68600,0,68600,304300,0,372900,67200,0,67200,267400,0,334600,A1,AG/GEN,,,
5146,12-6-0-5-0,6832-46-5759,SNGL FAM SUB,4.63,AC,87100,0,87100,430400,5500,523000,85400,0,85400,395900,5500,486800,A1,AG/GEN,,,
5147,12-6-0-6-0,6832-46-6966,SNGL FAM SUB,5.7,AC,95300,0,95300,335600,1500,432400,93500,0,93500,284900,1500,379900,A1,AG/GEN,,,
5148,12-6-0-8-0,6832-47-7400,SNGL FAM SUB,5.94,AC,97200,0,97200,219200,17500,333900,95300,0,95300,183900,17500,296700,A1,AG/GEN,,,
5149,12-6-0-14-A,6832-57-2358,SNGL FAM SUB,3.09,AC,59900,0,59900,251600,24400,335900,58700,0,58700,234200,27700,320600,A1,AG/GEN,,,
5150,12-6-0-14-B,6832-57-5505,SNGL FAM SUB,3,AC,56100,0,56100,238900,0,295000,55000,0,55000,184200,0,239200,A1,AG/GEN,,,
5151,12-6-0-15-0,6832-67-0063,SNGL FAM SUB,6.88,AC,80300,0,80300,220000,500,300800,78700,0,78700,191500,500,270700,A1,AG/GEN,,,
5152,12-6-0-16-0,6832-56-8857,SNGL FAM SUB,6.47,AC,86100,0,86100,322500,28200,436800,84400,0,84400,278700,24500,387600,A1,AG/GEN,,,
5153,12-6-0-17-0,6832-56-7589,SNGL FAM SUB,8.91,AC,96600,0,96600,340700,2500,439800,94700,0,94700,300200,2500,397400,A1,AG/GEN,,,
5154,12-6-0-18-0,6832-56-5394,SNGL FAM SUB,9.06,AC,90600,0,90600,449300,31100,571000,88700,0,88700,380600,34100,503400,A1,AG/GEN,,,
5155,12-6-0-19-0,6832-56-3185,SNGL FAM SUB,6.75,AC,88300,0,88300,291600,94600,474500,86500,0,86500,244000,97400,427900,A1,AG/GEN,,,
5156,12-6-0-20-0,6832-55-2906,SNGL FAM SUB,6.73,AC,88100,0,88100,206600,3000,297700,86300,0,86300,173500,3000,262800,A1,AG/GEN,,,
5157,44-1-0-19-D,6787-02-6221,SNGL FAM SUB,8,AC,166700,79700,87000,183100,73300,423100,148700,71200,77500,156200,64800,369700,A2,AG/LTD,,,
5158,64-12-B-6-0,7724-60-0662,SNGL FAM SUB,0,AC,77000,0,77000,157800,2500,237300,67000,0,67000,137100,2500,206600,R1,RES/LTD,,,
5159,64-12-B-6-A,7724-60-1528,SNGL FAM SUB,0.191,AC,17200,0,17200,0,0,17200,15000,0,15000,0,0,15000,R1,RES/LTD,,,
5160,47-24-0-3-0,7718-40-9977,SNGL FAM SUB,4,AC,150000,0,150000,341200,3100,494300,134000,0,134000,292600,0,426600,A2,AG/LTD,,,
5161,11-2-0-1-A,6822-53-1584,SNGL FAM SUB,0.5,AC,29800,0,29800,189700,0,219500,27300,0,27300,187900,0,215200,A1,AG/GEN,,,
5162,29-1-0-11-0,6749-23-8770,SNGL FAM SUB,6.08,AC,89000,85900,3100,0,0,89000,84300,81700,2600,0,0,84300,A1,AG/GEN,,,
5163,29-16-0-E-0,6749-56-9452,SNGL FAM SUB,5.28,AC,94000,0,94000,0,0,94000,90100,0,90100,0,0,90100,A1,AG/GEN,,,
5164,29-9-0-4-A,6748-88-5689,SNGL FAM SUB,3.3,AC,74200,0,74200,0,0,74200,69000,0,69000,0,0,69000,A1,AG/GEN,,,
5165,21-2-0-6-0,6769-19-5273,SNGL FAM SUB,2.6,AC,68700,0,68700,0,0,68700,63200,0,63200,0,0,63200,A2,AG/LTD,,,
5166,47-1-0-37-0,7717-70-3440,SNGL FAM SUB,2.725,AC,313000,0,313000,8900,0,321900,284600,0,284600,9300,0,293900,A2,AG/LTD,,,
5167,5-7-0-28-0,6824-21-8877,SNGL FAM SUB,7.17,AC,65900,0,65900,222600,7500,296000,64500,0,64500,193500,7500,265500,A1,AG/GEN,,,
5169,64-9-0-3-0,7724-91-4128,SNGL FAM SUB,3.56,AC,231200,0,231200,0,0,231200,201000,0,201000,0,0,201000,A2,AG/LTD,,,
5171,11-5-0-B-0,6822-53-0041,SNGL FAM SUB,4.44,AC,57200,0,57200,122200,0,179400,56200,0,56200,106700,0,162900,A1,AG/GEN,,,
5172,44-15-1-12-0,6776-97-2022,SNGL FAM SUB,10.07,AC,189000,0,189000,317900,0,506900,168300,0,168300,274500,0,442800,A2,AG/LTD,,,
5173,64-9-0-2-0,7724-90-4858,SNGL FAM SUB,1.82,AC,166200,0,166200,115700,1500,283400,144500,0,144500,97300,1500,243300,A2,AG/LTD,,,
5174,50-5-0-8-0,6726-43-9342,SNGL FAM SUB,8.44,AC,71100,0,71100,0,0,71100,67700,0,67700,0,0,67700,A1,AG/GEN,,,
5175,64-7-0-A-0,7724-81-8808,SNGL FAM SUB,18.3,AC,883900,0,883900,0,0,883900,768600,0,768600,0,0,768600,A2,AG/LTD,,,
5176,57-22-0-A-0,7706-73-0312,SNGL FAM SUB,6.85,AC,302900,0,302900,1489200,29800,1821900,263600,0,263600,1320200,24500,1608300,A2,AG/LTD,,,
5177,47-26-0-5-0,7727-09-9143,SNGL FAM SUB,8,AC,208100,0,208100,245600,39700,493400,186000,0,186000,215200,33700,434900,A2,AG/LTD,,,
5178,60-4-0-4-0,6784-29-0510,SNGL FAM SUB,4.718,AC,231500,0,231500,326600,41100,599200,206500,0,206500,270100,34400,511000,A2,AG/LTD,,,
5179,12-19-0-1-0,6832-21-6819,SNGL FAM SUB,1,AC,40300,0,40300,0,0,40300,39000,0,39000,0,0,39000,A1,AG/GEN,,,
5180,12-19-0-2-0,6832-22-4085,SNGL FAM SUB,1.94,AC,48000,0,48000,0,0,48000,46500,0,46500,0,0,46500,A1,AG/GEN,,,
5181,12-19-0-3-0,6832-22-2008,SNGL FAM SUB,2.94,AC,56100,0,56100,369000,3200,428300,54500,0,54500,317200,3200,374900,A1,AG/GEN,,,
5182,64-17-0-B-0,7733-68-1404,SNGL FAM SUB,2.115,AC,217800,0,217800,841800,70200,1129800,189300,0,189300,705100,62400,956800,R1,RES/LTD,,,
5183,12-1-0-51-0,6832-20-4429,AG > 100 AC,100.4,AC,598300,360200,238100,674600,30300,1303200,594400,379500,214900,609000,29700,1233100,A1,AG/GEN,,,
5184,39-1-0-88-A,6727-12-5387,SNGL FAM SUB,1.51,AC,41900,0,41900,119400,2500,163800,41100,0,41100,100300,2500,143900,A1,AG/GEN,,,
5185,67-11-B-3-0,7733-26-0876,SNGL FAM SUB,0,AC,265000,0,265000,432500,28400,725900,220000,0,220000,391500,24400,635900,R1,RES/LTD,,,
5186,45-5-0-6-0,6797-67-2698,COMM & IND,4.66,AC,398800,0,398800,449700,79900,928400,379800,0,379800,438600,80900,899300,M1,INDUS/L,,,
5187,18-1-0-6-0,6810-89-9265,SNGL FAM SUB,12.1,AC,134200,0,134200,131500,17800,283500,131600,0,131600,118700,16900,267200,A1,AG/GEN,,,
5188,18-1-0-6-D,6811-90-5082,SNGL FAM SUB,5.36,AC,65400,23400,42000,0,9300,74700,64200,24300,39900,0,8100,72300,A1,AG/GEN,,,
5190,18-1-0-52-0,6810-98-3859,SNGL FAM SUB,2.27,AC,47600,0,47600,0,0,47600,45600,0,45600,0,0,45600,A1,AG/GEN,,,
5192,18-1-0-6-C,6810-88-2929,AG 20-100 AC,32.124,AC,140400,0,140400,0,0,140400,138100,0,138100,0,0,138100,A1,AG/GEN,,,
5193,43-8-0-D-0,6778-41-5031,SNGL FAM SUB,7.352,AC,149500,0,149500,288800,15900,454200,133700,0,133700,225300,13400,372400,A2,AG/LTD,,,
5194,2-1-0-17-0,6814-73-8717,SNGL FAM SUB,10.61,AC,88700,0,88700,0,0,88700,87100,0,87100,0,0,87100,A1,AG/GEN,,,
5195,2-1-0-17-A,6814-73-3451,SNGL FAM SUB,1,AC,39700,0,39700,0,0,39700,39000,0,39000,0,0,39000,A1,AG/GEN,,,
5196,2-1-0-17-B,6814-73-4258,SNGL FAM SUB,1,AC,39700,0,39700,151700,9300,200700,39000,0,39000,132600,7700,179300,A1,AG/GEN,,,
5197,15-1-0-29-0,5789-39-0523,SNGL FAM SUB,10,AC,61000,0,61000,0,0,61000,60500,0,60500,0,0,60500,A1,AG/GEN,,,
5198,15-4-0-3-0,5880-30-5176,SNGL FAM SUB,1.34,AC,40000,0,40000,0,0,40000,39200,0,39200,0,0,39200,A1,AG/GEN,,,
5199,64-14-A-2-0,7733-27-0517,SNGL FAM SUB,0,AC,251800,0,251800,675400,68600,995800,209000,0,209000,576400,63500,848900,R1,RES/LTD,,,
5200,64-15-A-10-0,7733-37-5783,SNGL FAM SUB,0,AC,265000,0,265000,683700,24300,973000,220000,0,220000,582800,21200,824000,R1,RES/LTD,,,
5201,64-15-B-14-0,7733-27-8251,SNGL FAM SUB,0,AC,265000,0,265000,768200,0,1033200,220000,0,220000,644800,0,864800,R1,RES/LTD,,,
5202,64-15-B-15-0,7733-27-8308,SNGL FAM SUB,0,AC,265000,0,265000,669200,0,934200,220000,0,220000,572400,0,792400,R1,RES/LTD,,,
5368,42-1-0-91-0,6767-14-0681,SNGL FAM SUB,0.687,AC,52400,0,52400,200400,3000,255800,47300,0,47300,167100,3000,217400,R3,RES/GEN,,,
5369,42-19-0-6-0,6766-18-7881,SNGL FAM SUB,1.88,AC,77300,0,77300,231700,2500,311500,65700,0,65700,195400,2500,263600,R3A2,RES GEN,,,
5370,26-1-0-35-F,6718-03-0037,SNGL FAM SUB,3.01,AC,50100,0,50100,124900,1300,176300,49100,0,49100,111500,1300,161900,A1,AG/GEN,,,
5371,38-6-0-2-0,6717-18-0614,SNGL FAM SUB,3,AC,50000,0,50000,9600,2300,61900,49000,0,49000,9500,2300,60800,A1,AG/GEN,,,
5372,50-1-0-14-0,6726-35-3786,SNGL FAM SUB,2.54,AC,48200,0,48200,0,0,48200,47200,0,47200,0,0,47200,A1,AG/GEN,,,
5527,38-1-0-71-0,6717-05-9173,SNGL FAM SUB,2.54,AC,47400,0,47400,91200,2500,141100,46500,0,46500,78500,2500,127500,A1,AG/GEN,,,
5528,33-4-0-34-0,6798-52-0378,SNGL FAM SUB,3.16,AC,106500,0,106500,292500,14900,413900,95100,0,95100,242100,13900,351100,A2,AG/LTD,,,
5529,2-1-0-23-0,6814-72-5592,SNGL FAM SUB,2,AC,44800,0,44800,40400,200,85400,44000,0,44000,34700,200,78900,A1,AG/GEN,,,
5530,2-1-0-24-0,6814-72-4646,SNGL FAM SUB,1.498,AC,42200,0,42200,210600,0,252800,41200,0,41200,178900,0,220100,A1,AG/GEN,,,
5532,43-1-0-8-B,6767-78-5782,SNGL FAM SUB,2.01,AC,84600,0,84600,231900,1400,317900,75600,0,75600,196900,1400,273900,A2,AG/LTD,,,
5533,62-20-B-4-0,7714-15-4578,SNGL FAM SUB,0,AC,115000,0,115000,227800,600,343400,100000,0,100000,207900,600,308500,R1,RES/LTD,,,
5534,67-2-D-8-0,7723-54-8988,SNGL FAM SUB,0,AC,184000,0,184000,441700,68300,694000,160000,0,160000,365600,60600,586200,R1,RES/LTD,,,
5535,4-2-0-29-0,6814-40-3108,SNGL FAM SUB,3.32,AC,52000,0,52000,182000,46500,280500,50900,0,50900,157400,38800,247100,A1,AG/GEN,,,
5536,46-1-0-28-0,7707-23-6718,SNGL FAM SUB,3.38,AC,151800,0,151800,99800,15500,267100,135500,0,135500,84700,13400,233600,A2RR,AG& RUR,,,
5537,28-1-0-101-0,6738-56-0359,SNGL FAM SUB,13.59,AC,120700,0,120700,0,0,120700,119200,0,119200,0,0,119200,A1,AG/GEN,,,
5538,17-1-0-36-0,6810-07-0704,AG 20-100 AC,48.44,AC,177200,124300,52900,203000,200,380400,170800,100500,70300,175600,200,346600,A1,AG/GEN,,,
5539,26-1-0-24-0,6718-08-7657,SNGL FAM SUB,9.793,AC,88000,0,88000,172400,13100,273500,86400,0,86400,147500,13100,247000,A1,AG/GEN,,,
5540,55-1-0-71-0,6786-62-6005,SNGL FAM SUB,3,AC,103100,0,103100,176900,2000,282000,92000,0,92000,151400,2000,245400,A2,AG/LTD,,,
5542,55-1-0-71-A,6786-62-2681,SNGL FAM SUB,1,AC,70100,0,70100,91100,600,161800,62600,0,62600,74700,600,137900,A2,AG/LTD,,,
5543,9-1-0-1-0,5892-76-2412,AG 20-100 AC,28.69,AC,99300,86100,13200,0,0,99300,100400,88200,12200,0,0,100400,A1,AG/GEN,,,
5695,9-1-0-69-0,5892-72-4705,AG 20-100 AC,25.3,AC,63300,0,63300,0,0,63300,63300,0,63300,0,0,63300,A1,AG/GEN,,,
5697,21-1-0-9-0,6850-35-7034,SNGL FAM SUB,1.5,AC,7200,0,7200,0,0,7200,6800,0,6800,0,0,6800,A1,AG/GEN,,,
5699,42-21-0-1-0,6767-10-0922,SNGL FAM SUB,2,AC,80400,0,80400,192100,2500,275000,67100,0,67100,157600,2500,227200,R1,RES/LTD,,,
5700,58-3-C-7-0,7726-16-8735,SNGL FAM SUB,0,AC,88000,0,88000,209900,6800,304700,80000,0,80000,180400,7000,267400,RN,RESIDEN,,,
5701,64-1-0-84-0,7733-68-0009,SNGL FAM SUB,3,AC,250900,0,250900,220100,35900,506900,218100,0,218100,184300,32100,434500,R1,RES/LTD,,,
5702,48-1-0-11-0,7727-69-4681,SNGL FAM SUB,1.74,AC,140400,0,140400,123000,0,263400,125400,0,125400,102300,0,227700,A2,AG/LTD,,,
5703,62-1-0-36-0,7715-21-2198,SNGL FAM SUB,6.33,AC,194000,0,194000,0,0,194000,169000,0,169000,0,0,169000,A2,AG/LTD,,,
5704,63-1-0-14-0,7715-20-5215,AG 20-100 AC,26.33,AC,963900,0,963900,1461000,46500,2471400,837500,0,837500,1363900,43400,2244800,A2,AG/LTD,,,
5705,32-1-0-10-0,6779-94-2895,SNGL FAM SUB,5.11,AC,123300,0,123300,0,0,123300,110200,0,110200,0,0,110200,A2,AG/LTD,,,
5706,15-1-0-37-B,5789-27-2629,SNGL FAM SUB,6.4,AC,58200,0,58200,12400,0,70600,56900,0,56900,11000,0,67900,A1,AG/GEN,,,
5203,64-15-B-16-0,7733-27-7555,SNGL FAM SUB,0,AC,265000,0,265000,530000,0,795000,220000,0,220000,419800,0,639800,R1,RES/LTD,,,
5204,64-15-D-2-0,7733-27-5788,SNGL FAM SUB,0,AC,251800,0,251800,540700,0,792500,209000,0,209000,429200,0,638200,R1,RES/LTD,,,
5205,64-15-D-6-0,7733-37-3905,SNGL FAM SUB,0,AC,251800,0,251800,530700,0,782500,209000,0,209000,463800,0,672800,R1,RES/LTD,,,
5206,64-15-D-7-0,7733-38-4080,SNGL FAM SUB,0,AC,251800,0,251800,440800,12400,705000,209000,0,209000,377200,10900,597100,R1,RES/LTD,,,
5207,64-19-E-4-0,7733-48-1137,SNGL FAM SUB,0,AC,251800,0,251800,486300,0,738100,209000,0,209000,386400,0,595400,R1,RES/LTD,,,
5208,67-1-0-14-0,7733-35-9559,Cmn Area/Open Spc,4.8,AC,0,0,0,0,0,0,0,0,0,0,0,0,A2,AG/LTD,,,
5209,67-10-0-5-A,7733-07-3182,SNGL FAM SUB,0.24,AC,11500,0,11500,0,0,11500,9600,0,9600,0,0,9600,R1,RES/LTD,,,
5210,67-20-0-44-0,7733-35-4945,SNGL FAM SUB,1.27,AC,309400,0,309400,441500,0,750900,259400,0,259400,355200,0,614600,R1,RES/LTD,,,
5212,16-4-0-2-0,5890-45-3021,SNGL FAM SUB,1.02,AC,38900,0,38900,100900,2000,141800,38100,0,38100,85200,2000,125300,A1,AG/GEN,,,
5213,16-5-0-13-0,5890-35-9293,SNGL FAM SUB,3.04,AC,46100,0,46100,0,0,46100,44100,0,44100,0,0,44100,A1,AG/GEN,,,
5214,32-6-0-A-0,6778-81-0763,SNGL FAM SUB,10.54,AC,160500,0,160500,237100,21100,418700,143100,0,143100,194400,17900,355400,A2,AG/LTD,,,
5215,51-1-0-49-A,6736-55-3458,AG 20-100 AC,47.67,AC,145900,102800,43100,0,0,145900,143000,102100,40900,0,0,143000,A1,AG/GEN,,,
5216,31-1-0-95-0,6778-52-3833,SNGL FAM SUB,2.44,AC,84800,0,84800,186600,26900,298300,75800,0,75800,158700,23100,257600,A2,AG/LTD,,,
5217,38-1-0-66-0,6717-02-8858,SNGL FAM SUB,4.75,AC,24200,0,24200,0,0,24200,23800,0,23800,0,0,23800,A1,AG/GEN,,,
5218,67-3-F-4-0,7723-53-1734,SNGL FAM SUB,0,AC,92000,0,92000,0,0,92000,80000,0,80000,0,0,80000,R1,RES/LTD,,,
5219,67-3-F-5-0,7723-53-1584,SNGL FAM SUB,0,AC,238800,0,238800,834000,62800,1135600,207700,0,207700,699300,60200,967200,R1,RES/LTD,,,
5220,67-3-F-6-0,7723-53-3453,SNGL FAM SUB,0,AC,92000,0,92000,0,0,92000,80000,0,80000,0,0,80000,R1,RES/LTD,,,
5221,67-3-G-4-0,7723-53-4745,SNGL FAM SUB,0,AC,184000,0,184000,505200,0,689200,160000,0,160000,456400,0,616400,R1,RES/LTD,,,
5222,16-1-0-16-0,5890-25-4947,SNGL FAM SUB,16,AC,58300,50900,7400,0,0,58300,56500,49700,6800,0,0,56500,A1,AG/GEN,,,
5223,16-1-0-17-0,5890-15-8579,SNGL FAM SUB,16.25,AC,58800,51300,7500,0,0,58800,57100,50200,6900,0,0,57100,A1,AG/GEN,,,
5224,16-1-0-18-0,5890-25-4483,AG 20-100 AC,42.12,AC,134800,115400,19400,0,0,134800,131400,113500,17900,0,0,131400,A1,AG/GEN,,,
5225,48-2-F-4-0,7726-68-0367,SNGL FAM SUB,0,AC,130000,0,130000,145900,900,276800,117000,0,117000,126800,900,244700,R1,RES/LTD,,,
5226,46-1-0-118-0,7717-02-2913,AG 20-100 AC,32.476,AC,634100,486800,147300,751500,72800,1458400,566800,435400,131400,648600,70000,1285400,A2,AG/LTD,,,
5227,46-1-0-118-A,7717-05-7349,Roads,3.034,AC,0,0,0,0,0,0,0,0,0,0,0,0,A2,AG/LTD,,,
5228,67-2-B-12-0,7723-45-9167,SNGL FAM SUB,0,AC,184000,0,184000,335800,15400,535200,160000,0,160000,279100,13600,452700,R1,RES/LTD,,,
5229,43-14-0-B-0,6777-30-5435,AG 20-100 AC,22.66,AC,317000,0,317000,363400,126100,806500,283500,0,283500,295100,118400,697000,A2,AG/LTD,,,
5235,63-1-0-182-0,7724-02-3721,SNGL FAM SUB,9.918,AC,369900,0,369900,0,0,369900,321700,0,321700,0,0,321700,R3A2,RES GEN,,,
5236,63-1-0-184-0,7714-92-5645,SNGL FAM SUB,2.017,AC,148600,0,148600,0,0,148600,129300,0,129300,0,0,129300,R3,RES/GEN,,,
5237,11-1-0-35-A,6821-24-0486,SNGL FAM SUB,2.77,AC,50600,0,50600,15000,1300,66900,49500,0,49500,15000,1300,65800,A1,AG/GEN,,,
5238,62-1-0-9-B,7714-00-3143,COMM & IND,33.4,AC,184000,0,184000,0,0,184000,171300,0,171300,0,0,171300,M2,INDUS/G,,,
5239,48-1-0-23-0,7727-43-8026,SNGL FAM SUB,16.41,AC,956700,0,956700,0,0,956700,886100,0,886100,0,0,886100,B1A2,BS AND,,,
5243,60-2-0-C-0,6785-00-6291,SNGL FAM SUB,6.659,AC,270700,0,270700,0,0,270700,241500,0,241500,0,0,241500,A2,AG/LTD,,,
5245,60-7-0-B-1,6784-19-1990,SNGL FAM SUB,1.713,AC,15600,0,15600,0,0,15600,13900,0,13900,0,0,13900,A2,AG/LTD,,,
5246,60-9-0-1-0,6784-09-6893,SNGL FAM SUB,8.8,AC,314000,0,314000,0,0,314000,280000,0,280000,0,0,280000,A2,AG/LTD,,,
5248,60-1-0-3-0,6785-00-3562,SNGL FAM SUB,9.8,AC,482300,0,482300,996200,15000,1493500,430900,0,430900,847600,15000,1293500,A2,AG/LTD,,,
5249,56-4-0-B-1,6795-14-7626,SNGL FAM SUB,4.9,AC,39700,0,39700,0,0,39700,34500,0,34500,0,0,34500,A2,AG/LTD,,,
5250,48-1-0-22-0,7727-50-5994,SNGL FAM SUB,15.007,AC,480200,473300,6900,0,0,480200,428700,422300,6400,0,0,428700,A2,AG/LTD,,,
5251,48-1-0-24-A,7727-60-2827,SNGL FAM SUB,9.349,AC,295300,290500,4800,0,0,295300,264100,260100,4000,0,0,264100,A2,AG/LTD,,,
5252,47-1-0-99-0,7727-31-8780,AG 20-100 AC,77,AC,8561600,8524800,36800,0,0,8561600,7783400,7750500,32900,0,0,7783400,B1A2,BS AND,,,
5253,56-1-0-42-0,6795-47-2001,AG > 100 AC,210.5,AC,3415200,3315700,99500,0,0,3415200,2970200,2880500,89700,0,0,2970200,A2,AG/LTD,,,
5254,62-1-0-9-0,7703-99-9412,AG 20-100 AC,48.8,AC,331800,0,331800,0,0,331800,287900,0,287900,0,0,287900,A2,AG/LTD,,,
5255,62-6-0-C-2,7704-70-5478,AG 20-100 AC,47.1,AC,320300,0,320300,0,0,320300,277900,0,277900,0,0,277900,A2,AG/LTD,,,
5257,63-1-0-180-C,7724-12-0949,SNGL FAM SUB,3.927,AC,212800,0,212800,0,0,212800,185100,0,185100,0,0,185100,R3,RES/GEN,,,
5258,63-1-0-183-0,7714-92-4856,SNGL FAM SUB,1.199,AC,127300,0,127300,0,0,127300,110700,0,110700,0,0,110700,R3,RES/GEN,,,
5260,63-28-0-A-0,7724-03-3089,SNGL FAM SUB,1.437,AC,145900,0,145900,0,0,145900,126800,0,126800,0,0,126800,R3,RES/GEN,,,
5262,2-3-0-18-0,6824-13-9352,SNGL FAM SUB,4.39,AC,55600,0,55600,132100,5800,193500,54400,0,54400,111800,5100,171300,A1,AG/GEN,,,
5263,47-1-0-110-0,7727-47-5353,COMM & IND,0.771,AC,36500,0,36500,0,0,36500,34800,0,34800,0,0,34800,M2,INDUS/G,,,
5264,48-1-0-10-A,7727-79-3403,COMM & IND,13.342,AC,1803800,0,1803800,0,0,1803800,1718500,0,1718500,0,0,1718500,M2,INDUS/G,,,
5265,48-1-0-13-0,7727-48-8719,COMM & IND,3.413,AC,678400,0,678400,0,154100,832500,646100,0,646100,0,125700,771800,M2,INDUS/G,,,
5266,48-1-0-20-0,7727-45-5927,COMM & IND,2.69,AC,363700,0,363700,0,0,363700,346500,0,346500,0,0,346500,M2,INDUS/G,,,
5267,48-1-0-40-0,7727-56-1101,COMM & IND,20.322,AC,1686900,0,1686900,1229100,508100,3424100,1607000,0,1607000,1172600,496800,3276400,M2,INDUS/G,,,
5268,48-1-0-41-0,7727-46-8720,COMM & IND,4.322,AC,525900,0,525900,0,0,525900,501000,0,501000,0,0,501000,M2,INDUS/G,,,
5269,48-1-0-46-0,7727-57-5415,COMM & IND,9.221,AC,935000,0,935000,0,0,935000,890700,0,890700,0,0,890700,M2,INDUS/G,,,
5270,48-1-0-47-B,7727-78-6438,COMM & IND,0.531,AC,29600,0,29600,0,0,29600,28200,0,28200,0,0,28200,M2,INDUS/G,,,
5271,62-1-0-8-0,7704-71-1410,SNGL FAM SUB,0.776,AC,32200,0,32200,0,0,32200,28000,0,28000,0,0,28000,A2,AG/LTD,,,
5272,62-16-0-A-2,7704-82-1889,COMM & IND,66.92,AC,2249300,0,2249300,0,0,2249300,2082200,0,2082200,0,0,2082200,A2,AG/LTD,,,
5273,62-16-0-A-3,7704-62-4202,COMM & IND,39.36,AC,1494700,0,1494700,0,0,1494700,1383700,0,1383700,0,0,1383700,A2,AG/LTD,,,
5274,2-3-0-4-0,6824-33-5517,SNGL FAM SUB,3.64,AC,49600,0,49600,232000,2700,284300,48600,0,48600,215000,3000,266600,A1,AG/GEN,,,
5275,46-12-0-1-0,7717-10-2847,SNGL FAM SUB,3.45,AC,154900,0,154900,291200,1500,447600,138400,0,138400,244900,1500,384800,A2,AG/LTD,,,
5276,62-2-A-3-0,7704-93-8658,SNGL FAM SUB,0.81,AC,115000,0,115000,313500,2200,430700,100000,0,100000,282400,1500,383900,R1,RES/LTD,,,
5277,46-23-0-28-0,7707-84-3226,SNGL FAM SUB,2.165,AC,165000,0,165000,298500,800,464300,150000,0,150000,248900,800,399700,A2,AG/LTD,,,
5278,63-29-0-A-1,7724-13-4466,COMM & IND,2.387,AC,362900,0,362900,0,0,362900,329800,0,329800,0,0,329800,RO,RES/OF,,,
5279,57-1-0-35-C,7705-49-3319,SNGL FAM SUB,13.695,AC,482900,0,482900,584200,1500,1068600,420300,0,420300,493500,1500,915300,A2,AG/LTD,,,
5280,64-12-B-13-0,7723-69-0974,SNGL FAM SUB,0,AC,77000,0,77000,163400,800,241200,67000,0,67000,141900,800,209700,A2,AG/LTD,,,
5281,26-1-0-35-M,6718-01-0754,SNGL FAM SUB,3.01,AC,50100,0,50100,141000,7400,198500,49100,0,49100,120500,8100,177700,A1,AG/GEN,,,
5282,29-1-0-68-0,6749-54-4240,SNGL FAM SUB,6.66,AC,93500,0,93500,150000,0,243500,88800,0,88800,137000,0,225800,A1,AG/GEN,,,
5283,29-1-0-73-A,6749-55-2271,SNGL FAM SUB,18.47,AC,175600,0,175600,200000,60800,436400,172200,0,172200,165000,21900,359100,A1,AG/GEN,,,
5284,28-1-0-51-0,6738-26-3691,SNGL FAM SUB,4.17,AC,73300,0,73300,0,0,73300,72100,0,72100,0,0,72100,A1,AG/GEN,,,
5285,58-21-A-2-0,7716-53-5468,SNGL FAM SUB,2.369,AC,310000,0,310000,250200,1000,561200,285000,0,285000,228300,1000,514300,A2,AG/LTD,,,
5286,20-11-0-19-0,6841-90-7576,SNGL FAM SUB,2,AC,55600,0,55600,156000,7900,219500,52500,0,52500,152200,6100,210800,A1,AG/GEN,,,
5287,12-3-0-3-B,6831-18-1566,SNGL FAM SUB,19.38,AC,149800,0,149800,267300,32900,450000,144300,0,144300,228400,30400,403100,A1,AG/GEN,,,
5288,63-1-0-132-B,7715-71-2819,SNGL FAM SUB,1.09,AC,110200,0,110200,0,3600,113800,95900,0,95900,0,3600,99500,A2,AG/LTD,,,
5289,42-1-0-107-0,6767-12-5002,COMM & IND,8.01,AC,414800,0,414800,0,62000,476800,398900,0,398900,0,42700,441600,B1A2,BS AND,,,
5290,29-1-0-84-0,6749-75-8359,SNGL FAM SUB,2,AC,64000,0,64000,166900,1000,231900,59800,0,59800,142500,1000,203300,A1,AG/GEN,,,
5291,30-6-0-3-0,6759-53-2790,SNGL FAM SUB,1.29,AC,56900,0,56900,178300,0,235200,52900,0,52900,149200,0,202100,A2,AG/LTD,,,
5292,30-6-0-2-0,6759-53-3862,SNGL FAM SUB,1.27,AC,56700,0,56700,127000,3500,187200,52700,0,52700,104800,3500,161000,A2,AG/LTD,,,
5293,31-1-0-29-0,6768-97-9302,SNGL FAM SUB,3,AC,94300,0,94300,322000,0,416300,84200,0,84200,298800,0,383000,A2,AG/LTD,,,
5294,56-1-0-79-0,6795-89-5225,AG 20-100 AC,22.338,AC,662600,454300,208300,667000,20800,1350400,574800,387500,187300,576000,14100,1164900,A2,AG/LTD,,,
5295,18-3-0-2-B2,6810-92-0072,SNGL FAM SUB,3.79,AC,56500,0,56500,347400,2800,406700,53300,0,53300,288600,3200,345100,A1,AG/GEN,,,
5296,18-3-0-2-B,6810-92-0284,SNGL FAM SUB,15.21,AC,115700,0,115700,226800,17500,360000,116200,0,116200,189200,15100,320500,A1,AG/GEN,,,
5298,67-10-0-20-0,7733-05-9711,SNGL FAM SUB,2,AC,323000,0,323000,726600,51600,1101200,270800,0,270800,584700,51900,907400,R1,RES/LTD,,,
5299,10-1-0-27-0,6811-18-5526,AG 20-100 AC,80.62,AC,79100,0,79100,123600,4200,206900,72200,0,72200,107300,4200,183700,A1,AG/GEN,,,
5300,64-12-D-3-0,7723-59-2773,SNGL FAM SUB,0,AC,111700,0,111700,171500,400,283600,97200,0,97200,153100,400,250700,R1,RES/LTD,,,
5301,2-1-0-19-0,6814-83-3117,SNGL FAM SUB,9.3,AC,82000,0,82000,0,0,82000,80500,0,80500,0,0,80500,A1,AG/GEN,,,
5302,4-1-0-41-0,6814-00-3786,AG > 100 AC,195.2,AC,775300,685300,90000,0,0,775300,760100,677100,83000,0,0,760100,A1,AG/GEN,,,
5303,21-1-0-52-B,6850-64-8673,SNGL FAM SUB,0.67,AC,6200,0,6200,0,0,6200,5600,0,5600,0,0,5600,A2,AG/LTD,,,
5304,62-2-B-1-0,7714-03-1828,Cmn Area/Open Spc,0,AC,0,0,0,0,0,0,0,0,0,0,0,0,R1,RES/LTD,,,
5307,62-1-0-31-C,7714-14-2918,Cmn Area/Open Spc,2.33,AC,0,0,0,0,0,0,0,0,0,0,0,0,R1,RES/LTD,,,
5308,62-2-A-1-0,7714-03-1651,Cmn Area/Open Spc,0.798,AC,0,0,0,0,0,0,0,0,0,0,0,0,R1,RES/LTD,,,
5309,62-2-B-2-0,7704-93-9991,SNGL FAM SUB,0,AC,115000,0,115000,0,0,115000,100000,0,100000,0,0,100000,R1,RES/LTD,,,
5310,62-2-D-1-0,7714-03-3650,Cmn Area/Open Spc,0.69,AC,0,0,0,0,0,0,0,0,0,0,0,0,R1,RES/LTD,,,
5311,62-3-D-2-A,7714-03-4864,Cmn Area/Open Spc,0.14,AC,0,0,0,0,0,0,0,0,0,0,0,0,R1,RES/LTD,,,
5313,62-13-A-A-0,7714-06-7026,SNGL FAM SUB,0,AC,46000,0,46000,0,0,46000,35000,0,35000,0,0,35000,R1,RES/LTD,,,
5314,62-13-A-C-0,7714-05-9781,Cmn Area/Open Spc,0,AC,0,0,0,0,0,0,0,0,0,0,0,0,R1,RES/LTD,,,
5315,62-17-D-1-0,7714-06-4443,Cmn Area/Open Spc,0,AC,0,0,0,0,0,0,0,0,0,0,0,0,R1,RES/LTD,,,
5316,62-20-A-19-0,7714-15-1813,SNGL FAM SUB,0,AC,115000,0,115000,211100,0,326100,100000,0,100000,195100,0,295100,R1,RES/LTD,,,
5317,62-20-A-21-0,7714-06-9044,SNGL FAM SUB,0,AC,115000,0,115000,283600,0,398600,100000,0,100000,265200,0,365200,R1,RES/LTD,,,
5318,62-20-A-22-0,7714-06-8173,SNGL FAM SUB,0,AC,115000,0,115000,330300,45900,491200,100000,0,100000,297600,38400,436000,R1,RES/LTD,,,
5319,62-20-A-24-0,7714-06-5159,SNGL FAM SUB,0,AC,115000,0,115000,330300,500,445800,100000,0,100000,302500,500,403000,R1,RES/LTD,,,
5320,62-20-D-2-0,7714-06-6496,SNGL FAM SUB,1.5,AC,115000,0,115000,289900,2200,407100,100000,0,100000,277100,1900,379000,R1,RES/LTD,,,
5322,62-20-D-4-0,7714-06-8591,SNGL FAM SUB,0,AC,115000,0,115000,382500,0,497500,100000,0,100000,353300,0,453300,R1,RES/LTD,,,
5323,62-21-0-5-0,7714-07-7907,SNGL FAM SUB,8.33,AC,386700,0,386700,375900,0,762600,336300,0,336300,362000,0,698300,A2,AG/LTD,,,
5324,62-24-0-1-0,7704-87-1614,SNGL FAM SUB,2.06,AC,198000,0,198000,285700,5100,488800,180000,0,180000,247900,3500,431400,R1,RES/LTD,,,
5325,62-24-0-2-0,7704-87-3690,SNGL FAM SUB,2.32,AC,198000,0,198000,436300,14700,649000,180000,0,180000,393300,13700,587000,R1,RES/LTD,,,
5326,62-24-0-3-0,7704-87-6575,SNGL FAM SUB,2.08,AC,198000,0,198000,258500,20900,477400,180000,0,180000,236500,17600,434100,R1,RES/LTD,,,
5327,62-24-0-4-0,7704-97-0409,SNGL FAM SUB,2.35,AC,198000,0,198000,210400,21800,430200,180000,0,180000,183100,18500,381600,R1,RES/LTD,,,
5328,62-24-0-7-0,7704-96-6881,SNGL FAM SUB,2.4,AC,198000,0,198000,509200,1500,708700,180000,0,180000,448700,1500,630200,R1,RES/LTD,,,
5329,62-24-0-8-0,7704-97-8028,SNGL FAM SUB,2.04,AC,198000,0,198000,562800,23300,784100,180000,0,180000,488100,19700,687800,R1,RES/LTD,,,
5330,62-24-0-11-0,7714-06-1877,SNGL FAM SUB,2.09,AC,198000,0,198000,322000,12700,532700,180000,0,180000,281200,12000,473200,R1,RES/LTD,,,
5331,62-24-0-13-0,7704-96-9472,SNGL FAM SUB,2.94,AC,198000,0,198000,309900,36900,544800,180000,0,180000,272200,31300,483500,R1,RES/LTD,,,
5332,62-24-0-14-0,7704-96-8016,SNGL FAM SUB,2.47,AC,198000,0,198000,241300,29800,469100,180000,0,180000,209000,26100,415100,R1,RES/LTD,,,
5333,62-24-0-15-0,7704-96-5297,SNGL FAM SUB,2.14,AC,198000,0,198000,228900,30200,457100,180000,0,180000,200500,25000,405500,R1,RES/LTD,,,
5334,62-24-0-16-0,7704-96-4532,SNGL FAM SUB,2.86,AC,198000,0,198000,355400,40300,593700,180000,0,180000,309200,36600,525800,R1,RES/LTD,,,
5335,62-24-0-17-0,7704-96-2892,SNGL FAM SUB,2.94,AC,198000,0,198000,315500,0,513500,180000,0,180000,274800,0,454800,R1,RES/LTD,,,
5336,62-24-0-19-0,7704-87-6159,SNGL FAM SUB,2.62,AC,198000,0,198000,298700,3100,499800,180000,0,180000,264700,3400,448100,R1,RES/LTD,,,
5337,62-24-0-20-0,7704-87-3242,SNGL FAM SUB,2.35,AC,198000,0,198000,318800,0,516800,180000,0,180000,278400,0,458400,R1,RES/LTD,,,
5338,62-24-0-21-0,7704-87-0229,SNGL FAM SUB,2.1,AC,198000,0,198000,336500,32400,566900,180000,0,180000,297100,27600,504700,R1,RES/LTD,,,
5341,39-1-0-39-0,6717-92-5526,SNGL FAM SUB,12.682,AC,98400,0,98400,0,81900,180300,96400,0,96400,0,81900,178300,A1,AG/GEN,,,
5342,26-1-0-15-0,6709-93-0181,SNGL FAM SUB,2.783,AC,50700,0,50700,224100,1000,275800,47800,0,47800,182900,1100,231800,A1,AG/GEN,,,
5344,12-1-0-31-0,6821-93-8695,SNGL FAM SUB,6.429,AC,76100,0,76100,0,0,76100,76400,0,76400,0,0,76400,A1,AG/GEN,,,
5345,12-2-0-4-0,6821-83-0655,AG 20-100 AC,33.83,AC,203300,0,203300,2000,0,205300,193100,0,193100,2000,0,195100,A1,AG/GEN,,,
5346,19-3-0-4-0,6830-17-3326,AG 20-100 AC,21.2,AC,174000,0,174000,215100,8700,397800,169900,0,169900,176600,6900,353400,A1,AG/GEN,,,
5347,42-16-C-4-0,6757-94-7847,SNGL FAM SUB,1.248,AC,81500,0,81500,235800,9900,327200,74000,0,74000,219000,8100,301100,R1,RES/LTD,,,
5348,26-1-0-16-A,6709-91-5576,SNGL FAM SUB,10.01,AC,89300,0,89300,0,0,89300,87600,0,87600,0,0,87600,A1,AG/GEN,,,
5349,57-1-0-28-C,7706-11-4646,SNGL FAM SUB,2,AC,111700,0,111700,481800,47500,641000,97200,0,97200,416600,43600,557400,A2,AG/LTD,,,
5350,57-1-0-28-D,7706-11-4838,SNGL FAM SUB,2,AC,111700,0,111700,466300,0,578000,97200,0,97200,407100,0,504300,A2,AG/LTD,,,
5351,64-12-B-14-0,7723-59-9907,SNGL FAM SUB,0,AC,77000,0,77000,260000,0,337000,67000,0,67000,221000,0,288000,R1,RES/LTD,,,
5352,62-18-0-8-0,7704-64-6667,SNGL FAM SUB,3.2,AC,223800,0,223800,408100,33300,665200,200300,0,200300,365200,28300,593800,A2,AG/LTD,,,
5354,45-18-0-3-0,6797-46-5848,SNGL FAM SUB,3.92,AC,170000,0,170000,327100,18900,516000,153000,0,153000,297800,15700,466500,A2,AG/LTD,,,
5355,39-4-0-9-0,6726-47-9055,SNGL FAM SUB,10,AC,89200,0,89200,306000,6400,401600,87500,0,87500,258900,6400,352800,A1,AG/GEN,,,
5356,47-1-0-90-0,7726-37-3358,SNGL FAM SUB,0.501,AC,220800,0,220800,40200,7400,268400,200700,0,200700,32000,7500,240200,R3,RES/GEN,,,
5357,58-21-C-10-0,7716-22-7669,SNGL FAM SUB,4.477,AC,365000,0,365000,511400,2500,878900,335000,0,335000,465800,2700,803500,R3,RES/GEN,,,
5358,58-21-A-5-0,7716-53-0850,SNGL FAM SUB,1.099,AC,279000,0,279000,291000,0,570000,256500,0,256500,269400,0,525900,A2,AG/LTD,,,
5359,63-1-0-110-A,7715-32-5413,SNGL FAM SUB,7.52,AC,286600,0,286600,673300,25500,985400,249400,0,249400,569400,20900,839700,A2,AG/LTD,,,
5360,17-1-0-41-0,6810-19-3304,AG 20-100 AC,20,AC,123600,0,123600,482800,40100,646500,123600,0,123600,408400,42900,574900,A1,AG/GEN,,,
5363,38-6-0-3-0,6717-08-9227,SNGL FAM SUB,3,AC,50000,0,50000,180200,0,230200,49000,0,49000,158600,0,207600,A1,AG/GEN,,,
5364,9-1-0-32-0,5892-43-0536,SNGL FAM SUB,13.58,AC,69100,0,69100,0,0,69100,68200,0,68200,0,0,68200,A1,AG/GEN,,,
5365,4-1-0-1-A,6804-50-5972,SNGL FAM SUB,14.262,AC,100600,54500,46100,256900,0,357500,82500,78300,4200,248800,0,331300,A1,AG/GEN,,,
5366,4-4-0-2-0,6804-60-2461,AG 20-100 AC,20.58,AC,122900,0,122900,120300,14300,257500,120700,0,120700,99400,10500,230600,A1,AG/GEN,,,
5367,39-1-0-88-0,6727-22-6039,AG 20-100 AC,89.69,AC,384200,300500,83700,615800,76500,1076500,375000,298900,76100,510700,79700,965400,A1,AG/GEN,,,
5373,15-1-0-24-0,5789-49-3897,SNGL FAM SUB,1.75,AC,41500,0,41500,58500,300,100300,40600,0,40600,51900,300,92800,A1,AG/GEN,,,
5374,39-1-0-88-C,6727-33-1170,SNGL FAM SUB,5.11,AC,61800,0,61800,141300,1100,204200,60600,0,60600,121500,1900,184000,A1,AG/GEN,,,
5375,39-1-0-88-D,6727-23-7047,SNGL FAM SUB,5.66,AC,64900,0,64900,99300,3200,167400,63600,0,63600,84700,10100,158400,A1,AG/GEN,,,
5376,51-1-0-41-0,6726-93-4980,SNGL FAM SUB,3.01,AC,50100,0,50100,118400,1400,169900,49100,0,49100,99700,1400,150200,A1,AG/GEN,,,
5377,50-1-0-6-0,6726-35-3230,SNGL FAM SUB,8.63,AC,85300,0,85300,0,3500,88800,82700,0,82700,0,3500,86200,A1,AG/GEN,,,
5378,55-1-0-37-0,6785-58-8235,SNGL FAM SUB,8.78,AC,187600,0,187600,252100,14500,454200,167600,0,167600,203100,14500,385200,A2,AG/LTD,,,
5379,42-1-0-46-0,6767-03-6374,COMM & IND,0.489,AC,74300,0,74300,142100,5000,221400,71400,0,71400,136900,5100,213400,B1,BUS/GEN,,,
5380,42-1-0-99-0,6767-02-8995,General Gov,0.302,AC,58600,0,58600,176500,4000,239100,56400,0,56400,178600,4000,239000,B1,BUS/GEN,,,
5381,42-1-0-100-0,6767-12-0905,General Gov,0.43,AC,55700,0,55700,79700,0,135400,53600,0,53600,80000,0,133600,B1,BUS/GEN,,,
5382,42-1-0-101-0,6767-12-0817,General Gov,0.024,AC,4700,0,4700,0,0,4700,4500,0,4500,0,0,4500,B1,BUS/GEN,,,
5383,42-1-0-106-0,6767-12-0381,COMM & IND,1.119,AC,139800,0,139800,136900,0,276700,134400,0,134400,128600,0,263000,B1,BUS/GEN,,,
5384,42-3-0-15-0,6767-05-7173,SNGL FAM SUB,0.688,AC,70000,0,70000,349900,6500,426400,65000,0,65000,291700,6500,363200,R3,RES/GEN,,,
5385,42-3-0-15-A,6767-05-7169,SNGL FAM SUB,0.103,AC,3500,0,3500,0,0,3500,3300,0,3300,0,0,3300,R3,RES/GEN,,,
5386,42-14-0-B-2,6767-12-1328,COMM & IND,0.029,AC,3600,0,3600,0,0,3600,3500,0,3500,0,0,3500,B1,BUS/GEN,,,
5387,42-1-0-59-0,6757-85-6228,SNGL FAM SUB,3.228,AC,95000,0,95000,0,0,95000,83500,0,83500,0,0,83500,A2,AG/LTD,,,
5390,42-20-0-A-0,6767-14-1926,SNGL FAM SUB,5,AC,138700,0,138700,0,0,138700,127500,0,127500,0,0,127500,R3A2,RES GEN,,,
5392,29-12-0-8-0,6748-67-7905,SNGL FAM SUB,1,AC,54000,0,54000,103500,17100,174600,49900,0,49900,89400,17100,156400,A1,AG/GEN,,,
5393,29-12-0-8-A,6748-67-8894,SNGL FAM SUB,0.37,AC,3700,0,3700,0,0,3700,3500,0,3500,0,0,3500,A1,AG/GEN,,,
5394,67-2-C-7-0,7723-55-2169,SNGL FAM SUB,0,AC,176600,0,176600,390400,0,567000,153600,0,153600,334400,0,488000,R1,RES/LTD,,,
5395,46-27-A-8-0,7707-85-6869,SNGL FAM SUB,2.538,AC,165000,0,165000,390000,32400,587400,150000,0,150000,325500,27000,502500,RR,RES/RUR,,,
5396,58-3-A-22-0,7726-26-5685,SNGL FAM SUB,0,AC,88000,0,88000,163900,1200,253100,80000,0,80000,135600,1200,216800,RN,RESIDEN,,,
5397,58-3-A-20-0,7726-26-7435,SNGL FAM SUB,0.523,AC,88000,0,88000,135700,800,224500,80000,0,80000,113100,800,193900,RN,RESIDEN,,,
5399,63-24-0-A-1,7713-88-4298,SNGL FAM SUB,19.1,AC,669800,0,669800,0,17300,687100,582300,0,582300,0,17200,599500,A2,AG/LTD,,,
5400,9-1-0-42-A,5892-41-5345,SNGL FAM SUB,1,AC,38800,0,38800,6000,0,44800,38000,0,38000,6000,0,44000,A1,AG/GEN,,,
5401,63-3-D-21-0,7714-81-8732,SNGL FAM SUB,0,AC,70000,0,70000,282000,0,352000,60000,0,60000,249900,0,309900,R1,RES/LTD,,,
5402,63-3-B-E-0,7714-81-7892,SNGL FAM SUB,0.303,AC,7200,0,7200,0,0,7200,6300,0,6300,0,0,6300,R1,RES/LTD,,,
5403,64-2-0-4-0,7733-07-2735,SNGL FAM SUB,1.677,AC,201400,0,201400,829200,10000,1040600,175100,0,175100,707800,9200,892100,R1,RES/LTD,,,
5404,64-2-0-9-0,7723-97-5346,SNGL FAM SUB,1.11,AC,180200,0,180200,641200,63300,884700,156700,0,156700,539600,58500,754800,R1,RES/LTD,,,
5405,5-2-0-2-0,6823-27-4843,SNGL FAM SUB,2.5,AC,47400,0,47400,37000,0,84400,46500,0,46500,33500,0,80000,A1,AG/GEN,,,
5406,46-23-0-8-0,7707-95-6631,SNGL FAM SUB,2.331,AC,165000,0,165000,289600,4100,458700,150000,0,150000,243200,4100,397300,A2,AG/LTD,,,
5407,46-23-0-9-0,7707-95-5377,SNGL FAM SUB,3.052,AC,165000,0,165000,248700,0,413700,150000,0,150000,206800,0,356800,A2,AG/LTD,,,
5408,63-1-0-80-0,7713-98-6334,SNGL FAM SUB,10.87,AC,412000,0,412000,0,1500,413500,358200,0,358200,0,1500,359700,A2,AG/LTD,,,
5409,63-24-0-A-0,7713-98-0288,SNGL FAM SUB,3.006,AC,488000,0,488000,2073100,100800,2661900,424300,0,424300,1769300,90600,2284200,A2,AG/LTD,,,
5410,1-1-0-30-0,6814-26-7280,AG 20-100 AC,40.257,AC,192600,173700,18900,0,0,192600,265500,200400,65100,153500,108300,527300,A1,AG/GEN,,,
5411,12-1-0-68-0,6831-55-4096,AG 20-100 AC,30.265,AC,189600,124700,64900,246300,57200,493100,182200,120800,61400,202900,47600,432700,A1,AG/GEN,,,
5412,55-14-0-14-0,6786-20-3674,SNGL FAM SUB,12.7,AC,231100,0,231100,891400,12700,1135200,206600,0,206600,764500,10800,981900,A2,AG/LTD,,,
5413,40-1-0-15-0,6736-16-0732,SNGL FAM SUB,18.895,AC,133200,121900,11300,0,0,133200,130700,120100,10600,0,0,130700,A1,AG/GEN,,,
5414,40-2-0-B-0,6726-98-9495,SNGL FAM SUB,3.5,AC,62600,0,62600,308400,30400,401400,61500,0,61500,275500,25800,362800,A1,AG/GEN,,,
5415,46-1-0-111-0,7707-97-7225,SNGL FAM SUB,2.41,AC,110800,0,110800,90000,10900,211700,99000,0,99000,76400,9200,184600,A2,AG/LTD,,,
5416,28-1-0-66-0,6729-93-7211,SNGL FAM SUB,3.76,AC,65900,0,65900,0,3700,69600,63500,61900,1600,0,3700,67200,A1,AG/GEN,,,
5417,28-1-0-68-0,6729-93-4620,SNGL FAM SUB,13.74,AC,138300,0,138300,186500,0,324800,131300,81200,50100,154700,0,286000,A1,AG/GEN,,,
5418,28-1-0-88-A,6739-03-7260,AG 20-100 AC,26.18,AC,132800,0,132800,0,0,132800,136100,125000,11100,0,0,136100,A1,AG/GEN,,,
5419,45-1-0-44-0,6796-19-3382,AG > 100 AC,140,AC,1891500,0,1891500,0,0,1891500,1689000,0,1689000,0,0,1689000,A2,AG/LTD,,,
5420,45-1-0-52-0,6797-21-1986,AG > 100 AC,100,AC,1164000,0,1164000,0,0,1164000,1037900,0,1037900,0,0,1037900,A2,AG/LTD,,,
5421,20-14-0-1-0,6840-48-2985,SNGL FAM SUB,5,AC,83500,0,83500,335200,0,418700,82000,0,82000,293800,0,375800,A1,AG/GEN,,,
5422,20-14-0-2-0,6840-48-6967,SNGL FAM SUB,5,AC,83500,0,83500,0,0,83500,82000,0,82000,0,0,82000,A1,AG/GEN,,,
5423,20-14-0-3-0,6840-58-0927,SNGL FAM SUB,5,AC,83500,0,83500,308800,0,392300,82000,0,82000,274500,0,356500,A1,AG/GEN,,,
5424,20-14-0-4-0,6840-58-3999,SNGL FAM SUB,5,AC,83500,0,83500,294200,4400,382100,82000,0,82000,255500,3100,340600,A1,AG/GEN,,,
5425,20-14-0-5-0,6840-59-8003,SNGL FAM SUB,5,AC,83500,0,83500,277200,12700,373400,82000,0,82000,240500,9400,331900,A1,AG/GEN,,,
5426,20-14-0-6-0,6840-69-3028,SNGL FAM SUB,6.29,AC,93300,0,93300,265600,0,358900,91600,0,91600,245600,0,337200,A1,AG/GEN,,,
5427,20-1-0-47-0,6840-48-6306,SNGL FAM SUB,12.07,AC,120300,0,120300,522900,83600,726800,118500,0,118500,474200,79200,671900,A1,AG/GEN,,,
5428,20-1-0-65-0,6840-68-8524,SNGL FAM SUB,5,AC,83500,0,83500,207400,0,290900,82000,0,82000,199000,0,281000,A1,AG/GEN,,,
5429,20-1-0-65-A,6840-78-2008,SNGL FAM SUB,12.01,AC,145200,0,145200,181400,1000,327600,142500,0,142500,155900,1000,299400,A1,AG/GEN,,,
5430,20-13-0-1-0,6840-89-3118,SNGL FAM SUB,3.65,AC,72900,0,72900,0,0,72900,71500,0,71500,0,0,71500,A1,AG/GEN,,,
5431,20-13-0-2-0,6840-88-4477,SNGL FAM SUB,10.69,AC,140600,0,140600,123200,0,263800,137900,0,137900,107100,0,245000,A1,AG/GEN,,,
5432,20-13-0-3-0,6840-78-8383,SNGL FAM SUB,10.31,AC,137400,0,137400,461800,8600,607800,134800,0,134800,406600,6500,547900,A1,AG/GEN,,,
5433,20-13-0-4-0,6840-78-2716,SNGL FAM SUB,8.36,AC,114700,0,114700,330000,0,444700,112600,0,112600,287900,0,400500,A1,AG/GEN,,,
5434,20-13-0-5-0,6840-79-1104,SNGL FAM SUB,8.63,AC,117000,0,117000,469100,61100,647200,114800,0,114800,437700,58200,610700,A1,AG/GEN,,,
5435,20-13-0-6-0,6840-79-2572,SNGL FAM SUB,8.45,AC,115500,0,115500,379600,27900,523000,113300,0,113300,330800,25600,469700,A1,AG/GEN,,,
5436,20-13-0-7-0,6840-79-3904,SNGL FAM SUB,4.45,AC,79400,0,79400,259100,11000,349500,77900,0,77900,236300,12800,327000,A1,AG/GEN,,,
5438,20-13-0-9-0,6840-79-8736,SNGL FAM SUB,8.75,AC,118000,0,118000,297800,0,415800,115800,0,115800,260600,0,376400,A1,AG/GEN,,,
5439,20-13-0-10-0,6840-79-9035,SNGL FAM SUB,8.84,AC,124400,0,124400,0,0,124400,122100,0,122100,0,0,122100,A1,AG/GEN,,,
5440,5-34-0-A-0,6814-81-3449,SNGL FAM SUB,5.045,AC,60300,0,60300,225300,0,285600,59200,0,59200,210100,0,269300,A1,AG/GEN,,,
5443,44-1-0-37-0,6777-99-6644,AG 20-100 AC,37.472,AC,406900,311700,95200,400700,22800,830400,415800,328500,87300,325600,19900,761300,A2,AG/LTD,,,
5444,9-1-0-20-0,5892-64-7111,SNGL FAM SUB,5.061,AC,53400,0,53400,8100,1100,62600,50200,0,50200,8100,800,59100,A1,AG/GEN,,,
5445,58-8-0-1-0,7716-80-6849,SNGL FAM SUB,2.82,AC,281200,0,281200,0,0,281200,105100,103900,1200,0,0,105100,RPUD,RES/PUD,,,
5446,58-8-0-2-0,7716-90-4265,AG 20-100 AC,53.18,AC,5302000,0,5302000,0,0,5302000,1984100,1961500,22600,0,0,1984100,RPUD,RES/PUD,,,
5447,58-8-0-3-B,7726-00-0811,SNGL FAM SUB,3.01,AC,300100,0,300100,0,0,300100,148800,147500,1300,0,0,148800,RPUD,RES/PUD,,,
5448,9-1-0-35-C,5892-63-0754,SNGL FAM SUB,1,AC,38800,0,38800,91900,500,131200,38000,0,38000,80300,500,118800,A1,AG/GEN,,,
5449,32-4-0-3-0,6779-66-4246,SNGL FAM SUB,1.93,AC,77500,0,77500,197600,800,275900,69200,0,69200,166600,800,236600,A2,AG/LTD,,,
5450,21-1-0-41-0,6850-40-4748,SNGL FAM SUB,3.19,AC,80600,0,80600,195200,17700,293500,72700,0,72700,162600,15100,250400,A2,AG/LTD,,,
5451,21-1-0-41-A,6850-50-2932,SNGL FAM SUB,7.5,AC,123300,0,123300,424400,8100,555800,111000,0,111000,360800,8400,480200,A2,AG/LTD,,,
5452,20-12-0-8-0,6840-99-6557,SNGL FAM SUB,2.3,AC,58100,0,58100,182100,11600,251800,54400,0,54400,156800,10300,221500,A1,AG/GEN,,,
5453,62-18-0-1-0,7704-65-8058,SNGL FAM SUB,3.37,AC,227700,0,227700,357900,0,585600,200300,0,200300,316000,0,516300,A2,AG/LTD,,,
5456,58-21-A-4-0,7716-53-0548,SNGL FAM SUB,2.178,AC,310000,0,310000,612300,27800,950100,285000,0,285000,545800,26400,857200,A2,AG/LTD,,,
5457,46-23-0-29-0,7707-84-5501,SNGL FAM SUB,2.204,AC,165000,0,165000,418400,0,583400,150000,0,150000,350400,0,500400,A2,AG/LTD,,,
5458,63-1-0-49-0,7714-35-6075,SNGL FAM SUB,1.35,AC,124500,0,124500,123300,700,248500,108300,0,108300,104900,700,213900,R3,RES/GEN,,,
5459,27-1-0-34-0,6728-34-4901,AG 20-100 AC,22.14,AC,146600,0,146600,92800,6800,246200,143700,0,143700,80500,6800,231000,A1,AG/GEN,,,
5460,27-1-0-34-A,6728-25-8626,SNGL FAM SUB,7.55,AC,75500,0,75500,281400,0,356900,74000,0,74000,235900,0,309900,A1,AG/GEN,,,
5461,27-1-0-34-B,6728-35-9803,SNGL FAM SUB,2.25,AC,45800,0,45800,0,0,45800,44900,0,44900,0,0,44900,A1,AG/GEN,,,
5462,55-15-0-14-0,6785-77-2981,SNGL FAM SUB,3,AC,114300,0,114300,0,0,114300,102000,0,102000,0,0,102000,A2,AG/LTD,,,
5463,55-15-0-15-0,6785-78-0193,SNGL FAM SUB,3.01,AC,114500,0,114500,307700,0,422200,102100,0,102100,256500,0,358600,A2,AG/LTD,,,
5464,42-1-0-68-0,6757-89-7611,SNGL FAM SUB,3.13,AC,79800,0,79800,204700,23000,307500,72100,0,72100,169700,19700,261500,A2,AG/LTD,,,
5465,44-1-0-31-A,6787-12-8806,SNGL FAM SUB,3.89,AC,110000,0,110000,203100,30700,343800,98100,0,98100,166500,26100,290700,A2,AG/LTD,,,
5466,63-2-0-5-0,7723-28-1205,SNGL FAM SUB,4.162,AC,189300,0,189300,572200,0,761500,164500,0,164500,502000,0,666500,R1A2,RES LTD,,,
5467,30-1-0-37-0,6758-23-9658,SNGL FAM SUB,1,AC,37800,0,37800,0,0,37800,34900,0,34900,0,0,34900,A2,AG/LTD,,,
5468,31-17-0-3-0,6779-33-9337,SNGL FAM SUB,1.5,AC,71300,0,71300,179900,2000,253200,63700,0,63700,147400,2000,213100,A2,AG/LTD,,,
5469,57-20-C-1-0,7716-00-1174,SNGL FAM SUB,2.223,AC,315000,0,315000,315500,1000,631500,288800,0,288800,290600,1000,580400,A2,AG/LTD,,,
5470,47-6-0-5-0,7718-40-6644,SNGL FAM SUB,5.16,AC,169700,68600,101100,239100,1700,410500,151600,61400,90200,206000,1700,359300,A2,AG/LTD,,,
5472,54-3-0-C-3,6766-71-5160,SNGL FAM SUB,2.58,AC,6200,0,6200,0,0,6200,5400,0,5400,0,0,5400,A2,AG/LTD,,,
5477,54-5-0-9-0,6766-72-1777,AG 20-100 AC,58.722,AC,1118900,0,1118900,3487000,244100,4850000,1038900,0,1038900,3387700,188200,4614800,A2,AG/LTD,,,
5478,32-1-0-67-0,6788-49-7615,AG 20-100 AC,95.82,AC,1013800,969600,44200,0,0,1013800,903500,862800,40700,0,0,903500,A2,AG/LTD,,,
5479,12-1-0-19-0,6832-02-5372,SNGL FAM SUB,3,AC,56600,0,56600,192600,14700,263900,55000,0,55000,166900,1000,222900,A1,AG/GEN,,,
5480,32-1-0-64-0,6788-29-3655,AG > 100 AC,178.94,AC,1932600,1848600,84000,0,0,1932600,1717800,1641500,76300,0,0,1717800,A2,AG/LTD,,,
5481,32-1-0-56-0,6789-00-3672,AG > 100 AC,124.46,AC,1477500,1343600,133900,598300,248300,2324100,1321900,1203000,118900,489900,244000,2055800,A2,AG/LTD,,,
5482,51-6-0-A-1,6735-64-7701,AG > 100 AC,362.6,AC,1125900,848800,277100,680800,129200,1935900,1103700,851400,252300,636900,126600,1867200,A1,AG/GEN,,,
5483,51-6-0-D-0,6735-82-9791,AG > 100 AC,128.16,AC,256300,195900,60400,0,0,256300,256300,201700,54600,0,0,256300,A1,AG/GEN,,,
5484,38-1-0-130-0,6717-12-1664,SNGL FAM SUB,4.798,AC,24500,0,24500,0,6000,30500,24000,0,24000,0,5000,29000,A1,AG/GEN,,,
5485,38-1-0-131-0,6717-12-7965,SNGL FAM SUB,4.014,AC,20500,18600,1900,0,0,20500,20100,18400,1700,0,0,20100,A1,AG/GEN,,,
5486,58-8-0-2-A,7715-89-8595,SNGL FAM SUB,4.4,AC,176600,0,176600,349900,300,526800,153600,0,153600,292500,300,446400,A2,AG/LTD,,,
5487,58-1-0-111-0,7725-08-7523,SNGL FAM SUB,0.87,AC,101900,0,101900,107600,18100,227600,88600,0,88600,90500,14900,194000,A2,AG/LTD,,,
5488,28-1-0-87-A,6739-24-9677,SNGL FAM SUB,1.9,AC,53800,0,53800,70700,600,125100,51700,0,51700,59000,600,111300,A1,AG/GEN,,,
5489,46-1-0-117-A,7717-22-1161,SNGL FAM SUB,5,AC,162800,0,162800,466600,6500,635900,145300,0,145300,402800,4600,552700,A2,AG/LTD,,,
5490,45-1-0-116-0,6797-88-1502,SNGL FAM SUB,6.75,AC,149500,0,149500,292500,127700,569700,133300,0,133300,237500,107600,478400,A2,AG/LTD,,,
5491,21-1-0-2-0,6851-30-3399,SNGL FAM SUB,18.45,AC,174700,0,174700,0,1900,176600,171400,0,171400,0,2100,173500,A1,AG/GEN,,,
5492,17-1-0-44-A,6811-52-2020,SNGL FAM SUB,1.371,AC,40900,0,40900,113000,3400,157300,39900,0,39900,98500,3400,141800,A1,AG/GEN,,,
5493,17-1-0-44-0,6811-30-2898,AG 20-100 AC,26,AC,93400,81400,12000,0,0,93400,91000,79900,11100,0,0,91000,A1,AG/GEN,,,
5494,17-1-0-44-B,6811-31-5644,SNGL FAM SUB,11.742,AC,86900,81200,5700,0,0,86900,86300,81300,5000,0,0,86300,A1,AG/GEN,,,
5495,17-1-0-56-0,6810-36-6073,SNGL FAM SUB,3.39,AC,52200,0,52200,163800,14000,230000,51100,0,51100,142200,12900,206200,A1,AG/GEN,,,
5496,47-1-0-3-B,7718-41-5396,SNGL FAM SUB,2.62,AC,126500,0,126500,174500,3100,304100,113000,0,113000,144600,3100,260700,A2,AG/LTD,,,
5497,4-1-0-48-B,6803-86-8939,SNGL FAM SUB,4.009,AC,55000,0,55000,154900,3100,213000,54000,0,54000,137800,3100,194900,A1,AG/GEN,,,
5498,4-1-0-48-C,6803-96-1721,SNGL FAM SUB,4.578,AC,57900,0,57900,0,0,57900,56900,0,56900,0,0,56900,A1,AG/GEN,,,
5499,62-4-D-15-0,7714-15-0135,SNGL FAM SUB,0,AC,103500,0,103500,438200,0,541700,90000,0,90000,412300,0,502300,R1,RES/LTD,,,
5500,60-6-0-1-0,6784-19-9823,SNGL FAM SUB,1.5,AC,150900,0,150900,218900,3500,373300,134600,0,134600,179500,3500,317600,A2,AG/LTD,,,
5501,4-3-0-21-0,6803-93-9161,SNGL FAM SUB,4.73,AC,59600,0,59600,170800,26300,256700,58300,0,58300,144700,22200,225200,A1,AG/GEN,,,
5502,51-1-0-6-A,6726-82-1314,SNGL FAM SUB,3,AC,50000,0,50000,115100,0,165100,49000,0,49000,112000,0,161000,A1,AG/GEN,,,
5503,14-2-0-12-0,6851-27-5019,SNGL FAM SUB,3.11,AC,67400,0,67400,0,0,67400,66000,0,66000,0,0,66000,A1,AG/GEN,,,
5504,63-3-A-5-0,7714-91-1623,SNGL FAM SUB,0,AC,70000,0,70000,484300,0,554300,60000,0,60000,426000,0,486000,R1,RES/LTD,,,
5505,29-15-0-A-0,6749-81-5571,SNGL FAM SUB,8.564,AC,135100,0,135100,174900,200,310200,128500,0,128500,150100,200,278800,A1,AG/GEN,,,
5506,29-15-0-C-0,6749-71-8722,SNGL FAM SUB,13.053,AC,168000,0,168000,0,0,168000,163200,0,163200,0,0,163200,A1,AG/GEN,,,
5507,17-1-0-83-0,6709-99-9716,SNGL FAM SUB,13.68,AC,104200,0,104200,60600,16300,181100,101400,0,101400,50100,14700,166200,A1,AG/GEN,,,
5508,44-13-0-B-0,6787-63-4179,SNGL FAM SUB,2,AC,85900,0,85900,96000,1300,183200,76700,0,76700,79100,1300,157100,A2,AG/LTD,,,
5509,63-1-0-72-0,7714-43-3440,SNGL FAM SUB,0.19,AC,5000,0,5000,0,0,5000,4400,0,4400,0,0,4400,A2,AG/LTD,,,
5510,51-1-0-6-B,6726-82-5109,SNGL FAM SUB,6.61,AC,70200,0,70200,107800,1500,179500,68900,0,68900,94400,1500,164800,A1,AG/GEN,,,
5511,21-1-0-4-0,6850-28-6420,AG 20-100 AC,98.6,AC,45500,0,45500,0,0,45500,41900,0,41900,0,0,41900,A1,AG/GEN,,,
5512,10-6-0-A-3,6801-64-1194,AG 20-100 AC,26.37,AC,137600,82000,55600,160300,22500,320400,136300,77900,58400,141600,22500,300400,A1,AG/GEN,,,
5513,10-6-0-A-5,6801-55-4271,SNGL FAM SUB,5.57,AC,59800,0,59800,221500,45400,326700,58600,0,58600,202200,39800,300600,A1,AG/GEN,,,
5514,28-1-0-11-0,6738-09-0619,SNGL FAM SUB,3,AC,53800,0,53800,170700,0,224500,51900,0,51900,139800,0,191700,A1,AG/GEN,,,
5515,46-1-0-70-A,7707-61-3736,SNGL FAM SUB,1.723,AC,115500,0,115500,243900,24500,383900,103100,0,103100,202900,20700,326700,RR,RES/RUR,,,
5516,10-8-0-A-1,6801-63-0161,SNGL FAM SUB,15.77,AC,108500,100900,7600,0,0,108500,106600,99900,6700,0,0,106600,A1,AG/GEN,,,
5517,10-8-0-A-2,6801-52-8487,SNGL FAM SUB,5.86,AC,61200,58500,2700,0,0,61200,59900,57400,2500,0,0,59900,A1,AG/GEN,,,
5518,10-8-0-B-0,6801-53-3223,SNGL FAM SUB,15.24,AC,106100,99100,7000,0,0,106100,104500,98000,6500,0,0,104500,A1,AG/GEN,,,
5519,27-1-0-13-0,6719-51-5165,SNGL FAM SUB,10,AC,89200,0,89200,0,0,89200,87500,0,87500,0,0,87500,A1,AG/GEN,,,
5520,30-1-0-39-A,6758-34-0862,SNGL FAM SUB,1,AC,54000,0,54000,123500,2200,179700,49900,0,49900,102200,1500,153600,A2,AG/LTD,,,
5521,30-2-0-3-0,6758-45-2440,SNGL FAM SUB,4.81,AC,68400,0,68400,0,0,68400,65000,0,65000,0,0,65000,A2,AG/LTD,,,
5522,30-1-0-39-B,6758-34-4732,SNGL FAM SUB,2.008,AC,64100,0,64100,88800,0,152900,59400,0,59400,73600,0,133000,A2,AG/LTD,,,
5523,30-1-0-39-0,6758-44-5348,SNGL FAM SUB,3.77,AC,80700,0,80700,221900,7100,309700,75900,0,75900,183400,5100,264400,A2,AG/LTD,,,
5524,43-20-0-29-0,6768-51-9318,SNGL FAM SUB,3,AC,96800,0,96800,203300,34300,334400,88000,0,88000,179400,28800,296200,A2,AG/LTD,,,
5525,64-19-E-9-0,7733-47-4762,SNGL FAM SUB,1.026,AC,265000,0,265000,566000,700,831700,220000,0,220000,447600,700,668300,R1,RES/LTD,,,
5526,45-1-0-47-B,6796-37-2268,SNGL FAM SUB,6.62,AC,175400,0,175400,305800,39400,520600,156400,0,156400,251600,34400,442400,A2,AG/LTD,,,
5544,15-1-0-7-0,5880-77-9741,SNGL FAM SUB,10,AC,54200,49600,4600,0,0,54200,52200,47900,4300,0,0,52200,A1,AG/GEN,,,
5545,45-15-0-4-A,6797-63-5176,SNGL FAM SUB,3,AC,106900,0,106900,81000,0,187900,95500,0,95500,66400,0,161900,A2,AG/LTD,,,
5546,44-18-0-2-0,6786-38-0355,SNGL FAM SUB,3,AC,100300,0,100300,9700,1300,111300,89600,0,89600,9600,1300,100500,A2,AG/LTD,,,
5547,44-18-0-1-0,6786-38-2191,SNGL FAM SUB,3.01,AC,100500,0,100500,0,0,100500,89700,0,89700,0,0,89700,A2,AG/LTD,,,
5548,9-1-0-27-0,5892-45-7172,SNGL FAM SUB,4,AC,49100,0,49100,67500,800,117400,48000,0,48000,59500,800,108300,A1,AG/GEN,,,
5549,44-18-0-3-0,6786-28-7358,SNGL FAM SUB,3.12,AC,102100,0,102100,0,0,102100,91200,0,91200,0,0,91200,A2,AG/LTD,,,
5550,44-20-0-5-A,6787-42-4725,SNGL FAM SUB,2,AC,76900,0,76900,113400,0,190300,68600,0,68600,88800,0,157400,A2,AG/LTD,,,
5551,9-1-0-68-0,5892-62-5412,SNGL FAM SUB,5,AC,69000,0,69000,152600,35300,256900,67500,0,67500,131100,29900,228500,A1,AG/GEN,,,
5552,9-1-0-28-A,5892-45-6039,SNGL FAM SUB,2,AC,42400,0,42400,0,0,42400,41500,0,41500,0,0,41500,A1,AG/GEN,,,
5553,9-1-0-72-A,5892-73-9743,SNGL FAM SUB,1.352,AC,40100,0,40100,57100,400,97600,39200,0,39200,50300,400,89900,A1,AG/GEN,,,
5554,9-1-0-72-0,5892-83-1417,SNGL FAM SUB,10.648,AC,66500,0,66500,48700,800,116000,64100,0,64100,43500,800,108400,A1,AG/GEN,,,
5555,9-1-0-72-C,5892-83-2968,SNGL FAM SUB,1,AC,38800,0,38800,92500,1200,132500,38000,0,38000,82300,1200,121500,A1,AG/GEN,,,
5556,27-1-0-5-C,6719-52-5089,SNGL FAM SUB,3.84,AC,56800,0,56800,157300,1000,215100,55000,0,55000,132400,1000,188400,A1,AG/GEN,,,
5557,18-1-0-23-0,6719-78-6714,AG 20-100 AC,42,AC,145700,0,145700,0,0,145700,140000,0,140000,0,0,140000,A1,AG/GEN,,,
5558,50-5-0-14-0,6726-30-7817,SNGL FAM SUB,8.36,AC,70800,0,70800,691400,0,762200,67300,0,67300,655200,0,722500,A1,AG/GEN,,,
5559,47-1-0-43-E,7726-09-4861,SNGL FAM SUB,1.504,AC,123500,0,123500,293700,1400,418600,110200,0,110200,244100,1400,355700,A2,AG/LTD,,,
5560,47-25-0-1-0,7726-09-2930,SNGL FAM SUB,1.74,AC,98000,0,98000,0,0,98000,87500,0,87500,0,0,87500,A2,AG/LTD,,,
5561,45-1-0-91-D,6797-76-9766,SNGL FAM SUB,1,AC,76700,0,76700,153900,1000,231600,68500,0,68500,125600,1000,195100,A2,AG/LTD,,,
5562,45-1-0-91-G,6797-87-1330,SNGL FAM SUB,6.508,AC,163700,0,163700,0,0,163700,146200,0,146200,0,0,146200,A2,AG/LTD,,,
5563,63-1-0-153-0,7714-88-3752,AG 20-100 AC,62,AC,1438400,1409800,28600,0,0,1438400,1252400,1226000,26400,0,0,1252400,A2,AG/LTD,,,
5564,27-1-0-64-0,6729-30-4962,AG > 100 AC,183.6,AC,613200,528600,84600,0,18100,631300,598500,520500,78000,0,0,598500,A1,AG/GEN,,,
5565,6-4-0-3-0,6832-99-0160,SNGL FAM SUB,5.74,AC,80500,0,80500,443100,18900,542500,78800,0,78800,343600,19200,441600,A1,AG/GEN,,,
5566,46-1-0-97-F,7718-00-4224,SNGL FAM SUB,1.058,AC,98100,0,98100,164400,13900,276400,89100,0,89100,138600,11800,239500,A2,AG/LTD,,,
5567,62-2-B-18-0,7704-95-7277,SNGL FAM SUB,0,AC,115000,0,115000,215900,0,330900,100000,0,100000,199300,0,299300,R1,RES/LTD,,,
5569,43-20-0-34-0,6768-61-7650,SNGL FAM SUB,3.01,AC,96800,0,96800,159700,19600,276100,88000,0,88000,138800,16800,243600,A2,AG/LTD,,,
5570,4-1-0-49-0,6803-73-9748,AG 20-100 AC,35.89,AC,112600,0,112600,0,0,112600,110400,0,110400,0,0,110400,A1,AG/GEN,,,
5571,56-1-0-49-B,6796-22-8148,SNGL FAM SUB,2.915,AC,199400,0,199400,1205200,60000,1464600,173500,0,173500,1013100,60000,1246600,A2,AG/LTD,,,
5572,56-12-0-A-0,6796-12-8427,AG 20-100 AC,96.45,AC,1551300,1376700,174600,146400,12000,1709700,1349500,1198600,150900,128000,12000,1489500,A2,AG/LTD,,,
5573,56-12-0-D-0,6796-02-3121,AG 20-100 AC,35.2,AC,553900,466500,87400,649200,104100,1307200,496000,418700,77300,543900,86200,1126100,A2,AG/LTD,,,
5574,64-12-F-1-0,7723-59-3302,SNGL FAM SUB,0.557,AC,77000,0,77000,215100,3500,295600,67000,0,67000,186500,3500,257000,R1,RES/LTD,,,
5575,62-20-A-20-0,7714-15-0934,SNGL FAM SUB,0,AC,115000,0,115000,328700,200,443900,100000,0,100000,303300,200,403500,R1,RES/LTD,,,
5576,62-4-D-14-0,7714-05-9093,SNGL FAM SUB,0,AC,115000,0,115000,300400,1200,416600,100000,0,100000,272100,1200,373300,R1,RES/LTD,,,
5577,56-1-0-44-0,6795-49-1642,AG 20-100 AC,35.01,AC,733400,344300,389100,947500,36900,1717800,637800,298900,338900,798100,30700,1466600,A2,AG/LTD,,,
5578,46-26-0-1-0,7707-76-2909,SNGL FAM SUB,4.742,AC,158500,0,158500,414200,76200,648900,144100,0,144100,345100,63800,553000,A2,AG/LTD,,,
5579,6-1-0-28-0,6823-81-3356,SNGL FAM SUB,3.774,AC,53800,0,53800,147700,11700,213200,52900,0,52900,129400,10100,192400,A1,AG/GEN,,,
5580,10-9-0-2-0,6801-54-3564,SNGL FAM SUB,6,AC,61800,0,61800,379900,6700,448400,60500,0,60500,376500,6900,443900,A1,AG/GEN,,,
5581,13-1-0-54-0,6841-29-9985,AG 20-100 AC,97.01,AC,711000,505400,205600,1198400,65800,1975200,697500,472400,225100,1088700,66800,1853000,A1,AG/GEN,,,
5583,6-1-0-30-0,6823-70-3522,SNGL FAM SUB,5,AC,81000,0,81000,0,0,81000,78700,0,78700,0,0,78700,A1,AG/GEN,,,
5584,6-1-0-30-B,6823-70-8417,SNGL FAM SUB,4.3,AC,84100,0,84100,0,1800,85900,82900,0,82900,0,2000,84900,A1,AG/GEN,,,
5585,67-18-B-32-0,7733-25-5791,SNGL FAM SUB,5.167,AC,387600,0,387600,896400,16700,1300700,324900,0,324900,779600,17300,1121800,R1,RES/LTD,,,
5586,67-2-E-3-0,7723-65-2637,SNGL FAM SUB,0,AC,184000,0,184000,263200,1000,448200,160000,0,160000,218300,1000,379300,R1,RES/LTD,,,
5587,46-1-0-73-0,7707-63-9573,AG 20-100 AC,21.856,AC,466100,0,466100,204100,200,670400,415800,0,415800,174200,200,590200,A2RR,AG& RUR,,,
5588,6-1-0-52-0,6832-19-0119,SNGL FAM SUB,6.357,AC,72500,0,72500,0,0,72500,71900,0,71900,0,0,71900,A1,AG/GEN,,,
5589,64-13-0-2-0,7733-17-2481,SNGL FAM SUB,2.283,AC,309400,0,309400,545700,1600,856700,259400,0,259400,523600,1300,784300,R1,RES/LTD,,,
5590,12-6-0-7-0,6832-47-7137,SNGL FAM SUB,6.47,AC,101300,0,101300,374400,6100,481800,99400,0,99400,330400,5000,434800,A1,AG/GEN,,,
5591,62-13-A-10-0,7714-05-8769,SNGL FAM SUB,0,AC,115000,0,115000,254900,23400,393300,100000,0,100000,231400,20000,351400,R1,RES/LTD,,,
5592,62-13-A-11-0,7714-05-8627,SNGL FAM SUB,0,AC,115000,0,115000,247500,800,363300,100000,0,100000,235100,800,335900,R1,RES/LTD,,,
5593,45-17-0-G-0,6796-59-0808,SNGL FAM SUB,4.02,AC,130400,0,130400,272100,1100,403600,116400,0,116400,226700,1100,344200,A2,AG/LTD,,,
5594,45-1-0-73-A,6796-59-5559,SNGL FAM SUB,8.11,AC,198500,0,198500,187900,22300,408700,177100,0,177100,154300,19300,350700,A2,AG/LTD,,,
5596,45-17-0-A-0,6796-48-4666,SNGL FAM SUB,17.2,AC,331000,322600,8400,0,0,331000,295600,288200,7400,0,0,295600,A2,AG/LTD,,,
5597,45-17-0-D-0,6796-49-8004,SNGL FAM SUB,7.82,AC,190500,81600,108900,411600,120900,723000,170000,72700,97300,342300,109200,621500,A2,AG/LTD,,,
5598,45-17-0-F-0,6796-49-9467,SNGL FAM SUB,5,AC,145900,0,145900,263500,0,409400,130200,0,130200,205000,0,335200,A2,AG/LTD,,,
5599,45-17-0-E-0,6796-58-3843,SNGL FAM SUB,8.69,AC,207700,203300,4400,0,0,207700,185200,181500,3700,0,0,185200,A2,AG/LTD,,,
5600,45-17-0-C-0,6796-49-2448,SNGL FAM SUB,16.1,AC,337800,0,337800,363000,0,700800,301500,0,301500,304600,0,606100,A2,AG/LTD,,,
5601,46-1-0-88-A,7718-11-7319,SNGL FAM SUB,5.35,AC,169000,0,169000,299800,5400,474200,150800,0,150800,254100,5400,410300,A2,AG/LTD,,,
5602,46-1-0-89-A,7718-11-0211,SNGL FAM SUB,1.92,AC,113400,0,113400,188700,41400,343500,101300,0,101300,157200,35400,293900,A2,AG/LTD,,,
5603,46-1-0-89-0,7718-11-7164,SNGL FAM SUB,7.68,AC,210000,0,210000,0,7700,217700,187400,0,187400,0,7700,195100,A2,AG/LTD,,,
5604,32-4-0-8-0,6779-54-7829,SNGL FAM SUB,4.57,AC,104800,0,104800,175300,1500,281600,93600,0,93600,142400,1500,237500,A2,AG/LTD,,,
5605,30-1-0-72-0,6759-80-3272,SNGL FAM SUB,13,AC,174200,0,174200,213400,1500,389100,162700,0,162700,181500,1500,345700,A2,AG/LTD,,,
5606,4-3-0-8-0,6813-04-6657,SNGL FAM SUB,3.52,AC,53100,0,53100,221300,0,274400,52000,0,52000,198400,0,250400,A1,AG/GEN,,,
5607,19-1-0-57-0,6830-73-8537,SNGL FAM SUB,0.95,AC,51300,0,51300,181000,5200,237500,47400,0,47400,150900,5200,203500,A1,AG/GEN,,,
5608,4-3-0-7-0,6813-04-8963,SNGL FAM SUB,1.69,AC,46700,0,46700,119700,3300,169700,45700,0,45700,101200,3300,150200,A1,AG/GEN,,,
5609,12-1-0-61-0,6832-50-8117,AG 20-100 AC,38.432,AC,300900,192300,108600,232900,700,534500,292400,180700,111700,204600,600,497600,A1,AG/GEN,,,
5610,40-1-0-18-A,6726-88-3364,SNGL FAM SUB,5,AC,70300,0,70300,157500,1800,229600,69000,0,69000,135400,1800,206200,A1,AG/GEN,,,
5611,13-14-0-A-1,6841-93-6005,SNGL FAM SUB,2.13,AC,59700,0,59700,156200,2700,218600,58600,0,58600,137400,2900,198900,A1,AG/GEN,,,
5612,5-3-0-29-0,6824-10-4947,SNGL FAM SUB,3.69,AC,68000,0,68000,344300,29800,442100,66700,0,66700,280700,32000,379400,A1,AG/GEN,,,
5613,5-3-0-17-0,6824-10-4411,SNGL FAM SUB,3.92,AC,67200,0,67200,294200,2300,363700,65800,0,65800,251100,1600,318500,A1,AG/GEN,,,
5614,66-3-0-7-0,7723-45-1043,SNGL FAM SUB,3.27,AC,390000,0,390000,391300,6000,787300,340000,0,340000,343800,4200,688000,R1,RES/LTD,,,
5615,29-3-0-15-0,6749-63-4141,SNGL FAM SUB,2.03,AC,56300,0,56300,248700,2100,307100,52700,0,52700,205200,2100,260000,A1,AG/GEN,,,
5616,10-1-0-16-0,6801-53-0111,SNGL FAM SUB,1,AC,38800,0,38800,60400,1300,100500,38000,0,38000,52800,1300,92100,A1,AG/GEN,,,
5617,28-1-0-58-C,6738-19-4001,SNGL FAM SUB,1,AC,40000,0,40000,166900,300,207200,39500,0,39500,138000,300,177800,A1,AG/GEN,,,
5619,18-6-0-3-0,6810-99-9853,SNGL FAM SUB,2,AC,46000,0,46000,0,0,46000,44000,0,44000,0,0,44000,A1,AG/GEN,,,
5620,18-6-0-4-0,6820-09-4532,SNGL FAM SUB,6.85,AC,73300,0,73300,178800,3000,255100,70200,0,70200,149000,3000,222200,A1,AG/GEN,,,
5621,19-5-0-3-0,6739-19-7647,SNGL FAM SUB,1.599,AC,58600,0,58600,148900,1000,208500,55500,0,55500,121500,1000,178000,A1,AG/GEN,,,
5622,13-5-0-4-A,6841-86-2096,SNGL FAM SUB,1,AC,49900,0,49900,159700,4000,213600,49000,0,49000,140900,4000,193900,A1,AG/GEN,,,
5623,64-12-G-1-0,7723-59-5525,SNGL FAM SUB,0,AC,77000,0,77000,196500,1200,274700,67000,0,67000,170500,1200,238700,R1,RES/LTD,,,
5624,50-5-0-28-0,6726-43-0349,SNGL FAM SUB,8.44,AC,71100,0,71100,0,0,71100,67700,0,67700,0,0,67700,A1,AG/GEN,,,
5625,28-1-0-64-0,6729-92-9188,SNGL FAM SUB,17,AC,111000,103200,7800,0,0,111000,107900,100700,7200,0,0,107900,A1,AG/GEN,,,
5626,28-1-0-65-0,6729-92-0395,SNGL FAM SUB,16.1,AC,132300,0,132300,178200,19200,329700,125600,0,125600,147000,16400,289000,A1,AG/GEN,,,
5627,28-1-0-67-0,6729-92-5930,SNGL FAM SUB,15.41,AC,129600,122500,7100,0,0,129600,142700,136200,6500,0,0,142700,A1,AG/GEN,,,
5628,28-1-0-88-0,6739-12-1348,AG 20-100 AC,26.19,AC,132900,120800,12100,0,0,132900,136200,125100,11100,0,0,136200,A1,AG/GEN,,,
5629,63-4-0-6-0,7714-96-6728,SNGL FAM SUB,0,AC,158400,0,158400,454700,40800,653900,144000,0,144000,467300,35000,646300,A2,AG/LTD,,,
5630,57-12-0-3-0,7706-03-9976,SNGL FAM SUB,10.49,AC,358000,0,358000,701900,95800,1155700,311600,0,311600,631800,84600,1028000,RR,RES/RUR,,,
5631,31-16-0-2-0,6778-06-3482,SNGL FAM SUB,2.58,AC,88000,0,88000,150800,15100,253900,78500,0,78500,123100,13300,214900,A2,AG/LTD,,,
5632,44-1-0-6-A,6778-60-6450,SNGL FAM SUB,1.55,AC,77400,0,77400,0,0,77400,69100,68400,700,0,0,69100,A2,AG/LTD,,,
5633,43-1-0-65-0,6777-59-2939,SNGL FAM SUB,4.84,AC,125400,0,125400,197300,0,322700,112100,0,112100,168900,0,281000,A2,AG/LTD,,,
5636,44-1-0-5-0,6778-70-7157,AG > 100 AC,103,AC,1275000,376000,899000,1634600,176500,3086100,1141100,849800,291300,1439000,156500,2736600,A2,AG/LTD,,,
5637,44-1-0-6-0,6778-69-6848,SNGL FAM SUB,10.213,AC,209800,16900,192900,1626500,8200,1844500,187700,114900,72800,1330500,8500,1526700,A2,AG/LTD,,,
5638,44-1-0-8-0,6777-78-7876,SNGL FAM SUB,17.32,AC,302300,294300,8000,0,0,302300,269600,262200,7400,0,0,269600,A2,AG/LTD,,,
5640,44-1-0-9-A,6777-78-8529,SNGL FAM SUB,13.02,AC,220400,190000,30400,0,0,220400,197200,169900,27300,0,0,197200,A2,AG/LTD,,,
5643,32-10-2-3-0,6778-59-7745,SNGL FAM SUB,3.19,AC,98800,0,98800,182700,22800,304300,88400,0,88400,150700,19600,258700,A2,AG/LTD,,,
5644,64-17-0-D-0,7733-58-7209,SNGL FAM SUB,3.229,AC,259500,0,259500,305900,0,565400,225500,0,225500,257700,0,483200,R1,RES/LTD,,,
5645,29-1-0-13-0,6749-04-7119,AG 20-100 AC,30,AC,200800,187000,13800,0,0,200800,189000,176200,12800,0,0,189000,A1,AG/GEN,,,
5646,20-3-0-1-0,6840-25-9714,SNGL FAM SUB,3.296,AC,68900,0,68900,12100,2100,83100,63800,0,63800,11400,2100,77300,A1,AG/GEN,,,
5647,18-7-0-B-3,6820-08-0828,SNGL FAM SUB,2.06,AC,46400,0,46400,103500,100,150000,44400,0,44400,82300,100,126800,A1,AG/GEN,,,
5648,43-1-0-14-0,6767-76-1150,SNGL FAM SUB,0.48,AC,7200,0,7200,0,0,7200,6500,0,6500,0,0,6500,A2,AG/LTD,,,
5649,29-10-0-M-0,6749-84-9597,SNGL FAM SUB,9.03,AC,133500,0,133500,274400,25300,433200,125400,0,125400,223600,21300,370300,A1,AG/GEN,,,
5651,21-1-0-5-0,6850-36-7045,AG 20-100 AC,62.5,AC,356800,0,356800,37700,3000,397500,347600,0,347600,31700,3000,382300,A1,AG/GEN,,,
5652,29-3-0-5-A,6749-72-8955,SNGL FAM SUB,3.2,AC,75500,0,75500,0,0,75500,70600,0,70600,0,0,70600,A1,AG/GEN,,,
5653,21-1-0-15-B,6850-53-3620,SNGL FAM SUB,3,AC,75900,0,75900,88100,8300,172300,68700,0,68700,73000,7300,149000,A2,AG/LTD,,,
5654,29-17-0-4-0,6749-60-4805,SNGL FAM SUB,5.79,AC,98300,0,98300,200200,3000,301500,94900,0,94900,165400,3000,263300,A1,AG/GEN,,,
5655,21-1-0-48-0,6850-63-6817,SNGL FAM SUB,1.63,AC,56400,0,56400,73000,1000,130400,51500,0,51500,61400,1000,113900,A2,AG/LTD,,,
5656,39-1-0-91-A,6727-13-6767,SNGL FAM SUB,0.9,AC,36700,0,36700,116100,11200,164000,35900,0,35900,114700,14400,165000,A1,AG/GEN,,,
5657,43-1-0-44-0,6767-75-4819,SNGL FAM SUB,1.833,AC,82100,0,82100,187400,6800,276300,73300,0,73300,157300,6800,237400,A2,AG/LTD,,,
5659,28-1-0-90-0,6739-31-6489,SNGL FAM SUB,14.04,AC,88500,0,88500,0,0,88500,87000,0,87000,0,0,87000,A1,AG/GEN,,,
5660,20-1-0-78-0,6840-80-5920,SNGL FAM SUB,4,AC,82200,0,82200,209300,43800,335300,81100,0,81100,179500,36500,297100,A1,AG/GEN,,,
5661,21-1-0-45-A,6850-63-0287,SNGL FAM SUB,2.16,AC,68300,0,68300,209900,40700,318900,62000,0,62000,177600,40600,280200,A2,AG/LTD,,,
5662,29-1-0-8-0,6749-34-0430,SNGL FAM SUB,2,AC,21800,0,21800,0,0,21800,21300,0,21300,0,0,21300,A1,AG/GEN,,,
5663,29-1-0-63-0,6749-44-5289,SNGL FAM SUB,6,AC,86100,0,86100,0,0,86100,83700,0,83700,0,0,83700,A1,AG/GEN,,,
5664,29-1-0-62-0,6749-34-8353,SNGL FAM SUB,16.8,AC,153300,0,153300,0,0,153300,159000,0,159000,0,0,159000,A1,AG/GEN,,,
5665,29-1-0-112-0,6748-79-3984,SNGL FAM SUB,8.51,AC,121200,0,121200,81400,0,202600,120500,0,120500,68700,0,189200,A1,AG/GEN,,,
5666,29-10-0-B-0,6749-85-5651,COMM & IND,1.15,AC,49100,0,49100,89800,1800,140700,47600,0,47600,87400,1800,136800,A1,AG/GEN,,,
5667,29-10-0-K-0,6749-93-7732,SNGL FAM SUB,10.09,AC,104400,0,104400,0,0,104400,114300,0,114300,0,0,114300,A1,AG/GEN,,,
5668,20-1-0-97-0,6759-07-1673,SNGL FAM SUB,4.89,AC,83300,0,83300,0,0,83300,77200,0,77200,0,0,77200,A1,AG/GEN,,,
5669,26-1-0-13-0,6709-93-7977,SNGL FAM SUB,2.4,AC,48400,0,48400,111500,500,160400,46400,0,46400,91400,500,138300,A1,AG/GEN,,,
5670,26-1-0-13-C,6719-04-1162,SNGL FAM SUB,0.895,AC,39400,0,39400,219600,0,259000,37400,0,37400,179400,0,216800,A1,AG/GEN,,,
5671,26-1-0-13-D,6719-04-3147,SNGL FAM SUB,1.083,AC,40500,0,40500,150800,500,191800,38500,0,38500,123700,500,162700,A1,AG/GEN,,,
5672,4-1-0-35-A,6803-97-2870,SNGL FAM SUB,2.63,AC,48000,0,48000,149200,14300,211500,47200,0,47200,136600,12300,196100,A1,AG/GEN,,,
5673,29-3-0-24-0,6749-53-0540,SNGL FAM SUB,4.4,AC,76100,0,76100,0,0,76100,71200,0,71200,0,0,71200,A1,AG/GEN,,,
5674,29-1-0-96-0,6749-95-7755,SNGL FAM SUB,15,AC,184900,0,184900,143100,1700,329700,181500,0,181500,119300,1700,302500,A1,AG/GEN,,,
5675,29-1-0-87-0,6749-86-8858,SNGL FAM SUB,3.16,AC,75100,0,75100,188900,1100,265100,71300,0,71300,155200,1100,227600,A1,AG/GEN,,,
5676,29-1-0-112-B,6749-70-3209,SNGL FAM SUB,1.5,AC,59000,0,59000,125000,800,184800,54900,0,54900,102800,800,158500,A1,AG/GEN,,,
5677,29-5-0-2-0,6749-74-5863,SNGL FAM SUB,2.92,AC,72800,0,72800,246900,1500,321200,68900,0,68900,199500,1700,270100,A1,AG/GEN,,,
5678,21-1-0-43-0,6850-51-3986,SNGL FAM SUB,4,AC,90100,0,90100,0,0,90100,81100,0,81100,0,0,81100,A2,AG/LTD,,,
5679,21-1-0-43-A,6850-62-1079,SNGL FAM SUB,6,AC,108800,0,108800,0,0,108800,99400,0,99400,0,0,99400,A2,AG/LTD,,,
5680,21-1-0-6-0,6850-25-9704,AG 20-100 AC,20.716,AC,118000,0,118000,246500,0,364500,116300,0,116300,214500,0,330800,A1,AG/GEN,,,
5681,21-1-0-44-0,6850-62-1109,AG 20-100 AC,48.25,AC,564500,488300,76200,18000,0,582500,517700,447700,70000,18000,0,535700,A2,AG/LTD,,,
5682,29-1-0-112-A,6749-70-3562,SNGL FAM SUB,1.01,AC,54100,0,54100,24500,0,78600,50000,0,50000,19800,0,69800,A1,AG/GEN,,,
5683,21-1-0-14-0,6850-53-6881,SNGL FAM SUB,5,AC,96400,0,96400,27400,1600,125400,87500,0,87500,23800,1600,112900,A2,AG/LTD,,,
5684,21-1-0-45-0,6850-53-9115,SNGL FAM SUB,1.5,AC,60200,0,60200,78600,1300,140100,55100,0,55100,65200,1300,121600,A2,AG/LTD,,,
5685,21-1-0-47-0,6850-63-8104,SNGL FAM SUB,10.2,AC,110200,0,110200,0,6500,116700,102300,0,102300,0,5900,108200,A2,AG/LTD,,,
5686,18-7-0-E-0,6820-08-5991,SNGL FAM SUB,3.65,AC,49400,0,49400,219100,1200,269700,47500,0,47500,149700,0,197200,A1,AG/GEN,,,
5687,21-1-0-46-0,6850-63-2538,SNGL FAM SUB,3.867,AC,88500,0,88500,0,0,88500,79700,0,79700,0,0,79700,A2,AG/LTD,,,
5688,29-3-0-6-0,6749-73-4007,SNGL FAM SUB,1.83,AC,62300,0,62300,49600,100,112000,58100,0,58100,42400,100,100600,A1,AG/GEN,,,
5689,29-1-0-114-0,6748-89-4416,SNGL FAM SUB,5,AC,87800,0,87800,0,0,87800,81100,0,81100,0,0,81100,A1,AG/GEN,,,
5690,29-17-0-4-D,6749-60-8776,COMM & IND,5,AC,118300,0,118300,385800,67500,571600,114900,0,114900,388600,62700,566200,A1,AG/GEN,,,
5691,29-1-0-136-0,6748-85-4822,SNGL FAM SUB,3,AC,30400,0,30400,0,0,30400,28100,0,28100,0,0,28100,A1,AG/GEN,,,
5692,20-1-0-67-0,6850-17-8502,AG 20-100 AC,22.48,AC,166100,0,166100,0,0,166100,164300,0,164300,0,0,164300,A1,AG/GEN,,,
5693,21-1-0-12-0,6850-54-8383,SNGL FAM SUB,4.76,AC,89600,0,89600,128800,9300,227700,81100,0,81100,108400,8500,198000,A2,AG/LTD,,,
5694,21-1-0-8-0,6850-46-8040,SNGL FAM SUB,12,AC,109100,0,109100,20600,100,129800,106900,0,106900,17700,0,124600,A1,AG/GEN,,,
5707,63-3-A-4-0,7714-91-2675,SNGL FAM SUB,0,AC,70000,0,70000,441500,13000,524500,60000,0,60000,385200,13000,458200,R1,RES/LTD,,,
5708,5-8-0-C-0,6813-78-5191,SNGL FAM SUB,5.38,AC,62000,0,62000,0,10100,72100,60900,0,60900,0,9000,69900,A1,AG/GEN,,,
5709,62-17-A-6-0,7714-06-4074,SNGL FAM SUB,0,AC,115000,0,115000,231700,6000,352700,100000,0,100000,209300,6000,315300,R1,RES/LTD,,,
5711,42-16-D-5-0,6757-83-8927,SNGL FAM SUB,1.54,AC,110000,0,110000,310000,1700,421700,99900,0,99900,0,0,99900,R1,RES/LTD,,,
5712,42-16-A-4-0,6757-93-9893,SNGL FAM SUB,0.949,AC,81500,0,81500,244500,0,326000,74000,0,74000,228600,0,302600,R1,RES/LTD,,,
5713,42-16-D-4-0,6757-83-7735,SNGL FAM SUB,0.969,AC,81500,0,81500,316100,3500,401100,74000,0,74000,298800,3500,376300,R1,RES/LTD,,,
5714,4-1-0-25-0,6803-51-9876,SNGL FAM SUB,14.28,AC,107100,61500,45600,377900,20000,505000,104400,60700,43700,336200,20000,460600,A1,AG/GEN,,,
5715,32-10-2-14-0,6779-60-5266,SNGL FAM SUB,3.16,AC,98400,0,98400,302600,18300,419300,88000,0,88000,246500,16200,350700,A2,AG/LTD,,,
5716,62-4-C-17-0,7714-04-4615,SNGL FAM SUB,0,AC,115000,0,115000,258400,400,373800,100000,0,100000,232000,400,332400,R1,RES/LTD,,,
5717,46-23-0-31-0,7707-84-7996,SNGL FAM SUB,2.134,AC,165000,0,165000,244300,17400,426700,150000,0,150000,209100,14800,373900,A2,AG/LTD,,,
5872,45-1-0-91-C,6797-87-3094,SNGL FAM SUB,6.508,AC,159900,0,159900,7900,0,167800,142900,0,142900,7400,0,150300,A2,AG/LTD,,,
5873,38-1-0-1-0,6708-71-0054,SNGL FAM SUB,13.5,AC,102600,0,102600,0,0,102600,100500,0,100500,0,0,100500,A1,AG/GEN,,,
5874,62-1-0-24-0,7714-14-2027,COMM & IND,7.51,AC,718000,0,718000,308300,6100,1032400,660500,0,660500,286300,6200,953000,B1,BUS/GEN,,,
5875,9-3-0-3-0,5892-84-2926,SNGL FAM SUB,3.722,AC,38800,0,38800,0,2400,41200,37700,0,37700,0,2000,39700,A1,AG/GEN,,,
5876,46-1-0-88-0,7718-11-0489,SNGL FAM SUB,1.086,AC,94400,0,94400,195400,700,290500,84300,0,84300,161800,700,246800,A2,AG/LTD,,,
5877,18-4-0-A-1,6820-03-0504,AG 20-100 AC,25,AC,123800,78000,45800,181100,0,304900,124100,81500,42600,143400,0,267500,A1,AG/GEN,,,
5878,6-1-0-41-0,6832-07-4786,SNGL FAM SUB,13.24,AC,110300,0,110300,0,0,110300,107700,0,107700,0,0,107700,A1,AG/GEN,,,
5879,31-17-0-6-0,6779-44-4321,SNGL FAM SUB,8,AC,139700,0,139700,201000,55300,396000,124400,0,124400,165100,53400,342900,A2,AG/LTD,,,
5880,64-12-B-2-0,7724-60-3950,SNGL FAM SUB,3.09,AC,177100,0,177100,174800,2500,354400,154100,0,154100,150500,2500,307100,R1,RES/LTD,,,
5881,46-23-0-16-0,7707-92-4727,SNGL FAM SUB,10,AC,173300,0,173300,353100,1200,527600,157500,0,157500,298000,1200,456700,A2,AG/LTD,,,
5882,58-1-0-101-0,7726-20-3962,AG 20-100 AC,52.76,AC,3474100,3449800,24300,0,0,3474100,3093900,3071500,22400,0,0,3093900,A2,AG/LTD,,,
5883,28-1-0-56-0,6738-27-1406,SNGL FAM SUB,2.68,AC,61900,0,61900,0,36900,98800,59700,0,59700,0,32100,91800,A1,AG/GEN,,,
5884,46-1-0-76-D1,7707-32-3590,SNGL FAM SUB,3.37,AC,128100,0,128100,148600,18200,294900,118500,0,118500,124300,15500,258300,A2,AG/LTD,,,
5885,28-1-0-35-0,6738-06-0925,SNGL FAM SUB,1.804,AC,44100,0,44100,184400,0,228500,43200,0,43200,148400,0,191600,A1,AG/GEN,,,
5887,20-1-0-92-E,6749-98-9767,SNGL FAM SUB,3,AC,73600,0,73600,159000,3000,235600,69700,0,69700,135400,3000,208100,A1,AG/GEN,,,
6044,5-3-0-16-0,6824-10-3023,SNGL FAM SUB,3.33,AC,57200,0,57200,203700,0,260900,56100,0,56100,173600,0,229700,A1,AG/GEN,,,
6045,55-1-0-58-B,6786-75-9903,SNGL FAM SUB,3.68,AC,93100,91400,1700,0,0,93100,83200,81600,1600,0,0,83200,A2,AG/LTD,,,
6046,55-1-0-59-0,6786-76-3486,AG 20-100 AC,37.4,AC,674700,516400,158300,278800,376100,1329600,603100,462700,140400,230900,326600,1160600,A2,AG/LTD,,,
6047,57-1-0-46-0,7715-15-6428,SNGL FAM SUB,11.95,AC,428700,0,428700,268900,62800,760400,385800,0,385800,253100,52300,691200,A2,AG/LTD,,,
6048,57-1-0-46-A,7715-25-1346,SNGL FAM SUB,8.01,AC,303800,0,303800,0,0,303800,280600,0,280600,0,0,280600,A2,AG/LTD,,,
6207,45-1-0-98-0,6797-98-7917,SNGL FAM SUB,2.24,AC,76700,0,76700,288500,1500,366700,68500,0,68500,243300,1500,313300,A2,AG/LTD,,,
6208,47-1-0-15-0,7716-49-0023,AG 20-100 AC,26.78,AC,524900,512600,12300,0,0,524900,468700,457300,11400,0,0,468700,A2,AG/LTD,,,
6209,47-9-0-1-B,7716-59-0012,SNGL FAM SUB,18,AC,617500,609200,8300,0,0,617500,550800,543100,7700,0,0,550800,A2,AG/LTD,,,
6210,47-9-0-2-A,7716-58-7779,AG 20-100 AC,25.676,AC,783100,771300,11800,0,0,783100,698400,687500,10900,0,0,698400,A2,AG/LTD,,,
6211,55-1-0-9-0,6786-14-7195,AG 20-100 AC,56.566,AC,647300,619000,28300,0,0,647300,575900,552100,23800,0,0,575900,A2,AG/LTD,,,
6212,55-1-0-9-A,6786-10-1413,SNGL FAM SUB,16.381,AC,282400,136000,146400,0,0,282400,251800,121500,130300,0,0,251800,A2,AG/LTD,,,
6214,47-1-0-14-C,7717-30-5522,SNGL FAM SUB,9,AC,276600,0,276600,0,0,276600,246800,0,246800,0,0,246800,A2,AG/LTD,,,
6215,47-1-0-14-D,7717-30-1592,SNGL FAM SUB,1,AC,17000,0,17000,0,0,17000,15200,0,15200,0,0,15200,A2,AG/LTD,,,
6216,47-20-0-B-0,7717-31-6396,SNGL FAM SUB,15.52,AC,470800,347200,123600,784800,59200,1314800,419900,310000,109900,704500,50500,1174900,A2,AG/LTD,,,
6217,34-1-0-3-0,7708-14-1730,SNGL FAM SUB,4.39,AC,121300,119300,2000,0,4700,126000,108400,106500,1900,0,5000,113400,A2,AG/LTD,,,
5718,47-1-0-3-A,7718-41-6679,SNGL FAM SUB,3.55,AC,142400,0,142400,282800,21500,446700,127200,0,127200,242800,18400,388400,A2,AG/LTD,,,
5719,47-24-0-1-0,7718-51-1660,SNGL FAM SUB,3.875,AC,147900,0,147900,268000,19100,435000,132100,0,132100,224000,16300,372400,A2,AG/LTD,,,
5720,47-1-0-59-A,7718-81-9363,SNGL FAM SUB,4.074,AC,34600,0,34600,0,0,34600,31000,0,31000,0,0,31000,A2,AG/LTD,,,
5721,19-4-0-A-1,6830-26-1501,SNGL FAM SUB,7.72,AC,93700,0,93700,0,44200,137900,86400,0,86400,0,42300,128700,A1,AG/GEN,,,
5722,19-4-0-A-0,6830-25-1806,SNGL FAM SUB,2.28,AC,59500,0,59500,254800,2000,316300,56700,0,56700,217800,2000,276500,A1,AG/GEN,,,
5723,15-1-0-33-0,5789-17-7264,SNGL FAM SUB,2.12,AC,42800,0,42800,124800,1800,169400,41900,0,41900,107600,1800,151300,A1,AG/GEN,,,
5725,4-5-0-3-0,6813-13-2569,AG 20-100 AC,24.53,AC,123600,81000,42600,350100,105900,579600,121200,80000,41200,291200,95300,507700,A1,AG/GEN,,,
5726,55-1-0-43-0,6786-42-6113,SNGL FAM SUB,10,AC,188900,0,188900,185100,14100,388100,168800,0,168800,155200,10300,334300,A2,AG/LTD,,,
5727,32-10-1-3-0,6778-78-6874,SNGL FAM SUB,1.1,AC,68700,0,68700,194600,4100,267400,61400,0,61400,159800,4100,225300,A2,AG/LTD,,,
5728,45-1-0-67-0,6797-76-5613,COMM & IND,1.543,AC,178200,0,178200,263700,36800,478700,165000,0,165000,244500,31600,441100,B1,BUS/GEN,,,
5729,45-1-0-67-A,6797-76-4425,SNGL FAM SUB,1.079,AC,77900,0,77900,222400,5300,305600,69600,0,69600,184100,4000,257700,A2,AG/LTD,,,
5730,46-16-0-A-0,7707-71-4600,SNGL FAM SUB,4.77,AC,182700,0,182700,284500,44200,511400,163000,0,163000,245100,38700,446800,A2RR,AG& RUR,,,
5731,45-1-0-78-E,6797-73-5265,SNGL FAM SUB,2.713,AC,102600,0,102600,231900,71000,405500,91600,0,91600,189900,63700,345200,A2,AG/LTD,,,
5732,45-1-0-78-F,6797-73-8169,SNGL FAM SUB,2,AC,91800,0,91800,0,300,92100,82000,0,82000,0,300,82300,A2,AG/LTD,,,
5734,58-1-0-29-B,7715-23-2879,Other Religious,4.094,AC,196500,0,196500,243900,1500,441900,171000,0,171000,222900,1500,395400,A2,AG/LTD,,,
5735,4-1-0-29-0,6803-66-9086,SNGL FAM SUB,5,AC,61600,0,61600,171000,3000,235600,60000,0,60000,152900,3000,215900,A1,AG/GEN,,,
5736,4-1-0-43-B,6814-31-0411,SNGL FAM SUB,2.31,AC,46400,0,46400,187200,16000,249600,45600,0,45600,179700,20400,245700,A1,AG/GEN,,,
5738,12-6-0-4-0,6832-46-5459,SNGL FAM SUB,3.13,AC,60200,0,60200,0,0,60200,59000,0,59000,0,0,59000,A1,AG/GEN,,,
5739,26-1-0-67-C,6719-05-8727,SNGL FAM SUB,6.16,AC,69400,0,69400,123300,500,193200,69000,0,69000,101400,500,170900,A1,AG/GEN,,,
5740,67-13-B-11-0,7733-36-1840,SNGL FAM SUB,0,AC,265000,0,265000,524600,3700,793300,220000,0,220000,484600,2600,707200,R1,RES/LTD,,,
5741,43-1-0-88-F,6776-09-8691,Roads,0.6,AC,0,0,0,0,0,0,0,0,0,0,0,0,A2,AG/LTD,,,
5742,43-16-0-J-2,6776-08-2143,AG 20-100 AC,35,AC,420500,0,420500,120500,0,541000,374900,0,374900,98900,0,473800,A2,AG/LTD,,,
5743,67-2-B-2-0,7723-56-1667,SNGL FAM SUB,0,AC,165600,0,165600,354000,0,519600,144000,0,144000,295600,0,439600,R1,RES/LTD,,,
5744,27-1-0-76-0,6728-46-3178,SNGL FAM SUB,1.286,AC,40500,0,40500,98200,0,138700,39700,0,39700,83600,0,123300,A1,AG/GEN,,,
5745,43-3-0-3-0,6777-49-5308,SNGL FAM SUB,1,AC,70100,0,70100,97700,24400,192200,62600,0,62600,80200,20600,163400,A2,AG/LTD,,,
5747,43-3-0-4-0,6777-49-6581,SNGL FAM SUB,1.924,AC,83400,0,83400,0,0,83400,74500,0,74500,0,0,74500,A2,AG/LTD,,,
5748,43-3-0-1-0,6777-49-2210,SNGL FAM SUB,1,AC,70100,0,70100,63100,0,133200,62600,0,62600,56200,0,118800,A2,AG/LTD,,,
5749,43-3-0-2-0,6777-49-3278,SNGL FAM SUB,1,AC,70100,0,70100,0,2000,72100,62600,0,62600,0,2000,64600,A2,AG/LTD,,,
5750,32-1-0-61-A,6789-04-5479,SNGL FAM SUB,1.71,AC,74300,0,74300,0,0,74300,66400,0,66400,0,0,66400,A2,AG/LTD,,,
5751,46-1-0-10-C,6797-98-8197,SNGL FAM SUB,1.6,AC,102600,0,102600,179900,400,282900,91600,0,91600,154000,400,246000,A2,AG/LTD,,,
5752,38-1-0-27-0,6707-66-7592,SNGL FAM SUB,1.85,AC,43600,0,43600,216000,3900,263500,42700,0,42700,188800,3000,234500,A1,AG/GEN,,,
5753,9-1-0-47-A,5892-30-0371,SNGL FAM SUB,1,AC,38800,0,38800,109200,100,148100,38000,0,38000,95000,100,133100,A1,AG/GEN,,,
5754,38-1-0-111-B,6717-29-6731,SNGL FAM SUB,3,AC,50000,0,50000,66900,100,117000,49000,0,49000,57300,100,106400,A1,AG/GEN,,,
5755,38-1-0-113-A,6717-28-8815,SNGL FAM SUB,2,AC,44400,0,44400,73100,0,117500,43500,0,43500,63300,0,106800,A1,AG/GEN,,,
5756,39-1-0-38-A,6727-04-2202,SNGL FAM SUB,3,AC,50000,0,50000,65100,300,115400,49000,0,49000,55600,300,104900,A1,AG/GEN,,,
5757,39-1-0-38-B,6717-93-9651,SNGL FAM SUB,0.74,AC,3900,0,3900,0,0,3900,3900,0,3900,0,0,3900,A1,AG/GEN,,,
5758,30-4-0-4-0,6768-09-4062,SNGL FAM SUB,2.56,AC,73100,0,73100,205300,30700,309100,66100,0,66100,162600,26600,255300,A2,AG/LTD,,,
5759,51-1-0-50-A,6736-42-6472,SNGL FAM SUB,5.25,AC,58700,0,58700,39200,200,98100,57600,0,57600,34100,200,91900,A1,AG/GEN,,,
5760,40-1-0-9-0,6727-88-2302,AG 20-100 AC,73,AC,223400,189700,33700,0,0,223400,219000,188000,31000,0,0,219000,A1,AG/GEN,,,
5761,29-12-0-3-0,6748-78-0599,SNGL FAM SUB,1,AC,54000,0,54000,59600,1000,114600,49900,0,49900,50100,1000,101000,A1,AG/GEN,,,
5762,14-2-0-4-B,6851-26-7174,SNGL FAM SUB,3.16,AC,67800,0,67800,83000,5100,155900,66500,0,66500,71000,4300,141800,A1,AG/GEN,,,
5763,67-1-0-19-0,7733-33-6807,SNGL FAM SUB,11.53,AC,402500,397200,5300,0,0,402500,350100,345200,4900,0,0,350100,A2,AG/LTD,,,
5764,67-1-0-20-0,7733-45-0486,SNGL FAM SUB,0.64,AC,18700,0,18700,0,0,18700,15600,0,15600,0,0,15600,A2,AG/LTD,,,
5765,67-6-0-1-0,7733-34-9570,SNGL FAM SUB,16.4,AC,902000,226500,675500,1836300,36400,2774700,784100,196700,587400,1544800,33800,2362700,A2,AG/LTD,,,
5766,67-16-0-3-0,7733-25-8392,SNGL FAM SUB,3.9,AC,203200,0,203200,878900,0,1082100,176700,0,176700,770300,0,947000,A2,AG/LTD,,,
5767,67-16-0-4-0,7733-35-2435,SNGL FAM SUB,4.3,AC,207000,0,207000,684300,0,891300,179900,0,179900,594500,0,774400,A2,AG/LTD,,,
5768,67-16-0-5-0,7733-35-5322,SNGL FAM SUB,4.69,AC,279600,0,279600,664600,40800,985000,243000,0,243000,585000,34300,862300,A2,AG/LTD,,,
5769,67-16-0-6-0,7733-35-7037,SNGL FAM SUB,4.72,AC,280400,0,280400,0,0,280400,243800,0,243800,0,0,243800,A2,AG/LTD,,,
5770,28-1-0-34-0,6738-16-0040,AG 20-100 AC,44.7,AC,237800,0,237800,0,3500,241300,232400,0,232400,0,3500,235900,A1,AG/GEN,,,
5771,28-1-0-55-0,6738-17-5290,SNGL FAM SUB,1,AC,49000,0,49000,0,0,49000,47400,0,47400,0,0,47400,A1,AG/GEN,,,
5772,63-1-0-135-0,7715-72-2255,SNGL FAM SUB,0.95,AC,109300,0,109300,124000,600,233900,95100,0,95100,75500,600,171200,A2,AG/LTD,,,
5773,62-4-E-4-0,7714-04-5970,SNGL FAM SUB,0,AC,115000,0,115000,358300,1800,475100,100000,0,100000,324300,1300,425600,R1,RES/LTD,,,
5774,47-26-0-8-0,7717-99-5062,SNGL FAM SUB,2.197,AC,109400,0,109400,203200,28100,340700,97800,0,97800,169400,23000,290200,A2,AG/LTD,,,
5775,15-1-0-10-0,5880-85-8163,SNGL FAM SUB,11,AC,64700,0,64700,0,0,64700,63000,0,63000,0,0,63000,A1,AG/GEN,,,
5776,15-1-0-12-0,5880-76-9156,AG 20-100 AC,88.39,AC,181400,139000,42400,6000,400,187800,176800,137700,39100,6000,400,183200,A1,AG/GEN,,,
5777,4-5-0-1-0,6803-92-8035,AG 20-100 AC,23.9,AC,99100,0,99100,0,0,99100,97200,0,97200,0,0,97200,A1,AG/GEN,,,
5778,67-2-C-18-0,7723-55-4382,SNGL FAM SUB,0,AC,184000,0,184000,359300,0,543300,160000,0,160000,336300,0,496300,R1,RES/LTD,,,
5779,42-21-0-2-0,6767-10-2825,SNGL FAM SUB,2,AC,80400,0,80400,275100,9000,364500,67100,0,67100,237300,9000,313400,R1,RES/LTD,,,
5780,58-21-C-1-0,7716-23-6271,SNGL FAM SUB,1.668,AC,310000,0,310000,334100,1800,645900,285000,0,285000,298200,2000,585200,R3,RES/GEN,,,
5781,5-1-0-65-A,6823-28-7435,SNGL FAM SUB,2.5,AC,47400,0,47400,116800,3400,167600,46500,0,46500,102000,2500,151000,A1,AG/GEN,,,
5782,17-9-0-4-0,6810-03-4921,SNGL FAM SUB,3,AC,52000,0,52000,259900,0,311900,49000,0,49000,218300,0,267300,A1,AG/GEN,,,
5783,17-9-0-5-0,6810-03-7761,SNGL FAM SUB,3.5,AC,54900,0,54900,297600,0,352500,51800,0,51800,239500,0,291300,A1,AG/GEN,,,
5784,28-1-0-59-B,6739-10-6036,SNGL FAM SUB,3,AC,53800,0,53800,0,0,53800,50900,0,50900,0,0,50900,A1,AG/GEN,,,
5785,62-9-0-9-0,7714-19-2471,SNGL FAM SUB,9.36,AC,473200,0,473200,491900,13700,978800,411400,0,411400,461800,13800,887000,A2,AG/LTD,,,
5786,28-1-0-73-A,6739-16-4165,SNGL FAM SUB,2.01,AC,54700,0,54700,231300,9200,295200,52600,0,52600,199700,9200,261500,A1,AG/GEN,,,
5787,28-1-0-73-C,6739-16-6102,SNGL FAM SUB,1,AC,47000,0,47000,0,0,47000,44700,0,44700,0,0,44700,A1,AG/GEN,,,
5788,47-1-0-24-0,7716-47-2563,SNGL FAM SUB,1.86,AC,118600,0,118600,459500,23900,602000,105900,0,105900,381100,19700,506700,A2,AG/LTD,,,
5790,32-10-1-6-0,6778-78-2522,SNGL FAM SUB,2.15,AC,83900,0,83900,147500,2500,233900,74900,0,74900,121100,2500,198500,A2,AG/LTD,,,
5791,48-1-0-32-0,7726-58-6906,AG 20-100 AC,60,AC,2688000,2659200,28800,0,0,2688000,2400000,2374400,25600,0,0,2400000,A2,AG/LTD,,,
5792,48-2-A-1-0,7726-67-0670,SNGL FAM SUB,0,AC,130000,0,130000,134600,500,265100,117000,0,117000,118200,500,235700,R1,RES/LTD,,,
5793,48-2-A-3-0,7726-67-3720,SNGL FAM SUB,0.552,AC,130000,0,130000,379800,0,509800,117000,0,117000,361900,0,478900,R1,RES/LTD,,,
5794,48-2-A-7-0,7726-67-9827,SNGL FAM SUB,0,AC,130000,0,130000,264600,0,394600,117000,0,117000,233300,0,350300,R1,RES/LTD,,,
5795,48-2-B-3-0,7726-68-5096,SNGL FAM SUB,0,AC,130000,0,130000,389100,0,519100,117000,0,117000,369500,0,486500,R1,RES/LTD,,,
5796,48-2-C-3-0,7726-58-9065,SNGL FAM SUB,0.591,AC,130000,0,130000,392000,43800,565800,117000,0,117000,374700,40600,532300,R1,RES/LTD,,,
5797,48-2-C-5-0,7726-68-3240,SNGL FAM SUB,0.601,AC,130000,0,130000,308800,0,438800,117000,0,117000,297700,0,414700,R1,RES/LTD,,,
5798,48-2-C-8-0,7726-67-2997,SNGL FAM SUB,0.567,AC,130000,0,130000,446500,0,576500,117000,0,117000,424200,0,541200,R1,RES/LTD,,,
5799,48-2-C-9-0,7726-67-1964,SNGL FAM SUB,0.553,AC,130000,0,130000,462000,47000,639000,117000,0,117000,442400,43500,602900,R1,RES/LTD,,,
5800,48-3-D-3-0,7726-57-6705,SNGL FAM SUB,0,AC,130000,0,130000,0,0,130000,117000,0,117000,0,0,117000,R1,RES/LTD,,,
5801,48-3-H-5-0,7726-57-0677,SNGL FAM SUB,0,AC,221000,0,221000,0,0,221000,198900,0,198900,0,0,198900,R1,RES/LTD,,,
5802,48-4-0-A-0,7727-50-8396,SNGL FAM SUB,0.712,AC,79900,0,79900,69900,800,150600,71400,0,71400,59100,800,131300,A2,AG/LTD,,,
5803,48-4-0-A-1,7727-50-6398,SNGL FAM SUB,5.9,AC,227400,224400,3000,0,0,227400,203300,200800,2500,0,0,203300,A2,AG/LTD,,,
5804,48-4-0-C-0,7727-60-0384,SNGL FAM SUB,0.913,AC,102400,101900,500,0,0,102400,91500,91100,400,0,0,91500,A2,AG/LTD,,,
5805,58-1-0-107-0,7725-08-7856,SNGL FAM SUB,1.472,AC,151000,0,151000,0,0,151000,131400,0,131400,0,0,131400,A2,AG/LTD,,,
5807,59-1-0-29-0,7726-55-5728,COMM & IND,3.834,AC,102500,0,102500,0,0,102500,93200,0,93200,0,0,93200,B1,BUS/GEN,,,
5809,59-1-0-32-0,7726-56-5701,MultiFamily,2.21,AC,662500,0,662500,0,0,662500,542300,0,542300,0,0,542300,R3,RES/GEN,,,
5811,18-4-0-4-J,6820-20-3500,SNGL FAM SUB,0.474,AC,2800,0,2800,0,0,2800,2600,0,2600,0,0,2600,A1,AG/GEN,,,
5812,27-1-0-5-A,6719-50-6899,SNGL FAM SUB,5,AC,31400,0,31400,0,0,31400,30000,0,30000,0,0,30000,A1,AG/GEN,,,
5813,31-1-0-11-0,6769-63-5500,SNGL FAM SUB,3.11,AC,84100,0,84100,170000,1000,255100,76000,0,76000,140500,1000,217500,A2,AG/LTD,,,
5814,46-1-0-36-C,7707-32-7259,SNGL FAM SUB,2,AC,121200,0,121200,196900,300,318400,108200,0,108200,165100,300,273600,A2,AG/LTD,,,
5815,20-1-0-15-0,6840-45-5289,SNGL FAM SUB,1.13,AC,48300,0,48300,147300,0,195600,45900,0,45900,115800,0,161700,A1,AG/GEN,,,
5816,59-1-0-33-0,7726-56-2882,MultiFamily,1.242,AC,647900,0,647900,23700,1500,673100,589100,0,589100,19000,1500,609600,R3,RES/GEN,,,
5818,26-1-0-29-B,6708-93-6636,SNGL FAM SUB,2.448,AC,46900,0,46900,0,0,46900,46000,0,46000,0,0,46000,A1,AG/GEN,,,
5819,26-7-0-14-0,6708-93-8818,SNGL FAM SUB,4.1,AC,57700,0,57700,230800,3600,292100,56600,0,56600,197100,2800,256500,A1,AG/GEN,,,
5820,26-7-0-15-A,6718-04-0295,Roads,2.24,AC,0,0,0,0,0,0,0,0,0,0,0,0,A1,AG/GEN,,,
5821,63-1-0-195-0,7723-39-7431,SNGL FAM SUB,3.16,AC,210100,0,210100,0,0,210100,182700,0,182700,0,0,182700,A2,AG/LTD,,,
5822,63-1-0-196-0,7723-38-7897,SNGL FAM SUB,1.44,AC,161500,0,161500,25700,100,187300,140400,0,140400,22500,100,163000,A2,AG/LTD,,,
5823,28-1-0-61-0,6739-10-1164,SNGL FAM SUB,0.98,AC,39200,0,39200,0,0,39200,38700,0,38700,0,0,38700,A1,AG/GEN,,,
5824,42-1-0-56-0,6767-05-2748,SNGL FAM SUB,0.5,AC,70000,0,70000,159300,9300,238600,65000,0,65000,133600,7600,206200,R3,RES/GEN,,,
5825,55-12-0-B-2A,6785-53-0154,SNGL FAM SUB,13.09,AC,229700,0,229700,314200,35700,579600,205300,0,205300,261200,33800,500300,A2,AG/LTD,,,
5826,20-1-0-44-0,6840-45-7045,SNGL FAM SUB,1,AC,47000,0,47000,54100,1500,102600,44700,0,44700,45300,1500,91500,A1,AG/GEN,,,
5827,30-1-0-60-A,6759-42-9558,SNGL FAM SUB,1,AC,54000,0,54000,141200,6000,201200,49900,0,49900,116700,4300,170900,A2,AG/LTD,,,
5829,59-1-0-35-0,7726-56-5225,MultiFamily,9.529,AC,567700,0,567700,0,2700,570400,516300,0,516300,0,2500,518800,R3,RES/GEN,,,
5830,58-24-0-5-0,7716-71-3704,SNGL FAM SUB,15.85,AC,512500,0,512500,454100,700,967300,446100,0,446100,386100,700,832900,A2,AG/LTD,,,
5831,48-2-E-3-0,7726-68-4418,SNGL FAM SUB,0,AC,130000,0,130000,513100,118500,761600,117000,0,117000,488800,108900,714700,R1,RES/LTD,,,
5832,16-4-0-23-0,5890-36-8343,SNGL FAM SUB,4.26,AC,50500,0,50500,16000,100,66600,49400,0,49400,17900,100,67400,A1,AG/GEN,,,
5833,21-2-0-4-0,6769-28-1783,SNGL FAM SUB,16,AC,156000,0,156000,0,0,156000,142900,0,142900,0,0,142900,A2,AG/LTD,,,
5834,21-1-0-56-D,6850-83-5028,SNGL FAM SUB,1,AC,54000,0,54000,180200,100,234300,49900,0,49900,152900,100,202900,A2,AG/LTD,,,
5835,30-1-0-58-E,6759-41-8516,SNGL FAM SUB,2,AC,64000,0,64000,117400,1000,182400,60300,0,60300,96800,1000,158100,A2,AG/LTD,,,
5836,43-4-0-1-0,6767-76-5639,SNGL FAM SUB,2.62,AC,87400,0,87400,69700,2000,159100,78100,0,78100,57800,2000,137900,A2,AG/LTD,,,
5837,21-1-0-54-0,6850-72-3782,AG 20-100 AC,37.8,AC,220700,0,220700,0,0,220700,196600,0,196600,0,0,196600,A2,AG/LTD,,,
5838,21-1-0-56-A,6850-82-0282,SNGL FAM SUB,9,AC,111400,0,111400,133500,1000,245900,103000,0,103000,111100,1000,215100,A2,AG/LTD,,,
5839,43-4-0-2-0,6767-76-5316,SNGL FAM SUB,1.58,AC,72500,0,72500,139600,500,212600,64700,0,64700,114400,500,179600,A2,AG/LTD,,,
5840,29-1-0-25-0,6748-23-3331,SNGL FAM SUB,2,AC,64000,0,64000,0,0,64000,59800,0,59800,0,0,59800,A1,AG/GEN,,,
5841,13-1-0-35-B,6841-98-3841,SNGL FAM SUB,1.817,AC,57000,0,57000,41500,0,98500,55900,0,55900,42400,0,98300,A1,AG/GEN,,,
5842,45-1-0-90-A,6797-86-2251,SNGL FAM SUB,1.2,AC,79900,0,79900,117200,0,197100,71300,0,71300,97000,0,168300,A2,AG/LTD,,,
5843,47-23-0-6-0,7717-22-7201,SNGL FAM SUB,1.95,AC,109100,0,109100,520700,0,629800,97400,0,97400,452600,0,550000,A2,AG/LTD,,,
5844,43-1-0-67-0,6777-39-9534,SNGL FAM SUB,3.013,AC,99100,0,99100,296800,0,395900,88600,0,88600,244700,0,333300,A2,AG/LTD,,,
5845,43-1-0-70-0,6777-19-9336,AG 20-100 AC,54.72,AC,476700,0,476700,0,0,476700,423800,0,423800,0,0,423800,A2,AG/LTD,,,
5848,55-3-0-A-1,6785-55-1138,SNGL FAM SUB,2.552,AC,95700,0,95700,284200,14100,394000,85400,0,85400,232700,12600,330700,A2,AG/LTD,,,
5849,45-1-0-47-A,6796-27-8560,SNGL FAM SUB,7.7,AC,193300,0,193300,240500,15000,448800,172300,0,172300,200100,15500,387900,A2,AG/LTD,,,
5850,27-1-0-38-0,6728-26-1105,AG 20-100 AC,40,AC,174800,0,174800,0,0,174800,171000,0,171000,0,0,171000,A1,AG/GEN,,,
5851,43-1-0-78-0,6767-93-8528,SNGL FAM SUB,15,AC,229700,0,229700,0,0,229700,205400,0,205400,0,0,205400,A2,AG/LTD,,,
5852,30-4-0-3-0,6768-08-3939,SNGL FAM SUB,2.44,AC,71700,0,71700,0,0,71700,64900,0,64900,0,0,64900,A2,AG/LTD,,,
5854,58-21-B-4-0,7716-23-6882,SNGL FAM SUB,1.435,AC,310000,0,310000,280400,0,590400,285000,0,285000,258500,0,543500,A2,AG/LTD,,,
5855,55-1-0-77-0,6786-70-0296,AG 20-100 AC,20.349,AC,362300,0,362300,0,0,362300,323800,0,323800,0,0,323800,A2,AG/LTD,,,
5856,43-1-0-66-0,6777-49-1921,SNGL FAM SUB,5,AC,127700,0,127700,0,0,127700,114200,0,114200,0,0,114200,A2,AG/LTD,,,
5857,43-4-0-3-0,6767-76-4174,SNGL FAM SUB,1.6,AC,72700,0,72700,75700,300,148700,64900,0,64900,63300,300,128500,A2,AG/LTD,,,
5858,45-1-0-114-B,6797-79-1010,SNGL FAM SUB,3,AC,82700,0,82700,115600,700,199000,73800,0,73800,95000,700,169500,A2,AG/LTD,,,
5859,57-17-0-5-0,7706-13-6898,SNGL FAM SUB,3,AC,161000,0,161000,336600,2000,499600,140100,0,140100,290200,2000,432300,A2,AG/LTD,,,
5860,63-3-A-8-0,7714-81-7398,SNGL FAM SUB,0,AC,70000,0,70000,265000,0,335000,60000,0,60000,235200,0,295200,R1,RES/LTD,,,
5861,63-3-B-G-0,7714-81-7332,SNGL FAM SUB,0.214,AC,5100,0,5100,0,0,5100,4400,0,4400,0,0,4400,R1,RES/LTD,,,
5862,9-2-0-1-A,5892-95-6761,AG 20-100 AC,44.7,AC,128500,69600,58900,68000,2100,198600,125400,68800,56600,59900,2100,187400,A1,AG/GEN,,,
5863,9-2-0-1-B,5892-95-0301,SNGL FAM SUB,3,AC,46000,6300,39700,160200,9200,215400,44000,5100,38900,136500,10500,191000,A1,AG/GEN,,,
5864,46-24-0-1-0,7707-35-8980,SNGL FAM SUB,8.22,AC,190900,0,190900,0,0,190900,170600,0,170600,0,0,170600,A2,AG/LTD,,,
5865,63-19-0-B-1,7724-05-2137,SNGL FAM SUB,0,AC,19800,0,19800,0,0,19800,18000,0,18000,0,0,18000,A2,AG/LTD,,,
5866,42-3-0-2-0,6767-03-9840,SNGL FAM SUB,0.9,AC,70000,0,70000,194800,1100,265900,65000,0,65000,161400,1100,227500,R3,RES/GEN,,,
5868,67-2-D-4-0,7723-55-7517,SNGL FAM SUB,0,AC,184000,0,184000,371800,27900,583700,160000,0,160000,309800,23400,493200,R1,RES/LTD,,,
5869,16-1-0-74-0,5890-63-8480,SNGL FAM SUB,17,AC,79700,32700,47000,0,36700,116400,76000,31100,44900,0,30600,106600,A1,AG/GEN,,,
5870,50-5-0-27-0,6726-32-8919,SNGL FAM SUB,8.23,AC,70200,0,70200,571500,27900,669600,66700,0,66700,459000,36000,561700,A1,AG/GEN,,,
5871,21-1-0-15-D,6850-53-4290,SNGL FAM SUB,1.36,AC,45000,0,45000,0,8300,53300,41100,0,41100,0,7200,48300,A2,AG/LTD,,,
5888,57-11-0-3-0,7715-07-4519,SNGL FAM SUB,1.219,AC,16400,0,16400,0,0,16400,14300,0,14300,0,0,14300,A2,AG/LTD,,,
5889,57-11-0-1-0,7715-07-7944,SNGL FAM SUB,6.581,AC,306900,0,306900,387200,23400,717500,266900,0,266900,325600,23400,615900,A2,AG/LTD,,,
5890,20-1-0-92-A,6749-99-8561,SNGL FAM SUB,5.01,AC,91700,0,91700,164000,800,256500,91600,0,91600,139300,2500,233400,A1,AG/GEN,,,
5891,42-1-0-31-0,6767-01-5022,SNGL FAM SUB,1.78,AC,139900,0,139900,233600,22500,396000,134600,0,134600,227100,15200,376900,RO,RES/OF,,,
5892,45-1-0-73-D,6797-20-7614,SNGL FAM SUB,10.276,AC,229300,0,229300,450000,3800,683100,204600,0,204600,365400,3800,573800,A2,AG/LTD,,,
5893,67-12-0-13-0,7723-46-3063,SNGL FAM SUB,3.42,AC,390000,0,390000,817000,152700,1359700,340000,0,340000,782800,134700,1257500,R1,RES/LTD,,,
5894,28-1-0-9-0,6729-70-8182,AG 20-100 AC,22.5,AC,104700,0,104700,0,0,104700,105800,0,105800,0,0,105800,A1,AG/GEN,,,
5895,27-2-0-6-0,6719-60-4088,SNGL FAM SUB,1.79,AC,43200,0,43200,0,0,43200,42300,0,42300,0,0,42300,A1,AG/GEN,,,
5896,43-10-0-A-0,6767-66-6295,SNGL FAM SUB,4.47,AC,101600,0,101600,73800,200,175600,90500,0,90500,60900,200,151600,A2,AG/LTD,,,
5897,27-2-0-7-0,6719-60-5191,SNGL FAM SUB,1.78,AC,43200,0,43200,0,0,43200,42300,0,42300,0,0,42300,A1,AG/GEN,,,
5898,27-2-0-4-0,6719-60-2165,SNGL FAM SUB,1.81,AC,43300,0,43300,0,0,43300,42500,0,42500,0,0,42500,A1,AG/GEN,,,
5899,27-2-0-1-0,6719-60-6651,SNGL FAM SUB,3.6,AC,54700,0,54700,0,0,54700,53600,0,53600,0,0,53600,A1,AG/GEN,,,
5900,9-1-0-67-0,5892-61-4807,SNGL FAM SUB,16,AC,77700,0,77700,17300,0,95000,75500,0,75500,14700,0,90200,A1,AG/GEN,,,
5901,9-1-0-7-0,5892-75-0106,SNGL FAM SUB,7.024,AC,48300,0,48300,0,0,48300,46600,0,46600,0,0,46600,A1,AG/GEN,,,
5902,43-10-0-A-1,6767-75-0964,SNGL FAM SUB,1,AC,64100,0,64100,84600,300,149000,57200,0,57200,70100,300,127600,A2,AG/LTD,,,
5903,27-2-0-5-0,6719-60-3183,SNGL FAM SUB,1.8,AC,43300,0,43300,0,0,43300,42400,0,42400,0,0,42400,A1,AG/GEN,,,
5904,55-5-0-2-0,6785-66-3584,SNGL FAM SUB,1.02,AC,71500,0,71500,0,0,71500,63900,0,63900,0,0,63900,A2,AG/LTD,,,
5905,58-4-H-37-0,7716-66-0288,SNGL FAM SUB,0,AC,10000,0,10000,0,0,10000,9100,0,9100,0,0,9100,A2,AG/LTD,,,
5906,38-1-0-81-0,6707-75-3221,SNGL FAM SUB,3.56,AC,53100,0,53100,59300,0,112400,52100,0,52100,50800,0,102900,A1,AG/GEN,,,
5907,13-1-0-27-B,6842-90-4911,SNGL FAM SUB,2,AC,58600,0,58600,212700,1400,272700,57500,0,57500,184900,1400,243800,A1,AG/GEN,,,
5908,56-1-0-36-A,6785-83-9822,SNGL FAM SUB,1.85,AC,83500,0,83500,203300,23100,309900,74600,0,74600,172500,21600,268700,A2,AG/LTD,,,
5909,9-1-0-16-0,5892-63-7068,SNGL FAM SUB,1.48,AC,40500,0,40500,142000,8400,190900,39700,0,39700,125500,4400,169600,A1,AG/GEN,,,
5910,58-1-0-40-0,7715-72-3318,SNGL FAM SUB,0.93,AC,107000,0,107000,84300,1100,192400,93100,0,93100,71800,1100,166000,A2,AG/LTD,,,
5911,21-2-0-5-0,6769-29-1314,SNGL FAM SUB,14,AC,142000,0,142000,0,0,142000,130500,0,130500,0,0,130500,A2,AG/LTD,,,
5912,56-1-0-36-0,6785-83-9965,SNGL FAM SUB,1.77,AC,82300,0,82300,253000,10900,346200,73500,0,73500,143600,5500,222600,A2,AG/LTD,,,
5913,5-3-0-9-0,6823-18-5709,SNGL FAM SUB,1.31,AC,46100,0,46100,142200,0,188300,45200,0,45200,121100,0,166300,A1,AG/GEN,,,
5914,38-1-0-84-0,6707-76-4466,SNGL FAM SUB,3.41,AC,52300,0,52300,60100,100,112500,51300,0,51300,52500,100,103900,A1,AG/GEN,,,
5915,38-1-0-84-A,6707-76-4940,SNGL FAM SUB,2.58,AC,47600,0,47600,133500,400,181500,46700,0,46700,114300,400,161400,A1,AG/GEN,,,
5916,6-7-0-1-0,6823-82-2869,SNGL FAM SUB,8.51,AC,78000,0,78000,260400,0,338400,78400,0,78400,221000,0,299400,A1,AG/GEN,,,
5917,6-7-0-2-0,6823-82-8824,SNGL FAM SUB,8.5,AC,68100,0,68100,0,0,68100,66800,0,66800,0,0,66800,A1,AG/GEN,,,
5918,6-7-0-3-0,6823-92-4525,SNGL FAM SUB,8.52,AC,68200,0,68200,0,0,68200,66900,0,66900,0,0,66900,A1,AG/GEN,,,
5919,6-7-0-4-0,6823-92-6991,SNGL FAM SUB,8.5,AC,68100,0,68100,0,0,68100,66800,0,66800,0,0,66800,A1,AG/GEN,,,
5920,6-7-0-5-0,6833-02-4727,SNGL FAM SUB,8.5,AC,68100,0,68100,0,0,68100,66800,0,66800,0,0,66800,A1,AG/GEN,,,
5921,6-7-0-6-0,6833-02-1207,SNGL FAM SUB,8.5,AC,68100,0,68100,0,0,68100,66800,0,66800,0,0,66800,A1,AG/GEN,,,
5922,6-7-0-7-0,6823-91-7769,SNGL FAM SUB,8.5,AC,68100,0,68100,0,0,68100,66800,0,66800,0,0,66800,A1,AG/GEN,,,
5923,6-7-0-8-0,6823-91-2954,SNGL FAM SUB,8.51,AC,68100,0,68100,0,0,68100,66900,0,66900,0,0,66900,A1,AG/GEN,,,
5924,6-7-0-9-0,6823-82-7164,SNGL FAM SUB,8.5,AC,68100,0,68100,0,0,68100,66800,0,66800,0,0,66800,A1,AG/GEN,,,
5925,38-1-0-95-0,6717-06-8842,SNGL FAM SUB,5,AC,61200,0,61200,0,0,61200,60000,0,60000,0,0,60000,A1,AG/GEN,,,
5926,28-4-0-4-0,6739-00-5394,SNGL FAM SUB,0.97,AC,40000,0,40000,24900,800,65700,39500,0,39500,21400,900,61800,A1,AG/GEN,,,
5927,56-1-0-5-0,6786-93-6773,SNGL FAM SUB,2.14,AC,83600,0,83600,0,0,83600,74600,0,74600,0,0,74600,A2,AG/LTD,,,
5928,15-1-0-23-0,5880-50-0685,SNGL FAM SUB,5,AC,50600,0,50600,0,0,50600,50000,0,50000,0,0,50000,A1,AG/GEN,,,
5929,55-1-0-38-0,6786-60-0348,SNGL FAM SUB,7.72,AC,171600,0,171600,141800,3500,316900,153300,0,153300,117200,3500,274000,A2,AG/LTD,,,
5930,6-7-0-10-0,6823-82-2330,SNGL FAM SUB,8.5,AC,78000,0,78000,227400,2500,307900,76500,0,76500,207300,2500,286300,A1,AG/GEN,,,
5931,9-1-0-11-0,5892-73-3805,SNGL FAM SUB,3.89,AC,48700,0,48700,94200,200,143100,47600,0,47600,84000,200,131800,A1,AG/GEN,,,
5932,5-1-0-8-A,6813-76-6989,SNGL FAM SUB,1.07,AC,40100,0,40100,116200,2000,158300,39400,0,39400,103400,2000,144800,A1,AG/GEN,,,
5933,38-1-0-96-0,6717-07-9154,SNGL FAM SUB,5,AC,61200,0,61200,0,0,61200,60000,0,60000,0,0,60000,A1,AG/GEN,,,
5934,10-1-0-15-B,6801-43-3435,SNGL FAM SUB,1.5,AC,41100,0,41100,73200,300,114600,40300,0,40300,64800,300,105400,A1,AG/GEN,,,
5935,10-1-0-15-0,6801-32-6387,AG 20-100 AC,38.764,AC,135600,117700,17900,59700,14400,209700,132400,78300,54100,62700,12400,207500,A1,AG/GEN,,,
5937,10-1-0-13-0,6801-33-0128,AG 20-100 AC,23.254,AC,111000,0,111000,72900,2100,186000,104800,0,104800,65000,2100,171900,A1,AG/GEN,,,
5939,10-1-0-14-0,6801-33-9781,AG 20-100 AC,40.794,AC,122300,58400,63900,88800,28000,239100,117600,56100,61500,78700,25600,221900,A1,AG/GEN,,,
5940,19-2-0-A-1,6830-94-0314,AG 20-100 AC,38.06,AC,278400,202600,75800,295400,7500,581300,284600,214200,70400,252100,7500,544200,A1,AG/GEN,,,
5941,38-1-0-37-A,6707-45-2702,SNGL FAM SUB,9.995,AC,75000,70400,4600,0,0,75000,73500,69300,4200,0,0,73500,A1,AG/GEN,,,
5942,38-1-0-94-0,6717-06-6414,SNGL FAM SUB,7.695,AC,76300,0,76300,0,0,76300,74800,0,74800,0,0,74800,A1,AG/GEN,,,
5943,38-1-0-76-0,6707-93-5209,SNGL FAM SUB,7.26,AC,48200,0,48200,0,0,48200,47200,0,47200,0,0,47200,A1,AG/GEN,,,
5944,67-2-B-4-0,7723-56-2389,SNGL FAM SUB,0,AC,184000,0,184000,313600,12100,509700,160000,0,160000,261100,11400,432500,R1,RES/LTD,,,
5945,31-8-0-7-0,6779-51-2889,SNGL FAM SUB,6.99,AC,112100,108900,3200,0,0,112100,100000,97000,3000,0,0,100000,A2,AG/LTD,,,
5946,30-4-0-2-0,6768-08-1996,SNGL FAM SUB,2.25,AC,69400,0,69400,182200,22800,274400,62900,0,62900,150000,19500,232400,A2,AG/LTD,,,
5950,45-8-0-A-0,6798-61-9023,SNGL FAM SUB,1.25,AC,63100,0,63100,192100,1100,256300,56300,0,56300,156200,1100,213600,A2,AG/LTD,,,
5951,64-1-0-51-0,7724-92-4661,COMM & IND,0.97,AC,323000,0,323000,1232400,101300,1656700,299100,0,299100,1189300,68200,1556600,B1,BUS/GEN,,,
5953,6-1-0-35-0,6822-78-2696,SNGL FAM SUB,7.27,AC,72100,0,72100,0,0,72100,70200,0,70200,0,0,70200,A1,AG/GEN,,,
5954,46-14-0-12-0,7718-01-6286,SNGL FAM SUB,1.49,AC,104900,0,104900,179000,37200,321100,95400,0,95400,149500,31000,275900,A2,AG/LTD,,,
5955,1-1-0-33-0,6814-32-6467,SNGL FAM SUB,3.45,AC,52200,0,52200,0,1000,53200,51300,0,51300,0,1000,52300,A1,AG/GEN,,,
5956,3-1-0-4-0,6803-22-8938,AG 20-100 AC,23.125,AC,95800,85100,10700,0,26500,122300,92500,82700,9800,0,22000,114500,A1,AG/GEN,,,
5957,3-1-0-6-0,6802-28-6286,AG > 100 AC,529.268,AC,918700,674700,244000,0,0,918700,899800,674900,224900,0,0,899800,A1,AG/GEN,,,
5958,4-1-0-18-0,6803-41-4123,AG 20-100 AC,85.032,AC,174500,135300,39200,0,0,174500,170100,134000,36100,0,0,170100,A1,AG/GEN,,,
5959,48-1-0-48-0,7727-89-0175,COMM & IND,20.275,AC,2579000,0,2579000,71300,15000,2665300,1319000,0,1319000,548600,21000,1888600,M2,INDUS/G,,,
5962,43-20-0-5-0,6768-62-8204,SNGL FAM SUB,3.47,AC,96800,0,96800,181600,3400,281800,88000,0,88000,159400,3600,251000,A2,AG/LTD,,,
5963,13-10-0-4-0,6841-94-0874,SNGL FAM SUB,3.03,AC,67500,0,67500,171000,2000,240500,66300,0,66300,147300,2000,215600,A1,AG/GEN,,,
5964,13-10-0-5-0,6841-84-5352,SNGL FAM SUB,10.03,AC,124900,0,124900,0,0,124900,123700,0,123700,0,0,123700,A1,AG/GEN,,,
5965,13-10-0-6-0,6841-84-2577,SNGL FAM SUB,5.02,AC,83700,0,83700,279000,0,362700,82100,0,82100,249400,0,331500,A1,AG/GEN,,,
5966,44-16-0-20-0,6787-39-1203,SNGL FAM SUB,3.05,AC,129000,0,129000,249300,3900,382200,115000,0,115000,229300,3500,347800,A2,AG/LTD,,,
5968,46-1-0-121-0,7707-72-7390,SNGL FAM SUB,5.75,AC,207300,0,207300,214000,9400,430700,185300,0,185300,178700,8700,372700,A2,AG/LTD,,,
5971,16-1-0-23-0,5890-44-1027,SNGL FAM SUB,4.5,AC,51400,0,51400,64700,2900,119000,50300,0,50300,56900,2900,110100,A1,AG/GEN,,,
5972,46-8-0-B-2,7707-52-9419,SNGL FAM SUB,2.6,AC,135500,0,135500,0,10700,146200,121000,0,121000,0,10400,131400,RR,RES/RUR,,,
5973,46-1-0-72-0,7707-62-1492,SNGL FAM SUB,1,AC,99000,0,99000,155700,23300,278000,88400,0,88400,129000,19600,237000,RR,RES/RUR,,,
5974,46-1-0-73-B,7707-62-3179,SNGL FAM SUB,2,AC,121800,0,121800,191700,39400,352900,108800,0,108800,159300,32200,300300,RR,RES/RUR,,,
5975,57-1-0-53-E,7716-10-7051,SNGL FAM SUB,6.3,AC,576000,0,576000,601400,91300,1268700,528000,0,528000,583200,75400,1186600,A2,AG/LTD,,,
5976,57-1-0-53-F,7715-19-8540,Roads,0.426,AC,0,0,0,0,0,0,0,0,0,0,0,0,A2,AG/LTD,,,
5978,48-3-G-1-0,7726-57-2825,SNGL FAM SUB,0.698,AC,130000,0,130000,370200,28800,529000,117000,0,117000,373700,28800,519500,R3,RES/GEN,,,
5979,57-20-C-7-0,7716-10-3488,SNGL FAM SUB,1.9,AC,427100,0,427100,612200,21200,1060500,392000,0,392000,573300,17900,983200,A2,AG/LTD,,,
5980,55-1-0-98-0,6785-55-1349,SNGL FAM SUB,2.37,AC,92700,0,92700,238000,0,330700,82700,0,82700,196800,0,279500,A2,AG/LTD,,,
5981,63-15-A-1-0,7714-91-3040,SNGL FAM SUB,9.66,AC,542000,0,542000,1215800,129100,1886900,471200,0,471200,1134500,114900,1720600,A2R1,AG LTD/,,,
5982,63-15-A-2-0,7714-90-0908,SNGL FAM SUB,5.02,AC,276400,0,276400,139800,0,416200,240300,0,240300,116900,0,357200,A2,AG/LTD,,,
5983,57-1-0-70-0,7706-95-7358,SNGL FAM SUB,19,AC,766700,508000,258700,701900,78000,1546600,666400,441700,224700,600500,66500,1333400,A2,AG/LTD,,,
5984,58-3-A-13-0,7726-26-0467,SNGL FAM SUB,0,AC,88000,0,88000,167400,1000,256400,80000,0,80000,145200,1000,226200,RN,RESIDEN,,,
5985,57-15-0-A-0,7715-23-0572,SNGL FAM SUB,2,AC,207400,0,207400,121700,1000,330100,180300,0,180300,102400,1000,283700,A2,AG/LTD,,,
5986,59-1-0-3-0,7726-57-6176,MultiFamily,1.943,AC,1167900,0,1167900,0,0,1167900,973200,0,973200,0,0,973200,R3,RES/GEN,,,
5987,67-11-C-2-0,7733-27-3136,SNGL FAM SUB,0,AC,265000,0,265000,595500,61500,922000,220000,0,220000,524800,60000,804800,R1,RES/LTD,,,
5988,64-14-C-1-0,7733-27-2375,SNGL FAM SUB,0,AC,265000,0,265000,1045300,1500,1311800,220000,0,220000,859600,1500,1081100,R1,RES/LTD,,,
5989,32-4-0-7-0,6779-64-4506,SNGL FAM SUB,16.99,AC,225600,0,225600,183500,15300,424400,201100,0,201100,150300,13000,364400,A2,AG/LTD,,,
5991,2-1-0-16-0,6814-73-2759,SNGL FAM SUB,7.75,AC,74100,0,74100,90700,600,165400,72800,0,72800,79100,600,152500,A1,AG/GEN,,,
5992,4-2-0-17-0,6814-20-7326,SNGL FAM SUB,3.564,AC,53300,0,53300,289500,41000,383800,52200,0,52200,254500,36400,343100,A1,AG/GEN,,,
5993,4-2-0-12-0,6814-40-0967,SNGL FAM SUB,3.3,AC,51900,0,51900,196000,8600,256500,50800,0,50800,129100,6700,186600,A1,AG/GEN,,,
5994,2-3-0-20-0,6824-23-3279,SNGL FAM SUB,3.44,AC,50600,0,50600,185400,2500,238500,49400,0,49400,156400,2500,208300,A1,AG/GEN,,,
5995,31-1-0-31-0,6768-96-9812,SNGL FAM SUB,6.397,AC,131600,0,131600,247800,18100,397500,117600,0,117600,203300,15800,336700,A2,AG/LTD,,,
5996,39-1-0-46-B,6727-11-4323,SNGL FAM SUB,1.89,AC,43800,0,43800,9500,0,53300,42900,0,42900,9200,0,52100,A1,AG/GEN,,,
5997,28-1-0-58-A,6738-18-4329,SNGL FAM SUB,1,AC,40000,0,40000,70700,200,110900,39500,0,39500,58900,200,98600,A1,AG/GEN,,,
5998,29-8-0-3-B,6759-07-4127,SNGL FAM SUB,1,AC,54000,0,54000,123500,2000,179500,49900,0,49900,102300,2000,154200,A1,AG/GEN,,,
5999,39-1-0-85-0,6726-65-1468,AG 20-100 AC,80.7,AC,290500,250200,40300,0,0,290500,282500,245100,37400,0,0,282500,A1,AG/GEN,,,
6000,63-1-0-177-0,7724-12-6724,COMM & IND,10.417,AC,1239200,0,1239200,256200,147500,1642900,1147700,0,1147700,233700,124400,1505800,M1R3,INDUSTR,,,
6001,63-4-0-4-0,7714-96-5546,SNGL FAM SUB,1.967,AC,198000,0,198000,634800,121600,954400,180000,0,180000,579600,109500,869100,A2,AG/LTD,,,
6002,62-13-A-3-0,7714-05-3523,SNGL FAM SUB,0,AC,115000,0,115000,197400,0,312400,100000,0,100000,179800,0,279800,R1,RES/LTD,,,
6003,39-1-0-46-A,6727-11-3477,SNGL FAM SUB,2.29,AC,46000,0,46000,95600,800,142400,45100,0,45100,81300,800,127200,A1,AG/GEN,,,
6004,62-1-0-27-0,7714-04-9010,SNGL FAM SUB,0.49,AC,73300,0,73300,158600,16600,248500,63800,0,63800,135500,15300,214600,R3,RES/GEN,,,
6005,38-1-0-39-D,6707-63-1978,SNGL FAM SUB,2,AC,44400,0,44400,114800,0,159200,43500,0,43500,96500,0,140000,A1,AG/GEN,,,
6006,17-1-0-3-A,6801-60-0320,SNGL FAM SUB,2.412,AC,45300,0,45300,13400,2700,61400,44400,0,44400,14900,3300,62600,A1,AG/GEN,,,
6007,26-1-0-45-0,6719-11-7680,COMM & IND,0.06,AC,2900,0,2900,0,0,2900,2800,0,2800,0,0,2800,B1,BUS/GEN,,,
6008,67-13-C-7-0,7733-26-9529,SNGL FAM SUB,0,AC,265000,0,265000,677700,2600,945300,220000,0,220000,566500,1800,788300,R1,RES/LTD,,,
6009,19-1-0-65-0,6830-44-9375,SNGL FAM SUB,1,AC,54000,0,54000,117200,1500,172700,49900,0,49900,97500,1500,148900,A1,AG/GEN,,,
6010,19-1-0-66-0,6830-54-0507,SNGL FAM SUB,1.11,AC,10900,0,10900,0,0,10900,10400,0,10400,0,0,10400,A1,AG/GEN,,,
6011,57-1-0-59-0,7716-05-8268,SNGL FAM SUB,3.28,AC,247500,0,247500,286800,19400,553700,215100,0,215100,240000,16300,471400,A2,AG/LTD,,,
6013,56-1-0-80-0,6795-98-1843,AG 20-100 AC,28.43,AC,801500,0,801500,1089300,3600,1894400,696200,0,696200,947200,3600,1647000,A2,AG/LTD,,,
6014,46-14-0-11-0,7718-01-7423,SNGL FAM SUB,1.33,AC,104000,0,104000,199000,38000,341000,94500,0,94500,168000,32600,295100,A2,AG/LTD,,,
6015,56-1-0-33-0,6785-93-2168,SNGL FAM SUB,2.149,AC,95300,0,95300,298300,0,393600,85100,0,85100,250200,0,335300,A2,AG/LTD,,,
6016,9-1-0-69-A,5892-72-0281,SNGL FAM SUB,1,AC,38800,0,38800,165200,0,204000,38000,0,38000,148900,0,186900,A1,AG/GEN,,,
6017,46-21-B-4-0,7708-90-6290,SNGL FAM SUB,2.27,AC,124400,0,124400,349400,31700,505500,113000,0,113000,293600,29600,436200,A2,AG/LTD,,,
6018,31-13-0-1-0,6768-87-6026,SNGL FAM SUB,5.553,AC,121000,0,121000,383400,9000,513400,108200,0,108200,318500,7600,434300,A2,AG/LTD,,,
6019,31-13-0-2-0,6768-87-5321,SNGL FAM SUB,4.835,AC,112000,0,112000,0,0,112000,100200,0,100200,0,0,100200,A2,AG/LTD,,,
6020,31-13-0-3-0,6768-87-7525,SNGL FAM SUB,5.061,AC,114900,0,114900,263400,18300,396600,102700,0,102700,220700,18300,341700,A2,AG/LTD,,,
6021,31-14-0-1-0,6768-96-2577,SNGL FAM SUB,2.857,AC,87300,0,87300,187300,2000,276600,78000,0,78000,153200,2000,233200,A2,AG/LTD,,,
6023,56-1-0-32-0,6785-93-4021,SNGL FAM SUB,4.759,AC,136500,0,136500,298800,12500,447800,121900,0,121900,200400,12100,334400,A2,AG/LTD,,,
6024,67-2-E-11-0,7723-64-2340,SNGL FAM SUB,0,AC,184000,0,184000,391300,3600,578900,160000,0,160000,324500,3600,488100,R1,RES/LTD,,,
6025,46-21-A-4-0,7708-90-0654,SNGL FAM SUB,2.26,AC,124100,0,124100,291500,0,415600,112800,0,112800,245400,0,358200,A2,AG/LTD,,,
6026,55-19-0-5-0,6776-85-2457,SNGL FAM SUB,2.769,AC,94500,0,94500,172900,3700,271100,84400,0,84400,141100,3700,229200,A2,AG/LTD,,,
6027,57-17-0-6-0,7706-14-6166,SNGL FAM SUB,3,AC,161000,0,161000,349100,21000,531100,140100,0,140100,298000,21000,459100,A2,AG/LTD,,,
6028,4-1-0-2-C,6804-40-0486,SNGL FAM SUB,1,AC,39700,0,39700,208000,19900,267600,39000,0,39000,181600,16200,236800,A1,AG/GEN,,,
6029,4-1-0-2-B,6804-30-5270,SNGL FAM SUB,9,AC,61200,0,61200,0,0,61200,60000,0,60000,0,0,60000,A1,AG/GEN,,,
6030,57-25-B-8-0,7716-23-0660,SNGL FAM SUB,1.646,AC,310000,0,310000,454800,0,764800,285000,0,285000,412300,0,697300,A2,AG/LTD,,,
6032,12-1-0-52-D,6832-21-8809,SNGL FAM SUB,2.37,AC,51500,0,51500,223100,3500,278100,50000,0,50000,193700,3500,247200,A1,AG/GEN,,,
6033,20-11-0-14-0,6841-91-9557,SNGL FAM SUB,2,AC,55600,0,55600,248600,3300,307500,52500,0,52500,214100,2600,269200,A1,AG/GEN,,,
6034,33-5-0-B-0,6798-32-4523,SNGL FAM SUB,4.03,AC,118500,0,118500,255200,25700,399400,105800,0,105800,213500,20300,339600,A2,AG/LTD,,,
6035,33-5-0-A-0,6798-32-8667,SNGL FAM SUB,6.13,AC,140600,0,140600,105500,1000,247100,125500,0,125500,87100,1000,213600,A2,AG/LTD,,,
6036,58-1-0-91-0,7726-04-9184,SNGL FAM SUB,3.65,AC,205400,0,205400,418000,55900,679300,178600,0,178600,362400,52800,593800,A2,AG/LTD,,,
6037,33-5-0-C-0,6798-42-1197,SNGL FAM SUB,8.61,AC,163700,0,163700,244900,0,408600,146100,0,146100,204500,0,350600,A2,AG/LTD,,,
6038,45-1-0-134-0,6798-41-0491,SNGL FAM SUB,15.52,AC,223500,0,223500,0,0,223500,200200,0,200200,0,0,200200,A2,AG/LTD,,,
6039,43-1-0-63-B,6778-41-2703,SNGL FAM SUB,2.5,AC,91700,0,91700,190700,25900,308300,82000,0,82000,155900,21500,259400,A2,AG/LTD,,,
6040,15-5-0-18-0,5789-49-9735,SNGL FAM SUB,8.62,AC,66200,0,66200,339800,5400,411400,64700,0,64700,329900,4300,398900,A1,AG/GEN,,,
6041,42-20-0-C-3,6767-14-8753,SNGL FAM SUB,2.131,AC,92200,0,92200,289700,2000,383900,82900,0,82900,236700,2000,321600,A2,AG/LTD,,,
6042,10-2-0-2-0,6801-55-1523,AG 20-100 AC,27.42,AC,109200,0,109200,4000,0,113200,107800,0,107800,4000,0,111800,A1,AG/GEN,,,
6043,5-1-0-68-0,6824-50-0605,AG 20-100 AC,99.012,AC,293700,216700,77000,347300,24300,665300,288000,215000,73000,301600,20700,610300,A1,AG/GEN,,,
6049,31-1-0-55-0,6769-87-6279,SNGL FAM SUB,2.72,AC,82000,0,82000,192000,39000,313000,75700,0,75700,158000,32500,266200,A2,AG/LTD,,,
6050,32-1-0-46-A,6778-85-4220,SNGL FAM SUB,1,AC,64100,0,64100,169800,13000,246900,57200,0,57200,139700,13000,209900,A2,AG/LTD,,,
6051,32-1-0-46-0,6778-73-5689,SNGL FAM SUB,11.28,AC,175100,169900,5200,0,1000,176100,155900,151100,4800,0,1000,156900,A2,AG/LTD,,,
6052,32-1-0-49-0,6778-73-9393,SNGL FAM SUB,18.36,AC,239400,230900,8500,0,0,239400,213400,205600,7800,0,0,213400,A2,AG/LTD,,,
6053,32-1-0-49-B,6778-83-3821,SNGL FAM SUB,5.24,AC,112400,0,112400,234900,8000,355300,100400,0,100400,195000,8000,303400,A2,AG/LTD,,,
6054,46-1-0-26-0,7707-14-8377,SNGL FAM SUB,4.46,AC,175800,0,175800,265400,1500,442700,156900,0,156900,224000,1500,382400,A2,AG/LTD,,,
6055,46-1-0-26-A,7707-24-1223,SNGL FAM SUB,2.04,AC,122700,0,122700,170200,2100,295000,109600,0,109600,146800,2100,258500,A2,AG/LTD,,,
6056,45-1-0-9-0,6798-20-5454,AG 20-100 AC,30.5,AC,439200,0,439200,0,0,439200,393500,0,393500,0,0,393500,A2,AG/LTD,,,
6057,31-1-0-98-A,6778-33-2044,SNGL FAM SUB,2.15,AC,80700,0,80700,350200,5400,436300,72000,0,72000,287400,4300,363700,A2,AG/LTD,,,
6058,31-1-0-99-0,6778-12-6389,AG 20-100 AC,67.89,AC,724700,672700,52000,0,0,724700,647000,599700,47300,0,0,647000,A2,AG/LTD,,,
6059,32-1-0-27-0,6778-67-9831,COMM & IND,1.98,AC,144100,0,144100,75200,2300,221600,137200,0,137200,72300,2000,211500,B1,BUS/GEN,,,
6060,43-1-0-61-0,6778-21-1920,AG 20-100 AC,34.28,AC,443500,362700,80800,99200,300,543000,396700,325200,71500,81500,300,478500,A2,AG/LTD,,,
6061,43-1-0-69-T,6777-39-4886-9999,AG 20-100 AC,24.3,AC,380700,254900,125800,0,11900,392600,340500,227800,112700,0,10000,350500,A2,AG/LTD,,,
6062,31-1-0-98-0,6778-32-7427,SNGL FAM SUB,7.07,AC,151500,147900,3600,0,0,151500,135500,132500,3000,0,0,135500,A2,AG/LTD,,,
6063,43-1-0-62-0,6778-31-2166,AG 20-100 AC,71.1,AC,783100,749400,33700,0,0,783100,699900,669600,30300,0,0,699900,A2,AG/LTD,,,
6064,43-1-0-61-A,6778-20-3846,AG 20-100 AC,39.8,AC,456000,373100,82900,54000,11200,521200,406400,332600,73800,49300,11200,466900,A2,AG/LTD,,,
6065,16-3-0-1-A,5890-60-3083,SNGL FAM SUB,2.471,AC,44100,0,44100,216900,1500,262500,43100,0,43100,192900,1500,237500,A1,AG/GEN,,,
6067,4-1-0-2-A,6803-39-8815,SNGL FAM SUB,10,AC,77000,0,77000,183000,32700,292700,75600,0,75600,159400,32700,267700,A1,AG/GEN,,,
6068,67-4-0-3-0,7733-05-1413,SNGL FAM SUB,4.9,AC,322000,0,322000,618900,49700,990600,279900,0,279900,527000,45500,852400,A2,AG/LTD,,,
6069,6-4-0-8-0,6832-89-6003,SNGL FAM SUB,5.6,AC,79400,0,79400,302800,38100,420300,77800,0,77800,267000,33800,378600,A1,AG/GEN,,,
6070,26-9-0-C-0,6719-34-1006,SNGL FAM SUB,8.58,AC,81800,0,81800,0,0,81800,79700,0,79700,0,0,79700,A1,AG/GEN,,,
6071,26-9-0-D-0,6719-34-3566,SNGL FAM SUB,15,AC,114800,0,114800,246900,50200,411900,115000,0,115000,204800,46600,366400,A1,AG/GEN,,,
6072,31-17-0-4-0,6779-43-3283,SNGL FAM SUB,8.44,AC,139200,0,139200,0,0,139200,124200,0,124200,0,0,124200,A2,AG/LTD,,,
6073,62-2-C-3-0,7714-04-3219,SNGL FAM SUB,0,AC,115000,0,115000,184800,2000,301800,100000,0,100000,172100,2000,274100,R1,RES/LTD,,,
6074,17-1-0-105-0,6810-46-6033,SNGL FAM SUB,1.5,AC,43000,0,43000,12700,100,55800,40800,0,40800,12300,100,53200,A1,AG/GEN,,,
6075,55-17-0-7-0,6785-37-9390,SNGL FAM SUB,3.42,AC,151200,0,151200,761500,3800,916500,135000,0,135000,672200,3200,810400,A2,AG/LTD,,,
6076,55-1-0-36-0,6785-57-5510,SNGL FAM SUB,1.44,AC,77400,0,77400,141800,0,219200,69100,0,69100,116300,0,185400,A2,AG/LTD,,,
6077,5-3-0-15-0,6823-19-6756,SNGL FAM SUB,3.4,AC,57700,0,57700,0,0,57700,56500,0,56500,0,0,56500,A1,AG/GEN,,,
6078,14-2-0-16-0,6851-28-3277,SNGL FAM SUB,3.85,AC,74100,0,74100,181000,15300,270400,72600,0,72600,153900,16000,242500,A1,AG/GEN,,,
6079,4-2-0-28-0,6813-49-1935,SNGL FAM SUB,3.32,AC,52000,0,52000,0,0,52000,50900,0,50900,0,0,50900,A1,AG/GEN,,,
6080,63-3-A-3-0,7714-91-3783,SNGL FAM SUB,0,AC,70000,0,70000,372900,0,442900,60000,0,60000,339600,0,399600,R1,RES/LTD,,,
6081,14-2-0-21-0,6851-37-1920,SNGL FAM SUB,4.05,AC,72800,0,72800,232200,30400,335400,71300,0,71300,200600,36200,308100,A1,AG/GEN,,,
6082,4-1-0-43-C,6814-21-8208,SNGL FAM SUB,2,AC,44800,0,44800,142800,4000,191600,44000,0,44000,122900,4000,170900,A1,AG/GEN,,,
6083,56-1-0-30-0,6785-92-6705,SNGL FAM SUB,1.34,AC,75500,0,75500,162100,6300,243900,67400,0,67400,131900,5400,204700,A2,AG/LTD,,,
6084,31-1-0-79-0,6778-49-4103,AG 20-100 AC,33.224,AC,412100,0,412100,335100,0,747200,366600,0,366600,277300,0,643900,A2,AG/LTD,,,
6085,48-1-0-52-0,7728-92-7423,SNGL FAM SUB,14.21,AC,392300,385500,6800,0,0,392300,350000,344000,6000,0,0,350000,A2,AG/LTD,,,
6086,63-7-0-D-1,7723-07-0717,SNGL FAM SUB,4.934,AC,276700,0,276700,552900,27100,856700,240500,0,240500,471000,25900,737400,A2,AG/LTD,,,
6087,57-26-0-3-A,7706-51-4697,SNGL FAM SUB,3.57,AC,223500,0,223500,438700,23100,685300,194400,0,194400,371800,21900,588100,A2,AG/LTD,,,
6088,47-1-0-54-0,7717-79-6023,SNGL FAM SUB,5,AC,167000,164400,2600,0,0,167000,149200,147000,2200,0,0,149200,A2,AG/LTD,,,
6089,42-3-0-1-A,6767-03-9672,COMM & IND,0.793,AC,99000,0,99000,135500,6600,241100,95200,0,95200,125600,6800,227600,B1,BUS/GEN,,,
6090,42-3-0-1-B,6767-03-9563,SNGL FAM SUB,0.568,AC,105000,0,105000,202800,0,307800,97500,0,97500,171600,0,269100,B1,BUS/GEN,,,
6092,42-3-0-1-0,6767-03-9730,COMM & IND,0.452,AC,69000,0,69000,0,46600,115600,66300,0,66300,0,36700,103000,R3,RES/GEN,,,
6093,30-11-0-8-0,6758-13-8622,SNGL FAM SUB,3,AC,73600,0,73600,212500,1300,287400,70700,0,70700,182400,1300,254400,A2,AG/LTD,,,
6094,46-1-0-2-A,7707-09-9839,SNGL FAM SUB,2,AC,115200,0,115200,158900,100,274200,102900,0,102900,120700,100,223700,A2,AG/LTD,,,
6095,43-6-0-1-B,6767-64-7018,SNGL FAM SUB,0.2,AC,2500,0,2500,0,0,2500,2200,0,2200,0,0,2200,A2,AG/LTD,,,
6096,43-13-0-B-0,6767-73-2659,SNGL FAM SUB,5.11,AC,105600,0,105600,87100,13000,205700,94200,0,94200,71800,11000,177000,A2,AG/LTD,,,
6097,44-19-0-9-0,6778-91-4217,SNGL FAM SUB,5.17,AC,106200,0,106200,207400,1200,314800,94700,0,94700,171400,1200,267300,A2,AG/LTD,,,
6098,44-19-0-10-0,6778-91-3074,SNGL FAM SUB,5.26,AC,107100,0,107100,0,0,107100,95500,0,95500,0,0,95500,A2,AG/LTD,,,
6099,56-1-0-1-E,6786-94-0429,SNGL FAM SUB,1,AC,70100,0,70100,144400,6900,221400,62600,0,62600,117400,5800,185800,A2,AG/LTD,,,
6100,44-10-0-5-0,6787-53-6992,SNGL FAM SUB,5.85,AC,134100,0,134100,165000,14000,313100,119800,0,119800,136100,12000,267900,A2,AG/LTD,,,
6101,34-1-0-2-0,7708-23-1940,SNGL FAM SUB,6,AC,145600,0,145600,299200,16200,461000,130100,0,130100,248100,12200,390400,A2,AG/LTD,,,
6102,29-1-0-26-A,6748-32-3261,SNGL FAM SUB,2.55,AC,69300,0,69300,223500,0,292800,63500,0,63500,185000,0,248500,A1,AG/GEN,,,
6104,29-1-0-27-0,6748-32-9296,SNGL FAM SUB,0.83,AC,51500,0,51500,147600,0,199100,47600,0,47600,122800,0,170400,A1,AG/GEN,,,
6106,48-1-0-24-0,7727-61-3871,COMM & IND,7.219,AC,540600,0,540600,0,0,540600,514600,0,514600,0,0,514600,M2,INDUS/G,,,
6108,48-8-0-2-0,7727-62-2741,COMM & IND,7.25,AC,366200,0,366200,0,0,366200,349000,0,349000,0,0,349000,M2,INDUS/G,,,
6109,48-8-0-3-0,7727-63-2038,COMM & IND,7.25,AC,366200,0,366200,0,0,366200,349000,0,349000,0,0,349000,M2,INDUS/G,,,
6110,48-8-0-4-0,7727-71-0564,COMM & IND,2,AC,127400,0,127400,0,0,127400,121400,0,121400,0,0,121400,M2,INDUS/G,,,
6111,48-8-0-4-A,7727-71-0707,COMM & IND,5.25,AC,265200,0,265200,0,0,265200,252700,0,252700,0,0,252700,M2,INDUS/G,,,
6112,48-8-0-5-0,7727-72-0107,COMM & IND,7.26,AC,366700,0,366700,0,0,366700,349500,0,349500,0,0,349500,M2,INDUS/G,,,
6113,48-8-0-6-0,7727-62-9762,COMM & IND,7.26,AC,366700,0,366700,0,0,366700,349500,0,349500,0,0,349500,M2,INDUS/G,,,
6114,62-2-D-2-0,7714-03-4733,SNGL FAM SUB,0,AC,115000,0,115000,198500,1700,315200,100000,0,100000,180100,1300,281400,R1,RES/LTD,,,
6115,66-2-0-B-0,7723-06-2992,AG 20-100 AC,20.491,AC,938500,0,938500,8363900,746700,10049100,816800,0,816800,7710800,712300,9239900,A2,AG/LTD,,,
6116,40-1-0-24-0,6736-27-2512,AG 20-100 AC,69.788,AC,266400,228200,38200,0,0,266400,259900,224800,35100,0,0,259900,A1,AG/GEN,,,
6117,40-1-0-24-B,6736-38-4658,AG > 100 AC,109.96,AC,528200,0,528200,587300,58900,1174400,515700,0,515700,538100,59300,1113100,A1,AG/GEN,,,
6118,30-1-0-123-0,6759-37-5171,SNGL FAM SUB,3.787,AC,87600,0,87600,154100,5500,247200,78900,0,78900,125000,4400,208300,A2,AG/LTD,,,
6119,13-1-0-9-0,6842-60-6710,AG 20-100 AC,33.49,AC,120800,99100,21700,0,0,120800,118500,104300,14200,0,0,118500,A1,AG/GEN,,,
6120,47-1-0-7-0,7718-31-9982,SNGL FAM SUB,0.11,AC,1900,0,1900,0,0,1900,1700,0,1700,0,0,1700,A2,AG/LTD,,,
6121,47-6-0-2-0,7718-40-0322,AG 20-100 AC,38.99,AC,706800,588500,118300,70200,25700,802700,631700,527000,104700,58400,25700,715800,A2,AG/LTD,,,
6123,13-1-0-11-0,6842-70-6001,AG 20-100 AC,40.55,AC,148500,0,148500,0,0,148500,145600,123400,22200,0,0,145600,A1,AG/GEN,,,
6124,47-9-0-5-0,7717-50-0402,SNGL FAM SUB,15.2,AC,499400,0,499400,452400,38000,989800,446200,0,446200,382800,32100,861100,A2,AG/LTD,,,
6125,47-20-0-C-0,7717-41-4618,SNGL FAM SUB,13.93,AC,432000,285600,146400,94300,4600,530900,385300,254700,130600,73200,4800,463300,A2,AG/LTD,,,
6126,47-20-0-A-0,7717-31-6924,AG 20-100 AC,20.78,AC,645700,516900,128800,940700,0,1586400,576100,461500,114600,801000,0,1377100,A2,AG/LTD,,,
6128,58-1-0-45-A,7715-83-0218,SNGL FAM SUB,0.86,AC,102500,0,102500,235500,10100,348100,89200,0,89200,199900,10100,299200,A2,AG/LTD,,,
6129,58-20-0-C-0,7715-73-7440,SNGL FAM SUB,1.78,AC,129700,0,129700,0,0,129700,112800,0,112800,0,0,112800,A2,AG/LTD,,,
6130,47-1-0-4-0,7717-37-6724,AG > 100 AC,108.74,AC,1453000,1401800,51200,0,0,1453000,1293600,1247200,46400,0,0,1293600,A2,AG/LTD,,,
6131,42-6-0-1-0,6767-03-9049,COMM & IND,0.253,AC,69000,0,69000,154200,0,223200,66300,0,66300,141500,0,207800,B1,BUS/GEN,,,
6132,42-6-0-2-0,6767-03-9137,COMM & IND,0.279,AC,69000,0,69000,203400,0,272400,66300,0,66300,185400,0,251700,B1,BUS/GEN,,,
6134,54-1-0-2-0,6766-45-4187,SNGL FAM SUB,14.65,AC,322900,0,322900,484700,1800,809400,288100,0,288100,217000,1800,506900,A2,AG/LTD,,,
6135,54-1-0-3-0,6766-46-0993,SNGL FAM SUB,5.925,AC,129200,0,129200,320400,0,449600,115300,0,115300,268500,0,383800,A2,AG/LTD,,,
6136,43-22-0-B-1,6766-78-5354,SNGL FAM SUB,12.7,AC,96200,0,96200,0,0,96200,85700,0,85700,0,0,85700,A2,AG/LTD,,,
6137,43-22-0-B-2,6766-87-5952,SNGL FAM SUB,6.35,AC,72600,0,72600,0,0,72600,64700,0,64700,0,0,64700,A2,AG/LTD,,,
6138,42-1-0-88-0,6767-07-3070,SNGL FAM SUB,1.11,AC,69400,0,69400,222500,5000,296900,61600,0,61600,185100,5000,251700,R3,RES/GEN,,,
6139,42-1-0-88-A,6767-07-8103,SNGL FAM SUB,2,AC,26900,0,26900,0,0,26900,24000,0,24000,0,0,24000,A2,AG/LTD,,,
6141,46-1-0-93-0,7718-00-5632,SNGL FAM SUB,1.015,AC,92900,0,92900,87800,100,180800,82900,0,82900,73500,100,156500,A2,AG/LTD,,,
6142,55-1-0-24-0,6785-36-3622,SNGL FAM SUB,11.27,AC,225200,0,225200,0,0,225200,201200,0,201200,0,0,201200,A2,AG/LTD,,,
6143,55-1-0-25-0,6785-36-8333,SNGL FAM SUB,4.949,AC,135300,0,135300,0,0,135300,120700,0,120700,0,0,120700,A2,AG/LTD,,,
6144,55-1-0-80-0,6785-76-9171,SNGL FAM SUB,1.01,AC,70200,0,70200,141200,2000,213400,62700,0,62700,115500,2000,180200,A2,AG/LTD,,,
6145,55-1-0-84-0,6785-75-9366,SNGL FAM SUB,5,AC,130500,0,130500,334000,26200,490700,116600,0,116600,272400,25300,414300,A2,AG/LTD,,,
6146,56-1-0-19-0,6785-83-0799,COMM & IND,10.72,AC,248200,0,248200,184100,54400,486700,235800,0,235800,151600,50700,438100,B1A2,BS AND,,,
6148,56-1-0-20-0,6785-83-4772,COMM & IND,1,AC,95000,0,95000,59100,1000,155100,87900,0,87900,59100,1000,148000,B1,BUS/GEN,,,
6149,56-1-0-37-0,6785-84-9223,SNGL FAM SUB,6.62,AC,158900,0,158900,0,0,158900,141800,0,141800,0,0,141800,A2,AG/LTD,,,
6150,56-7-0-4-0,6785-84-6562,SNGL FAM SUB,2,AC,77300,0,77300,0,0,77300,69000,0,69000,0,0,69000,A2,AG/LTD,,,
6154,46-1-0-92-0,7718-00-5890,SNGL FAM SUB,1.451,AC,102700,0,102700,94200,3400,200300,91700,0,91700,78900,3200,173800,A2,AG/LTD,,,
6155,34-1-0-1-0,7708-13-7698,AG 20-100 AC,37.02,AC,444200,427100,17100,0,0,444200,396100,380400,15700,0,0,396100,A2,AG/LTD,,,
6157,55-1-0-14-H,6785-09-6869,SNGL FAM SUB,3.568,AC,115900,0,115900,308300,0,424200,103600,0,103600,261800,0,365400,A2,AG/LTD,,,
6158,48-1-0-8-B,7728-70-2752,SNGL FAM SUB,3,AC,150200,50200,100000,121800,0,272000,134200,44900,89300,101000,0,235200,A2,AG/LTD,,,
6161,46-1-0-114-0,7717-07-3049,SNGL FAM SUB,3.026,AC,118900,0,118900,0,0,118900,106200,0,106200,0,0,106200,A2,AG/LTD,,,
6162,46-1-0-114-A,7717-05-0270,SNGL FAM SUB,8.61,AC,228400,224000,4400,0,0,228400,204100,200400,3700,0,0,204100,A2,AG/LTD,,,
6164,46-1-0-115-0,7717-15-4012,SNGL FAM SUB,4.527,AC,165000,0,165000,101100,41800,307900,150000,0,150000,85200,34100,269300,A2,AG/LTD,,,
6166,46-1-0-3-0,7708-21-6439,AG 20-100 AC,87.602,AC,1489200,1412200,77000,0,0,1489200,1331600,1263500,68100,0,0,1331600,A2,AG/LTD,,,
6167,46-1-0-4-0,7708-30-7932,SNGL FAM SUB,5.185,AC,174400,0,174400,0,93400,267800,155700,0,155700,0,84400,240100,A2,AG/LTD,,,
6169,46-26-0-2-0,7707-67-7045,SNGL FAM SUB,4.682,AC,157600,0,157600,337500,75900,571000,143200,0,143200,280500,72500,496200,A2,AG/LTD,,,
6170,46-26-0-4-0,7707-66-5776,SNGL FAM SUB,8.031,AC,212800,0,212800,399600,38300,650700,193500,0,193500,332600,32300,558400,A2,AG/LTD,,,
6171,46-26-0-5-0,7707-66-5510,SNGL FAM SUB,8.235,AC,216200,0,216200,296900,36500,549600,196500,0,196500,249800,30400,476700,A2,AG/LTD,,,
6172,46-26-0-6-0,7707-66-4292,SNGL FAM SUB,8.026,AC,212700,0,212700,331300,900,544900,193400,0,193400,277900,900,472200,A2,AG/LTD,,,
6173,46-26-0-7-0,7707-65-4915,SNGL FAM SUB,8.046,AC,213100,0,213100,338500,0,551600,193700,0,193700,283500,0,477200,A2,AG/LTD,,,
6174,46-26-0-8-0,7707-65-3513,SNGL FAM SUB,15.533,AC,226000,0,226000,0,0,226000,205700,0,205700,0,0,205700,A2,AG/LTD,,,
6175,46-26-0-9-0,7707-55-3996,SNGL FAM SUB,7.05,AC,196600,0,196600,785100,69000,1050700,178800,0,178800,668500,63800,911100,RR,RES/RUR,,,
6176,46-26-0-10-0,7707-56-4865,SNGL FAM SUB,8.086,AC,213700,95900,117800,403600,79400,696700,194300,87400,106900,336000,65900,596200,A2,AG/LTD,,,
6177,46-26-0-12-0,7707-57-3553,SNGL FAM SUB,8.33,AC,217700,0,217700,522000,0,739700,198000,0,198000,449500,0,647500,A2,AG/LTD,,,
6178,46-26-0-13-0,7707-46-9908,SNGL FAM SUB,10.02,AC,245600,0,245600,402800,1400,649800,223300,0,223300,345700,1400,570400,A2,AG/LTD,,,
6179,45-1-0-77-C,6797-71-0206,SNGL FAM SUB,1.93,AC,98000,0,98000,264800,18900,381700,87500,0,87500,218000,17500,323000,A2,AG/LTD,,,
6182,46-1-0-95-0,7707-99-8464,SNGL FAM SUB,0.93,AC,91900,0,91900,214300,3800,310000,82100,0,82100,184100,3900,270100,A2,AG/LTD,,,
6183,48-1-0-18-0,7727-46-1593,SNGL FAM SUB,3,AC,166200,0,166200,184800,17000,368000,148400,0,148400,155400,14000,317800,A2,AG/LTD,,,
6184,47-1-0-109-0,7727-38-1153,AG 20-100 AC,94.26,AC,5462400,5358700,103700,0,0,5462400,4881400,4789100,92300,0,0,4881400,A2,AG/LTD,,,
6185,47-1-0-107-0,7727-27-7146,SNGL FAM SUB,3,AC,91500,90100,1400,0,0,91500,81600,80300,1300,0,0,81600,A2,AG/LTD,,,
6186,47-1-0-108-0,7727-27-3374,SNGL FAM SUB,4.77,AC,119700,117500,2200,0,0,119700,106800,104800,2000,0,0,106800,A2,AG/LTD,,,
6187,47-9-0-4-A,7717-41-8467,AG 20-100 AC,21.8,AC,672900,543700,129200,157500,51500,881900,600300,485200,115100,133500,42900,776700,A2,AG/LTD,,,
6189,56-1-0-29-0,6785-92-1583,SNGL FAM SUB,3.511,AC,109800,0,109800,251300,65400,426500,98000,0,98000,213500,55500,367000,A2,AG/LTD,,,
6190,48-10-0-B-0,7728-51-2025,COMM & IND,9.04,AC,1094300,0,1094300,2238500,1879900,5212700,1042200,0,1042200,2117900,1766500,4926600,M2,INDUS/G,,,
6191,45-18-0-35-0,6797-55-4038,SNGL FAM SUB,2.539,AC,170000,0,170000,290700,2000,462700,153000,0,153000,265200,2000,420200,A2,AG/LTD,,,
6192,47-1-0-42-0,7716-89-8335,COMM & IND,37.579,AC,11112900,0,11112900,0,0,11112900,10585600,0,10585600,0,0,10585600,MPUD,MIXPUD,,,
6193,47-1-0-46-0,7717-71-9965,SNGL FAM SUB,17.274,AC,697500,531000,166500,553900,2600,1254000,623100,474500,148600,458300,2200,1083600,A2,AG/LTD,,,
6194,47-1-0-74-A,7726-08-8435,COMM & IND,1,AC,613000,0,613000,0,4200,617200,557300,0,557300,0,1800,559100,A2,AG/LTD,,,
6196,47-21-0-8-0,7726-19-9998,COMM & IND,1.832,AC,886700,0,886700,644100,202600,1733400,806100,0,806100,641800,117200,1565100,B1,BUS/GEN,,,
6197,48-1-0-10-0,7728-60-5844,AG 20-100 AC,43.848,AC,1474400,1255800,218600,183600,7700,1665700,1315100,1120300,194800,156300,7700,1479100,A2,AG/LTD,,,
6198,57-6-0-A-0,7716-04-6728,SNGL FAM SUB,14.961,AC,640300,429900,210400,219900,322000,1182200,556500,373700,182800,188400,271900,1016800,A2,AG/LTD,,,
6199,57-6-0-B-0,7716-14-3308,SNGL FAM SUB,15.92,AC,598300,0,598300,726800,132800,1457900,520100,0,520100,613600,111500,1245200,A2,AG/LTD,,,
6200,57-25-B-14-0,7716-04-1693,SNGL FAM SUB,4.234,AC,343100,0,343100,372400,41900,757400,314900,0,314900,341800,35400,692100,A2,AG/LTD,,,
6201,47-1-0-74-0,7726-08-7380,COMM & IND,0.941,AC,705900,0,705900,114400,161900,982200,670900,0,670900,112000,111800,894700,B1,BUS/GEN,,,
6202,47-1-0-93-0,7727-10-7906,SNGL FAM SUB,1.9033,AC,114400,0,114400,0,0,114400,102100,0,102100,0,0,102100,A2,AG/LTD,,,
6203,45-1-0-99-0,6797-98-1570,SNGL FAM SUB,0.696,AC,61000,0,61000,88800,4000,153800,54500,0,54500,73000,4000,131500,A2,AG/LTD,,,
6204,47-16-0-B-0,7718-30-5185,AG 20-100 AC,43.58,AC,697300,675500,21800,0,10400,707700,623200,604500,18700,0,10400,633600,A2,AG/LTD,,,
6205,47-1-0-3-0,7718-41-1463,SNGL FAM SUB,10.86,AC,266600,146400,120200,291600,5600,563800,238300,130900,107400,252600,5600,496500,A2,AG/LTD,,,
6206,47-16-0-B-1,7717-39-3859,SNGL FAM SUB,2,AC,116000,0,116000,219900,1800,337700,103600,0,103600,192500,1800,297900,A2,AG/LTD,,,
6218,46-4-0-4-0,7708-32-5889,AG 20-100 AC,26.95,AC,431200,418800,12400,0,0,431200,385400,373900,11500,0,0,385400,A2,AG/LTD,,,
6219,46-25-0-1-0,7708-32-9782,SNGL FAM SUB,15.49,AC,324200,316800,7400,0,0,324200,289700,283100,6600,0,0,289700,A2,AG/LTD,,,
6220,34-1-0-1-A,7708-04-1969,SNGL FAM SUB,0.93,AC,65200,0,65200,181400,1000,247600,58200,0,58200,152200,1000,211400,A2,AG/LTD,,,
6223,55-1-0-9-B,6786-21-1915,AG 20-100 AC,37.779,AC,88900,0,88900,303100,65000,457000,78400,0,78400,247700,59200,385300,A2,AG/LTD,,,
6224,55-1-0-32-0,6785-66-0334,SNGL FAM SUB,0.22,AC,33700,0,33700,109400,900,144000,30100,0,30100,90300,900,121300,A2,AG/LTD,,,
6227,48-1-0-8-A,7728-71-4490,SNGL FAM SUB,17.08,AC,552500,445300,107200,129200,8800,690500,493600,398300,95300,106900,8800,609300,A2,AG/LTD,,,
6229,48-1-0-7-0,7728-81-3149,AG 20-100 AC,28.568,AC,876400,763900,112500,165000,8000,1049400,783100,682900,100200,139700,8000,930800,A2,AG/LTD,,,
6230,46-1-0-102-B,7707-98-8993,SNGL FAM SUB,10.04,AC,269600,264500,5100,0,0,269600,240700,236400,4300,0,0,240700,A2,AG/LTD,,,
6234,47-9-0-3-0,7717-32-9626,SNGL FAM SUB,2,AC,133300,0,133300,58900,3900,196100,119000,0,119000,57600,100,176700,A2,AG/LTD,,,
6235,15-5-0-29-0,5789-78-7920,SNGL FAM SUB,8.24,AC,64900,0,64900,170400,0,235300,63300,0,63300,150400,0,213700,A1,AG/GEN,,,
6364,56-1-0-34-0,6785-93-1320,SNGL FAM SUB,3.02,AC,102000,0,102000,199200,6000,307200,91100,0,91100,166400,6000,263500,A2,AG/LTD,,,
6365,38-1-0-31-0,6707-66-6094,SNGL FAM SUB,9.75,AC,85400,0,85400,0,0,85400,83700,79600,4100,0,0,83700,A1,AG/GEN,,,
6366,38-1-0-26-0,6707-56-1995,AG 20-100 AC,41,AC,210700,0,210700,252300,6400,469400,206200,0,206200,215200,6400,427800,A1,AG/GEN,,,
6367,38-1-0-26-A,6707-77-1425,SNGL FAM SUB,2,AC,44400,0,44400,106600,0,151000,43500,0,43500,90900,0,134400,A1,AG/GEN,,,
6368,27-1-0-20-A,6718-54-3747,SNGL FAM SUB,15,AC,97800,0,97800,0,0,97800,96000,0,96000,0,0,96000,A1,AG/GEN,,,
6531,13-1-0-28-B,6842-92-7193,SNGL FAM SUB,2.659,AC,64300,63100,1200,0,0,64300,63100,62000,1100,0,0,63100,A1,AG/GEN,,,
6532,1-1-0-12-0,6814-37-3260,SNGL FAM SUB,3.32,AC,51500,0,51500,134000,0,185500,50600,0,50600,118500,0,169100,A1,AG/GEN,,,
6533,26-1-0-36-0,6718-11-6720,AG 20-100 AC,65.15,AC,234500,0,234500,0,0,234500,228000,0,228000,0,0,228000,A1,AG/GEN,,,
6534,7-1-0-13-0,6842-58-0548,AG 20-100 AC,58.48,AC,271900,208100,63800,500,0,272400,266000,206400,59600,500,0,266500,A1,AG/GEN,,,
6536,57-1-0-25-0,7706-01-5084,SNGL FAM SUB,5.8,AC,248100,0,248100,170700,87500,506300,215900,0,215900,142900,71700,430500,A2,AG/LTD,,,
6537,30-1-0-120-0,6759-46-3155,SNGL FAM SUB,1.03,AC,50100,0,50100,0,0,50100,46300,0,46300,0,0,46300,A2,AG/LTD,,,
6538,30-1-0-121-A,6759-36-8375,COMM & IND,0.75,AC,46800,0,46800,46900,28400,122100,45400,0,45400,44600,29700,119700,A2,AG/LTD,,,
6539,30-1-0-121-0,6759-46-5581,AG 20-100 AC,37.72,AC,351700,0,351700,137400,2600,491700,336900,0,336900,117200,2600,456700,A2,AG/LTD,,,
6540,19-1-0-53-0,6830-65-7350,SNGL FAM SUB,2.44,AC,59600,0,59600,146000,9100,214700,56700,0,56700,121200,9100,187000,A1,AG/GEN,,,
6541,57-1-0-24-0,7706-01-2278,SNGL FAM SUB,2,AC,134700,0,134700,6000,3500,144200,117200,0,117200,6800,2900,126900,A2,AG/LTD,,,
6701,9-1-0-35-0,5892-62-4812,SNGL FAM SUB,2.39,AC,43800,0,43800,46600,200,90600,42900,0,42900,40800,200,83900,A1,AG/GEN,,,
6702,62-2-B-8-0,7704-94-3352,SNGL FAM SUB,0,AC,115000,0,115000,186300,0,301300,100000,0,100000,172200,0,272200,R1,RES/LTD,,,
6703,62-2-B-9-0,7704-94-2368,SNGL FAM SUB,0,AC,115000,0,115000,0,0,115000,100000,0,100000,0,0,100000,R1,RES/LTD,,,
6704,57-10-0-27-0,7705-86-5894,SNGL FAM SUB,4.43,AC,230000,0,230000,400300,82400,712700,210000,0,210000,381100,73300,664400,A2,AG/LTD,,,
6705,62-3-D-3-A,7714-03-5973,SNGL FAM SUB,0,AC,5800,0,5800,0,0,5800,2000,0,2000,0,0,2000,R1,RES/LTD,,,
6706,62-3-D-4-0,7714-03-6919,SNGL FAM SUB,0,AC,115000,0,115000,256500,51100,422600,100000,0,100000,232300,48500,380800,R1,RES/LTD,,,
6707,62-2-B-7-0,7704-94-4246,SNGL FAM SUB,0,AC,115000,0,115000,229300,0,344300,100000,0,100000,213900,0,313900,R1,RES/LTD,,,
6708,21-7-0-37-0,6850-36-9602,SNGL FAM SUB,2.61,AC,57500,0,57500,157800,11400,226700,57100,0,57100,136900,11400,205400,A1,AG/GEN,,,
6709,46-26-0-11-0,7707-57-8307,SNGL FAM SUB,8.262,AC,216600,100100,116500,362200,0,578800,196900,91200,105700,305300,0,502200,A2,AG/LTD,,,
6710,47-1-0-28-0,7716-67-0820,COMM & IND,1.77,AC,256000,0,256000,315400,0,571400,232800,0,232800,304600,0,537400,A2,AG/LTD,,,
6868,20-1-0-16-E,6840-54-5462,SNGL FAM SUB,4.98,AC,104200,30400,73800,484900,2500,591600,101800,32900,68900,397400,2100,501300,A1,AG/GEN,,,
6869,38-1-0-81-A,6707-75-4824,SNGL FAM SUB,1.5,AC,41600,0,41600,97200,1000,139800,40800,0,40800,82700,1000,124500,A1,AG/GEN,,,
6870,13-1-0-20-B,6841-56-8146,SNGL FAM SUB,1,AC,49900,0,49900,85500,0,135400,39000,0,39000,77400,700,117100,A1,AG/GEN,,,
6871,43-1-0-2-0,6768-50-9597,AG 20-100 AC,75.374,AC,786000,677900,108100,252900,31500,1070400,698900,602700,96200,206800,26100,931800,A2,AG/LTD,,,
6872,32-4-0-4-0,6779-65-6983,SNGL FAM SUB,7.89,AC,142600,0,142600,360600,38400,541600,127500,0,127500,300800,32300,460600,A2,AG/LTD,,,
6236,20-11-0-22-0,6841-91-5310,SNGL FAM SUB,2,AC,55600,0,55600,179300,15900,250800,52500,0,52500,174500,13700,240700,A1,AG/GEN,,,
6237,48-3-G-3-0,7726-57-4966,SNGL FAM SUB,0,AC,130000,0,130000,215200,31500,376700,117000,0,117000,189700,28100,334800,R1,RES/LTD,,,
6238,45-9-0-E-0,6798-11-4077,SNGL FAM SUB,3.12,AC,44900,0,44900,0,0,44900,40200,0,40200,0,0,40200,A2,AG/LTD,,,
6239,31-1-0-70-0,6779-23-2299,SNGL FAM SUB,3,AC,89100,0,89100,121000,14500,224600,79600,0,79600,99500,14500,193600,A2,AG/LTD,,,
6240,21-1-0-56-0,6850-83-5632,SNGL FAM SUB,4.5,AC,95700,0,95700,127700,5700,229100,82800,0,82800,105500,3900,192200,A2,AG/LTD,,,
6242,45-1-0-8-0,6798-10-9726,AG 20-100 AC,39.8,AC,628800,0,628800,137200,1200,767200,563100,0,563100,112100,1200,676400,A2,AG/LTD,,,
6243,55-11-0-C-0,6786-34-8498,SNGL FAM SUB,11.42,AC,213100,207600,5500,0,1000,214100,190700,185800,4900,0,1000,191700,A2,AG/LTD,,,
6244,55-11-0-E-0,6786-35-7032,SNGL FAM SUB,7.5,AC,138400,0,138400,456100,0,594500,123700,0,123700,376500,0,500200,A2,AG/LTD,,,
6245,55-11-0-F-0,6786-45-8130,AG 20-100 AC,22.63,AC,348600,337900,10700,0,0,348600,311500,301800,9700,0,0,311500,A2,AG/LTD,,,
6246,55-11-0-D-0,6786-44-0023,SNGL FAM SUB,7.5,AC,138400,82500,55900,152200,0,290600,123700,73900,49800,88800,0,212500,A2,AG/LTD,,,
6247,58-4-H-39-0,7716-66-0454,SNGL FAM SUB,0,AC,10000,0,10000,0,0,10000,9100,0,9100,0,0,9100,A2,AG/LTD,,,
6248,50-5-0-21-A,6726-20-8417,SNGL FAM SUB,2.13,AC,42100,0,42100,0,0,42100,39300,0,39300,0,0,39300,A1,AG/GEN,,,
6249,50-5-0-21-B,6725-29-5251,SNGL FAM SUB,6,AC,37100,34000,3100,0,0,37100,36300,33700,2600,0,0,36300,A1,AG/GEN,,,
6250,50-5-0-22-A,6726-20-9710,SNGL FAM SUB,4.61,AC,53500,0,53500,418700,17100,489300,50400,0,50400,378700,16500,445600,A1,AG/GEN,,,
6251,50-5-0-22-B,6725-29-3292,SNGL FAM SUB,3.7,AC,22600,0,22600,0,0,22600,22100,0,22100,0,0,22100,A1,AG/GEN,,,
6252,57-17-0-3-0,7706-23-0580,SNGL FAM SUB,3,AC,161000,0,161000,298300,46000,505300,140100,0,140100,252000,37700,429800,A2,AG/LTD,,,
6253,37-1-0-7-0,6706-29-9667,SNGL FAM SUB,1.317,AC,32800,0,32800,154500,600,187900,32100,0,32100,132300,600,165000,M2,INDUS/G,,,
6254,58-21-D-7-0,7716-42-7036,SNGL FAM SUB,10.211,AC,528000,0,528000,1041300,0,1569300,484000,0,484000,1007800,0,1491800,R3,RES/GEN,,,
6255,46-23-0-24-0,7707-83-6718,SNGL FAM SUB,3.187,AC,181500,0,181500,308500,1000,491000,165000,0,165000,260100,1000,426100,A2,AG/LTD,,,
6256,58-21-D-6-0,7716-41-0950,SNGL FAM SUB,8.71,AC,398400,0,398400,901300,3400,1303100,364800,0,364800,848900,2800,1216500,R3,RES/GEN,,,
6258,62-2-B-11-0,7714-04-0234,SNGL FAM SUB,0,AC,115000,0,115000,236400,0,351400,100000,0,100000,216000,0,316000,R1,RES/LTD,,,
6259,62-2-B-12-0,7714-04-0307,SNGL FAM SUB,0,AC,115000,0,115000,0,0,115000,100000,0,100000,0,0,100000,R1,RES/LTD,,,
6260,15-1-0-29-A,5789-39-1318,SNGL FAM SUB,2,AC,42400,0,42400,75400,1100,118900,41500,0,41500,65700,1100,108300,A1,AG/GEN,,,
6261,15-4-0-4-T,5880-30-6084-9999,COMM & IND,1.27,AC,101000,0,101000,0,0,101000,100900,0,100900,0,0,100900,A1,AG/GEN,,,
6262,10-1-0-40-0,6811-48-0820,AG 20-100 AC,56.48,AC,114400,88400,26000,0,0,114400,113000,89000,24000,0,0,113000,A1,AG/GEN,,,
6263,10-1-0-28-0,6812-13-6073,SNGL FAM SUB,13.563,AC,76900,0,76900,217700,11500,306100,75700,0,75700,189100,9600,274400,A1,AG/GEN,,,
6264,10-1-0-36-0,6812-52-1963,AG 20-100 AC,26,AC,123900,72500,51400,324800,12600,461300,125500,76700,48800,288100,10600,424200,A1,AG/GEN,,,
6265,10-1-0-37-0,6812-61-1038,AG > 100 AC,102.187,AC,307500,217800,89700,258200,9400,575100,305100,223900,81200,227100,9400,541600,A1,AG/GEN,,,
6268,62-4-E-12-0,7714-04-7939,SNGL FAM SUB,0,AC,115000,0,115000,200800,100,315900,100000,0,100000,182200,100,282300,R1,RES/LTD,,,
6269,62-4-E-13-0,7714-04-7845,SNGL FAM SUB,0,AC,115000,0,115000,0,0,115000,100000,0,100000,0,0,100000,R1,RES/LTD,,,
6270,55-14-0-24-0,6786-31-9797,SNGL FAM SUB,13.8,AC,282500,0,282500,359100,200,641800,252500,0,252500,289500,200,542200,A2,AG/LTD,,,
6271,28-1-0-95-B,6738-27-6531,SNGL FAM SUB,9.38,AC,106100,0,106100,206200,17200,329500,104400,0,104400,181200,14500,300100,A1,AG/GEN,,,
6272,31-1-0-72-0,6779-03-3164,AG 20-100 AC,22.134,AC,305000,294800,10200,0,0,305000,272800,263400,9400,0,0,272800,A2,AG/LTD,,,
6273,31-1-0-44-0,6769-94-5015,SNGL FAM SUB,3.41,AC,98800,0,98800,244300,53500,396600,88300,0,88300,208500,44700,341500,A2,AG/LTD,,,
6274,18-1-0-26-A,6729-18-2019,SNGL FAM SUB,17.37,AC,128800,0,128800,0,0,128800,128000,0,128000,0,0,128000,A1,AG/GEN,,,
6275,31-1-0-44-A,6769-74-4844,SNGL FAM SUB,9.94,AC,144000,139400,4600,0,0,144000,129300,125100,4200,0,0,129300,A2,AG/LTD,,,
6277,54-5-0-15-0,6766-63-3592,SNGL FAM SUB,5.832,AC,141500,0,141500,568400,4700,714600,132000,0,132000,522900,5200,660100,A2,AG/LTD,,,
6278,20-1-0-77-C,6850-00-0018,SNGL FAM SUB,1.16,AC,55600,0,55600,192400,6900,254900,51800,0,51800,158000,6900,216700,A1,AG/GEN,,,
6279,47-1-0-36-0,7717-70-4081,SNGL FAM SUB,5.03,AC,599700,0,599700,18100,900,618700,545300,0,545300,14700,700,560700,R1,RES/LTD,,,
6280,6-1-0-4-E,6823-78-6969,AG 20-100 AC,26.079,AC,128900,0,128900,0,0,128900,126400,0,126400,0,0,126400,A1,AG/GEN,,,
6281,14-2-0-18-0,6851-37-1183,SNGL FAM SUB,3.14,AC,67700,0,67700,65600,1200,134500,66300,0,66300,58200,1300,125800,A1,AG/GEN,,,
6282,20-8-A-1-0,6840-42-3295,SNGL FAM SUB,4.04,AC,74900,0,74900,186900,800,262600,72000,0,72000,129800,800,202600,A1,AG/GEN,,,
6283,43-1-0-82-B,6777-01-3138,SNGL FAM SUB,0.12,AC,1700,0,1700,0,0,1700,1500,0,1500,0,0,1500,A2,AG/LTD,,,
6284,43-1-0-82-E,6777-01-5615,SNGL FAM SUB,6.972,AC,138200,0,138200,195200,35000,368400,123500,0,123500,166600,34500,324600,A2,AG/LTD,,,
6285,44-1-0-31-0,6787-12-6852,SNGL FAM SUB,1.2,AC,73300,0,73300,68800,6000,148100,65400,0,65400,56700,6000,128100,A2,AG/LTD,,,
6286,43-1-0-82-A,6777-01-0514,SNGL FAM SUB,1.908,AC,83200,0,83200,0,0,83200,74300,0,74300,0,0,74300,A2,AG/LTD,,,
6287,44-3-0-6-0,6777-80-0480,SNGL FAM SUB,17.66,AC,290000,0,290000,185100,18600,493700,259200,0,259200,156700,15400,431300,A2,AG/LTD,,,
6289,43-5-0-C-0,6776-29-8462,SNGL FAM SUB,2,AC,84500,0,84500,261500,21000,367000,75500,0,75500,221400,16800,313700,A2,AG/LTD,,,
6290,29-1-0-50-0,6748-59-6615,SNGL FAM SUB,2.696,AC,70700,0,70700,0,0,70700,64800,0,64800,0,0,64800,A1,AG/GEN,,,
6291,29-2-0-4-0,6749-50-9050,SNGL FAM SUB,3.16,AC,75100,0,75100,158800,1100,235000,70200,0,70200,129900,1100,201200,A1,AG/GEN,,,
6292,30-9-0-3-0,6759-42-6936,SNGL FAM SUB,1.9,AC,63000,0,63000,227900,25500,316400,59300,0,59300,186200,23300,268800,A2,AG/LTD,,,
6293,38-1-0-86-0,6707-75-9303,AG 20-100 AC,28.01,AC,85700,0,85700,0,0,85700,84000,0,84000,0,0,84000,A1,AG/GEN,,,
6295,30-1-0-49-0,6758-58-7373,AG 20-100 AC,43.07,AC,308500,199000,109500,489800,10800,809100,289700,187800,101900,403000,9100,701800,A2,AG/LTD,,,
6296,42-1-0-66-E,6757-99-4057,COMM & IND,0.523,AC,70600,0,70600,212500,6800,289900,67800,0,67800,197700,5000,270500,B1,BUS/GEN,,,
6297,31-8-0-2-0,6779-51-2210,SNGL FAM SUB,6.99,AC,118400,0,118400,13900,100,132400,105500,0,105500,21300,100,126900,A2,AG/LTD,,,
6298,30-1-0-91-0,6768-03-3446,SNGL FAM SUB,3,AC,78300,0,78300,171000,0,249300,70700,0,70700,143400,0,214100,A2,AG/LTD,,,
6299,31-1-0-81-0,6779-00-2377,SNGL FAM SUB,2.32,AC,83100,0,83100,5000,1300,89400,74200,0,74200,17700,1300,93200,A2,AG/LTD,,,
6300,48-1-0-3-0,7728-92-0170,SNGL FAM SUB,3,AC,151400,0,151400,202400,7200,361000,135200,0,135200,170000,7200,312400,A2,AG/LTD,,,
6301,56-7-0-2-0,6785-94-3872,SNGL FAM SUB,1.5,AC,78000,0,78000,146600,4000,228600,69700,0,69700,119600,4000,193300,A2,AG/LTD,,,
6302,64-15-D-5-0,7733-37-1920,SNGL FAM SUB,0,AC,251800,0,251800,582000,0,833800,209000,0,209000,462000,0,671000,R1,RES/LTD,,,
6303,31-1-0-75-0,6779-42-5556,SNGL FAM SUB,16.158,AC,227800,156300,71500,206600,4100,438500,202700,139000,63700,176400,4100,383200,A2,AG/LTD,,,
6304,31-1-0-75-B,6779-42-2324,SNGL FAM SUB,1.6,AC,72700,0,72700,114700,2900,190300,64900,0,64900,93800,2100,160800,A2,AG/LTD,,,
6305,31-1-0-22-0,6768-67-7341,SNGL FAM SUB,2.429,AC,78600,0,78600,0,0,78600,70000,0,70000,0,0,70000,A2,AG/LTD,,,
6306,31-1-0-23-A,6768-76-0785,SNGL FAM SUB,3.591,AC,90700,0,90700,0,0,90700,82000,0,82000,0,0,82000,A2,AG/LTD,,,
6307,31-1-0-23-B,6768-77-2578,SNGL FAM SUB,4.82,AC,106200,0,106200,35300,0,141500,96700,0,96700,34600,0,131300,A2,AG/LTD,,,
6308,31-1-0-23-0,6768-77-1292,SNGL FAM SUB,1.99,AC,73300,0,73300,229000,17600,319900,67000,0,67000,191800,15200,274000,A2,AG/LTD,,,
6309,30-1-0-100-0,6768-18-2247,SNGL FAM SUB,5.5,AC,106500,0,106500,74600,2100,183200,96700,0,96700,63100,2100,161900,RR,RES/RUR,,,
6310,63-1-0-123-0,7715-50-7425,SNGL FAM SUB,1.45,AC,117600,0,117600,168700,0,286300,102300,0,102300,143000,0,245300,A2,AG/LTD,,,
6311,58-21-B-2-0,7716-23-9983,SNGL FAM SUB,1.323,AC,310000,0,310000,315100,600,625700,285000,0,285000,281500,600,567100,A2,AG/LTD,,,
6312,55-1-0-55-0,6786-65-2667,SNGL FAM SUB,19.7,AC,365100,0,365100,639300,151900,1156300,326300,0,326300,531400,141200,998900,A2,AG/LTD,,,
6313,20-11-0-12-0,6841-91-8997,SNGL FAM SUB,2.14,AC,56800,0,56800,138900,2700,198400,53700,0,53700,131300,700,185700,A1,AG/GEN,,,
6314,62-16-0-B-4,7704-43-5551,AG 20-100 AC,65.91,AC,1386000,1355600,30400,0,0,1386000,1208500,1180300,28200,0,0,1208500,A2,AG/LTD,,,
6315,11-4-0-2-0,6821-68-0022,SNGL FAM SUB,3,AC,52000,0,52000,209100,0,261100,51000,0,51000,170200,0,221200,A1,AG/GEN,,,
6316,11-4-0-6-0,6821-68-1329,SNGL FAM SUB,3,AC,52000,0,52000,0,0,52000,51000,0,51000,0,0,51000,A1,AG/GEN,,,
6317,17-1-0-63-0,6810-36-8372,SNGL FAM SUB,1.5,AC,41600,0,41600,71600,1100,114300,40800,0,40800,63800,1100,105700,A1,AG/GEN,,,
6318,42-8-2-7-0,6767-28-3168,SNGL FAM SUB,0.88,AC,60000,0,60000,120600,300,180900,55000,0,55000,99800,300,155100,A2,AG/LTD,,,
6319,12-4-0-A-0,6821-82-4198,SNGL FAM SUB,1.11,AC,40800,0,40800,128500,3000,172300,40100,0,40100,107500,3000,150600,A1,AG/GEN,,,
6320,15-5-0-33-0,5880-70-2191,SNGL FAM SUB,8.16,AC,64600,0,64600,187900,0,252500,63100,0,63100,167500,0,230600,A1,AG/GEN,,,
6321,17-3-0-1-B,6800-30-5263,SNGL FAM SUB,2.35,AC,46400,0,46400,145900,0,192300,45400,0,45400,132700,0,178100,A1,AG/GEN,,,
6322,11-4-0-7-0,6821-68-5108,SNGL FAM SUB,3.05,AC,52300,0,52300,126400,2300,181000,51300,0,51300,100400,2400,154100,A1,AG/GEN,,,
6323,11-1-0-48-0,6821-49-6695,SNGL FAM SUB,1.03,AC,40200,0,40200,127600,15200,183000,38200,0,38200,138600,13100,189900,A1,AG/GEN,,,
6324,11-1-0-48-A,6821-49-4781,SNGL FAM SUB,3.56,AC,55200,0,55200,0,0,55200,53400,0,53400,0,0,53400,A1,AG/GEN,,,
6325,11-1-0-48-B,6822-40-8004,SNGL FAM SUB,2.17,AC,47000,0,47000,123400,18500,188900,45600,0,45600,99100,15000,159700,A1,AG/GEN,,,
6326,27-3-0-1-0,6728-45-0638,SNGL FAM SUB,4.85,AC,62300,0,62300,7800,200,70300,61100,0,61100,7600,200,68900,A1,AG/GEN,,,
6327,12-1-0-45-C,6831-05-6268,SNGL FAM SUB,2,AC,47600,0,47600,116100,2000,165700,47300,0,47300,95900,2000,145200,A1,AG/GEN,,,
6328,11-4-0-1-0,6821-58-7612,SNGL FAM SUB,3,AC,52000,0,52000,96900,2200,151100,51000,0,51000,79600,2200,132800,A1,AG/GEN,,,
6329,12-1-0-34-G,6831-14-5025,SNGL FAM SUB,2.06,AC,51300,0,51300,296100,3500,350900,47800,0,47800,248400,3500,299700,A1,AG/GEN,,,
6330,19-1-0-2-A,6821-81-5585,SNGL FAM SUB,2.04,AC,46300,0,46300,144800,5700,196800,45400,0,45400,121700,5700,172800,A1,AG/GEN,,,
6331,45-1-0-78-A,6797-71-3485,SNGL FAM SUB,19.69,AC,374500,0,374500,609500,63400,1047400,334300,0,334300,500600,53600,888500,A2,AG/LTD,,,
6333,12-9-0-B-0,6831-23-0915,SNGL FAM SUB,3,AC,59300,0,59300,133800,25000,218100,55100,0,55100,110700,19400,185200,A1,AG/GEN,,,
6334,12-1-0-34-H,6831-13-8648,SNGL FAM SUB,3.01,AC,55400,0,55400,0,9700,65100,53200,0,53200,0,8100,61300,A1,AG/GEN,,,
6335,19-1-0-1-0,6821-81-5962,SNGL FAM SUB,1.33,AC,42500,0,42500,156300,2000,200800,41400,0,41400,131000,2000,174400,A1,AG/GEN,,,
6336,11-4-0-3-0,6821-59-0054,SNGL FAM SUB,1.29,AC,41700,0,41700,174700,4600,221000,39900,0,39900,143500,4600,188000,A1,AG/GEN,,,
6338,20-6-0-2-0,6840-71-7055,SNGL FAM SUB,4.02,AC,82400,0,82400,185000,4100,271500,81300,0,81300,154500,4100,239900,A1,AG/GEN,,,
6339,20-6-0-3-0,6840-71-9041,SNGL FAM SUB,4.04,AC,82600,0,82600,0,0,82600,81500,0,81500,0,0,81500,A1,AG/GEN,,,
6340,30-1-0-112-A,6759-63-1901,SNGL FAM SUB,2.25,AC,69400,0,69400,0,0,69400,62900,0,62900,0,0,62900,A2,AG/LTD,,,
6341,12-4-0-C-0,6821-83-1032,SNGL FAM SUB,6.073,AC,63100,0,63100,9300,0,72400,59400,0,59400,9000,0,68400,A1,AG/GEN,,,
6342,11-4-0-5-0,6821-57-9637,SNGL FAM SUB,3,AC,52000,0,52000,0,0,52000,50000,0,50000,0,0,50000,A1,AG/GEN,,,
6343,12-9-0-A-0,6831-14-7083,SNGL FAM SUB,2,AC,50800,0,50800,0,10500,61300,47300,0,47300,0,8700,56000,A1,AG/GEN,,,
6344,58-3-A-10-0,7726-16-7546,SNGL FAM SUB,0,AC,88000,0,88000,163200,1000,252200,80000,0,80000,140200,1000,221200,RN,RESIDEN,,,
6345,11-4-0-4-0,6821-58-3804,SNGL FAM SUB,3.01,AC,52100,0,52100,118900,21100,192100,51100,0,51100,97700,17900,166700,A1,AG/GEN,,,
6349,11-1-0-39-0,6821-67-2006,SNGL FAM SUB,17.669,AC,85700,0,85700,0,0,85700,82900,0,82900,0,0,82900,A1,AG/GEN,,,
6350,19-1-0-1-A,6821-81-1920,SNGL FAM SUB,1,AC,40000,0,40000,148200,2500,190700,39500,0,39500,126100,2500,168100,A1,AG/GEN,,,
6351,31-1-0-71-0,6779-10-4649,AG 20-100 AC,56.96,AC,668500,576900,91600,65900,14400,748800,594400,513300,81100,54700,14400,663500,A2,AG/LTD,,,
6352,42-5-0-9-0,6767-04-2490,SNGL FAM SUB,0.5,AC,70000,0,70000,157300,2800,230100,64000,0,64000,148100,2900,215000,R3,RES/GEN,,,
6353,46-1-0-82-0,7708-82-0116,SNGL FAM SUB,10,AC,250800,0,250800,0,0,250800,223800,0,223800,0,0,223800,A2,AG/LTD,,,
6354,9-1-0-40-A,5892-31-1605,SNGL FAM SUB,4.99,AC,50500,0,50500,19900,0,70400,49400,0,49400,19600,0,69000,A1,AG/GEN,,,
6355,46-21-A-2-0,7708-80-8111,SNGL FAM SUB,3.887,AC,159400,0,159400,159500,1400,320300,144900,0,144900,135100,1400,281400,A2,AG/LTD,,,
6356,38-7-0-C-3,6717-08-7873,SNGL FAM SUB,6.3,AC,68500,0,68500,119900,0,188400,67200,0,67200,100700,0,167900,A1,AG/GEN,,,
6357,45-1-0-38-0,6787-91-1192,AG > 100 AC,292.74,AC,3148700,3011400,137300,0,7400,3156100,2818500,2693800,124700,0,6600,2825100,A2,AG/LTD,,,
6358,18-8-0-5-0,6820-10-7592,SNGL FAM SUB,3,AC,52000,0,52000,109000,2400,163400,50000,0,50000,90900,2400,143300,A1,AG/GEN,,,
6359,44-1-0-33-A,6787-13-7485,SNGL FAM SUB,1.9,AC,84300,0,84300,200400,58400,343100,75300,0,75300,168500,55800,299600,A2,AG/LTD,,,
6360,28-1-0-89-0,6739-11-8301,AG 20-100 AC,47.1,AC,170700,149000,21700,0,0,170700,169600,149600,20000,0,0,169600,A1,AG/GEN,,,
6361,64-19-E-2-0,7733-38-8049,SNGL FAM SUB,0,AC,251800,0,251800,519500,500,771800,209000,0,209000,442100,500,651600,R1,RES/LTD,,,
6363,29-3-0-20-0,6749-63-0592,SNGL FAM SUB,2.59,AC,61100,0,61100,258700,0,319800,57100,0,57100,210600,0,267700,A1,AG/GEN,,,
6369,26-2-0-3-G,6709-80-2992,SNGL FAM SUB,8.05,AC,81800,0,81800,0,0,81800,80300,0,80300,0,0,80300,A1,AG/GEN,,,
6370,63-1-0-77-0,7713-87-7757,SNGL FAM SUB,7.42,AC,348800,0,348800,682300,17600,1048700,303200,0,303200,581600,17200,902000,A2,AG/LTD,,,
6371,42-1-0-36-0,6767-02-4006,COMM & IND,3.1,AC,182700,0,182700,122400,100,305200,175500,0,175500,129200,100,304800,B1A2,BS AND,,,
6372,58-1-0-30-C,7715-44-2957,SNGL FAM SUB,2.284,AC,148900,0,148900,448600,0,597500,129500,0,129500,382200,0,511700,A2,AG/LTD,,,
6373,55-1-0-76-0,6786-71-3214,AG 20-100 AC,21.45,AC,378900,0,378900,398600,0,777500,338700,0,338700,330200,0,668900,A2,AG/LTD,,,
6374,55-1-0-76-A,6786-70-1874,SNGL FAM SUB,4.538,AC,123500,0,123500,417000,0,540500,110400,0,110400,339200,0,449600,A2,AG/LTD,,,
6375,21-1-0-40-0,6850-40-1246,SNGL FAM SUB,6.662,AC,118400,0,118400,186400,22000,326800,106000,0,106000,158800,17000,281800,A2,AG/LTD,,,
6376,42-3-0-16-0,6767-05-7236,SNGL FAM SUB,0.685,AC,70000,0,70000,187700,500,258200,65000,0,65000,156300,500,221800,R3,RES/GEN,,,
6377,42-3-0-16-A,6767-05-7250,SNGL FAM SUB,0.103,AC,3500,0,3500,0,0,3500,3300,0,3300,0,0,3300,R3,RES/GEN,,,
6378,21-1-0-40-B,6759-49-8873,SNGL FAM SUB,5.2,AC,98300,0,98300,279700,18400,396400,89400,0,89400,227900,16100,333400,A2,AG/LTD,,,
6379,21-1-0-40-A,6850-40-7134,SNGL FAM SUB,3.01,AC,78400,0,78400,215500,2000,295900,69800,0,69800,170800,2000,242600,RR,RES/RUR,,,
6381,42-19-0-1-0,6766-19-3678,SNGL FAM SUB,13,AC,187500,0,187500,0,0,187500,170800,0,170800,0,0,170800,R3A2,RES GEN,,,
6382,5-1-0-61-B,6823-36-6714,SNGL FAM SUB,1.004,AC,39800,0,39800,33200,2200,75200,39100,0,39100,30000,2200,71300,A1,AG/GEN,,,
6383,5-11-0-A-0,6823-36-4830,SNGL FAM SUB,0.884,AC,35100,34700,400,0,0,35100,34500,34100,400,0,0,34500,A1,AG/GEN,,,
6384,21-1-0-37-0,6759-38-4836,SNGL FAM SUB,4.407,AC,89900,0,89900,471400,4500,565800,85300,0,85300,387200,4500,477000,A2,AG/LTD,,,
6385,21-1-0-38-0,6759-39-3429,SNGL FAM SUB,1.45,AC,59600,0,59600,150900,25900,236400,54600,0,54600,127600,23300,205500,A2,AG/LTD,,,
6386,30-1-0-76-A,6758-86-6492,SNGL FAM SUB,3,AC,78300,0,78300,240600,34900,353800,70700,0,70700,199300,29300,299300,A2,AG/LTD,,,
6387,12-1-0-49-0,6831-57-0793,AG 20-100 AC,97.66,AC,285300,240300,45000,0,25600,310900,281300,239800,41500,0,25600,306900,A1,AG/GEN,,,
6388,12-22-0-1-0,6832-81-3279,AG 20-100 AC,31.83,AC,188100,0,188100,303600,31500,523200,184300,0,184300,264300,27400,476000,A1,AG/GEN,,,
6394,13-1-0-16-0,6841-47-5208,SNGL FAM SUB,2.01,AC,58700,0,58700,82800,27000,168500,52600,0,52600,79700,25500,157800,A1,AG/GEN,,,
6395,13-9-0-7-0,6841-64-7516,SNGL FAM SUB,3.79,AC,74100,0,74100,0,0,74100,72700,0,72700,0,0,72700,A1,AG/GEN,,,
6396,13-17-0-5-0,6832-90-7726,SNGL FAM SUB,2.97,AC,67000,0,67000,148900,1000,216900,60700,0,60700,144700,1000,206400,A1,AG/GEN,,,
6397,13-17-0-7-0,6842-00-0524,SNGL FAM SUB,3.28,AC,69700,0,69700,204300,0,274000,63400,0,63400,192100,0,255500,A1,AG/GEN,,,
6399,12-1-0-55-0,6832-64-2226,SNGL FAM SUB,3.79,AC,66700,0,66700,199600,4100,270400,62700,0,62700,182100,2900,247700,A1,AG/GEN,,,
6400,26-1-0-58-0,6719-12-8535,SNGL FAM SUB,10,AC,89100,44500,44600,93700,14500,197300,87500,45600,41900,78000,13300,178800,A1B1,AG GEN/,,,
6401,26-1-0-18-0,6719-01-6498,SNGL FAM SUB,2.6,AC,48600,0,48600,0,0,48600,47600,0,47600,0,0,47600,A1,AG/GEN,,,
6402,26-1-0-18-A,6719-11-1756,SNGL FAM SUB,4.79,AC,61900,0,61900,231100,5800,298800,60700,0,60700,198900,5800,265400,A1,AG/GEN,,,
6403,26-1-0-20-0,6719-01-0104,SNGL FAM SUB,2.08,AC,45400,0,45400,0,0,45400,44500,0,44500,0,0,44500,A1,AG/GEN,,,
6404,42-3-0-8-0,6767-04-8591,COMM & IND,1.279,AC,159700,0,159700,505300,0,665000,153600,0,153600,454600,0,608200,RO,RES/OF,,,
6405,6-10-0-1-B,6822-98-7908,SNGL FAM SUB,10.5,AC,107700,0,107700,0,0,107700,104000,0,104000,0,0,104000,A1,AG/GEN,,,
6406,6-1-0-37-B,6822-77-9874,SNGL FAM SUB,2,AC,48500,0,48500,112300,18600,179400,47000,0,47000,97900,17100,162000,A1,AG/GEN,,,
6407,28-1-0-87-0,6739-04-1033,SNGL FAM SUB,7.5,AC,78300,0,78300,0,0,78300,73800,0,73800,0,0,73800,A1,AG/GEN,,,
6408,21-1-0-22-0,6850-10-4120,AG > 100 AC,134.511,AC,1458400,1384900,73500,0,27000,1485400,1331700,1265000,66700,0,25900,1357600,A1,AG/GEN,,,
6410,6-1-0-33-0,6822-79-9567,SNGL FAM SUB,2,AC,48500,0,48500,124900,23500,196900,47000,0,47000,108200,20400,175600,A1,AG/GEN,,,
6411,28-1-0-71-0,6739-05-6709,SNGL FAM SUB,12.71,AC,124900,0,124900,0,0,124900,124300,0,124300,0,0,124300,A1,AG/GEN,,,
6412,28-1-0-76-0,6739-17-8079,SNGL FAM SUB,19.585,AC,157500,0,157500,26900,0,184400,150600,0,150600,23600,0,174200,A1,AG/GEN,,,
6413,13-1-0-29-A,6852-13-0253,SNGL FAM SUB,9.284,AC,114000,0,114000,142400,3700,260100,111900,0,111900,123000,2800,237700,A1,AG/GEN,,,
6414,20-1-0-34-0,6840-40-1140,AG 20-100 AC,54.67,AC,427300,347600,79700,3500,43100,473900,413400,351000,62400,3500,40800,457700,A1,AG/GEN,,,
6416,42-16-B-5-0,6757-93-5975,SNGL FAM SUB,2.35,AC,121000,0,121000,291200,2400,414600,109900,0,109900,277600,2300,389800,R1,RES/LTD,,,
6418,16-1-0-7-0,5891-50-9117,SNGL FAM SUB,5,AC,42500,40200,2300,0,0,42500,40500,38400,2100,0,0,40500,A1,AG/GEN,,,
6419,16-1-0-9-0,5890-69-3599,SNGL FAM SUB,8.17,AC,64600,60800,3800,0,0,64600,59500,56000,3500,0,0,59500,A1,AG/GEN,,,
6420,20-1-0-34-A,6840-41-4642,SNGL FAM SUB,1.851,AC,62300,0,62300,273700,31700,367700,58800,0,58800,228400,34700,321900,A1,AG/GEN,,,
6421,16-1-0-5-0,5891-50-5458,SNGL FAM SUB,10.55,AC,55400,50500,4900,0,0,55400,52400,47900,4500,0,0,52400,A1,AG/GEN,,,
6422,30-1-0-100-C,6768-27-7669,SNGL FAM SUB,13.04,AC,150000,0,150000,298700,8700,457400,139600,0,139600,250900,8700,399200,A2,AG/LTD,,,
6423,30-1-0-100-D,6768-28-8240,SNGL FAM SUB,1.2,AC,4200,0,4200,0,0,4200,4000,0,4000,0,0,4000,A2,AG/LTD,,,
6424,20-1-0-33-0,6749-38-7409,AG 20-100 AC,22,AC,110900,100800,10100,0,0,110900,103400,94000,9400,0,0,103400,A1,AG/GEN,,,
6425,20-1-0-35-0,6749-29-9634,AG 20-100 AC,38,AC,91200,73700,17500,0,0,91200,87400,71200,16200,0,0,87400,A1,AG/GEN,,,
6426,20-1-0-89-0,6749-79-6048,AG 20-100 AC,23,AC,216700,199200,17500,0,7500,224200,210500,193800,16700,0,7500,218000,A1,AG/GEN,,,
6429,16-3-0-3-0,5799-37-8005,SNGL FAM SUB,2.61,AC,44600,0,44600,181100,33200,258900,42800,0,42800,159700,33000,235500,A1,AG/GEN,,,
6430,5-1-0-55-A,6823-61-3113,SNGL FAM SUB,14.05,AC,111100,0,111100,0,0,111100,109800,0,109800,0,0,109800,A1,AG/GEN,,,
6431,31-1-0-78-0,6779-50-1784,SNGL FAM SUB,10.475,AC,175300,0,175300,0,0,175300,156700,0,156700,0,0,156700,A2,AG/LTD,,,
6432,31-1-0-78-A,6779-40-9464,SNGL FAM SUB,2,AC,55300,0,55300,0,0,55300,49400,0,49400,0,0,49400,A2,AG/LTD,,,
6433,16-1-0-78-0,5799-79-6420,AG 20-100 AC,95.246,AC,184900,141000,43900,0,0,184900,180500,140000,40500,0,0,180500,A1,AG/GEN,,,
6435,19-1-0-51-B,6830-66-7864,SNGL FAM SUB,3.12,AC,11700,0,11700,0,0,11700,11200,0,11200,0,0,11200,A1,AG/GEN,,,
6436,11-2-0-2-0,6822-42-8921,Vacant Land,2.71,AC,48400,0,48400,0,0,48400,47600,0,47600,0,0,47600,A1,AG/GEN,,,
6437,19-1-0-51-0,6830-76-4694,AG 20-100 AC,62.58,AC,281700,0,281700,0,80800,362500,266400,0,266400,0,75300,341700,A1,AG/GEN,,,
6439,7-1-0-9-0,6842-39-4973,SNGL FAM SUB,1.03,AC,40500,0,40500,210800,0,251300,39200,0,39200,204700,0,243900,A1,AG/GEN,,,
6440,42-2-0-1-0,6767-05-2247,SNGL FAM SUB,1.71,AC,116800,0,116800,108000,400,225200,106400,0,106400,90400,400,197200,RO,RES/OF,,,
6441,20-1-0-90-0,6749-99-4122,SNGL FAM SUB,1.492,AC,20300,0,20300,0,0,20300,16300,0,16300,0,0,16300,R1,RES/LTD,,,
6443,48-1-0-15-0,7727-57-2719,SNGL FAM SUB,0.993,AC,98300,0,98300,0,0,98300,87800,0,87800,0,0,87800,A2,AG/LTD,,,
6444,56-1-0-83-B,6795-88-7089,Parsonage,2.12,AC,137900,0,137900,175700,0,313600,119900,0,119900,161600,0,281500,A2,AG/LTD,,,
6445,20-1-0-69-0,6840-76-5738,SNGL FAM SUB,14.573,AC,151900,93500,58400,233500,97300,482700,149100,92100,57000,205100,89100,443300,A1,AG/GEN,,,
6446,38-1-0-98-0,6717-07-7619,SNGL FAM SUB,10.29,AC,86200,38500,47700,227400,5200,318800,84500,38000,46500,194500,4900,283900,A1,AG/GEN,,,
6447,39-1-0-68-0,6726-16-3404,SNGL FAM SUB,4.242,AC,58600,0,58600,185400,22400,266400,57500,0,57500,158600,18400,234500,A1,AG/GEN,,,
6449,28-1-0-81-0,6739-43-5377,AG 20-100 AC,27,AC,179000,0,179000,70800,0,249800,170700,0,170700,59000,0,229700,A1,AG/GEN,,,
6450,13-1-0-1-C,6841-19-0696,SNGL FAM SUB,3.39,AC,68100,0,68100,193900,6000,268000,64300,0,64300,179700,6000,250000,A1,AG/GEN,,,
6451,13-1-0-56-B,6842-00-3298,SNGL FAM SUB,3.31,AC,64900,0,64900,0,0,64900,63600,0,63600,0,0,63600,A1,AG/GEN,,,
6452,1-1-0-15-A,6814-19-4395,SNGL FAM SUB,2.8,AC,48900,0,48900,308600,0,357500,48000,0,48000,269300,0,317300,A1,AG/GEN,,,
6453,4-1-0-56-0,6803-50-6540,SNGL FAM SUB,13.5,AC,50500,44300,6200,0,0,50500,50400,44700,5700,0,0,50400,A1,AG/GEN,,,
6454,30-1-0-78-0,6758-73-1620,SNGL FAM SUB,17,AC,102400,0,102400,0,0,102400,96900,0,96900,0,0,96900,A2,AG/LTD,,,
6455,13-1-0-56-A,6832-90-8270,SNGL FAM SUB,3,AC,60700,0,60700,237300,1500,299500,60000,0,60000,205500,1500,267000,A1,AG/GEN,,,
6456,13-1-0-56-0,6842-00-2061,SNGL FAM SUB,3,AC,60700,0,60700,212900,8500,282100,60000,0,60000,189000,8500,257500,A1,AG/GEN,,,
6457,17-10-0-4-0,6800-49-2230,SNGL FAM SUB,6.14,AC,62400,0,62400,0,0,62400,61100,0,61100,0,0,61100,A1,AG/GEN,,,
6458,12-18-0-B-0,6832-40-0021,AG 20-100 AC,29.91,AC,163700,0,163700,0,0,163700,160400,0,160400,0,0,160400,A1,AG/GEN,,,
6459,17-10-0-3-0,6800-49-0121,SNGL FAM SUB,6.13,AC,62400,0,62400,249700,2500,314600,61100,0,61100,223300,2500,286900,A1,AG/GEN,,,
6460,5-1-0-86-0,6823-72-1455,SNGL FAM SUB,1.85,AC,47200,0,47200,163400,1000,211600,45800,0,45800,142800,1000,189600,A1,AG/GEN,,,
6461,32-1-0-65-A,6789-41-7120,SNGL FAM SUB,7.71,AC,144600,77100,67500,219700,27900,392200,129000,68900,60100,185300,22900,337200,A2,AG/LTD,,,
6462,10-7-0-C-0,6801-62-9163,SNGL FAM SUB,6.22,AC,62800,21500,41300,146000,1400,210200,61500,21300,40200,126300,1400,189200,A1,AG/GEN,,,
6463,12-18-0-C-0,6832-41-9145,SNGL FAM SUB,3.88,AC,63800,0,63800,130800,10800,205400,62000,0,62000,115400,11700,189100,A1,AG/GEN,,,
6464,5-1-0-86-A,6823-72-3599,SNGL FAM SUB,1.04,AC,8100,0,8100,0,0,8100,7900,0,7900,0,0,7900,A1,AG/GEN,,,
6465,26-1-0-21-A,6719-00-4722,SNGL FAM SUB,6.26,AC,64500,0,64500,199900,22100,286500,63200,0,63200,177400,18700,259300,A1,AG/GEN,,,
6466,20-1-0-86-0,6749-68-2530,SNGL FAM SUB,18,AC,116600,107900,8700,0,0,116600,111600,103900,7700,0,0,111600,A1,AG/GEN,,,
6467,28-1-0-70-0,6739-04-9790,SNGL FAM SUB,15,AC,111700,0,111700,0,0,111700,109200,0,109200,0,0,109200,A1,AG/GEN,,,
6468,43-11-0-3-A,6767-78-4108,SNGL FAM SUB,1.92,AC,66500,0,66500,0,0,66500,59400,0,59400,0,0,59400,A2,AG/LTD,,,
6469,43-11-0-4-0,6767-78-5187,SNGL FAM SUB,2.41,AC,91400,0,91400,182800,20700,294900,81600,0,81600,156100,16900,254600,A2,AG/LTD,,,
6470,45-1-0-93-0,6797-87-3741,SNGL FAM SUB,2.09,AC,85100,0,85100,364400,1800,451300,76000,0,76000,305100,1900,383000,A2,AG/LTD,,,
6471,6-1-0-36-0,6822-78-9353,SNGL FAM SUB,3,AC,56600,0,56600,165300,6500,228400,55000,0,55000,147400,6500,208900,A1,AG/GEN,,,
6472,6-1-0-37-0,6822-78-4181,SNGL FAM SUB,11,AC,101500,0,101500,0,0,101500,99000,0,99000,0,0,99000,A1,AG/GEN,,,
6473,4-1-0-55-0,6802-88-8017,SNGL FAM SUB,6.57,AC,70500,67400,3100,0,0,70500,68600,65800,2800,0,0,68600,A1,AG/GEN,,,
6474,54-5-0-4-0,6766-64-6177,SNGL FAM SUB,5.077,AC,141500,0,141500,501600,0,643100,132000,0,132000,463100,0,595100,A2,AG/LTD,,,
6475,28-1-0-77-0,6739-26-9806,SNGL FAM SUB,17.72,AC,139300,84600,54700,76800,200,216300,140000,88200,51800,65000,200,205200,A1,AG/GEN,,,
6476,30-1-0-73-B,6758-89-3752,SNGL FAM SUB,5.93,AC,108100,105400,2700,0,0,108100,98700,96200,2500,0,0,98700,A2,AG/LTD,,,
6477,30-1-0-74-0,6758-89-6008,AG 20-100 AC,22.26,AC,270600,176700,93900,286600,600,557800,248900,160800,88100,239400,600,488900,A2,AG/LTD,,,
6478,30-1-0-74-B,6758-79-3087,AG 20-100 AC,34.61,AC,235200,219200,16000,0,0,235200,214600,199900,14700,0,0,214600,A2,AG/LTD,,,
6479,42-5-0-12-0,6767-04-2685,SNGL FAM SUB,0,AC,70000,0,70000,114900,300,185200,64000,0,64000,105900,300,170200,R3,RES/GEN,,,
6480,18-4-0-4-C,6820-30-1347,SNGL FAM SUB,3.62,AC,55500,0,55500,100000,19200,174700,53700,0,53700,85100,16400,155200,A1,AG/GEN,,,
6481,26-3-0-1-0,6719-11-4941,COMM & IND,3.51,AC,150400,0,150400,0,100,150500,93600,0,93600,0,100,93700,B1,BUS/GEN,,,
6483,26-1-0-59-0,6719-13-6054,SNGL FAM SUB,16.1,AC,123600,115900,7700,0,0,123600,121100,114200,6900,0,0,121100,A1,AG/GEN,,,
6484,42-5-0-6-0,6767-04-5455,COMM & IND,0.35,AC,74300,0,74300,325500,14800,414600,71400,0,71400,301100,10200,382700,RO,RES/OF,,,
6485,42-5-0-7-0,6767-04-5367,COMM & IND,0.42,AC,74300,0,74300,127600,0,201900,71400,0,71400,117600,0,189000,BN,BUS/NHD,,,
6486,7-1-0-10-0,6842-39-8810,SNGL FAM SUB,3.71,AC,62400,0,62400,108400,24300,195100,60700,0,60700,94500,22200,177400,A1,AG/GEN,,,
6488,28-1-0-47-0,6738-44-1636,SNGL FAM SUB,9.9,AC,100900,0,100900,41900,900,143700,99900,0,99900,36800,900,137600,A1,AG/GEN,,,
6489,57-1-0-26-0,7706-00-6359,SNGL FAM SUB,14.74,AC,178300,0,178300,95000,7100,280400,154900,0,154900,81200,7100,243200,A2,AG/LTD,,,
6490,57-1-0-26-F,7706-10-0925,SNGL FAM SUB,3.88,AC,170600,0,170600,0,0,170600,148500,0,148500,0,0,148500,A2,AG/LTD,,,
6491,28-1-0-12-0,6728-99-7209,SNGL FAM SUB,5.43,AC,69800,0,69800,317600,1900,389300,67000,0,67000,268400,1900,337300,A1,AG/GEN,,,
6492,6-1-0-18-0,6823-72-6445,SNGL FAM SUB,2.57,AC,47700,0,47700,152100,2000,201800,46900,0,46900,122500,2000,171400,A1,AG/GEN,,,
6493,6-1-0-18-A,6823-72-7603,SNGL FAM SUB,2,AC,44800,0,44800,0,0,44800,44000,0,44000,0,0,44000,A1,AG/GEN,,,
6494,55-2-0-6-0,6785-34-7908,SNGL FAM SUB,1.61,AC,92800,0,92800,261200,6600,360600,82800,0,82800,214300,5900,303000,R1,RES/LTD,,,
6496,26-1-0-35-H,6718-02-0309,SNGL FAM SUB,3.07,AC,50400,0,50400,210600,40500,301500,49400,0,49400,186400,34200,270000,A1,AG/GEN,,,
6497,26-1-0-35-K,6708-92-9574,SNGL FAM SUB,1.515,AC,41700,0,41700,0,0,41700,40800,0,40800,0,0,40800,A1,AG/GEN,,,
6498,26-6-0-1-0,6718-02-0218,SNGL FAM SUB,0.684,AC,3800,0,3800,0,0,3800,3800,0,3800,0,0,3800,A1,AG/GEN,,,
6499,38-1-0-106-0,6717-19-4816,SNGL FAM SUB,17.32,AC,130200,0,130200,0,0,130200,127800,0,127800,0,0,127800,A1,AG/GEN,,,
6500,26-1-0-50-0,6718-49-4447,AG 20-100 AC,41.567,AC,161900,136600,25300,11400,0,173300,158000,135200,22800,9600,0,167600,A1,AG/GEN,,,
6501,28-1-0-46-A,6738-52-2298,SNGL FAM SUB,15.466,AC,130000,122900,7100,0,0,130000,127100,120500,6600,0,0,127100,A1,AG/GEN,,,
6502,42-8-2-4-0,6767-28-0263,SNGL FAM SUB,0.89,AC,60000,0,60000,155800,3000,218800,55000,0,55000,128600,3000,186600,A2,AG/LTD,,,
6503,17-10-0-1-0,6800-38-8769,SNGL FAM SUB,6.13,AC,62400,0,62400,20800,4800,88000,61100,0,61100,19900,4500,85500,A1,AG/GEN,,,
6504,17-10-0-2-0,6800-38-9943,SNGL FAM SUB,6.13,AC,62400,0,62400,0,0,62400,61100,0,61100,0,0,61100,A1,AG/GEN,,,
6505,31-1-0-53-0,6769-96-0463,SNGL FAM SUB,1.5,AC,67200,0,67200,141100,2000,210300,60600,0,60600,116200,2000,178800,A2,AG/LTD,,,
6506,28-1-0-62-0,6739-11-1641,AG 20-100 AC,20,AC,121400,0,121400,0,0,121400,118900,0,118900,0,0,118900,A1,AG/GEN,,,
6508,38-1-0-64-0,6717-02-8062,AG 20-100 AC,22.126,AC,67700,0,67700,0,0,67700,66400,0,66400,0,0,66400,A1,AG/GEN,,,
6509,4-3-0-1-0,6813-14-1980,SNGL FAM SUB,1.19,AC,43800,0,43800,161300,0,205100,42900,0,42900,138200,0,181100,A1,AG/GEN,,,
6510,4-3-0-2-0,6813-14-3769,SNGL FAM SUB,1.19,AC,43800,0,43800,143300,0,187100,42900,0,42900,122100,0,165000,A1,AG/GEN,,,
6511,4-3-0-3-0,6813-14-5700,SNGL FAM SUB,1.19,AC,43800,0,43800,155400,0,199200,42900,0,42900,135900,0,178800,A1,AG/GEN,,,
6512,11-1-0-23-A,6821-16-5610,SNGL FAM SUB,2,AC,46000,0,46000,73900,1100,121000,44500,0,44500,62100,1100,107700,A1,AG/GEN,,,
6513,17-1-0-30-0,6800-66-1562,AG 20-100 AC,82.05,AC,220700,161800,58900,10600,1000,232300,216600,146000,70600,10500,1000,228100,A1,AG/GEN,,,
6514,26-3-0-1-A,6719-11-6759,COMM & IND,1,AC,42800,0,42800,135300,31100,209200,41600,0,41600,138500,27500,207600,B1,BUS/GEN,,,
6515,5-1-0-61-C,6823-35-9232,Roads,0.897,AC,0,0,0,0,0,0,0,0,0,0,0,0,A1,AG/GEN,,,
6516,5-1-0-70-0,6824-61-2872,AG 20-100 AC,80.1,AC,205500,168600,36900,0,0,205500,201500,167500,34000,0,0,201500,A1,AG/GEN,,,
6517,5-1-0-72-0,6823-58-3466,SNGL FAM SUB,7.177,AC,16500,0,16500,0,0,16500,16100,0,16100,0,0,16100,A1,AG/GEN,,,
6519,1-1-0-8-0,6814-49-4090,SNGL FAM SUB,12.043,AC,95900,89900,6000,0,0,95900,94100,89000,5100,0,0,94100,A1,AG/GEN,,,
6520,42-1-0-35-0,6767-01-7850,COMM & IND,0.5,AC,75100,0,75100,160500,0,235600,72200,0,72200,150600,0,222800,B1,BUS/GEN,,,
6521,27-1-0-44-0,6718-88-9335,AG 20-100 AC,66.44,AC,270800,0,270800,0,0,270800,265100,0,265100,0,0,265100,A1,AG/GEN,,,
6522,42-1-0-34-0,6767-01-6676,SNGL FAM SUB,1,AC,68000,0,68000,415100,0,483100,60300,0,60300,343900,0,404200,R3,RES/GEN,,,
6524,42-1-0-109-0,6767-11-4832,COMM & IND,3.896,AC,326600,0,326600,1156500,91000,1574100,314000,0,314000,1080000,65900,1459900,B1A2,BS AND,,,
6525,42-1-0-110-0,6767-11-0645,COMM & IND,0.5,AC,74300,0,74300,360200,0,434500,71400,0,71400,332600,0,404000,B1,BUS/GEN,,,
6526,42-1-0-111-0,6767-11-1557,COMM & IND,1.07,AC,127000,0,127000,0,0,127000,122100,0,122100,0,0,122100,B1,BUS/GEN,,,
6527,42-1-0-112-T,6767-11-6375-9999,COMM & IND,20.035,AC,710500,0,710500,0,134500,845000,687300,0,687300,0,133600,820900,B1A2,BS AND,,,
6528,12-18-0-A-0,6832-30-6205,AG 20-100 AC,29.91,AC,199900,142100,57800,365600,0,565500,195500,140200,55300,343300,0,538800,A1,AG/GEN,,,
6529,29-1-0-58-A,6749-51-2508,SNGL FAM SUB,3.77,AC,80700,0,80700,159100,300,240100,75900,0,75900,131800,300,208000,A1,AG/GEN,,,
6530,11-1-0-34-0,6821-13-1251,SNGL FAM SUB,17.76,AC,134100,0,134100,72300,200,206600,130200,0,130200,60700,200,191100,A1,AG/GEN,,,
6542,57-1-0-25-A,7706-00-8938,SNGL FAM SUB,1,AC,26300,0,26300,0,0,26300,22900,0,22900,0,0,22900,A2,AG/LTD,,,
6544,13-1-0-29-0,6852-02-7700,AG 20-100 AC,29.165,AC,208600,144800,63800,127500,4300,340400,204600,143500,61100,111900,4300,320800,A1,AG/GEN,,,
6545,13-1-0-30-0,6852-02-8001,SNGL FAM SUB,10.681,AC,117000,62200,54800,5000,5100,127100,114800,61700,53100,5000,5100,124900,A1,AG/GEN,,,
6546,5-8-0-D-0,6813-77-7604,SNGL FAM SUB,13.18,AC,101100,0,101100,0,0,101100,99200,0,99200,0,0,99200,A1,AG/GEN,,,
6547,64-1-0-28-0,7723-47-5879,SNGL FAM SUB,6.293,AC,312400,0,312400,0,0,312400,271600,0,271600,0,0,271600,R1A2,RES LTD,,,
6548,66-1-0-4-0,7723-43-1155,SNGL FAM SUB,6.7,AC,63700,0,63700,0,0,63700,55600,0,55600,0,0,55600,A2,AG/LTD,,,
6549,67-1-0-1-0,7723-44-2667,Cmn Area/Open Spc,1.944,AC,0,0,0,0,0,0,0,0,0,0,0,0,R1,RES/LTD,,,
6550,67-12-0-9-0,7723-45-6291,SNGL FAM SUB,3.908,AC,390000,0,390000,1257600,0,1647600,340000,0,340000,1135000,0,1475000,R1,RES/LTD,,,
6551,20-11-0-4-0,6841-91-1640,SNGL FAM SUB,2,AC,58600,0,58600,212600,7100,278300,57500,0,57500,194700,4500,256700,A1,AG/GEN,,,
6552,47-1-0-96-0,7727-21-2491,SNGL FAM SUB,1.9,AC,114300,0,114300,182700,1300,298300,102100,0,102100,130300,1300,233700,A2,AG/LTD,,,
6553,45-1-0-79-B,6797-81-1350,SNGL FAM SUB,13.84,AC,264900,0,264900,0,0,264900,236400,0,236400,0,0,236400,A2,AG/LTD,,,
6554,45-1-0-75-0,6796-79-5506,AG 20-100 AC,55.12,AC,1052800,933000,119800,1255400,170700,2478900,915900,810400,105500,1054900,142400,2113200,A2,AG/LTD,,,
6556,45-1-0-79-0,6797-80-8832,SNGL FAM SUB,3.21,AC,96900,95400,1500,0,0,96900,86600,85300,1300,0,0,86600,A2,AG/LTD,,,
6557,45-1-0-79-A,6797-70-7591,SNGL FAM SUB,5.1,AC,126800,124400,2400,0,0,126800,113200,111000,2200,0,0,113200,A2,AG/LTD,,,
6558,45-1-0-79-C,6797-81-5102,SNGL FAM SUB,8.83,AC,183700,0,183700,709500,0,893200,164100,0,164100,580600,0,744700,A2,AG/LTD,,,
6559,46-23-0-12-0,7707-94-5268,SNGL FAM SUB,2.937,AC,165000,0,165000,293300,18400,476700,150000,0,150000,247100,15600,412700,A2,AG/LTD,,,
6561,42-23-0-C-0,6767-31-8886,SNGL FAM SUB,4.404,AC,121500,0,121500,484300,0,605800,108600,0,108600,397100,0,505700,A2,AG/LTD,,,
6562,42-23-0-10-0,6767-22-7688,SNGL FAM SUB,5.95,AC,98600,0,98600,234900,1000,334500,88000,0,88000,191500,1000,280500,A2,AG/LTD,,,
6563,42-23-0-13-0,6767-32-4489,SNGL FAM SUB,2.376,AC,90900,0,90900,270800,6300,368000,81200,0,81200,229700,6000,316900,A2,AG/LTD,,,
6564,42-23-0-14-0,6767-32-8414,SNGL FAM SUB,2.686,AC,95600,0,95600,197100,1500,294200,85400,0,85400,160200,1500,247100,A2,AG/LTD,,,
6565,43-21-0-21-0,6767-41-3800,SNGL FAM SUB,2.167,AC,86900,0,86900,202800,1000,290700,77700,0,77700,165900,1000,244600,A2,AG/LTD,,,
6566,19-1-0-49-0,6830-47-0882,AG 20-100 AC,31.687,AC,121700,107100,14600,0,0,121700,114100,100600,13500,0,0,114100,A1,AG/GEN,,,
6567,64-15-A-8-0,7733-37-2687,SNGL FAM SUB,0,AC,265000,0,265000,460300,13800,739100,220000,0,220000,402200,14300,636500,R1,RES/LTD,,,
6568,56-1-0-10-0,6786-90-8172,SNGL FAM SUB,1.911,AC,83900,0,83900,120000,16600,220500,74900,0,74900,99300,16600,190800,A2,AG/LTD,,,
6569,56-1-0-11-0,6795-09-5840,SNGL FAM SUB,16.143,AC,273400,0,273400,0,2000,275400,243800,0,243800,0,2000,245800,A2,AG/LTD,,,
6570,55-1-0-36-A,6785-58-3330,SNGL FAM SUB,1.31,AC,75200,0,75200,290900,0,366100,67200,0,67200,240800,0,308000,A2,AG/LTD,,,
6571,46-23-0-35-0,7707-95-1619,SNGL FAM SUB,2.16,AC,165000,0,165000,403500,45600,614100,150000,0,150000,338300,37600,525900,A2,AG/LTD,,,
6573,63-1-0-171-0,7724-22-3110,AG 20-100 AC,28.215,AC,2531700,2518700,13000,0,0,2531700,2201600,2189600,12000,0,0,2201600,R3A2,RES GEN,,,
6574,47-25-0-8-0,7727-01-0134,SNGL FAM SUB,2.2,AC,138400,0,138400,259600,2800,400800,123500,0,123500,219400,3100,346000,A2,AG/LTD,,,
6578,67-1-0-15-A,7733-04-9221,AG 20-100 AC,27.69,AC,1011500,0,1011500,1935400,120600,3067500,879100,0,879100,1634900,108600,2622600,A2,AG/LTD,,,
6579,64-1-0-50-B,7734-02-1569,COMM & IND,1.0127,AC,337200,0,337200,879800,13400,1230400,312200,0,312200,863800,10100,1186100,B1,BUS/GEN,,,
6581,64-1-0-50-D,7724-92-9579,COMM & IND,0.771,AC,256700,0,256700,220000,5800,482500,237700,0,237700,215600,4400,457700,B1,BUS/GEN,,,
6582,43-1-0-88-A,6777-00-2978,SNGL FAM SUB,1,AC,70100,0,70100,127100,1000,198200,62600,0,62600,104400,1000,168000,A2,AG/LTD,,,
6583,43-20-0-31-0,6768-51-9849,SNGL FAM SUB,3,AC,96800,0,96800,273400,71300,441500,88000,0,88000,238300,62400,388700,A2,AG/LTD,,,
6584,64-15-A-2-0,7733-37-2439,SNGL FAM SUB,0,AC,265000,0,265000,489700,23500,778200,220000,0,220000,427700,23100,670800,R1,RES/LTD,,,
6585,4-1-0-28-0,6803-85-4542,AG 20-100 AC,87.299,AC,291500,250600,40900,0,500,292000,285800,248600,37200,0,500,286300,A1,AG/GEN,,,
6586,64-15-A-3-0,7733-37-2385,SNGL FAM SUB,0,AC,265000,0,265000,416600,0,681600,220000,0,220000,331100,0,551100,R1,RES/LTD,,,
6587,15-5-0-7-0,5789-56-7947,SNGL FAM SUB,8.01,AC,67500,0,67500,608500,24200,700200,66000,0,66000,529400,27800,623200,A1,AG/GEN,,,
6588,24-2-0-7-A,5789-55-6277,SNGL FAM SUB,8.01,AC,20000,0,20000,0,0,20000,20000,0,20000,0,0,20000,A1,AG/GEN,,,
6589,29-13-0-4-0,6748-42-5168,SNGL FAM SUB,1.7,AC,61000,0,61000,231100,1200,293300,56500,0,56500,194100,1300,251900,A1,AG/GEN,,,
6591,55-1-0-73-0,6786-72-0194,SNGL FAM SUB,6.66,AC,155600,0,155600,98700,300,254600,139000,0,139000,81900,300,221200,A2,AG/LTD,,,
6592,22-1-0-2-C,6769-59-7118,SNGL FAM SUB,1,AC,61000,0,61000,108600,1000,170600,55100,0,55100,89800,1000,145900,A2,AG/LTD,,,
6593,63-1-0-132-C,7715-61-8475,SNGL FAM SUB,1.41,AC,116800,0,116800,115900,1600,234300,101600,0,101600,96900,1600,200100,A2,AG/LTD,,,
6594,12-1-0-2-0,6822-76-8587,SNGL FAM SUB,2.5,AC,52500,0,52500,144000,32600,229100,51000,0,51000,127300,30200,208500,A1,AG/GEN,,,
6595,43-11-0-10-0,6767-88-3116,SNGL FAM SUB,1.27,AC,74000,0,74000,0,0,74000,66100,0,66100,0,0,66100,A2,AG/LTD,,,
6596,10-1-0-43-0,6811-24-6892,AG 20-100 AC,47.1,AC,116300,0,116300,0,0,116300,114200,0,114200,0,0,114200,A1,AG/GEN,,,
6597,4-1-0-46-B,6803-97-1338,SNGL FAM SUB,2.12,AC,45400,0,45400,185500,24900,255800,44600,0,44600,167600,21000,233200,A1,AG/GEN,,,
6598,55-1-0-37-B,6785-58-7505,SNGL FAM SUB,3.58,AC,109100,0,109100,199000,3000,311100,97400,0,97400,160700,1900,260000,A2,AG/LTD,,,
6599,55-1-0-83-0,6785-75-7640,SNGL FAM SUB,3.373,AC,102800,0,102800,176700,4700,284200,91800,0,91800,154600,2900,249300,A2,AG/LTD,,,
6600,2-1-0-11-0,6814-84-7295,AG 20-100 AC,71.03,AC,164700,132000,32700,0,0,164700,161500,131300,30200,0,0,161500,A1,AG/GEN,,,
6601,2-1-0-4-0,6814-75-3314,COMM & IND,15.8,AC,478600,471300,7300,0,0,478600,464600,457900,6700,0,0,464600,A1B1,AG GEN/,,,
6604,1-2-0-3-0,6804-53-7201,AG > 100 AC,138.804,AC,495500,431500,64000,0,0,495500,481000,422000,59000,0,0,481000,A1,AG/GEN,,,
6606,1-1-0-16-0,6814-16-1910,SNGL FAM SUB,10.26,AC,23100,18400,4700,0,0,23100,23100,18700,4400,0,0,23100,A1,AG/GEN,,,
6607,1-1-0-21-0,6804-96-9277,AG > 100 AC,100.41,AC,243800,197500,46300,0,0,243800,239000,196300,42700,0,0,239000,A1,AG/GEN,,,
6608,2-1-0-6-0,6814-77-2799,AG 20-100 AC,33.17,AC,74600,59300,15300,0,0,74600,74600,60500,14100,0,0,74600,A1,AG/GEN,,,
6609,19-1-0-41-0,6831-61-2906,SNGL FAM SUB,0.89,AC,41800,41300,500,0,0,41800,39800,39400,400,0,0,39800,A1,AG/GEN,,,
6610,19-1-0-42-0,6831-61-2414,SNGL FAM SUB,18.77,AC,185400,175900,9500,0,0,185400,174400,166300,8100,0,0,174400,A1,AG/GEN,,,
6611,19-1-0-46-0,6831-81-5115,AG 20-100 AC,71.821,AC,473300,439100,34200,0,11000,484300,450200,419500,30700,0,11000,461200,A1,AG/GEN,,,
6612,56-1-0-38-0,6785-94-7299,AG 20-100 AC,30.38,AC,513700,0,513700,0,0,513700,459200,0,459200,0,0,459200,A2,AG/LTD,,,
6613,26-1-0-65-A,6719-04-9549,SNGL FAM SUB,1,AC,40000,0,40000,138400,11900,190300,38000,0,38000,118300,11500,167800,A1,AG/GEN,,,
6614,12-1-0-47-0,6831-36-4167,SNGL FAM SUB,6.49,AC,76500,33700,42800,206700,17500,300700,73500,31600,41900,176300,17500,267300,A1,AG/GEN,,,
6615,44-2-0-6-0,6787-73-6877,SNGL FAM SUB,1.44,AC,77100,0,77100,300700,0,377800,68800,0,68800,256900,0,325700,A2,AG/LTD,,,
6616,29-8-0-1-A,6749-96-6888,SNGL FAM SUB,2,AC,64000,0,64000,205800,73800,343600,59800,0,59800,168800,65100,293700,A1,AG/GEN,,,
6617,11-1-0-2-0,6812-54-8441,AG 20-100 AC,26,AC,126400,74400,52000,93000,6000,225400,124200,74400,49800,82300,6000,212500,A1,AG/GEN,,,
6618,11-1-0-3-A,6812-86-5607,SNGL FAM SUB,1,AC,500,0,500,0,68200,68700,400,0,400,0,59900,60300,A1,AG/GEN,,,
6619,11-1-0-3-B,6812-96-7212,SNGL FAM SUB,4,AC,2000,0,2000,0,104100,106100,1700,0,1700,0,89600,91300,A1,AG/GEN,,,
6620,12-5-0-5-0,6832-35-6139,SNGL FAM SUB,5.88,AC,65200,0,65200,236400,0,301600,63400,0,63400,209400,0,272800,A1,AG/GEN,,,
6621,6-1-0-40-A,6832-08-2122,SNGL FAM SUB,6.64,AC,71800,0,71800,0,8500,80300,69800,0,69800,0,7500,77300,A1,AG/GEN,,,
6622,6-1-0-40-0,6832-08-4159,SNGL FAM SUB,3,AC,56600,0,56600,0,11000,67600,55000,0,55000,0,9500,64500,A1,AG/GEN,,,
6623,28-3-0-3-A,6729-82-4190,SNGL FAM SUB,2.788,AC,52600,0,52600,12900,0,65500,50600,0,50600,18400,0,69000,A1,AG/GEN,,,
6624,5-1-0-57-0,6823-62-1900,SNGL FAM SUB,2.785,AC,52700,0,52700,88000,2500,143200,51900,0,51900,77100,2000,131000,A1,AG/GEN,,,
6625,4-1-0-46-A,6813-06-0543,SNGL FAM SUB,2.125,AC,45400,0,45400,174900,37800,258100,44600,0,44600,152000,32900,229500,A1,AG/GEN,,,
6626,6-1-0-4-0,6823-98-1502,SNGL FAM SUB,3,AC,49900,0,49900,123300,2400,175600,49000,0,49000,107000,2300,158300,A1,AG/GEN,,,
6627,12-2-0-1-A,6831-05-2404,SNGL FAM SUB,0.84,AC,33600,0,33600,71700,900,106200,33200,0,33200,59800,900,93900,A1,AG/GEN,,,
6628,1-1-0-6-0,6815-20-7790,AG 20-100 AC,23.97,AC,121100,110000,11100,0,0,121100,118800,108600,10200,0,0,118800,A1,AG/GEN,,,
6629,2-1-0-1-T,6814-57-2579-9999,AG 20-100 AC,71.74,AC,442100,309500,132600,0,0,442100,421000,286500,134500,0,0,421000,A1,AG/GEN,,,
6630,5-1-0-67-0,6823-39-5940,AG 20-100 AC,24.462,AC,101100,89800,11300,0,0,101100,99100,88700,10400,0,0,99100,A1,AG/GEN,,,
6631,1-1-0-1-0,6805-82-4232,SNGL FAM SUB,5.066,AC,60400,0,60400,190500,8000,258900,59300,0,59300,164000,8000,231300,A1,AG/GEN,,,
6632,12-1-0-13-0,6832-07-4059,SNGL FAM SUB,3.506,AC,51700,0,51700,215700,3500,270900,51500,0,51500,186500,3500,241500,A1,AG/GEN,,,
6633,4-1-0-11-0,6803-34-4705,AG 20-100 AC,27,AC,129300,116900,12400,0,0,129300,121500,110000,11500,0,0,121500,A1,AG/GEN,,,
6634,5-1-0-7-0,6813-88-9573,AG 20-100 AC,52.494,AC,212800,188600,24200,0,0,212800,208700,186400,22300,0,0,208700,A1,AG/GEN,,,
6635,7-1-0-6-0,6832-99-8248,AG 20-100 AC,55.398,AC,280300,254800,25500,0,0,280300,274800,251300,23500,0,0,274800,A1,AG/GEN,,,
6636,11-1-0-3-0,6812-87-9137,AG > 100 AC,143.42,AC,105900,0,105900,173600,5000,284500,99600,0,99600,151900,5000,256500,A1,AG/GEN,,,
6637,1-1-0-15-0,6814-17-9948,AG 20-100 AC,66.06,AC,295200,224300,70900,110000,400,405600,289400,222600,66800,97500,400,387300,A1,AG/GEN,,,
6638,63-1-0-132-A,7715-61-7391,SNGL FAM SUB,1.08,AC,110000,0,110000,6000,0,116000,95700,0,95700,5900,0,101600,A2,AG/LTD,,,
6640,55-1-0-83-A,6785-75-8803,SNGL FAM SUB,1,AC,63100,0,63100,81100,100,144300,56300,0,56300,66700,100,123100,A2,AG/LTD,,,
6641,26-1-0-43-0,6718-29-3576,AG 20-100 AC,72.485,AC,260900,227500,33400,0,0,260900,253700,222900,30800,0,0,253700,A1,AG/GEN,,,
6642,4-1-0-53-0,6813-00-3829,AG > 100 AC,167.64,AC,571000,459700,111300,109600,3000,683600,562900,453700,109200,96600,3000,662500,A1,AG/GEN,,,
6643,3-1-0-14-0,6803-23-9602,SNGL FAM SUB,4,AC,55900,0,55900,0,0,55900,53000,0,53000,0,0,53000,A1,AG/GEN,,,
6644,3-1-0-15-0,6803-33-1523,SNGL FAM SUB,6,AC,64500,0,64500,0,0,64500,63000,0,63000,0,0,63000,A1,AG/GEN,,,
6645,1-2-0-1-0,6804-54-7520,SNGL FAM SUB,8.096,AC,75900,0,75900,0,2000,77900,74500,0,74500,0,2000,76500,A1,AG/GEN,,,
6646,1-1-0-19-0,6805-80-6202,AG 20-100 AC,28.822,AC,88700,75400,13300,0,0,88700,86900,74700,12200,0,0,86900,A1,AG/GEN,,,
6647,1-1-0-19-A,6805-81-0215,AG 20-100 AC,46.227,AC,188600,166000,22600,0,0,188600,184900,165100,19800,0,0,184900,A1,AG/GEN,,,
6648,4-1-0-47-0,6813-05-6862,SNGL FAM SUB,1.75,AC,43500,0,43500,154100,3500,201100,42800,0,42800,139200,3500,185500,A1,AG/GEN,,,
6649,6-18-0-1-0,6832-07-9974,SNGL FAM SUB,3.425,AC,56100,0,56100,68200,1200,125500,55500,0,55500,55200,1200,111900,A1,AG/GEN,,,
6650,12-1-0-34-B,6831-14-3209,SNGL FAM SUB,1.01,AC,42100,0,42100,116900,500,159500,39600,0,39600,97300,500,137400,A1,AG/GEN,,,
6652,4-1-0-46-0,6803-97-4005,SNGL FAM SUB,2.56,AC,74400,0,74400,141300,1300,217000,73000,0,73000,124000,1300,198300,A1,AG/GEN,,,
6657,11-1-0-43-0,6821-39-3927,SNGL FAM SUB,2,AC,46000,0,46000,0,0,46000,44500,0,44500,0,0,44500,A1,AG/GEN,,,
6658,11-1-0-44-0,6822-30-4109,SNGL FAM SUB,2.06,AC,46400,0,46400,111700,1800,159900,44900,0,44900,92300,1800,139000,A1,AG/GEN,,,
6659,19-1-0-47-0,6831-90-1013,SNGL FAM SUB,3.63,AC,16100,0,16100,0,0,16100,14300,0,14300,0,0,14300,A1,AG/GEN,,,
6660,16-1-0-4-B,5891-61-1397,SNGL FAM SUB,4,AC,49600,0,49600,172900,9100,231600,48500,0,48500,150100,8400,207000,A1,AG/GEN,,,
6661,20-5-0-F-1,6840-06-6900,SNGL FAM SUB,12.7,AC,124000,0,124000,130000,2000,256000,116600,0,116600,111900,2000,230500,RR,RES/RUR,,,
6662,43-1-0-86-A,6777-20-1616,SNGL FAM SUB,2,AC,98500,0,98500,547000,0,645500,88000,0,88000,464900,0,552900,A2,AG/LTD,,,
6663,20-1-0-41-A,6840-33-9298,SNGL FAM SUB,2.63,AC,62800,0,62800,7900,1000,71700,60800,0,60800,7500,1000,69300,A1,AG/GEN,,,
6664,28-1-0-30-0,6738-07-5427,SNGL FAM SUB,3,AC,61700,0,61700,0,0,61700,60100,0,60100,0,0,60100,A1,AG/GEN,,,
6665,12-3-0-3-A1,6831-19-5135,SNGL FAM SUB,9,AC,102000,0,102000,226200,46100,374300,101900,0,101900,184800,39400,326100,A1,AG/GEN,,,
6666,6-4-0-5-0,6832-88-7192,SNGL FAM SUB,5.05,AC,75100,0,75100,193900,1300,270300,73600,0,73600,174000,1300,248900,A1,AG/GEN,,,
6667,55-1-0-63-0,6786-65-6119,SNGL FAM SUB,2.074,AC,87800,0,87800,164400,3000,255200,78400,0,78400,134300,3000,215700,A2,AG/LTD,,,
6668,4-5-0-2-0,6813-02-6724,AG 20-100 AC,23.42,AC,97700,0,97700,381000,0,478700,95800,0,95800,328500,0,424300,A1,AG/GEN,,,
6669,11-1-0-5-0,6822-02-9210,AG > 100 AC,313.51,AC,989000,790600,198400,367700,29600,1386300,975500,801400,174100,304600,29600,1309700,A1,AG/GEN,,,
6670,11-3-0-1-0,6822-32-8670,AG 20-100 AC,21,AC,120500,110800,9700,0,0,120500,118100,109200,8900,0,0,118100,A1,AG/GEN,,,
6671,62-13-A-13-0,7714-05-8530,SNGL FAM SUB,0,AC,115000,0,115000,255800,0,370800,100000,0,100000,233900,0,333900,R1,RES/LTD,,,
6672,55-1-0-78-0,6785-69-7033,AG 20-100 AC,25.09,AC,402500,0,402500,59300,31100,492900,358900,0,358900,49900,25900,434700,A2,AG/LTD,,,
6673,58-22-A-6-0,7715-27-6056,SNGL FAM SUB,3.09,AC,383300,0,383300,679400,47700,1110400,351800,0,351800,633100,39700,1024600,A2,AG/LTD,,,
6674,62-4-C-13-0,7714-05-2027,SNGL FAM SUB,0,AC,115000,0,115000,276700,14900,406600,100000,0,100000,249700,14900,364600,R1,RES/LTD,,,
6675,62-13-C-2-0,7714-05-2265,SNGL FAM SUB,0,AC,46000,0,46000,0,0,46000,35000,0,35000,0,0,35000,R1,RES/LTD,,,
6676,58-1-0-54-0,7725-09-1690,SNGL FAM SUB,3.9,AC,167600,0,167600,198100,6000,371700,145600,0,145600,170100,5500,321200,A2,AG/LTD,,,
6677,58-8-0-2-B,7715-99-5577,SNGL FAM SUB,2,AC,139600,0,139600,0,100,139700,121400,0,121400,0,100,121500,A2,AG/LTD,,,
6678,58-4-G-11-0,7716-55-6360,SNGL FAM SUB,0,AC,10000,0,10000,0,0,10000,9100,0,9100,0,0,9100,A2,AG/LTD,,,
6679,64-19-E-15-0,7733-47-0457,SNGL FAM SUB,0,AC,265000,0,265000,522100,0,787100,220000,0,220000,411000,0,631000,R1,RES/LTD,,,
6680,14-3-0-15-0,6851-48-2221,SNGL FAM SUB,3.79,AC,70700,0,70700,0,0,70700,69300,0,69300,0,0,69300,A1,AG/GEN,,,
6681,14-1-0-8-0,6851-47-2404,AG 20-100 AC,27.18,AC,185400,97300,88100,231800,4700,421900,175700,97100,78600,222300,4700,402700,A1,AG/GEN,,,
6682,58-4-C-9-0,7716-56-5872,SNGL FAM SUB,1,AC,96800,0,96800,170100,800,267700,88000,0,88000,141100,800,229900,A2,AG/LTD,,,
6683,13-1-0-1-A,6841-19-6780,SNGL FAM SUB,3.67,AC,73000,0,73000,137000,9100,219100,66700,0,66700,124200,13600,204500,A1,AG/GEN,,,
6684,2-3-0-38-0,6824-32-9985,SNGL FAM SUB,3.84,AC,50600,0,50600,135700,7500,193800,49500,0,49500,122600,4400,176500,A1,AG/GEN,,,
6685,64-1-0-37-0,7724-62-7417,SNGL FAM SUB,2.972,AC,206900,0,206900,0,0,206900,179900,0,179900,0,0,179900,R3,RES/GEN,,,
6687,33-4-0-31-0,6798-52-8791,SNGL FAM SUB,3.26,AC,107900,0,107900,295200,15700,418800,96300,0,96300,243400,14700,354400,A2,AG/LTD,,,
6688,55-1-0-12-0,6776-92-0725,SNGL FAM SUB,2.987,AC,106700,0,106700,489500,4900,601100,95300,0,95300,414800,4900,515000,A2,AG/LTD,,,
6689,2-1-0-32-0,6824-43-9193,AG 20-100 AC,30,AC,133600,0,133600,47600,600,181800,131000,0,131000,40800,600,172400,A1,AG/GEN,,,
6690,1-1-0-19-B,6805-82-0177,SNGL FAM SUB,4.143,AC,55700,0,55700,147700,18000,221400,54700,0,54700,127200,18000,199900,A1,AG/GEN,,,
6691,7-1-0-1-0,6843-12-1437,SNGL FAM SUB,0.522,AC,1800,0,1800,0,0,1800,1800,0,1800,0,0,1800,A1,AG/GEN,,,
6692,31-1-0-19-A,6768-37-9446,SNGL FAM SUB,2.58,AC,84200,0,84200,0,0,84200,74100,0,74100,0,0,74100,RP,"RURAL,P",,,
6693,46-23-0-6-0,7717-05-0823,SNGL FAM SUB,2.891,AC,165000,0,165000,236100,100,401200,150000,0,150000,199900,100,350000,A2,AG/LTD,,,
6694,26-1-0-13-A,6719-04-1416,SNGL FAM SUB,6,AC,68500,0,68500,0,0,68500,68000,0,68000,0,0,68000,A1,AG/GEN,,,
6695,13-1-0-8-0,6842-82-6196,AG 20-100 AC,46,AC,234000,212800,21200,0,0,234000,229400,209800,19600,0,0,229400,A1,AG/GEN,,,
6696,11-1-0-24-A,6821-04-9353,AG 20-100 AC,25,AC,170800,112900,57900,177900,12900,361600,170000,114600,55400,144900,12900,327800,A1,AG/GEN,,,
6697,56-1-0-43-0,6795-55-6039,AG 20-100 AC,44.35,AC,1050100,0,1050100,904100,82200,2036400,913200,0,913200,775200,80500,1768900,A2,AG/LTD,,,
6698,9-1-0-61-B,5891-88-2419,SNGL FAM SUB,3.5,AC,46900,0,46900,76300,2600,125800,45900,0,45900,64900,2600,113400,A1,AG/GEN,,,
6699,43-20-0-1-0,6768-71-7717,SNGL FAM SUB,1.8,AC,69900,0,69900,147400,16300,233600,63600,0,63600,129700,14100,207400,A2,AG/LTD,,,
6700,15-1-0-25-0,5880-20-9429,SNGL FAM SUB,9.33,AC,64400,60100,4300,0,0,64400,63000,59000,4000,0,0,63000,A1,AG/GEN,,,
6711,47-1-0-29-0,7716-67-2925,SNGL FAM SUB,2.87,AC,141600,0,141600,250100,31200,422900,126500,0,126500,209300,30000,365800,A2,AG/LTD,,,
6712,42-23-0-8-0,6767-32-5212,SNGL FAM SUB,3.14,AC,102400,0,102400,0,0,102400,91500,0,91500,0,0,91500,A2,AG/LTD,,,
6713,42-23-0-B-0,6767-31-3964,SNGL FAM SUB,4.112,AC,117100,0,117100,0,0,117100,104600,0,104600,0,0,104600,A2,AG/LTD,,,
6714,58-1-0-84-0,7716-57-5012,SNGL FAM SUB,0.838,AC,88000,0,88000,255800,800,344600,80000,0,80000,213600,800,294400,A2,AG/LTD,,,
6715,67-10-0-27-A,7733-06-9993,SNGL FAM SUB,1.723,AC,323000,0,323000,485400,120100,928500,270800,0,270800,384000,110800,765600,R1,RES/LTD,,,
6716,64-4-1-1-0,7724-93-1130,SNGL FAM SUB,0,AC,70000,0,70000,135800,500,206300,60000,0,60000,118300,500,178800,RN,RESIDEN,,,
6717,30-1-0-46-0,6758-48-0123,SNGL FAM SUB,7.42,AC,118000,0,118000,0,0,118000,110200,0,110200,0,0,110200,A2,AG/LTD,,,
6718,30-1-0-47-0,6758-38-5045,SNGL FAM SUB,1.07,AC,54700,0,54700,129600,17100,201400,50600,0,50600,109700,16700,177000,A2,AG/LTD,,,
6719,30-1-0-44-0,6758-37-6777,SNGL FAM SUB,4,AC,82800,0,82800,0,0,82800,78100,0,78100,0,0,78100,A2,AG/LTD,,,
6720,28-9-0-5-0,6729-84-8347,SNGL FAM SUB,1.49,AC,50700,0,50700,89500,1500,141700,48300,0,48300,74200,1500,124000,A1,AG/GEN,,,
6721,30-1-0-6-0,6759-34-0051,AG 20-100 AC,97.43,AC,860400,767400,93000,41200,0,901600,797800,711900,85900,33700,0,831500,A1A2,AG GEN/,,,
6722,58-19-0-3-0,7725-09-0372,SNGL FAM SUB,6.48,AC,233300,0,233300,281400,4800,519500,202800,0,202800,238400,4800,446000,A2,AG/LTD,,,
6723,67-10-0-25-0,7733-16-7530,SNGL FAM SUB,7.29,AC,476000,0,476000,1142800,76400,1695200,399000,0,399000,946200,64600,1409800,R1,RES/LTD,,,
6724,67-10-0-25-A,7733-16-3661,SNGL FAM SUB,3.29,AC,340000,0,340000,0,35400,375400,285000,0,285000,0,31200,316200,R1,RES/LTD,,,
6725,47-14-0-E-0,7728-11-8565,SNGL FAM SUB,4.028,AC,150500,0,150500,331000,32700,514200,134400,0,134400,272600,28500,435500,A2,AG/LTD,,,
6726,47-14-0-F-0,7728-11-9218,SNGL FAM SUB,0.286,AC,4900,0,4900,0,0,4900,4300,0,4300,0,0,4300,A2,AG/LTD,,,
6727,62-1-0-29-0,7714-04-8011,SNGL FAM SUB,0.55,AC,82300,0,82300,140600,20500,243400,71600,0,71600,118700,17300,207600,R3,RES/GEN,,,
6728,64-19-E-13-0,7733-47-1705,SNGL FAM SUB,0,AC,265000,0,265000,521700,34500,821200,220000,0,220000,412500,31700,664200,R1,RES/LTD,,,
6729,44-1-0-24-0,6777-81-9592,SNGL FAM SUB,4.548,AC,126200,0,126200,80100,15500,221800,112600,0,112600,66200,14200,193000,A2,AG/LTD,,,
6730,44-3-0-7-0,6777-80-4305,SNGL FAM SUB,15.27,AC,241300,234300,7000,0,0,241300,215300,208800,6500,0,0,215300,A2,AG/LTD,,,
6731,44-3-0-8-0,6777-80-7301,SNGL FAM SUB,12.7,AC,193000,187100,5900,0,0,193000,172200,166800,5400,0,0,172200,A2,AG/LTD,,,
6732,47-18-0-1-0,7717-98-7224,SNGL FAM SUB,3.7,AC,135000,0,135000,86900,0,221900,120600,0,120600,73200,0,193800,A2,AG/LTD,,,
6733,47-18-0-2-0,7727-08-0006,SNGL FAM SUB,3.2,AC,126500,0,126500,142200,300,269000,113000,0,113000,118300,300,231600,A2,AG/LTD,,,
6734,47-18-0-3-0,7727-08-2050,SNGL FAM SUB,3.2,AC,126500,0,126500,140200,400,267100,113000,0,113000,116800,400,230200,A2,AG/LTD,,,
6735,47-18-0-4-0,7727-08-5061,SNGL FAM SUB,3.3,AC,128200,0,128200,148000,1200,277400,114600,0,114600,123200,1200,239000,A2,AG/LTD,,,
6736,47-18-0-5-0,7727-08-9010,SNGL FAM SUB,3.51,AC,131800,0,131800,170600,65500,367900,117800,0,117800,144700,56900,319400,A2,AG/LTD,,,
6737,47-18-0-6-0,7727-07-9530,SNGL FAM SUB,3.35,AC,129100,0,129100,181400,24300,334800,115300,0,115300,153300,20000,288600,A2,AG/LTD,,,
6740,47-18-0-9-0,7727-07-5655,SNGL FAM SUB,3.2,AC,126500,0,126500,138400,73600,338500,113000,0,113000,115400,62400,290800,A2,AG/LTD,,,
6741,47-21-0-7-0,7726-19-6878,COMM & IND,1.03,AC,351500,0,351500,646800,75100,1073400,319500,0,319500,618200,53800,991500,B1,BUS/GEN,,,
6742,51-8-0-7-0,6735-39-8366,SNGL FAM SUB,3.43,AC,48500,0,48500,11000,500,60000,47600,0,47600,10200,500,58300,A1,AG/GEN,,,
6743,19-1-0-9-0,6820-88-0984,AG 20-100 AC,40,AC,115300,0,115300,0,0,115300,114800,0,114800,0,0,114800,A1,AG/GEN,,,
6744,19-1-0-2-0,6821-71-6282,AG 20-100 AC,52.63,AC,241600,156800,84800,46800,0,288400,225400,163800,61600,39900,0,265300,A1,AG/GEN,,,
6745,48-1-0-42-0,7727-47-9027,COMM & IND,0.86,AC,116300,0,116300,0,0,116300,110800,0,110800,0,0,110800,M2,INDUS/G,,,
6747,18-4-0-5-0,6820-12-2540,SNGL FAM SUB,5,AC,63500,0,63500,194200,21100,278800,62000,0,62000,164200,18300,244500,A1,AG/GEN,,,
6748,42-16-C-1-0,6767-04-0734,SNGL FAM SUB,1.928,AC,93700,0,93700,223100,3900,320700,85100,0,85100,201000,3900,290000,R1,RES/LTD,,,
6749,50-5-0-20-A,6726-20-8240,SNGL FAM SUB,2.08,AC,41900,0,41900,350600,0,392500,39100,0,39100,287200,0,326300,A1,AG/GEN,,,
6750,50-5-0-20-B,6725-29-7137,SNGL FAM SUB,6,AC,37100,0,37100,0,0,37100,36300,0,36300,0,0,36300,A1,AG/GEN,,,
6751,12-1-0-60-A,6832-50-5945,SNGL FAM SUB,2.14,AC,49600,0,49600,14700,4000,68300,48100,0,48100,17700,4000,69800,A1,AG/GEN,,,
6752,13-1-0-38-C,6841-93-4305,SNGL FAM SUB,2.93,AC,66600,0,66600,154600,7000,228200,65400,0,65400,134500,7000,206900,A1,AG/GEN,,,
6753,57-20-C-4-0,7716-00-6619,SNGL FAM SUB,2.382,AC,315000,0,315000,579100,15000,909100,288800,0,288800,529100,15000,832900,A2,AG/LTD,,,
6754,31-1-0-21-A,6768-56-4971,SNGL FAM SUB,15,AC,212300,0,212300,529600,68900,810800,193700,0,193700,438000,68900,700600,A2,AG/LTD,,,
6757,4-1-0-16-0,6803-44-6291,SNGL FAM SUB,17.52,AC,125400,0,125400,135900,2000,263300,120600,0,120600,122700,2000,245300,A1,AG/GEN,,,
6759,39-1-0-25-0,6717-94-8499,SNGL FAM SUB,10,AC,84700,0,84700,247300,8100,340100,83000,0,83000,220300,8400,311700,A1,AG/GEN,,,
6760,39-1-0-36-A,6727-03-2434,SNGL FAM SUB,1.95,AC,44100,0,44100,66400,200,110700,43200,0,43200,56700,200,100100,A1,AG/GEN,,,
6761,64-19-E-6-0,7733-48-5204,SNGL FAM SUB,1.66,AC,265000,0,265000,491300,1000,757300,220000,0,220000,426900,1000,647900,R1,RES/LTD,,,
6762,58-21-A-7-0,7716-43-6772,SNGL FAM SUB,1.368,AC,310000,0,310000,822200,0,1132200,285000,0,285000,745300,0,1030300,A2,AG/LTD,,,
6763,42-16-B-6-0,6757-94-5190,SNGL FAM SUB,0.75,AC,12200,0,12200,0,0,12200,11100,0,11100,0,0,11100,R1,RES/LTD,,,
6764,42-16-B-7-0,6757-94-5201,SNGL FAM SUB,1.9,AC,111200,0,111200,248200,0,359400,101000,0,101000,241100,0,342100,R1,RES/LTD,,,
6765,25-2-0-2-0,5798-77-1799,AG 20-100 AC,41.3,AC,123900,103100,20800,0,0,123900,123900,106200,17700,0,0,123900,A1,AG/GEN,,,
6766,46-1-0-8-A,7707-16-6721,SNGL FAM SUB,4.17,AC,171300,0,171300,124300,100,295700,153100,0,153100,108500,100,261700,A2,AG/LTD,,,
6767,46-1-0-8-0,7707-27-1949,SNGL FAM SUB,18.11,AC,346700,337600,9100,0,0,346700,310000,302200,7800,0,0,310000,A2,AG/LTD,,,
6768,46-7-0-D-2,7707-52-9932,SNGL FAM SUB,2,AC,121800,0,121800,139700,500,262000,108800,0,108800,115900,500,225200,RR,RES/RUR,,,
6769,60-9-0-3-0,6774-98-9607,SNGL FAM SUB,6.919,AC,433200,0,433200,663800,0,1097000,386600,0,386600,549500,0,936100,A2,AG/LTD,,,
6770,60-9-0-C-1,6784-19-4754,Cmn Area/Open Spc,0.255,AC,0,0,0,0,0,0,0,0,0,0,0,0,A2,AG/LTD,,,
6771,60-9-0-C-2,6784-08-7934,Cmn Area/Open Spc,3.57,AC,0,0,0,0,0,0,0,0,0,0,0,0,A2,AG/LTD,,,
6772,58-3-A-14-0,7726-26-1464,SNGL FAM SUB,0,AC,88000,0,88000,208900,1300,298200,80000,0,80000,136400,1300,217700,RN,RESIDEN,,,
6773,58-3-B-7-0,7726-16-4907,SNGL FAM SUB,0,AC,88000,0,88000,173300,1000,262300,80000,0,80000,143200,1000,224200,RN,RESIDEN,,,
6774,62-21-0-9-0,7704-87-9959,SNGL FAM SUB,8.01,AC,378700,0,378700,599000,0,977700,329200,0,329200,553400,0,882600,A2,AG/LTD,,,
6775,43-17-0-B-0,6767-91-5799,SNGL FAM SUB,1.06,AC,71000,0,71000,131400,1600,204000,63400,0,63400,106800,1600,171800,A2,AG/LTD,,,
6776,40-1-0-12-0,6737-00-3621,SNGL FAM SUB,13.29,AC,114900,0,114900,0,6000,120900,112800,0,112800,0,5000,117800,A1,AG/GEN,,,
6779,29-19-0-B-0,6759-06-6637,SNGL FAM SUB,3,AC,73600,0,73600,0,0,73600,69700,0,69700,0,0,69700,A1,AG/GEN,,,
6780,29-19-0-C-0,6759-06-7779,SNGL FAM SUB,3,AC,73600,0,73600,243100,0,316700,69700,0,69700,201600,0,271300,A1,AG/GEN,,,
6781,26-1-0-35-G,6708-92-9874,SNGL FAM SUB,3.02,AC,50100,0,50100,162200,6600,218900,49100,0,49100,141300,6800,197200,A1,AG/GEN,,,
6782,26-1-0-35-J,6708-92-9686,SNGL FAM SUB,1.515,AC,22300,0,22300,0,900,23200,21800,0,21800,0,900,22700,A1,AG/GEN,,,
6783,5-1-0-79-B,6823-65-1131,SNGL FAM SUB,3,AC,49900,0,49900,106900,2000,158800,49000,0,49000,93000,2000,144000,A1,AG/GEN,,,
6784,4-1-0-23-0,6803-60-2115,SNGL FAM SUB,11,AC,55100,50000,5100,0,0,55100,54400,49700,4700,0,0,54400,A1,AG/GEN,,,
6785,4-1-0-24-0,6803-50-8187,SNGL FAM SUB,4.5,AC,35200,33100,2100,0,0,35200,34700,32800,1900,0,0,34700,A1,AG/GEN,,,
6786,4-1-0-22-0,6802-69-8906,AG 20-100 AC,28.43,AC,152000,109700,42300,317400,3500,472900,149100,99300,49800,274500,3500,427100,A1,AG/GEN,,,
6788,9-1-0-87-0,6801-07-4091,AG 20-100 AC,22.09,AC,92500,0,92500,9100,1400,103000,90700,0,90700,9600,1300,101600,A1,AG/GEN,,,
6789,44-3-0-1-A,6777-71-9471,SNGL FAM SUB,2,AC,85900,0,85900,215700,16200,317800,76700,0,76700,176100,13900,266700,A2,AG/LTD,,,
6790,62-18-0-23-0,7704-72-2824,SNGL FAM SUB,3.65,AC,234200,0,234200,207300,600,442100,200300,0,200300,185100,700,386100,A2,AG/LTD,,,
6791,47-14-0-D-0,7728-11-5426,SNGL FAM SUB,3,AC,133000,0,133000,179000,17800,329800,118800,0,118800,149000,17800,285600,A2,AG/LTD,,,
6792,64-14-A-3-0,7733-27-2604,SNGL FAM SUB,0,AC,251800,0,251800,682000,0,933800,209000,0,209000,584200,0,793200,R1,RES/LTD,,,
6793,56-3-0-1-0,6785-82-4814,SNGL FAM SUB,5.074,AC,145600,0,145600,555600,0,701200,130100,0,130100,457000,0,587100,A2,AG/LTD,,,
6794,62-15-0-D-0,7704-27-2332,COMM & IND,56.3,AC,1344700,0,1344700,657600,1230400,3232700,1247400,0,1247400,655100,1216700,3119200,A2,AG/LTD,,,
6795,62-15-0-G-0,6794-95-9756,AG 20-100 AC,42.2,AC,20900,0,20900,0,0,20900,18000,0,18000,0,0,18000,A2,AG/LTD,,,
6796,14-3-0-21-0,6851-37-6493,SNGL FAM SUB,3.39,AC,69900,0,69900,0,0,69900,68500,0,68500,0,0,68500,A1,AG/GEN,,,
6797,46-14-0-3-0,7708-91-9009,SNGL FAM SUB,3.19,AC,132900,0,132900,197300,11200,341400,120900,0,120900,163900,11200,296000,A2,AG/LTD,,,
6798,12-1-0-75-A,6831-62-6486,SNGL FAM SUB,1.42,AC,8300,7600,700,0,0,8300,8100,7500,600,0,0,8100,A1,AG/GEN,,,
6799,12-1-0-75-0,6831-73-0632,SNGL FAM SUB,11.94,AC,113100,60600,52500,339100,7400,459600,101600,52200,49400,285800,7400,394800,A1,AG/GEN,,,
6801,63-3-A-2-0,7714-91-5880,SNGL FAM SUB,0,AC,70000,0,70000,425100,1600,496700,60000,0,60000,365300,1600,426900,R1,RES/LTD,,,
6802,17-1-0-51-0,6810-08-3921,AG 20-100 AC,22.48,AC,67500,0,67500,0,0,67500,64900,0,64900,0,0,64900,A1,AG/GEN,,,
6803,46-1-0-87-0,7718-11-7662,SNGL FAM SUB,6.65,AC,191800,0,191800,201000,18600,411400,171200,0,171200,165800,15300,352300,A2,AG/LTD,,,
6804,9-1-0-57-A,6801-34-1448,SNGL FAM SUB,3.367,AC,47200,0,47200,180300,3700,231200,46300,0,46300,161600,3700,211600,A1,AG/GEN,,,
6805,10-1-0-12-0,6801-34-3203,SNGL FAM SUB,3.086,AC,46000,0,46000,108500,30100,184600,45300,0,45300,95400,25400,166100,A1,AG/GEN,,,
6806,12-1-0-61-A,6832-70-0582,SNGL FAM SUB,5.53,AC,75300,0,75300,112500,5800,193600,73300,0,73300,102500,5800,181600,A1,AG/GEN,,,
6807,12-1-0-62-A,6831-69-7715,SNGL FAM SUB,19.14,AC,92900,84100,8800,0,0,92900,86100,0,86100,0,0,86100,A1,AG/GEN,,,
6808,12-1-0-62-B,6832-70-2064,SNGL FAM SUB,2,AC,46100,0,46100,127800,2000,175900,44000,0,44000,114200,2000,160200,A1,AG/GEN,,,
6809,5-3-0-14-0,6823-19-4539,SNGL FAM SUB,3.26,AC,56800,0,56800,301900,2500,361200,55700,0,55700,256900,2500,315100,A1,AG/GEN,,,
6810,12-1-0-62-0,6831-79-6785,AG 20-100 AC,44.45,AC,248500,186000,62500,314000,5000,567500,215000,0,215000,277300,3600,495900,A1,AG/GEN,,,
6811,58-6-0-3-0,7726-11-7970,SNGL FAM SUB,0.98,AC,95600,0,95600,87000,100,182700,83200,0,83200,72800,100,156100,A2,AG/LTD,,,
6812,42-1-0-21-0,6766-16-7944,SNGL FAM SUB,0.144,AC,1900,0,1900,0,0,1900,1700,0,1700,0,0,1700,A2,AG/LTD,,,
6813,42-1-0-23-0,6766-17-9167,SNGL FAM SUB,8.436,AC,213200,0,213200,352300,7800,573300,190300,0,190300,291300,7800,489400,A2,AG/LTD,,,
6814,31-1-0-64-0,6779-45-5340,SNGL FAM SUB,1.891,AC,76900,0,76900,116100,5000,198000,68700,0,68700,94400,5000,168100,A2,AG/LTD,,,
6815,62-4-C-18-0,7714-04-4564,SNGL FAM SUB,0,AC,115000,0,115000,322800,0,437800,100000,0,100000,296300,0,396300,R1,RES/LTD,,,
6816,55-8-0-2-0,6785-58-9794,SNGL FAM SUB,10,AC,206000,0,206000,0,0,206000,184100,0,184100,0,0,184100,A2,AG/LTD,,,
6817,67-10-0-13-0,7733-04-9925,SNGL FAM SUB,0,AC,340000,0,340000,714800,0,1054800,285000,0,285000,620000,0,905000,R1,RES/LTD,,,
6818,10-1-0-11-0,6801-44-6094,AG 20-100 AC,20.959,AC,110400,0,110400,82200,700,193300,107900,0,107900,71200,700,179800,A1,AG/GEN,,,
6819,29-3-0-9-0,6749-62-4227,SNGL FAM SUB,4.01,AC,82900,0,82900,110300,1600,194800,78200,0,78200,92000,1600,171800,A1,AG/GEN,,,
6820,29-1-0-75-0,6749-45-6200,SNGL FAM SUB,5,AC,77100,0,77100,0,4200,81300,75900,0,75900,0,3500,79400,A1,AG/GEN,,,
6821,29-1-0-75-A,6749-45-8127,SNGL FAM SUB,5,AC,77100,0,77100,103000,200,180300,75900,0,75900,86100,200,162200,A1,AG/GEN,,,
6822,51-1-0-54-0,6736-51-6827,SNGL FAM SUB,12.174,AC,97500,0,97500,82800,1400,181700,95700,0,95700,68900,1500,166100,A1,AG/GEN,,,
6823,30-1-0-63-A,6759-53-3256,SNGL FAM SUB,1.03,AC,54300,0,54300,149000,0,203300,50200,0,50200,119000,0,169200,A2,AG/LTD,,,
6824,62-2-C-4-0,7714-04-3404,SNGL FAM SUB,0,AC,115000,0,115000,167300,500,282800,100000,0,100000,155000,500,255500,R1,RES/LTD,,,
6825,9-1-0-35-B,5892-53-9514,SNGL FAM SUB,4,AC,49100,0,49100,122800,0,171900,48000,0,48000,103000,0,151000,A1,AG/GEN,,,
6826,45-16-0-20-0,6798-51-0952,SNGL FAM SUB,2.49,AC,93500,0,93500,181800,800,276100,83400,0,83400,148100,800,232300,A2,AG/LTD,,,
6827,26-1-0-51-0,6719-51-0097,SNGL FAM SUB,4.07,AC,58100,0,58100,0,0,58100,56400,0,56400,0,0,56400,A1,AG/GEN,,,
6829,43-11-0-5-0,6767-78-7244,SNGL FAM SUB,2.14,AC,86500,0,86500,214700,21700,322900,77300,0,77300,180700,17900,275900,A2,AG/LTD,,,
6830,13-14-0-A-2,6841-92-8961,SNGL FAM SUB,2,AC,58600,0,58600,171900,20800,251300,57500,0,57500,152200,18500,228200,A1,AG/GEN,,,
6831,13-14-0-A-2A,6841-92-9891,SNGL FAM SUB,0.959,AC,9100,0,9100,0,0,9100,9100,0,9100,0,0,9100,A1,AG/GEN,,,
6832,43-1-0-43-0,6767-75-2161,SNGL FAM SUB,3.91,AC,100500,0,100500,209600,16700,326800,89800,0,89800,179600,14200,283600,A2,AG/LTD,,,
6834,57-1-0-49-0,7715-08-2077,SNGL FAM SUB,5.858,AC,301100,0,301100,165300,3500,469900,261700,0,261700,146400,3500,411600,A2,AG/LTD,,,
6835,32-1-0-33-A,6778-76-0533,SNGL FAM SUB,5.71,AC,115000,0,115000,50200,300,165500,102400,0,102400,40900,300,143600,A2,AG/LTD,,,
6836,32-1-0-33-B,6778-76-3295,SNGL FAM SUB,2.31,AC,83000,0,83000,152100,1000,236100,74100,0,74100,125400,1000,200500,A2,AG/LTD,,,
6837,32-1-0-33-C,6778-65-7986,SNGL FAM SUB,3,AC,92900,0,92900,154700,2500,250100,83000,0,83000,125500,2500,211000,A2,AG/LTD,,,
6842,63-1-0-8-0,7715-30-4957,SNGL FAM SUB,3.7,AC,184200,0,184200,20300,1200,205700,160300,0,160300,17000,1200,178500,A2,AG/LTD,,,
6843,63-1-0-6-0,7715-31-2242,SNGL FAM SUB,0.85,AC,107600,0,107600,81800,10000,199400,93600,0,93600,70100,10000,173700,A2,AG/LTD,,,
6844,63-1-0-5-0,7715-31-1004,SNGL FAM SUB,1,AC,115100,0,115100,143500,8100,266700,100100,0,100100,113900,7600,221600,A2,AG/LTD,,,
6845,63-1-0-9-0,7715-31-2073,SNGL FAM SUB,0.45,AC,9200,0,9200,0,0,9200,8000,0,8000,0,0,8000,A2,AG/LTD,,,
6846,44-1-0-41-0,6788-70-5980,SNGL FAM SUB,11.72,AC,204600,0,204600,0,0,204600,182800,0,182800,0,0,182800,A2,AG/LTD,,,
6847,32-10-1-24-0,6778-79-1021,SNGL FAM SUB,3.23,AC,99400,0,99400,200300,2000,301700,88900,0,88900,163300,2000,254200,A2,AG/LTD,,,
6848,44-1-0-40-0,6788-71-1606,SNGL FAM SUB,1,AC,70100,0,70100,176300,17700,264100,62600,0,62600,145600,14500,222700,A2,AG/LTD,,,
6849,44-1-0-40-A,6788-71-1201,SNGL FAM SUB,11.73,AC,218200,0,218200,0,0,218200,194600,0,194600,0,0,194600,A2,AG/LTD,,,
6850,46-1-0-83-0,7708-80-1987,SNGL FAM SUB,18.16,AC,394400,0,394400,250700,16500,661600,351900,0,351900,216600,13800,582300,A2,AG/LTD,,,
6852,42-8-2-3-0,6767-18-9275,SNGL FAM SUB,0,AC,60000,0,60000,150600,4400,215000,55000,0,55000,126100,4700,185800,A2,AG/LTD,,,
6853,10-1-0-18-0,6801-52-5278,SNGL FAM SUB,1,AC,38800,0,38800,85800,1000,125600,38000,0,38000,75300,1000,114300,A1,AG/GEN,,,
6854,17-8-0-4-0,6801-51-7928,SNGL FAM SUB,5,AC,57200,0,57200,0,27500,84700,56000,0,56000,0,27500,83500,A1,AG/GEN,,,
6855,17-8-0-3-0,6801-51-5593,SNGL FAM SUB,9.06,AC,75600,0,75600,10000,0,85600,70200,0,70200,10000,0,80200,A1,AG/GEN,,,
6856,17-8-0-2-0,6801-51-2198,SNGL FAM SUB,5,AC,37800,0,37800,0,0,37800,37000,0,37000,0,0,37000,A1,AG/GEN,,,
6857,42-9-0-1-0,6767-01-5370,SNGL FAM SUB,0.33,AC,55000,0,55000,216400,5500,276900,50000,0,50000,178200,5500,233700,R3,RES/GEN,,,
6858,42-9-0-2-0,6767-01-5262,SNGL FAM SUB,0.33,AC,55000,0,55000,0,0,55000,50000,0,50000,0,0,50000,R3,RES/GEN,,,
6859,45-1-0-72-D,6796-59-8879,SNGL FAM SUB,9.18,AC,215400,0,215400,140400,38900,394700,192100,0,192100,114100,32400,338600,A2,AG/LTD,,,
6860,67-2-A-3-0,7723-56-5589,SNGL FAM SUB,0,AC,165600,0,165600,478700,0,644300,144000,0,144000,402900,0,546900,R1,RES/LTD,,,
6861,67-2-A-1-0,7723-56-9545,SNGL FAM SUB,0,AC,165600,0,165600,909000,0,1074600,144000,0,144000,766000,0,910000,R1,RES/LTD,,,
6862,67-2-A-2-0,7723-56-7576,SNGL FAM SUB,0,AC,165600,0,165600,423000,1000,589600,144000,0,144000,358100,1000,503100,R1,RES/LTD,,,
6863,62-15-0-C-0,7704-46-3851,AG 20-100 AC,28.3,AC,792600,778500,14100,0,0,792600,689800,677600,12200,0,0,689800,A2,AG/LTD,,,
6864,62-15-0-F-0,7704-04-9993,AG 20-100 AC,68.9,AC,413400,329400,84000,0,0,413400,275600,205300,70300,0,0,275600,A2,AG/LTD,,,
6865,62-15-0-A-0,7704-45-0898,SNGL FAM SUB,16.3,AC,520000,0,520000,2384500,203400,3107900,453400,0,453400,2187700,195500,2836600,A2,AG/LTD,,,
6866,12-1-0-59-B,6832-45-1260,SNGL FAM SUB,8.12,AC,92600,0,92600,0,0,92600,92500,0,92500,0,0,92500,A1,AG/GEN,,,
6867,20-1-0-16-A,6840-54-4667,AG 20-100 AC,62.557,AC,541000,470600,70400,0,45700,586700,519200,453200,66000,0,39500,558700,A1,AG/GEN,,,
6873,57-10-0-4-0,7705-76-9241,SNGL FAM SUB,4.22,AC,230000,0,230000,303000,800,533800,210000,0,210000,304700,800,515500,A2,AG/LTD,,,
6874,42-1-0-66-F,6757-98-5776,COMM & IND,1.517,AC,204900,0,204900,1252400,60400,1517700,197000,0,197000,1153900,53900,1404800,B1,BUS/GEN,,,
6875,5-4-0-3-0,6813-90-7387,SNGL FAM SUB,4.25,AC,56300,0,56300,0,0,56300,55300,0,55300,0,0,55300,A1,AG/GEN,,,
6876,50-5-0-33-0,6726-33-1460,SNGL FAM SUB,4.14,AC,53200,0,53200,0,0,53200,51000,0,51000,0,0,51000,A1,AG/GEN,,,
6877,12-5-0-7-0,6832-35-5850,SNGL FAM SUB,8.45,AC,113500,0,113500,227700,5000,346200,109600,0,109600,202000,4700,316300,A1,AG/GEN,,,
7032,63-1-0-133-0,7715-72-1088,SNGL FAM SUB,1.9,AC,126800,0,126800,244000,500,371300,110200,0,110200,205100,500,315800,A2,AG/LTD,,,
7034,4-1-0-70-0,6813-50-0227,AG 20-100 AC,26.127,AC,143400,131300,12100,0,0,143400,140600,129500,11100,0,0,140600,A1,AG/GEN,,,
7036,11-1-0-41-0,6821-37-2402,AG 20-100 AC,74.687,AC,293700,215800,77900,111100,32900,437700,288500,216100,72400,91600,32100,412200,A1,AG/GEN,,,
7037,11-1-0-41-B,6821-27-1904,SNGL FAM SUB,2.5,AC,49000,0,49000,185600,9600,244200,47800,0,47800,153700,9600,211100,A1,AG/GEN,,,
7038,32-4-0-10-0,6779-55-7834,SNGL FAM SUB,5,AC,114100,0,114100,0,0,114100,102000,0,102000,0,0,102000,A2,AG/LTD,,,
7039,4-1-0-64-0,6813-21-7735,AG 20-100 AC,39.82,AC,199300,141100,58200,343400,40800,583500,195400,139800,55600,305200,37700,538300,A1,AG/GEN,,,
7040,4-1-0-69-A,6813-40-8962,SNGL FAM SUB,13.767,AC,99100,53300,45800,53300,1000,153400,97200,52700,44500,48000,1000,146200,A1,AG/GEN,,,
7041,4-1-0-69-0,6813-41-4535,AG 20-100 AC,25,AC,149900,98300,51600,121800,5000,276700,147000,97700,49300,108700,5000,260700,A1,AG/GEN,,,
7042,4-1-0-52-A,6813-14-6663,SNGL FAM SUB,2.11,AC,45400,0,45400,246100,8900,300400,44600,0,44600,215200,9700,269500,A1,AG/GEN,,,
7043,5-1-0-17-0,6813-51-5864,AG 20-100 AC,22.2,AC,57100,46900,10200,0,0,57100,55900,46500,9400,0,0,55900,A1,AG/GEN,,,
7044,2-1-0-3-0,6814-45-7239,AG 20-100 AC,29.24,AC,147100,132800,14300,0,0,147100,144200,131700,12500,0,0,144200,A1,AG/GEN,,,
7045,10-1-0-39-0,6812-50-2061,AG 20-100 AC,85.08,AC,172800,133600,39200,0,0,172800,170200,134000,36200,0,0,170200,A1,AG/GEN,,,
7046,11-1-0-16-A,6811-78-0463,AG 20-100 AC,85,AC,280800,240300,40500,0,95100,375900,280500,244300,36200,0,82100,362600,A1,AG/GEN,,,
7047,11-1-0-42-A,6821-28-3179,SNGL FAM SUB,3,AC,52000,0,52000,374700,64900,491600,51000,0,51000,305200,63100,419300,A1,AG/GEN,,,
7049,14-3-0-7-0,6851-39-5387,SNGL FAM SUB,3.22,AC,68400,0,68400,185500,800,254700,67000,0,67000,155500,800,223300,A1,AG/GEN,,,
7204,27-1-0-43-0,6718-78-6470,AG 20-100 AC,43.118,AC,235100,0,235100,145000,20900,401000,230500,0,230500,124600,18700,373800,A1,AG/GEN,,,
7205,27-1-0-43-B,6728-08-0518,SNGL FAM SUB,17.17,AC,91600,0,91600,211700,26100,329400,90400,0,90400,185400,20600,296400,A1,AG/GEN,,,
7206,46-1-0-79-B,7708-70-3350,SNGL FAM SUB,2.28,AC,121600,0,121600,182600,43000,347200,108600,0,108600,153400,33900,295900,A2,AG/LTD,,,
7207,43-1-0-28-A,6767-53-3087,SNGL FAM SUB,1.07,AC,65100,0,65100,75400,500,141000,58100,0,58100,63100,500,121700,A2,AG/LTD,,,
7208,67-2-C-22-0,7723-55-4983,SNGL FAM SUB,0,AC,184000,0,184000,594900,8300,787200,160000,0,160000,500800,7300,668100,R1,RES/LTD,,,
7209,67-2-C-23-0,7723-56-4191,SNGL FAM SUB,0,AC,184000,0,184000,460500,600,645100,160000,0,160000,386700,600,547300,R1,RES/LTD,,,
7210,64-12-A-3-0,7724-50-9842,SNGL FAM SUB,0.463,AC,77000,0,77000,196400,500,273900,67000,0,67000,168000,500,235500,R1,RES/LTD,,,
7211,32-1-0-31-0,6778-68-1136,SNGL FAM SUB,3.02,AC,93200,0,93200,0,1200,94400,83300,0,83300,0,1000,84300,A2,AG/LTD,,,
7212,32-1-0-31-B,6778-67-2976,SNGL FAM SUB,2.78,AC,89700,0,89700,0,0,89700,80200,0,80200,0,0,80200,A2,AG/LTD,,,
7213,32-1-0-31-A,6778-58-9494,SNGL FAM SUB,3.06,AC,93800,0,93800,175100,13600,282500,83800,0,83800,142300,9700,235800,A2,AG/LTD,,,
7214,58-3-D-3-0,7726-26-1719,SNGL FAM SUB,0,AC,88000,0,88000,180500,0,268500,80000,0,80000,150700,0,230700,RN,RESIDEN,,,
7215,64-1-0-14-0,7724-52-7551,SNGL FAM SUB,2.03,AC,146400,0,146400,160500,4700,311600,127200,0,127200,136100,4700,268000,R3,RES/GEN,,,
7216,64-11-0-A-0,7724-52-5188,SNGL FAM SUB,2.19,AC,150200,0,150200,322900,27300,500400,130500,0,130500,270700,25300,426500,R1,RES/LTD,,,
7217,64-11-0-A-1,7724-52-6355,SNGL FAM SUB,0.5,AC,13200,0,13200,0,0,13200,11500,0,11500,0,0,11500,R3,RES/GEN,,,
7219,57-20-B-3-0,7716-01-3226,SNGL FAM SUB,2.068,AC,365000,0,365000,296400,0,661400,335000,0,335000,267700,0,602700,A2,AG/LTD,,,
7220,18-1-0-26-D,6729-17-9774,SNGL FAM SUB,3.48,AC,54700,0,54700,197200,1500,253400,52900,0,52900,161800,1700,216400,A1,AG/GEN,,,
7221,27-1-0-53-0,6729-25-1310,SNGL FAM SUB,16,AC,111300,0,111300,0,0,111300,111000,0,111000,0,0,111000,A1,AG/GEN,,,
7222,56-1-0-75-0,6796-92-5464,SNGL FAM SUB,3.09,AC,130700,0,130700,141700,1500,273900,113600,0,113600,119600,1500,234700,A2,AG/LTD,,,
7223,57-1-0-22-0,7706-01-3994,SNGL FAM SUB,2.39,AC,131500,0,131500,234300,20200,386000,114300,0,114300,195900,20200,330400,A2,AG/LTD,,,
7224,12-3-0-1-0,6832-11-1277,AG 20-100 AC,20.29,AC,153000,0,153000,347700,64800,565500,149500,0,149500,288200,60500,498200,A1,AG/GEN,,,
6878,32-10-2-1-0,6778-59-8463,SNGL FAM SUB,1.61,AC,76100,0,76100,164700,1500,242300,68000,0,68000,136600,1500,206100,A2,AG/LTD,,,
6879,60-9-0-A-0,6774-98-6398,SNGL FAM SUB,6.161,AC,417200,0,417200,0,0,417200,372200,0,372200,0,0,372200,A2,AG/LTD,,,
6880,60-9-0-4-0,6774-97-8900,SNGL FAM SUB,12.03,AC,482600,0,482600,1949600,8800,2441000,431100,0,431100,1816200,8100,2255400,A2,AG/LTD,,,
6882,60-9-0-6-0,6784-07-1568,SNGL FAM SUB,6.61,AC,426700,0,426700,0,0,426700,380700,0,380700,0,0,380700,A2,AG/LTD,,,
6883,60-9-0-7-0,6784-07-5631,SNGL FAM SUB,5.31,AC,380100,0,380100,0,0,380100,339200,0,339200,0,0,339200,A2,AG/LTD,,,
6884,32-4-0-5-0,6779-65-9503,SNGL FAM SUB,14.53,AC,218300,211100,7200,0,0,218300,195200,189000,6200,0,0,195200,A2,AG/LTD,,,
6885,51-9-0-B-0,6736-40-6475,SNGL FAM SUB,2.74,AC,45500,0,45500,221700,900,268100,44600,0,44600,199600,900,245100,A1,AG/GEN,,,
6886,39-6-0-12-0,6726-17-3748,SNGL FAM SUB,2.415,AC,46700,0,46700,0,0,46700,45800,0,45800,0,0,45800,A1,AG/GEN,,,
6887,39-6-0-11-0,6726-18-4140,SNGL FAM SUB,4,AC,55600,0,55600,116400,400,172400,54500,0,54500,95700,400,150600,A1,AG/GEN,,,
6889,56-1-0-63-A,6796-52-6939,SNGL FAM SUB,18.06,AC,463400,246100,217300,978800,33300,1475500,402500,213700,188800,827300,29600,1259400,A2,AG/LTD,,,
6890,64-17-0-A-0,7733-68-3422,SNGL FAM SUB,1.965,AC,212200,0,212200,529100,11700,753000,184500,0,184500,496400,9100,690000,R1,RES/LTD,,,
6891,67-11-B-6-0,7733-26-3279,SNGL FAM SUB,0,AC,265000,0,265000,528300,0,793300,220000,0,220000,478000,0,698000,R1,RES/LTD,,,
6892,56-1-0-63-0,6796-54-1026,AG 20-100 AC,42.3,AC,1063500,0,1063500,188800,316500,1568800,923600,0,923600,165100,277700,1366400,A2,AG/LTD,,,
6896,56-1-0-63-B,6796-43-3938,SNGL FAM SUB,0.511,AC,10400,0,10400,0,0,10400,9000,0,9000,0,0,9000,A2,AG/LTD,,,
6898,43-23-0-9-0,6776-57-4948,SNGL FAM SUB,12.1,AC,215200,0,215200,0,0,215200,191700,0,191700,0,0,191700,A2,AG/LTD,,,
6899,43-23-0-10-0,6776-58-7512,SNGL FAM SUB,11.73,AC,210400,0,210400,293000,55900,559300,187400,0,187400,252800,51900,492100,A2,AG/LTD,,,
6900,43-23-0-11-0,6776-48-8658,SNGL FAM SUB,12.53,AC,196600,0,196600,0,0,196600,175000,0,175000,0,0,175000,A2,AG/LTD,,,
6901,43-23-0-12-0,6776-59-0386,SNGL FAM SUB,13.59,AC,234400,0,234400,598600,76200,909200,208800,0,208800,520300,63100,792200,A2,AG/LTD,,,
6902,43-23-0-13-0,6776-59-7243,SNGL FAM SUB,11.25,AC,204200,0,204200,335800,29900,569900,181900,0,181900,294100,29900,505900,A2,AG/LTD,,,
6903,44-15-1-4-0,6786-27-5444,SNGL FAM SUB,9.18,AC,177500,0,177500,353900,0,531400,158100,0,158100,309000,0,467100,A2,AG/LTD,,,
6904,44-15-1-5-0,6786-27-0383,SNGL FAM SUB,9.54,AC,182200,0,182200,526000,47500,755700,162200,0,162200,453900,40000,656100,A2,AG/LTD,,,
6905,44-15-1-6-0,6786-17-5680,SNGL FAM SUB,9.14,AC,177000,0,177000,318100,30900,526000,157600,0,157600,283400,29300,470300,A2,AG/LTD,,,
6906,44-15-1-7-0,6786-16-3953,SNGL FAM SUB,16,AC,265500,0,265500,705900,7600,979000,236500,0,236500,646500,3100,886100,A2,AG/LTD,,,
6907,44-15-1-8-0,6786-17-0706,SNGL FAM SUB,8.56,AC,162300,0,162300,401100,0,563400,144500,0,144500,352000,0,496500,A2,AG/LTD,,,
6908,44-15-1-10-0,6786-07-2073,SNGL FAM SUB,10.77,AC,198000,0,198000,290300,19800,508100,176400,0,176400,255300,17000,448700,A2,AG/LTD,,,
6909,44-15-1-11-0,6776-97-8036,SNGL FAM SUB,8.38,AC,167200,0,167200,401400,0,568600,148900,0,148900,351500,10800,511200,A2,AG/LTD,,,
6910,44-15-1-13-0,6776-86-2975,SNGL FAM SUB,13.24,AC,229900,0,229900,630900,46100,906900,204800,0,204800,546900,42500,794200,A2,AG/LTD,,,
6911,44-15-1-14-0,6776-87-2991,SNGL FAM SUB,10.528,AC,194900,0,194900,578000,2400,775300,173600,0,173600,495500,2700,671800,A2,AG/LTD,,,
6912,44-15-1-15-0,6776-88-2739,SNGL FAM SUB,9.12,AC,176700,0,176700,0,0,176700,157400,0,157400,0,0,157400,A2,AG/LTD,,,
6913,44-15-1-16-0,6776-88-7848,SNGL FAM SUB,17.56,AC,296300,0,296300,0,0,296300,254400,0,254400,0,0,254400,A2,AG/LTD,,,
6914,44-15-1-18-0,6776-97-1825,SNGL FAM SUB,10.93,AC,200100,0,200100,0,0,200100,178200,0,178200,0,0,178200,A2,AG/LTD,,,
6915,44-15-1-19-0,6776-97-6909,SNGL FAM SUB,13.87,AC,238000,0,238000,392300,59000,689300,212000,0,212000,366400,54500,632900,A2,AG/LTD,,,
6917,44-15-1-22-0,6786-08-0280,SNGL FAM SUB,10.58,AC,195600,0,195600,267100,4200,466900,174200,0,174200,235800,4500,414500,A2,AG/LTD,,,
6918,44-15-1-23-0,6786-08-5377,SNGL FAM SUB,10.45,AC,193900,0,193900,346100,31600,571600,172700,0,172700,299700,28300,500700,A2,AG/LTD,,,
6919,44-15-1-24-0,6786-19-0117,SNGL FAM SUB,14.1,AC,241000,0,241000,466300,36400,743700,214700,0,214700,399200,34100,648000,A2,AG/LTD,,,
6920,44-15-1-25-0,6786-18-3694,SNGL FAM SUB,15.33,AC,266100,0,266100,0,108900,375000,228800,0,228800,0,86000,314800,A2,AG/LTD,,,
6921,44-15-1-26-0,6786-18-8302,SNGL FAM SUB,11.34,AC,205400,0,205400,1030800,0,1236200,182900,0,182900,900500,0,1083400,A2,AG/LTD,,,
6922,44-15-2-4-0,6776-76-6826,SNGL FAM SUB,12.47,AC,227400,0,227400,0,0,227400,195900,0,195900,0,0,195900,A2,AG/LTD,,,
6923,44-15-2-5-0,6776-76-0729,SNGL FAM SUB,19.75,AC,313900,0,313900,491700,90300,895900,279600,0,279600,426400,110100,816100,A2,AG/LTD,,,
6924,44-15-2-6-0,6776-66-5885,SNGL FAM SUB,16,AC,265500,0,265500,0,0,265500,236500,0,236500,0,0,236500,A2,AG/LTD,,,
6925,44-15-2-7-0,6776-67-2063,SNGL FAM SUB,13.26,AC,230200,0,230200,0,0,230200,205000,0,205000,0,0,205000,A2,AG/LTD,,,
6926,44-15-2-8-0,6776-57-9460,SNGL FAM SUB,12.94,AC,226000,0,226000,0,3900,229900,201300,0,201300,0,3900,205200,A2,AG/LTD,,,
6927,44-15-2-14-0,6776-69-1286,SNGL FAM SUB,8.22,AC,165100,0,165100,330100,0,495200,147000,0,147000,296800,0,443800,A2,AG/LTD,,,
6928,44-15-2-15-0,6776-69-5054,SNGL FAM SUB,10.66,AC,196600,0,196600,0,0,196600,175100,0,175100,0,0,175100,A2,AG/LTD,,,
6929,44-15-2-16-0,6776-68-3127,SNGL FAM SUB,10,AC,188100,0,188100,469800,8000,665900,167500,0,167500,404700,3800,576000,A2,AG/LTD,,,
6930,44-15-2-17-0,6776-68-8582,SNGL FAM SUB,12.94,AC,226000,0,226000,0,0,226000,201300,0,201300,0,0,201300,A2,AG/LTD,,,
6931,44-15-2-18-0,6776-78-2414,SNGL FAM SUB,13.91,AC,238500,0,238500,595900,0,834400,212500,0,212500,525000,0,737500,A2,AG/LTD,,,
6932,44-15-2-19-0,6776-78-5225,SNGL FAM SUB,13.48,AC,233000,0,233000,0,55100,288100,207500,0,207500,0,47400,254900,A2,AG/LTD,,,
6933,44-15-2-20-0,6776-78-8248,SNGL FAM SUB,14.23,AC,242700,0,242700,308500,2900,554100,216100,0,216100,266300,2400,484800,A2,AG/LTD,,,
6934,44-21-0-D-1,6786-37-2786,Roads,1.09,AC,0,0,0,0,0,0,0,0,0,0,0,0,A2,AG/LTD,,,
6935,55-9-0-1-0,6786-26-3399,SNGL FAM SUB,8.9,AC,173900,0,173900,237000,12900,423800,154900,0,154900,202900,12300,370100,A2,AG/LTD,,,
6936,55-9-0-2-0,6786-16-3373,SNGL FAM SUB,9.27,AC,184000,0,184000,286200,3100,473300,159100,0,159100,246900,3100,409100,A2,AG/LTD,,,
6937,55-9-0-3-0,6786-26-1639,SNGL FAM SUB,8.71,AC,171500,0,171500,404200,5400,581100,152700,0,152700,333300,0,486000,A2,AG/LTD,,,
6938,55-22-0-1-0,6776-74-5982,SNGL FAM SUB,18.43,AC,296800,0,296800,949900,190100,1436800,274500,0,274500,851100,172800,1298400,A2,AG/LTD,,,
6939,55-22-0-2-0,6776-75-7910,SNGL FAM SUB,16.87,AC,287000,0,287000,0,0,287000,255600,0,255600,0,0,255600,A2,AG/LTD,,,
6940,55-22-0-3-0,6776-75-1944,AG 20-100 AC,20.41,AC,334900,0,334900,1044400,175100,1554400,298400,0,298400,947600,168600,1414600,A2,AG/LTD,,,
6941,46-1-0-70-0,7707-61-2933,SNGL FAM SUB,1.05,AC,100100,0,100100,198500,28500,327100,89400,0,89400,170500,24100,284000,RR,RES/RUR,,,
6943,5-1-0-76-0,6823-66-1340,SNGL FAM SUB,17.179,AC,114000,33800,80200,177500,15200,306700,111800,33300,78500,155700,13800,281300,A1,AG/GEN,,,
6944,9-1-0-40-0,5892-31-3142,SNGL FAM SUB,5.83,AC,53400,0,53400,9500,0,62900,52200,0,52200,9400,0,61600,A1,AG/GEN,,,
6945,59-1-0-8-0,7726-66-3941,MultiFamily,1.008,AC,686500,0,686500,40100,1900,728500,686500,0,686500,31900,1900,720300,R3,RES/GEN,,,
6946,59-1-0-9-0,7726-66-5975,MultiFamily,3.379,AC,2148500,0,2148500,0,0,2148500,2148500,0,2148500,0,0,2148500,R3,RES/GEN,,,
6947,47-1-0-94-0,7727-11-8096,SNGL FAM SUB,1.49,AC,107300,0,107300,147600,14300,269200,95800,0,95800,124200,12800,232800,A2,AG/LTD,,,
6948,19-4-0-C-1,6830-25-3774,SNGL FAM SUB,1,AC,23500,0,23500,0,0,23500,22400,0,22400,0,0,22400,A1,AG/GEN,,,
6949,19-4-0-C-2,6830-46-1785,SNGL FAM SUB,5,AC,84300,0,84300,365800,9500,459600,68700,0,68700,305200,9500,383400,A1,AG/GEN,,,
6950,31-1-0-57-0,6769-96-2727,SNGL FAM SUB,2.05,AC,74000,0,74000,175300,0,249300,67700,0,67700,150000,0,217700,A2,AG/LTD,,,
6951,59-1-0-7-0,7726-66-2904,MultiFamily,0.929,AC,633700,0,633700,16300,2800,652800,633700,0,633700,12900,2300,648900,R3,RES/GEN,,,
6952,47-1-0-9-0,7717-23-4784,SNGL FAM SUB,1.9,AC,106700,0,106700,85900,300,192900,95200,0,95200,71400,300,166900,A2,AG/LTD,,,
6953,64-15-B-1-0,7733-27-9630,SNGL FAM SUB,0,AC,265000,0,265000,654800,32400,952200,220000,0,220000,549600,30900,800500,R1,RES/LTD,,,
6954,47-1-0-27-0,7716-57-7898,SNGL FAM SUB,3.82,AC,163300,0,163300,114000,6100,283400,145900,0,145900,97000,6200,249100,A2,AG/LTD,,,
6955,31-1-0-56-0,6769-87-9199,SNGL FAM SUB,2.5,AC,79400,0,79400,71900,0,151300,73100,0,73100,61800,0,134900,A2,AG/LTD,,,
6956,31-1-0-60-0,6779-16-5879,SNGL FAM SUB,11.08,AC,140500,0,140500,0,1500,142000,125200,0,125200,0,1500,126700,A2,AG/LTD,,,
6958,9-1-0-34-0,5892-54-5046,SNGL FAM SUB,3.804,AC,48900,0,48900,0,0,48900,47800,0,47800,0,0,47800,A1,AG/GEN,,,
6959,26-8-0-7-0,6708-92-0627,SNGL FAM SUB,3.002,AC,20900,0,20900,0,0,20900,20500,0,20500,0,0,20500,A1,AG/GEN,,,
6960,26-8-0-5-0,6708-92-3266,SNGL FAM SUB,3.987,AC,55500,0,55500,161900,3600,221000,54400,0,54400,137200,3700,195300,A1,AG/GEN,,,
6961,46-1-0-35-A,7707-42-9607,SNGL FAM SUB,1.67,AC,114300,0,114300,278100,17200,409600,102100,0,102100,230000,17200,349300,RR,RES/RUR,,,
6962,46-1-0-35-B,7707-42-8560,SNGL FAM SUB,0.33,AC,7300,0,7300,0,0,7300,6500,0,6500,0,0,6500,RR,RES/RUR,,,
6963,10-1-0-17-A,6801-42-7993,SNGL FAM SUB,2,AC,43400,0,43400,60900,300,104600,42500,0,42500,53900,300,96700,A1,AG/GEN,,,
6964,58-1-0-45-D,7715-84-8787,SNGL FAM SUB,11.56,AC,328800,0,328800,189100,24200,542100,286200,0,286200,159600,20100,465900,A2,AG/LTD,,,
6966,9-1-0-62-A,5891-79-9120,SNGL FAM SUB,1.68,AC,41200,0,41200,97200,1300,139700,40400,0,40400,84800,1300,126500,A1,AG/GEN,,,
6967,30-1-0-69-0,6759-80-5611,SNGL FAM SUB,3.9,AC,83500,0,83500,102400,2000,187900,75100,0,75100,85500,2000,162600,A2,AG/LTD,,,
6968,5-5-0-F-0,6823-56-7764,SNGL FAM SUB,14.491,AC,101600,0,101600,129000,6600,237200,99700,0,99700,105500,4800,210000,A1,AG/GEN,,,
6969,47-1-0-95-0,7727-21-0116,SNGL FAM SUB,2.1,AC,117700,0,117700,142800,1500,262000,105100,0,105100,119300,1500,225900,A2,AG/LTD,,,
6970,15-1-0-38-0,5789-38-5625,SNGL FAM SUB,16.64,AC,79000,0,79000,220300,12800,312100,77100,0,77100,209900,17000,304000,A1,AG/GEN,,,
6971,58-1-0-44-0,7715-73-7104,SNGL FAM SUB,2.98,AC,154200,0,154200,219800,67800,441800,134000,0,134000,186500,62400,382900,A2,AG/LTD,,,
6972,63-1-0-151-0,7714-79-4421,SNGL FAM SUB,2.5,AC,84800,0,84800,0,0,84800,73800,0,73800,0,0,73800,A2,AG/LTD,,,
6973,58-1-0-45-E,7715-84-2281,SNGL FAM SUB,2.51,AC,144600,0,144600,126600,3000,274200,125700,0,125700,107900,3000,236600,A2,AG/LTD,,,
6974,58-1-0-45-0,7715-84-5317,SNGL FAM SUB,3.81,AC,187700,0,187700,19000,200,206900,163300,0,163300,15900,200,179400,A2,AG/LTD,,,
6975,47-23-0-3-0,7717-22-6943,SNGL FAM SUB,2,AC,110000,0,110000,169800,4500,284300,98200,0,98200,142500,4500,245200,A2,AG/LTD,,,
6976,16-1-0-30-0,5890-20-9843,SNGL FAM SUB,18,AC,46000,0,46000,0,0,46000,45000,0,45000,0,0,45000,A1,AG/GEN,,,
6977,58-22-A-14-0,7715-38-4041,SNGL FAM SUB,2.81,AC,460800,0,460800,0,0,460800,422400,0,422400,0,0,422400,A2,AG/LTD,,,
6978,12-16-0-4-0,6822-90-3263,SNGL FAM SUB,10,AC,91700,0,91700,0,0,91700,90800,0,90800,0,0,90800,A1,AG/GEN,,,
6979,12-16-0-5-0,6822-90-3034,SNGL FAM SUB,10,AC,91700,0,91700,0,0,91700,90800,0,90800,0,0,90800,A1,AG/GEN,,,
6980,47-1-0-91-0,7726-28-5901,COMM & IND,73.019,AC,16221500,9305800,6915700,406500,66200,16694200,14745500,8459200,6286300,384800,53500,15183800,B1A2,BS AND,,,
6981,42-16-B-3-0,6757-93-4543,SNGL FAM SUB,0.982,AC,40800,0,40800,0,0,40800,37000,0,37000,0,0,37000,R1,RES/LTD,,,
6982,47-1-0-92-B,7727-20-4241,SNGL FAM SUB,1.56,AC,31900,31200,700,0,0,31900,29000,28300,700,0,0,29000,A2,AG/LTD,,,
6984,32-1-0-60-0,6789-04-5735,SNGL FAM SUB,2.96,AC,92300,0,92300,206300,6000,304600,82500,0,82500,169000,6000,257500,A2,AG/LTD,,,
6986,60-1-0-7-0,6784-47-5728,AG 20-100 AC,56.5,AC,192100,166100,26000,0,0,192100,169500,145500,24000,0,0,169500,A2,AG/LTD,,,
6987,47-1-0-92-C,7727-20-4061,SNGL FAM SUB,2.29,AC,152600,151500,1100,0,0,152600,138700,137700,1000,0,0,138700,A2,AG/LTD,,,
6988,47-1-0-73-0,7726-08-8747,COMM & IND,1.02,AC,361700,0,361700,0,0,361700,328800,0,328800,0,0,328800,A2,AG/LTD,,,
6989,47-1-0-71-A,7727-21-2126,SNGL FAM SUB,0.92,AC,91100,0,91100,83400,200,174700,81300,0,81300,67400,200,148900,A2,AG/LTD,,,
6990,47-1-0-98-0,7727-20-9697,AG 20-100 AC,23.26,AC,2328600,0,2328600,221800,46900,2597300,2117100,0,2117100,0,281800,2398900,A2,AG/LTD,,,
6991,57-2-0-2-0,7716-16-5277,SNGL FAM SUB,1.07,AC,100600,0,100600,266900,5500,373000,89800,0,89800,232500,3800,326100,A2,AG/LTD,,,
6992,57-2-0-3-0,7716-16-7210,SNGL FAM SUB,1.313,AC,106100,0,106100,235900,2000,344000,94800,0,94800,204400,2000,301200,A2,AG/LTD,,,
6993,57-2-0-4-0,7716-16-9102,SNGL FAM SUB,2.636,AC,136300,0,136300,0,0,136300,121800,0,121800,0,0,121800,A2,AG/LTD,,,
6994,57-2-0-6-0,7716-16-7673,SNGL FAM SUB,2.843,AC,141000,0,141000,224700,2000,367700,126000,0,126000,193200,2000,321200,A2,AG/LTD,,,
6996,57-2-0-8-0,7716-16-5627,SNGL FAM SUB,1.292,AC,105700,0,105700,165500,1000,272200,94400,0,94400,146900,1000,242300,A2,AG/LTD,,,
6997,47-1-0-91-A,7726-38-0119,SNGL FAM SUB,16.34,AC,4238800,3508100,730700,500700,173700,4913200,3853500,3725600,127900,457500,145000,4456000,A2,AG/LTD,,,
6998,45-1-0-47-C,6796-27-3077,SNGL FAM SUB,4.04,AC,132900,0,132900,223900,25300,382100,118500,0,118500,181800,25300,325600,A2,AG/LTD,,,
6999,47-1-0-64-0,7727-18-4477,SNGL FAM SUB,12.238,AC,255400,0,255400,0,0,255400,236400,0,236400,0,0,236400,RR,RES/RUR,,,
7000,47-1-0-69-0,7727-17-6454,AG 20-100 AC,36.53,AC,1579700,0,1579700,0,0,1579700,1505800,0,1505800,0,0,1505800,M2,INDUS/G,,,
7001,47-1-0-104-0,7727-35-3830,AG 20-100 AC,54,AC,4826600,4143500,683100,0,0,4826600,4595900,3946800,649100,0,0,4595900,M2,INDUS/G,,,
7002,47-1-0-106-0,7727-26-8637,SNGL FAM SUB,17,AC,905800,316900,588900,0,0,905800,863300,302100,561200,0,0,863300,A2,AG/LTD,,,
7004,48-7-0-A-0,7728-52-8398,AG 20-100 AC,90,AC,1440000,1396500,43500,0,0,1440000,1287000,1248500,38500,0,0,1287000,A2,AG/LTD,,,
7005,47-1-0-60-0,7718-91-6185,SNGL FAM SUB,6.859,AC,198600,0,198600,402600,13700,614900,177500,0,177500,362600,12000,552100,A2,AG/LTD,,,
7006,18-1-0-9-0,6810-58-4100,AG 20-100 AC,72.75,AC,194000,160500,33500,0,0,194000,196400,165500,30900,0,0,196400,A1,AG/GEN,,,
7007,6-1-0-22-A,6833-13-4010,SNGL FAM SUB,1.97,AC,5000,0,5000,0,0,5000,4900,0,4900,0,0,4900,A1,AG/GEN,,,
7008,6-1-0-23-B,6833-10-2742,COMM & IND,1.05,AC,54800,0,54800,0,0,54800,53200,0,53200,0,0,53200,B1A1,BS & AG,,,
7009,11-1-0-9-0,6821-09-8766,AG 20-100 AC,35,AC,169100,153000,16100,0,0,169100,166300,151400,14900,0,0,166300,A1,AG/GEN,,,
7010,11-1-0-10-0,6821-29-3064,SNGL FAM SUB,3,AC,52000,50500,1500,0,0,52000,51000,49700,1300,0,0,51000,A1,AG/GEN,,,
7011,11-1-0-12-0,6821-18-3455,AG 20-100 AC,63.7,AC,285300,255200,30100,0,160200,445500,286700,259500,27200,0,123200,409900,A1,AG/GEN,,,
7012,11-17-0-A-0,6821-39-0272,SNGL FAM SUB,8.33,AC,84500,36800,47700,172900,0,257400,80500,29800,50700,145500,0,226000,A1,AG/GEN,,,
7013,11-1-0-13-0,6821-08-3564,SNGL FAM SUB,1,AC,38800,0,38800,0,0,38800,38000,0,38000,0,0,38000,A1,AG/GEN,,,
7014,6-1-0-22-0,6833-12-0021,AG 20-100 AC,26.82,AC,150800,138400,12400,0,0,150800,147800,136400,11400,0,0,147800,A1,AG/GEN,,,
7015,6-1-0-23-0,6833-11-4257,COMM & IND,12.06,AC,712700,707100,5600,0,0,712700,692300,687200,5100,0,0,692300,B1A1,BS & AG,,,
7016,6-1-0-23-A,6833-10-9297,COMM & IND,20.94,AC,323600,313900,9700,0,0,323600,314600,305700,8900,0,0,314600,B1A1,BS & AG,,,
7017,11-1-0-6-0,6822-20-5360,AG 20-100 AC,35.3,AC,181300,164400,16900,0,0,181300,176500,161400,15100,0,0,176500,A1,AG/GEN,,,
7018,12-1-0-1-0,6822-76-5911,AG 20-100 AC,27.484,AC,153600,140900,12700,0,0,153600,150600,138900,11700,0,0,150600,A1,AG/GEN,,,
7019,11-1-0-14-0,6811-97-9805,AG 20-100 AC,36,AC,166300,149100,17200,0,0,166300,162000,146700,15300,0,0,162000,A1,AG/GEN,,,
7020,11-1-0-17-0,6811-87-7968,SNGL FAM SUB,11,AC,94800,89400,5400,0,0,94800,93000,88300,4700,0,0,93000,A1,AG/GEN,,,
7021,11-1-0-22-0,6811-86-0721,AG 20-100 AC,50,AC,185200,161800,23400,0,0,185200,183600,162300,21300,0,0,183600,A1,AG/GEN,,,
7022,11-1-0-22-A,6811-66-9734,SNGL FAM SUB,9,AC,83600,40800,42800,80500,0,164100,82000,40500,41500,70700,0,152700,A1,AG/GEN,,,
7023,11-1-0-28-0,6811-55-9812,AG 20-100 AC,60.41,AC,248400,179500,68900,206800,364400,819600,245900,182400,63500,187000,341800,774700,A1,AG/GEN,,,
7024,11-1-0-28-A,6811-75-1458,AG 20-100 AC,38.66,AC,170500,152100,18400,0,0,170500,170500,154000,16500,0,0,170500,A1,AG/GEN,,,
7025,10-1-0-44-0,6811-44-4121,AG 20-100 AC,29.2,AC,88300,74800,13500,0,0,88300,87600,75200,12400,0,0,87600,A1,AG/GEN,,,
7026,11-1-0-29-0,6811-54-2451,AG 20-100 AC,25.5,AC,162300,112000,50300,15300,0,177600,160500,112100,48400,15500,0,176000,A1,AG/GEN,,,
7027,11-1-0-16-0,6811-79-8673,AG 20-100 AC,48.857,AC,179900,154100,25800,0,0,179900,181300,157300,24000,0,0,181300,A1,AG/GEN,,,
7028,2-1-0-3-A,6814-54-2385,SNGL FAM SUB,1.058,AC,40000,0,40000,205500,8600,254100,39300,0,39300,177600,7800,224700,A1,AG/GEN,,,
7029,18-1-0-3-0,6811-92-5401,AG 20-100 AC,86.556,AC,266100,225100,41000,0,0,266100,259700,222800,36900,0,0,259700,A1,AG/GEN,,,
7030,11-1-0-15-0,6811-98-9925,SNGL FAM SUB,7,AC,72400,0,72400,319400,800,392600,74000,0,74000,282100,800,356900,A1,AG/GEN,,,
7031,58-1-0-50-A,7715-62-3600,SNGL FAM SUB,3.01,AC,137400,0,137400,66800,0,204200,119500,0,119500,56900,0,176400,A2,AG/LTD,,,
7050,67-6-0-1-A,7733-45-4070,SNGL FAM SUB,14.6,AC,517300,473600,43700,0,0,517300,449900,411600,38300,0,0,449900,A2,AG/LTD,,,
7051,11-1-0-53-A,6822-44-7855,AG 20-100 AC,59.6,AC,237300,209800,27500,0,0,237300,232700,207400,25300,0,0,232700,A1,AG/GEN,,,
7052,7-1-0-7-A,6842-28-3082,AG 20-100 AC,62.775,AC,226600,197700,28900,0,0,226600,222200,195500,26700,0,0,222200,A1,AG/GEN,,,
7053,13-1-0-46-0,6841-43-1958,AG > 100 AC,221.2,AC,570400,466300,104100,0,0,570400,559200,463600,95600,0,0,559200,A1,AG/GEN,,,
7054,13-9-0-3-0,6841-74-1195,SNGL FAM SUB,4.72,AC,81500,79300,2200,0,0,81500,79900,77900,2000,0,0,79900,A1,AG/GEN,,,
7055,17-1-0-13-0,6709-57-4114,AG 20-100 AC,60.06,AC,180000,152300,27700,0,0,180000,175100,149600,25500,0,0,175100,A1,AG/GEN,,,
7056,17-1-0-38-0,6800-79-9759,AG > 100 AC,161.5,AC,482200,407700,74500,0,0,482200,468900,400300,68600,0,0,468900,A1,AG/GEN,,,
7057,25-3-0-2-0,6709-13-6126,AG 20-100 AC,53.71,AC,128300,103500,24800,0,0,128300,124300,101500,22800,0,0,124300,A1,AG/GEN,,,
7058,26-1-0-1-0,6709-36-7652,AG 20-100 AC,59.56,AC,178100,150600,27500,0,0,178100,178700,153400,25300,0,0,178700,A1,AG/GEN,,,
7059,28-1-0-105-0,6738-65-6464,AG > 100 AC,177.752,AC,767300,685400,81900,0,0,767300,751900,676400,75500,0,0,751900,A1,AG/GEN,,,
7060,19-3-0-2-0,6830-07-4216,AG 20-100 AC,25,AC,145100,133600,11500,0,0,145100,142500,131900,10600,0,0,142500,A1,AG/GEN,,,
7061,1-1-0-22-A,6804-77-7668,SNGL FAM SUB,0.393,AC,2000,0,2000,0,0,2000,2000,0,2000,0,0,2000,A1,AG/GEN,,,
7062,1-1-0-22-C,6804-77-4369,SNGL FAM SUB,10.422,AC,87800,0,87800,0,0,87800,86100,0,86100,0,0,86100,A1,AG/GEN,,,
7063,4-1-0-34-0,6803-87-5276,SNGL FAM SUB,2.516,AC,47400,0,47400,157300,6000,210700,46600,0,46600,138800,6000,191400,A1,AG/GEN,,,
7064,9-1-0-90-0,6801-37-2593,AG 20-100 AC,73.5,AC,150800,116900,33900,0,0,150800,147000,115800,31200,0,0,147000,A1,AG/GEN,,,
7065,25-1-0-3-0,5799-51-8881,AG > 100 AC,500.926,AC,242600,0,242600,0,13500,256100,214100,0,214100,0,13500,227600,A1,AG/GEN,,,
7066,47-26-0-7-0,7717-99-5265,SNGL FAM SUB,2.379,AC,112500,0,112500,211000,3500,327000,100600,0,100600,180700,3500,284800,A2,AG/LTD,,,
7067,45-18-0-25-0,6797-33-2315,SNGL FAM SUB,4.727,AC,200000,0,200000,555000,79200,834200,180000,0,180000,508600,73900,762500,A2,AG/LTD,,,
7068,45-18-0-32-0,6797-53-1833,SNGL FAM SUB,4.188,AC,200000,0,200000,258100,62300,520400,180000,0,180000,234900,57800,472700,A2,AG/LTD,,,
7069,4-2-0-13-0,6814-40-4824,SNGL FAM SUB,3.3,AC,51900,0,51900,189800,500,242200,50800,0,50800,165600,500,216900,A1,AG/GEN,,,
7070,18-6-0-1-B,6810-99-6306,SNGL FAM SUB,2.85,AC,51100,0,51100,28200,0,79300,49100,0,49100,22900,0,72000,A1,AG/GEN,,,
7071,28-1-0-24-0,6728-98-9364,SNGL FAM SUB,5.48,AC,70100,0,70100,0,0,70100,67300,0,67300,0,0,67300,A1,AG/GEN,,,
7072,28-1-0-29-0,6738-08-6103,SNGL FAM SUB,0.68,AC,13600,0,13600,0,0,13600,13400,0,13400,0,0,13400,A1,AG/GEN,,,
7074,27-7-0-2-C,6718-69-8971,SNGL FAM SUB,4.575,AC,58800,0,58800,155200,24600,238600,57700,0,57700,132200,24600,214500,A1,AG/GEN,,,
7075,30-1-0-104-B,6758-99-4452,SNGL FAM SUB,1.45,AC,59600,0,59600,188600,1000,249200,54600,0,54600,157100,1000,212700,A2,AG/LTD,,,
7076,42-23-0-12-0,6767-32-3884,SNGL FAM SUB,2.803,AC,87900,0,87900,174700,1000,263600,78500,0,78500,142600,1000,222100,A2,AG/LTD,,,
7077,38-9-0-1-0,6716-67-6119,AG > 100 AC,232.01,AC,793500,684300,109200,0,0,793500,771400,672500,98900,0,0,771400,A1,AG/GEN,,,
7078,38-9-0-2-0,6716-07-8689,AG > 100 AC,445.27,AC,1674500,1448900,225600,0,28800,1703300,1635800,1444400,191400,0,28800,1664600,A1,AG/GEN,,,
7079,38-9-0-3-0,6706-86-0790,AG > 100 AC,110.631,AC,500700,370900,129800,713300,1000,1215000,488700,372300,116400,650500,1000,1140200,A1,AG/GEN,,,
7081,49-1-0-2-0,6716-45-2918,AG > 100 AC,315,AC,1449000,1302600,146400,0,0,1449000,1417500,1283500,134000,0,0,1417500,A1,AG/GEN,,,
7082,49-2-0-4-0,6716-33-8505,AG > 100 AC,111.308,AC,53600,0,53600,0,0,53600,47500,0,47500,0,0,47500,A1,AG/GEN,,,
7083,49-2-0-5-0,6716-11-7518,AG > 100 AC,751.45,AC,370200,0,370200,0,0,370200,321800,0,321800,0,0,321800,A1,AG/GEN,,,
7084,50-1-0-8-A,6715-89-2121,AG > 100 AC,104.98,AC,49600,0,49600,0,0,49600,44700,0,44700,0,0,44700,A1,AG/GEN,,,
7085,48-3-G-2-0,7726-57-3941,SNGL FAM SUB,0,AC,130000,0,130000,149400,22600,302000,117000,0,117000,131600,19200,267800,R1,RES/LTD,,,
7086,21-1-0-27-0,6759-17-7861,SNGL FAM SUB,2.21,AC,66000,0,66000,249900,21200,337100,62500,0,62500,209200,20000,291700,A2,AG/LTD,,,
7087,62-13-A-9-0,7714-05-8901,SNGL FAM SUB,0,AC,115000,0,115000,257900,1000,373900,100000,0,100000,237000,1000,338000,R1,RES/LTD,,,
7088,12-8-0-13-0,6832-76-5969,SNGL FAM SUB,5.65,AC,90700,0,90700,371500,3000,465200,88800,0,88800,313600,3000,405400,A1,AG/GEN,,,
7089,44-21-0-A-0,6786-19-8278,SNGL FAM SUB,10.67,AC,186100,0,186100,0,0,186100,166100,0,166100,0,0,166100,A2,AG/LTD,,,
7090,44-21-0-B-0,6786-28-3619,SNGL FAM SUB,2.66,AC,95200,0,95200,774600,34800,904600,85000,0,85000,640600,34500,760100,A2,AG/LTD,,,
7091,44-21-0-C-0,6786-28-6203,SNGL FAM SUB,3.6,AC,109400,0,109400,292600,0,402000,97700,0,97700,239900,0,337600,A2,AG/LTD,,,
7092,44-21-0-D-0,6786-37-1848,SNGL FAM SUB,3.6,AC,109400,0,109400,343200,0,452600,97700,0,97700,279500,0,377200,A2,AG/LTD,,,
7093,44-21-0-E-0,6786-27-9561,SNGL FAM SUB,3.054,AC,101100,0,101100,272400,500,374000,90300,0,90300,223900,500,314700,A2,AG/LTD,,,
7094,44-21-0-F-0,6786-37-0384,SNGL FAM SUB,2.365,AC,90700,0,90700,210400,0,301100,81000,0,81000,172500,0,253500,A2,AG/LTD,,,
7096,38-1-0-125-0,6717-14-7049,AG 20-100 AC,20,AC,92000,0,92000,0,0,92000,90000,0,90000,0,0,90000,A1,AG/GEN,,,
7097,16-1-0-49-0,5890-75-7860,AG 20-100 AC,25,AC,69700,0,69700,0,0,69700,67000,0,67000,0,0,67000,A1,AG/GEN,,,
7098,43-1-0-7-D,6767-57-8740,SNGL FAM SUB,2.94,AC,98000,0,98000,199100,3500,300600,87600,0,87600,162600,3500,253700,A2,AG/LTD,,,
7099,38-1-0-116-B,6717-48-7916,SNGL FAM SUB,5,AC,61200,0,61200,220300,21700,303200,60000,0,60000,193800,21700,275500,A1,AG/GEN,,,
7100,5-1-0-36-0,6813-96-7716,AG 20-100 AC,30.84,AC,182300,0,182300,10000,0,192300,178800,0,178800,10000,0,188800,A1,AG/GEN,,,
7101,5-1-0-23-A,6822-09-2524,SNGL FAM SUB,3,AC,49900,48400,1500,0,0,49900,49000,47700,1300,0,0,49000,A1,AG/GEN,,,
7102,15-5-0-23-0,5789-68-7905,SNGL FAM SUB,8.29,AC,65000,0,65000,256000,2200,323200,63500,0,63500,229200,2400,295100,A1,AG/GEN,,,
7103,13-11-0-C-0,6841-04-6099,AG > 100 AC,147.94,AC,471700,399600,72100,0,11000,482700,465400,402100,63300,0,11000,476400,A1,AG/GEN,,,
7104,13-11-0-A-0,6841-05-9028,SNGL FAM SUB,8.44,AC,73800,35200,38600,91300,4800,169900,68900,30600,38300,82400,4800,156100,A1,AG/GEN,,,
7105,13-11-0-B-2,6841-06-1096,AG > 100 AC,106.97,AC,359700,308300,51400,0,10000,369700,353300,307600,45700,0,10000,363300,A1,AG/GEN,,,
7106,12-12-0-E-0,6831-87-7314,SNGL FAM SUB,2.1,AC,3700,2700,1000,0,0,3700,3700,2800,900,0,0,3700,A1,AG/GEN,,,
7107,13-11-0-D-2,6841-01-7934,AG 20-100 AC,82.31,AC,427200,388900,38300,0,0,427200,408100,373100,35000,0,0,408100,A1,AG/GEN,,,
7108,20-10-0-D-1,6831-91-9646,AG 20-100 AC,22.79,AC,121500,110500,11000,0,0,121500,117300,107500,9800,0,0,117300,A1,AG/GEN,,,
7109,12-12-0-F-0,6831-96-0156,SNGL FAM SUB,5.04,AC,8800,6500,2300,0,0,8800,8800,6700,2100,0,0,8800,A1,AG/GEN,,,
7110,38-1-0-116-A,6717-47-2714,SNGL FAM SUB,1.642,AC,42400,0,42400,0,12200,54600,41500,0,41500,0,10600,52100,A1,AG/GEN,,,
7111,5-4-0-4-0,6813-90-8073,SNGL FAM SUB,4.26,AC,56300,0,56300,0,0,56300,55300,0,55300,0,0,55300,A1,AG/GEN,,,
7113,6-1-0-7-0,6833-04-4269,SNGL FAM SUB,14.757,AC,54800,0,54800,0,0,54800,53700,0,53700,0,0,53700,A1,AG/GEN,,,
7114,27-1-0-56-0,6729-66-5524,AG > 100 AC,140,AC,500700,436200,64500,0,0,500700,493600,434100,59500,0,0,493600,A1,AG/GEN,,,
7115,28-1-0-1-0,6729-85-5820,SNGL FAM SUB,14.7,AC,110700,103900,6800,0,0,110700,107300,101100,6200,0,0,107300,A1,AG/GEN,,,
7116,28-1-0-109-0,6738-59-4054,SNGL FAM SUB,1,AC,11800,11300,500,0,0,11800,11200,10800,400,0,0,11200,A1,AG/GEN,,,
7117,29-1-0-104-0,6749-92-2439,AG 20-100 AC,66.77,AC,452800,422000,30800,0,0,452800,454000,425600,28400,0,0,454000,A1,AG/GEN,,,
7118,29-1-0-119-0,6758-09-7677,AG 20-100 AC,37.55,AC,170700,153400,17300,0,0,170700,168000,152000,16000,0,0,168000,A1,AG/GEN,,,
7119,29-1-0-122-0,6758-08-7167,SNGL FAM SUB,7.65,AC,63500,60000,3500,0,0,63500,61000,57700,3300,0,0,61000,A1,AG/GEN,,,
7120,30-1-0-15-0,6759-32-0571,SNGL FAM SUB,8,AC,85100,81400,3700,0,0,85100,80800,77400,3400,0,0,80800,A1,AG/GEN,,,
7121,30-1-0-17-0,6759-32-6943,SNGL FAM SUB,10.214,AC,118700,114000,4700,0,0,118700,113900,109600,4300,0,0,113900,A1,AG/GEN,,,
7122,30-1-0-18-0,6759-22-4435,SNGL FAM SUB,18,AC,118700,110400,8300,0,0,118700,117300,109600,7700,0,0,117300,A1,AG/GEN,,,
7123,30-1-0-48-0,6758-48-6728,SNGL FAM SUB,15.32,AC,175500,0,175500,0,12400,187900,154400,0,154400,0,12400,166800,A2,AG/LTD,,,
7125,42-1-0-5-0,6757-47-8519,AG 20-100 AC,28.6,AC,317300,302800,14500,0,0,317300,283100,270800,12300,0,0,283100,A2,AG/LTD,,,
7126,42-1-0-7-0,6757-46-2559,SNGL FAM SUB,6.15,AC,116200,59700,56500,10000,9600,135800,103500,51400,52100,10000,8200,121700,A2,AG/LTD,,,
7127,9-1-0-91-0,6801-36-8494,AG 20-100 AC,91.5,AC,187800,145600,42200,0,0,187800,183000,144100,38900,0,0,183000,A1,AG/GEN,,,
7128,10-1-0-10-0,6801-35-9524,SNGL FAM SUB,10.97,AC,77100,72000,5100,0,0,77100,75100,70400,4700,0,0,75100,A1,AG/GEN,,,
7130,42-1-0-6-0,6757-36-5353,SNGL FAM SUB,1,AC,48800,0,48800,99800,400,149000,44100,0,44100,82900,400,127400,A2,AG/LTD,,,
7131,42-1-0-9-0,6757-36-9256,SNGL FAM SUB,2.51,AC,82600,0,82600,253700,200,336500,73200,0,73200,212600,200,286000,A2,AG/LTD,,,
7134,19-1-0-22-A,6729-87-9583,AG > 100 AC,118.42,AC,488200,433600,54600,0,0,488200,472500,422200,50300,0,0,472500,A1,AG/GEN,,,
7135,28-1-0-94-0,6738-49-7242,SNGL FAM SUB,6.5,AC,46600,43600,3000,0,0,46600,44000,41200,2800,0,0,44000,A1,AG/GEN,,,
7136,42-16-A-7-0,6757-94-9286,SNGL FAM SUB,0.949,AC,81500,0,81500,368600,0,450100,74000,0,74000,344700,0,418700,R1,RES/LTD,,,
7137,42-16-A-8-0,6757-94-9481,SNGL FAM SUB,0.963,AC,81500,0,81500,0,0,81500,74000,0,74000,0,0,74000,R1,RES/LTD,,,
7138,28-1-0-95-A,6738-37-4611,AG 20-100 AC,35.1,AC,185700,151100,34600,0,0,185700,182500,143700,38800,0,0,182500,A1,AG/GEN,,,
7139,28-1-0-108-0,6738-47-2612,SNGL FAM SUB,12.53,AC,108900,103100,5800,0,0,108900,106400,101100,5300,0,0,106400,A1,AG/GEN,,,
7140,28-1-0-107-0,6738-58-3072,AG 20-100 AC,48.5,AC,175000,152600,22400,0,0,175000,174600,154000,20600,0,0,174600,A1,AG/GEN,,,
7142,30-1-0-20-0,6759-21-3856,AG 20-100 AC,24.67,AC,138200,126800,11400,0,0,138200,136800,126300,10500,0,0,136800,A1,AG/GEN,,,
7143,42-1-0-10-0,6757-46-0048,SNGL FAM SUB,2.34,AC,68900,0,68900,0,0,68900,62800,0,62800,0,0,62800,A2,AG/LTD,,,
7145,28-1-0-93-0,6738-38-5706,AG 20-100 AC,33.6,AC,141700,126200,15500,0,0,141700,141100,126800,14300,0,0,141100,A1,AG/GEN,,,
7146,26-1-0-49-A,6719-30-9839,SNGL FAM SUB,2,AC,44400,0,44400,115500,0,159900,43500,0,43500,99300,0,142800,A1,AG/GEN,,,
7147,48-2-F-2-0,7726-58-7271,SNGL FAM SUB,0,AC,130000,0,130000,233200,17100,380300,117000,0,117000,210200,14500,341700,R1,RES/LTD,,,
7148,13-11-0-B-1,6841-06-6505,SNGL FAM SUB,8,AC,81100,77100,4000,0,0,81100,80200,76700,3500,0,0,80200,A1,AG/GEN,,,
7149,38-1-0-127-0,6717-13-5149,SNGL FAM SUB,9.017,AC,60200,0,60200,23000,4300,87500,58900,0,58900,24500,4100,87500,A1,AG/GEN,,,
7150,38-1-0-126-0,6717-12-8548,SNGL FAM SUB,13.83,AC,63600,0,63600,0,0,63600,62200,0,62200,0,0,62200,A1,AG/GEN,,,
7151,38-1-0-116-0,6717-48-3533,AG 20-100 AC,20.578,AC,119100,0,119100,86900,900,206900,116300,0,116300,74100,900,191300,A1,AG/GEN,,,
7152,56-9-0-A-0,6785-79-8911,SNGL FAM SUB,8.01,AC,180800,0,180800,767700,90900,1039400,161300,0,161300,646300,78500,886100,A2,AG/LTD,,,
7153,56-9-0-B-0,6785-89-1427,SNGL FAM SUB,12,AC,203000,0,203000,163300,600,366900,181000,0,181000,96400,600,278000,A2,AG/LTD,,,
7154,42-18-0-A-0,6757-48-6177,SNGL FAM SUB,2,AC,69100,0,69100,0,0,69100,61900,0,61900,0,0,61900,A2,AG/LTD,,,
7155,42-18-0-B-0,6757-48-4159,SNGL FAM SUB,2,AC,69100,0,69100,0,0,69100,61900,0,61900,0,0,61900,A2,AG/LTD,,,
7156,30-1-0-98-0,6768-07-1983,AG 20-100 AC,24.05,AC,307700,242100,65600,10000,1100,318800,278100,218300,59800,10000,1100,289200,A2,AG/LTD,,,
7157,42-8-2-2-0,6767-18-8277,SNGL FAM SUB,0,AC,60000,0,60000,128900,3400,192300,55000,0,55000,108500,3400,166900,A2,AG/LTD,,,
7158,5-1-0-23-0,6822-09-3893,SNGL FAM SUB,4,AC,55000,53000,2000,0,0,55000,54000,52300,1700,0,0,54000,A1,AG/GEN,,,
7159,5-1-0-26-0,6823-00-6223,SNGL FAM SUB,12,AC,79000,73000,6000,0,0,79000,77600,72400,5200,0,0,77600,A1,AG/GEN,,,
7160,5-4-0-5-0,6813-90-9529,SNGL FAM SUB,10.14,AC,77700,0,77700,237300,5000,320000,76200,0,76200,204900,5000,286100,A1,AG/GEN,,,
7162,6-1-0-1-0,6824-70-9339,AG 20-100 AC,98.534,AC,302000,256600,45400,0,0,302000,296100,254200,41900,0,0,296100,A1,AG/GEN,,,
7163,17-1-0-42-0,6811-00-7888,AG 20-100 AC,54.61,AC,165600,140400,25200,0,0,165600,164000,140800,23200,0,0,164000,A1,AG/GEN,,,
7164,18-1-0-42-0,6820-22-2786,AG 20-100 AC,50,AC,147900,124800,23100,0,0,147900,150000,128700,21300,0,0,150000,A1,AG/GEN,,,
7165,18-1-0-62-0,6820-15-3301,SNGL FAM SUB,16.43,AC,121100,113500,7600,0,0,121100,122900,115900,7000,0,0,122900,A1,AG/GEN,,,
7166,67-12-0-11-0,7723-45-7761,SNGL FAM SUB,3.02,AC,390000,0,390000,456000,45800,891800,340000,0,340000,399900,45700,785600,R1,RES/LTD,,,
7167,5-1-0-34-0,6813-94-0334,SNGL FAM SUB,18.52,AC,57800,0,57800,0,0,57800,56700,0,56700,0,0,56700,A1,AG/GEN,,,
7168,10-1-0-6-0,6802-64-5404,AG 20-100 AC,38.407,AC,139600,121900,17700,0,0,139600,134400,118100,16300,0,0,134400,A1,AG/GEN,,,
7170,11-1-0-26-0,6821-13-3798,SNGL FAM SUB,1.93,AC,45600,0,45600,8700,20800,75100,44000,0,44000,8100,19200,71300,A1,AG/GEN,,,
7171,11-1-0-25-0,6821-13-4903,SNGL FAM SUB,2,AC,46000,0,46000,14500,500,61000,44500,0,44500,14500,500,59500,A1,AG/GEN,,,
7172,5-13-0-25-0,6813-63-7215,SNGL FAM SUB,8.155,AC,65700,0,65700,0,0,65700,64400,0,64400,0,0,64400,A1,AG/GEN,,,
7173,57-1-0-5-0,7706-54-5527,SNGL FAM SUB,3.8,AC,182000,0,182000,265100,6000,453100,158400,0,158400,222600,6000,387000,A2,AG/LTD,,,
7174,57-1-0-5-A,7706-54-4758,SNGL FAM SUB,0.8,AC,21000,0,21000,0,0,21000,18300,0,18300,0,0,18300,A2,AG/LTD,,,
7175,56-1-0-55-0,6796-46-1993,AG 20-100 AC,35.439,AC,1006300,723200,283100,921900,149200,2077400,874200,628300,245900,867700,126500,1868400,A2,AG/LTD,,,
7176,67-9-0-B-0,7733-24-7728,SNGL FAM SUB,4.2,AC,295800,0,295800,0,0,295800,257100,0,257100,0,0,257100,A2,AG/LTD,,,
7177,45-9-0-C-0,6798-11-2105,SNGL FAM SUB,14.89,AC,267800,0,267800,121200,3700,392700,239400,0,239400,98300,3700,341400,A2,AG/LTD,,,
7178,45-1-0-16-0,6797-19-0682,SNGL FAM SUB,1.96,AC,85300,0,85300,31300,200,116800,76100,0,76100,26400,200,102700,A2,AG/LTD,,,
7180,31-1-0-30-A,6768-96-5370,SNGL FAM SUB,9,AC,160100,0,160100,0,0,160100,142800,0,142800,0,0,142800,A2,AG/LTD,,,
7181,43-1-0-12-B,6767-76-1696,SNGL FAM SUB,1.75,AC,74900,0,74900,152400,0,227300,66900,0,66900,127000,0,193900,A2,AG/LTD,,,
7182,5-1-0-27-0,6823-10-5073,AG 20-100 AC,44.5,AC,114400,91700,22700,0,0,114400,112100,91100,21000,0,0,112100,A1,AG/GEN,,,
7183,43-1-0-13-0,6767-76-0257,SNGL FAM SUB,2.22,AC,81700,0,81700,0,0,81700,72900,0,72900,0,0,72900,A2,AG/LTD,,,
7184,45-1-0-17-0,6797-09-8816,COMM & IND,2.615,AC,287700,0,287700,262000,38800,588500,266500,0,266500,216800,34200,517500,B1,BUS/GEN,,,
7185,43-1-0-12-0,6767-67-5153,SNGL FAM SUB,2.12,AC,62100,0,62100,0,0,62100,55400,0,55400,0,0,55400,A2,AG/LTD,,,
7187,5-1-0-21-0,6822-09-1142,SNGL FAM SUB,3.37,AC,51800,0,51800,0,0,51800,50900,0,50900,0,0,50900,A1,AG/GEN,,,
7188,19-5-0-7-0,6830-10-6203,SNGL FAM SUB,1.029,AC,54200,0,54200,167500,28000,249700,50200,0,50200,140200,24600,215000,A1,AG/GEN,,,
7189,28-1-0-78-A,6739-35-1330,SNGL FAM SUB,2.12,AC,55400,0,55400,213500,2100,271000,53400,0,53400,175700,2300,231400,A1,AG/GEN,,,
7190,28-1-0-73-B,6739-24-5916,SNGL FAM SUB,3,AC,60800,0,60800,134100,700,195600,58300,0,58300,110800,700,169800,A1,AG/GEN,,,
7191,43-1-0-12-A,6767-66-8970,SNGL FAM SUB,2.25,AC,79700,0,79700,105400,1800,186900,71200,0,71200,86300,1800,159300,A2,AG/LTD,,,
7192,28-1-0-78-0,6739-36-5339,SNGL FAM SUB,18.88,AC,144900,0,144900,0,0,144900,146600,0,146600,0,0,146600,A1,AG/GEN,,,
7193,45-1-0-15-0,6797-19-3605,SNGL FAM SUB,1.96,AC,85300,0,85300,0,0,85300,76100,0,76100,0,0,76100,A2,AG/LTD,,,
7194,5-1-0-20-0,6812-87-4947,AG 20-100 AC,31.02,AC,80200,64500,15700,0,0,80200,78600,65300,13300,0,0,78600,A1,AG/GEN,,,
7195,43-1-0-13-A,6767-76-1425,SNGL FAM SUB,1.73,AC,74600,0,74600,108800,1500,184900,66600,0,66600,88600,1500,156700,A2,AG/LTD,,,
7196,5-1-0-21-A,6822-09-6470,SNGL FAM SUB,2.237,AC,46000,0,46000,100800,5900,152700,45200,0,45200,82800,4900,132900,A1,AG/GEN,,,
7197,9-2-0-4-0,6802-32-3206,AG 20-100 AC,89.924,AC,221300,0,221300,296800,134100,652200,215800,0,215800,266500,124500,606800,A1,AG/GEN,,,
7198,26-1-0-2-B,6709-42-8412,SNGL FAM SUB,16.38,AC,120900,73800,47100,166400,42500,329800,122600,78100,44500,141500,37600,301700,A1,AG/GEN,,,
7199,26-1-0-2-C,6709-41-7859,SNGL FAM SUB,8.81,AC,52300,48200,4100,0,0,52300,51200,47500,3700,0,0,51200,A1,AG/GEN,,,
7200,26-1-0-2-0,6709-43-0126,AG 20-100 AC,40.81,AC,174100,102000,72100,20400,5400,199900,166700,98500,68200,16900,5000,188600,A1,AG/GEN,,,
7201,18-8-0-4-0,6820-10-9563,SNGL FAM SUB,2.91,AC,48900,0,48900,186700,7800,243400,47000,0,47000,152500,7000,206500,A1,AG/GEN,,,
7202,14-1-0-7-A,6851-46-1581,AG 20-100 AC,25,AC,140500,0,140500,443700,0,584200,138800,0,138800,380700,0,519500,A1,AG/GEN,,,
7203,27-1-0-44-A,6718-89-3840,SNGL FAM SUB,1.01,AC,38900,0,38900,139600,0,178500,38100,0,38100,119400,0,157500,A1,AG/GEN,,,
7225,64-2-0-7-0,7723-98-6454,COMM & IND,8.631,AC,340300,0,340300,233000,8400,581700,315200,0,315200,222200,8500,545900,R1,RES/LTD,,,
7226,13-1-0-50-B,6841-46-2575,SNGL FAM SUB,5.405,AC,79100,0,79100,263700,2300,345100,75600,0,75600,230700,3500,309800,A1,AG/GEN,,,
7229,48-1-0-36-0,7726-97-4536,AG > 100 AC,107.958,AC,13736000,13686200,49800,0,0,13736000,12697100,12651200,45900,0,0,12697100,A2,AG/LTD,,,
7230,5-1-0-81-0,6823-54-6537,SNGL FAM SUB,9.52,AC,86500,0,86500,116900,4500,207900,84300,0,84300,101000,4500,189800,A1,AG/GEN,,,
7231,5-1-0-81-A,6823-54-4688,SNGL FAM SUB,6.51,AC,71400,0,71400,39900,0,111300,69500,0,69500,35900,0,105400,A1,AG/GEN,,,
7233,63-1-0-149-0,7714-79-2685,SNGL FAM SUB,2.328,AC,81300,0,81300,0,0,81300,70700,0,70700,0,0,70700,A2,AG/LTD,,,
7234,57-1-0-34-0,7706-40-1083,Roads,4.46,AC,0,0,0,0,0,0,0,0,0,0,0,0,A2,AG/LTD,,,
7235,57-1-0-35-0,7705-49-6351,Roads,1.26,AC,0,0,0,0,0,0,0,0,0,0,0,0,A2,AG/LTD,,,
7236,57-1-0-81-A,7706-42-7419,Roads,1.71,AC,0,0,0,0,0,0,0,0,0,0,0,0,A2,AG/LTD,,,
7237,57-3-0-3-B,7706-51-0224,Roads,1.36,AC,0,0,0,0,0,0,0,0,0,0,0,0,A2,AG/LTD,,,
7238,61-3-0-1-A,6795-92-2188,AG 20-100 AC,34.278,AC,1018400,684500,333900,1545800,41900,2606100,886300,595900,290400,1603600,37500,2527400,A2,AG/LTD,,,
7239,63-1-0-149-A,7714-89-3646,SNGL FAM SUB,5.417,AC,144300,0,144300,168200,900,313400,125400,0,125400,144500,900,270800,A2,AG/LTD,,,
7241,55-1-0-42-0,6786-51-4721,AG 20-100 AC,24.94,AC,431600,0,431600,0,81900,513500,385800,0,385800,0,71000,456800,A2,AG/LTD,,,
7242,55-1-0-42-A,6786-52-2117,SNGL FAM SUB,5.75,AC,135700,0,135700,440600,0,576300,121000,0,121000,366300,0,487300,A2,AG/LTD,,,
7243,57-10-0-31-0,7705-67-3090,SNGL FAM SUB,4.01,AC,230000,0,230000,450500,25000,705500,210000,0,210000,324900,17300,552200,A2,AG/LTD,,,
7244,55-1-0-58-0,6786-86-6223,AG 20-100 AC,77.66001,AC,1356900,1067800,289100,742200,1778100,3877200,1212600,956200,256400,618700,1579100,3410400,A2,AG/LTD,,,
7246,61-4-0-B-0,6795-60-0701,AG 20-100 AC,38.46,AC,195000,0,195000,683600,7500,886100,169200,0,169200,584500,5900,759600,RR,RES/RUR,,,
7247,62-1-0-16-0,7714-13-9765,COMM & IND,1,AC,131300,0,131300,152400,11000,294700,119300,0,119300,149700,7700,276700,RO,RES/OF,,,
7249,57-10-0-28-0,7705-86-8786,SNGL FAM SUB,5.21,AC,265000,0,265000,576000,0,841000,240000,0,240000,534200,0,774200,A2,AG/LTD,,,
7250,32-1-0-77-0,6788-32-8409,AG 20-100 AC,21.008,AC,444200,0,444200,633100,53200,1130500,396200,0,396200,519500,48000,963700,A2,AG/LTD,,,
7251,32-1-0-78-0,6788-13-6517,SNGL FAM SUB,1.96,AC,27000,0,27000,0,0,27000,24100,0,24100,0,0,24100,A2,AG/LTD,,,
7252,32-1-0-79-0,6788-03-6858,SNGL FAM SUB,2.33,AC,32200,0,32200,0,0,32200,28700,0,28700,0,0,28700,A2,AG/LTD,,,
7253,30-1-0-58-A,6759-52-0177,SNGL FAM SUB,2.58,AC,69600,0,69600,130600,1400,201600,65500,0,65500,108800,1000,175300,A2,AG/LTD,,,
7254,18-5-0-A-3,6820-52-1380,SNGL FAM SUB,17.22,AC,128300,0,128300,191900,2000,322200,127200,0,127200,162600,2000,291800,A1,AG/GEN,,,
7255,67-17-0-B-0,7733-13-2510,SNGL FAM SUB,6.28,AC,373600,0,373600,0,0,373600,324700,0,324700,0,0,324700,A2,AG/LTD,,,
7257,4-1-0-40-0,6803-79-8296,AG > 100 AC,160.66,AC,735800,622700,113100,133100,7400,876300,717600,618200,99400,117700,9600,844900,A1,AG/GEN,,,
7258,67-2-D-3-0,7723-55-7713,SNGL FAM SUB,0,AC,184000,0,184000,303700,500,488200,160000,0,160000,253400,500,413900,R1,RES/LTD,,,
7259,58-3-B-5-0,7726-17-2051,SNGL FAM SUB,0,AC,88000,0,88000,147300,13600,248900,80000,0,80000,122500,12000,214500,RN,RESIDEN,,,
7261,42-11-0-2-0,6757-49-2161,SNGL FAM SUB,6.417,AC,118600,0,118600,172000,4100,294700,106200,0,106200,141900,4100,252200,A2,AG/LTD,,,
7262,5-1-0-73-A,6823-37-5450,SNGL FAM SUB,3.979,AC,54900,53100,1800,0,0,54900,53900,52200,1700,0,0,53900,A1,AG/GEN,,,
7263,67-2-E-2-0,7723-65-2801,SNGL FAM SUB,0,AC,184000,0,184000,339200,500,523700,160000,0,160000,290100,500,450600,R1,RES/LTD,,,
7264,58-21-A-12-0,7716-33-7873,SNGL FAM SUB,1.304,AC,310000,0,310000,239300,0,549300,285000,0,285000,214000,0,499000,A2,AG/LTD,,,
7265,47-17-0-A-6B,7717-29-8546,SNGL FAM SUB,5.17,AC,169900,0,169900,194000,5500,369400,151800,0,151800,171300,5500,328600,A2,AG/LTD,,,
7266,50-5-0-35-0,6726-23-6303,SNGL FAM SUB,4.52,AC,55000,0,55000,0,0,55000,52700,0,52700,0,0,52700,A1,AG/GEN,,,
7267,60-1-0-8-0,6784-67-9762,AG 20-100 AC,40,AC,136000,0,136000,0,0,136000,120000,0,120000,0,0,120000,A2,AG/LTD,,,
7268,50-1-0-9-0,6716-91-1643,AG > 100 AC,138.7,AC,377600,0,377600,0,0,377600,371100,0,371100,0,0,371100,A1,AG/GEN,,,
7269,50-1-0-10-0,6726-11-4116,AG > 100 AC,220.35,AC,627500,0,627500,0,0,627500,616100,0,616100,0,0,616100,A1,AG/GEN,,,
7270,63-1-0-193-0,7723-19-2454,SNGL FAM SUB,12.304,AC,516400,510700,5700,0,0,516400,448900,443700,5200,0,0,448900,R1A2,RES LTD,,,
7271,45-1-0-51-0,6796-38-2768,AG 20-100 AC,72.195,AC,953000,0,953000,0,0,953000,851900,0,851900,0,0,851900,A2,AG/LTD,,,
7272,45-1-0-51-A,6796-38-8295,SNGL FAM SUB,7.7,AC,167900,0,167900,0,0,167900,149900,0,149900,0,0,149900,A2,AG/LTD,,,
7273,58-18-E-6-0,7715-29-5349,SNGL FAM SUB,1.947,AC,427500,0,427500,1780100,7200,2214800,391400,0,391400,1670200,7200,2068800,A2,AG/LTD,,,
7277,45-1-0-42-0,6786-98-8433,SNGL FAM SUB,18.69,AC,362200,0,362200,0,0,362200,323200,0,323200,0,0,323200,A2,AG/LTD,,,
7278,42-1-0-74-0,6758-91-2101,SNGL FAM SUB,3.392,AC,83000,0,83000,190200,800,274000,78600,0,78600,158600,1500,238700,A2,AG/LTD,,,
7279,41-2-0-21-0,6748-41-7541,SNGL FAM SUB,1.75,AC,61500,0,61500,161500,29600,252600,57000,0,57000,132700,25100,214800,A1,AG/GEN,,,
7280,41-2-0-24-0,6748-41-3559,SNGL FAM SUB,3.26,AC,76000,0,76000,231400,3600,311000,69800,0,69800,191300,3600,264700,A1,AG/GEN,,,
7281,3-1-0-9-0,5892-89-5019,SNGL FAM SUB,3.441,AC,50400,0,50400,132500,5400,188300,49000,0,49000,113900,5500,168400,A1,AG/GEN,,,
7282,3-1-0-10-0,5892-89-6723,SNGL FAM SUB,3.68,AC,51300,0,51300,0,0,51300,50100,0,50100,0,0,50100,A1,AG/GEN,,,
7283,3-1-0-11-0,5892-89-5417,SNGL FAM SUB,6.116,AC,60600,0,60600,174300,41100,276000,61000,0,61000,151200,33500,245700,A1,AG/GEN,,,
7285,46-16-0-E-0,7707-81-6820,SNGL FAM SUB,5.79,AC,208200,0,208200,0,0,208200,186100,0,186100,0,0,186100,A2,AG/LTD,,,
7286,46-16-0-E-1,7707-82-8424,SNGL FAM SUB,5,AC,190200,0,190200,648200,18000,856400,170000,0,170000,554000,18000,742000,A2,AG/LTD,,,
7287,18-1-0-67-0,6820-54-1680,SNGL FAM SUB,10,AC,89100,0,89100,182600,1800,273500,87500,0,87500,149100,1900,238500,A1,AG/GEN,,,
7288,13-4-0-9-A,6852-04-7846,SNGL FAM SUB,0.25,AC,1100,0,1100,0,0,1100,1100,0,1100,0,0,1100,A1,AG/GEN,,,
7291,67-1-0-10-0,7723-66-2533,SNGL FAM SUB,1.316,AC,191400,0,191400,653600,11800,856800,166400,0,166400,550200,10400,727000,R1,RES/LTD,,,
7292,9-4-0-4-0,5892-70-4499,SNGL FAM SUB,1.03,AC,38900,0,38900,110300,0,149200,38100,0,38100,96100,0,134200,A1,AG/GEN,,,
7293,17-1-0-74-0,6810-00-4773,SNGL FAM SUB,2.358,AC,48100,0,48100,231300,0,279400,66000,0,66000,184700,0,250700,A1,AG/GEN,,,
7294,64-19-E-10-0,7733-47-3715,SNGL FAM SUB,0,AC,265000,0,265000,399200,800,665000,220000,0,220000,352500,800,573300,R1,RES/LTD,,,
7295,44-1-0-16-0,6787-00-1146,AG 20-100 AC,34.02,AC,466300,368300,98000,534700,137700,1138700,415900,328800,87100,438300,127800,982000,A2,AG/LTD,,,
7296,44-15-1-21-0,6786-09-1029,AG 20-100 AC,20.1,AC,330700,0,330700,395200,84700,810600,283700,0,283700,327600,32500,643800,A2,AG/LTD,,,
7297,63-2-0-3-0,7723-28-9152,SNGL FAM SUB,6.854,AC,303900,0,303900,201000,0,504900,264200,0,264200,175900,0,440100,R1A2,RES LTD,,,
7298,44-1-0-17-A,6777-91-7405,SNGL FAM SUB,3.9,AC,115900,0,115900,113600,9100,238600,103500,0,103500,94600,9100,207200,A2,AG/LTD,,,
7299,44-3-0-9-0,6777-90-0129,SNGL FAM SUB,15.03,AC,238500,231000,7500,0,0,238500,212700,206200,6500,0,0,212700,A2,AG/LTD,,,
7300,44-3-0-10-0,6777-90-5760,SNGL FAM SUB,15.8,AC,265500,257400,8100,0,0,265500,237200,230400,6800,0,0,237200,A2,AG/LTD,,,
7305,27-1-0-30-A,6728-23-7548,AG 20-100 AC,53.34,AC,186900,162300,24600,0,0,186900,182800,160100,22700,0,0,182800,A1,AG/GEN,,,
7306,27-1-0-33-0,6728-13-4209,SNGL FAM SUB,4.3,AC,8100,6100,2000,0,0,8100,8100,6300,1800,0,0,8100,A1,AG/GEN,,,
7307,60-6-0-1-A,6785-10-9699,SNGL FAM SUB,4.29,AC,222900,220700,2200,0,0,222900,198800,197000,1800,0,0,198800,A2,AG/LTD,,,
7308,29-11-0-2-0,6749-32-3714,SNGL FAM SUB,3.305,AC,67200,0,67200,0,0,67200,62700,0,62700,0,0,62700,A1,AG/GEN,,,
7309,29-11-0-3-0,6749-32-4714,SNGL FAM SUB,3.304,AC,67200,0,67200,0,0,67200,62700,0,62700,0,0,62700,A1,AG/GEN,,,
7310,55-1-0-14-E,6775-82-7657,SNGL FAM SUB,7.88,AC,12100,0,12100,0,0,12100,10600,0,10600,0,0,10600,A2,AG/LTD,,,
7311,60-1-0-2-0,6784-39-6593,AG > 100 AC,149.6,AC,2238200,1992100,246100,554200,140200,2932600,1993800,1721300,272500,456200,108700,2558700,A2,AG/LTD,,,
7312,20-11-0-27-0,6851-01-3900,SNGL FAM SUB,3.226,AC,69200,0,69200,197200,28800,295200,67900,0,67900,176300,24300,268500,A1,AG/GEN,,,
7313,29-3-0-17-0,6749-63-0041,SNGL FAM SUB,3.42,AC,68200,0,68200,16400,0,84600,63600,0,63600,17500,0,81100,A1,AG/GEN,,,
7314,62-2-B-6-0,7704-94-5240,SNGL FAM SUB,0,AC,115000,0,115000,275100,500,390600,100000,0,100000,248000,500,348500,R1,RES/LTD,,,
7315,40-1-0-24-C,6736-47-5001,AG 20-100 AC,24.417,AC,151600,88600,63000,771400,19200,942200,148400,87300,61100,670000,20400,838800,A1,AG/GEN,,,
7316,55-11-0-G-0,6786-43-2617,SNGL FAM SUB,9,AC,158200,0,158200,0,0,158200,141400,0,141400,0,0,141400,A2,AG/LTD,,,
7317,46-1-0-29-0,7707-24-7012,SNGL FAM SUB,0.86,AC,89400,0,89400,47600,300,137300,79800,0,79800,40800,300,120900,RR,RES/RUR,,,
7318,60-1-0-10-0,6784-35-1906,SNGL FAM SUB,18.125,AC,61600,53200,8400,0,0,61600,54400,46700,7700,0,0,54400,A2,AG/LTD,,,
7319,60-1-0-11-0,6784-16-2071,SNGL FAM SUB,18.125,AC,61600,53200,8400,0,0,61600,54400,46700,7700,0,0,54400,A2,AG/LTD,,,
7324,16-1-0-48-0,5890-74-1765,AG 20-100 AC,26.69,AC,66600,54300,12300,0,0,66600,64700,53400,11300,0,0,64700,A1,AG/GEN,,,
7325,55-1-0-14-B,6785-09-8573,SNGL FAM SUB,19.897,AC,355400,0,355400,211400,9000,575800,317700,0,317700,175100,9000,501800,A2,AG/LTD,,,
7326,55-1-0-89-0,6785-66-5224,COMM & IND,0.25,AC,33000,0,33000,56600,1900,91500,30500,0,30500,56400,1900,88800,B1,BUS/GEN,,,
7327,55-1-0-14-G,6785-09-9011,SNGL FAM SUB,5.249,AC,179600,0,179600,174600,48900,403100,160200,0,160200,171400,48900,380500,A2,AG/LTD,,,
7328,55-14-0-11-0,6785-18-3849,SNGL FAM SUB,16.5,AC,281300,273300,8000,0,0,281300,251400,244300,7100,0,0,251400,A2,AG/LTD,,,
7329,63-1-0-161-0,7724-04-1248,COMM & IND,158.741,AC,3439900,0,3439900,367900,2420800,6228600,3178000,0,3178000,349200,2352500,5879700,A2,AG/LTD,,,
7330,14-3-0-20-0,6851-37-5783,SNGL FAM SUB,3.24,AC,68600,0,68600,139500,500,208600,67200,0,67200,117600,500,185300,A1,AG/GEN,,,
7333,67-20-0-45-0,7733-35-2889,SNGL FAM SUB,1.5,AC,309400,0,309400,848100,0,1157500,259400,0,259400,701000,0,960400,R1,RES/LTD,,,
7334,45-1-0-72-A,6797-61-4903,SNGL FAM SUB,13.496,AC,280100,191300,88800,450800,69700,800600,250000,170800,79200,361600,62300,673900,A2,AG/LTD,,,
7365,42-1-0-15-0,6757-72-3893,SNGL FAM SUB,6,AC,125700,0,125700,453100,100,578900,107300,0,107300,390000,100,497400,A2,AG/LTD,,,
7366,31-7-0-8-A,6779-55-3443,SNGL FAM SUB,3.833,AC,104900,0,104900,192200,2000,299100,93700,0,93700,157400,2000,253100,A2,AG/LTD,,,
7367,54-2-0-8-0,6776-22-5976,SNGL FAM SUB,4.375,AC,98200,0,98200,276800,15800,390800,87600,0,87600,227400,13500,328500,A2,AG/LTD,,,
7368,64-1-0-16-0,7724-62-0286,SNGL FAM SUB,10.72,AC,605000,0,605000,182700,36300,824000,526000,0,526000,156000,31100,713100,R1,RES/LTD,,,
7369,64-1-0-17-0,7724-61-0381,SNGL FAM SUB,2.34,AC,185600,0,185600,141500,2000,329100,161400,0,161400,124300,2000,287700,R1,RES/LTD,,,
7370,64-1-0-19-0,7724-61-0180,SNGL FAM SUB,0.353,AC,9300,0,9300,0,0,9300,8100,0,8100,0,0,8100,R1,RES/LTD,,,
7371,64-3-3-17-A,7724-82-7949,COMM & IND,0.46,AC,104900,0,104900,56000,900,161800,97100,0,97100,55200,600,152900,RO,RES/OF,,,
7372,63-3-A-1-A,7714-91-4675,SNGL FAM SUB,0.3,AC,7200,0,7200,0,2500,9700,6200,0,6200,0,2500,8700,R1,RES/LTD,,,
7373,6-4-0-7-0,6832-88-4402,SNGL FAM SUB,5.85,AC,81300,0,81300,520000,19700,621000,79700,0,79700,470000,17500,567200,A1,AG/GEN,,,
7374,16-4-0-14-0,5890-35-3976,SNGL FAM SUB,3.16,AC,46600,0,46600,0,0,46600,45600,0,45600,0,0,45600,A1,AG/GEN,,,
7375,64-13-0-1-0,7733-17-5444,SNGL FAM SUB,0,AC,309400,0,309400,593500,0,902900,259400,0,259400,517400,0,776800,R1,RES/LTD,,,
7376,29-1-0-83-0,6749-75-8036,SNGL FAM SUB,5.04,AC,91900,0,91900,95400,9400,196700,89900,0,89900,79700,6400,176000,A1,AG/GEN,,,
7377,39-4-0-10-0,6726-56-6809,SNGL FAM SUB,11.3,AC,96500,0,96500,0,0,96500,94700,0,94700,0,0,94700,A1,AG/GEN,,,
7378,55-1-0-45-0,6786-43-6282,SNGL FAM SUB,5.89,AC,137600,0,137600,303600,19600,460800,122700,0,122700,254100,16300,393100,A2,AG/LTD,,,
7381,18-5-0-B-0,6729-49-4957,SNGL FAM SUB,3.91,AC,57100,0,57100,261500,200,318800,55500,0,55500,216600,200,272300,A1,AG/GEN,,,
7382,64-4-2-10-0,7724-93-4917,SNGL FAM SUB,0,AC,70000,0,70000,131800,2000,203800,60000,0,60000,111400,2000,173400,RN,RESIDEN,,,
7383,44-16-0-11-0,6787-39-8487,SNGL FAM SUB,4.32,AC,129000,0,129000,256300,2500,387800,115000,0,115000,237300,2700,355000,A2,AG/LTD,,,
7384,42-1-0-48-0,6767-03-4721,COMM & IND,2.92,AC,192200,0,192200,285200,35500,512900,184900,0,184900,261000,28300,474200,RO,RES/OF,,,
7385,42-1-0-66-0,6757-99-2080,COMM & IND,4.471,AC,436400,0,436400,561000,0,997400,419600,0,419600,561000,0,980600,B1,BUS/GEN,,,
7386,42-5-0-8-0,6767-04-4400,MultiFamily,0,AC,70000,0,70000,184300,0,254300,64000,0,64000,176400,0,240400,R3,RES/GEN,,,
7387,42-5-0-11-0,6767-04-1684,SNGL FAM SUB,0.544,AC,70000,0,70000,108700,1600,180300,64000,0,64000,99300,1700,165000,R3,RES/GEN,,,
7388,42-16-A-1-0,6767-03-0400,SNGL FAM SUB,0.889,AC,81500,0,81500,337200,0,418700,74000,0,74000,314200,0,388200,R1,RES/LTD,,,
7389,64-3-3-2-0,7724-73-9065,COMM & IND,0.47,AC,113800,0,113800,0,0,113800,112800,0,112800,0,0,112800,B1,BUS/GEN,,,
7390,64-3-3-52-A,7724-73-8226,COMM & IND,0.38,AC,31000,0,31000,0,0,31000,15100,0,15100,0,0,15100,B1,BUS/GEN,,,
7391,42-16-A-2-0,6767-03-0504,SNGL FAM SUB,0.984,AC,81500,0,81500,246700,0,328200,74000,0,74000,231700,0,305700,R1,RES/LTD,,,
7413,18-1-0-68-0,6820-54-1989,SNGL FAM SUB,10.08,AC,89500,0,89500,236200,4300,330000,87900,0,87900,198000,4000,289900,A1,AG/GEN,,,
7414,56-1-0-81-0,6795-98-9988,SNGL FAM SUB,10.56,AC,394100,213200,180900,131300,1200,526600,342400,185200,157200,110900,1200,454500,A2,AG/LTD,,,
7415,57-1-0-26-E,7706-10-8164,AG 20-100 AC,36.44,AC,173300,0,173300,545300,7400,726000,151100,0,151100,451200,6100,608400,A2,AG/LTD,,,
7416,57-4-0-2-0,7705-09-8497,AG 20-100 AC,38.189,AC,1061700,786300,275400,852500,90900,2005100,924000,685000,239000,824600,89100,1837700,A2,AG/LTD,,,
7417,17-6-0-X-0,6800-94-6936,SNGL FAM SUB,18.68,AC,108700,0,108700,0,0,108700,108100,0,108100,0,0,108100,A1,AG/GEN,,,
7418,32-10-1-10-0,6778-68-6335,SNGL FAM SUB,1.48,AC,74200,0,74200,204100,34100,312400,66300,0,66300,172100,30600,269000,A2,AG/LTD,,,
7419,63-1-0-174-0,7724-03-8498,COMM & IND,5.669,AC,654200,0,654200,0,0,654200,601100,0,601100,0,0,601100,RO,RES/OF,,,
7420,62-3-D-6-0,7714-04-7159,SNGL FAM SUB,0,AC,115000,0,115000,278600,400,394000,100000,0,100000,258000,400,358400,R1,RES/LTD,,,
7421,27-1-0-69-A,6729-50-9094,AG 20-100 AC,20.569,AC,138600,0,138600,0,2400,141000,135800,0,135800,5900,800,142500,A1,AG/GEN,,,
7422,20-1-0-5-0,6840-27-9695,AG 20-100 AC,24.9,AC,140100,128600,11500,0,0,140100,132100,121500,10600,0,0,132100,A1,AG/GEN,,,
7423,46-1-0-59-0,7716-17-8609,SNGL FAM SUB,3,AC,143400,0,143400,123100,0,266500,128000,0,128000,103200,0,231200,A2,AG/LTD,,,
7424,31-12-0-6-0,6769-67-4403,AG 20-100 AC,51.58,AC,537300,0,537300,0,0,537300,484900,0,484900,0,0,484900,A2,AG/LTD,,,
7425,63-1-0-11-0,7715-31-8041,SNGL FAM SUB,0.778,AC,111900,0,111900,0,0,111900,97300,0,97300,0,0,97300,A2,AG/LTD,,,
7426,46-6-0-1-0,7716-18-1256,SNGL FAM SUB,2.64,AC,136400,0,136400,106500,7400,250300,121900,0,121900,91100,6300,219300,A2,AG/LTD,,,
7427,32-11-0-1-0,6778-78-9667,SNGL FAM SUB,5.26,AC,125400,0,125400,0,0,125400,112200,0,112200,0,0,112200,A2,AG/LTD,,,
7428,32-13-0-3-0,6778-77-7490,SNGL FAM SUB,2.28,AC,82500,0,82500,154700,2000,239200,73700,0,73700,125100,2000,200800,A2,AG/LTD,,,
7429,28-6-0-2-0,6739-00-2160,SNGL FAM SUB,1,AC,40000,0,40000,157800,200,198000,39500,0,39500,130700,200,170400,A1,AG/GEN,,,
7430,46-1-0-55-0,7716-07-8735,SNGL FAM SUB,2.64,AC,136400,0,136400,124700,3000,264100,121900,0,121900,104300,3000,229200,A2,AG/LTD,,,
7431,58-1-0-16-0,7716-35-2624,SNGL FAM SUB,3.25,AC,127400,0,127400,0,0,127400,113800,0,113800,0,0,113800,A2,AG/LTD,,,
7432,38-1-0-82-0,6707-76-4131,SNGL FAM SUB,0.47,AC,17400,0,17400,0,0,17400,17100,0,17100,0,0,17100,A1,AG/GEN,,,
7433,38-1-0-83-0,6707-76-4215,SNGL FAM SUB,0.5,AC,27000,0,27000,30300,200,57500,26400,0,26400,28100,200,54700,A1,AG/GEN,,,
7434,32-1-0-29-0,6778-77-2979,SNGL FAM SUB,2.7,AC,88600,0,88600,51500,100,140200,79100,0,79100,43800,100,123000,A2,AG/LTD,,,
7436,31-8-0-3-0,6779-51-8122,SNGL FAM SUB,6.99,AC,112100,0,112100,0,0,112100,100000,0,100000,0,0,100000,A2,AG/LTD,,,
7437,46-1-0-55-B,7716-17-0606,SNGL FAM SUB,2.01,AC,122000,0,122000,337800,59500,519300,109000,0,109000,281400,50900,441300,A2,AG/LTD,,,
7438,38-1-0-105-B,6717-18-4241,SNGL FAM SUB,1.016,AC,38900,0,38900,83100,600,122600,38100,0,38100,70800,600,109500,A1,AG/GEN,,,
7439,12-1-0-34-F,6831-14-0401,SNGL FAM SUB,1.15,AC,43300,0,43300,104600,18200,166100,40700,0,40700,93700,15700,150100,A1,AG/GEN,,,
7440,58-1-0-19-0,7716-45-3242,SNGL FAM SUB,4.75,AC,183500,0,183500,0,0,183500,159500,0,159500,0,0,159500,A2,AG/LTD,,,
7441,58-1-0-18-0,7716-45-3397,SNGL FAM SUB,8.649,AC,200200,0,200200,0,0,200200,174000,0,174000,0,0,174000,A2,AG/LTD,,,
7445,32-1-0-61-B,6789-04-7344,SNGL FAM SUB,1.99,AC,78400,0,78400,162500,4500,245400,70000,0,70000,133000,4500,207500,A2,AG/LTD,,,
7446,32-1-0-28-0,6778-77-1521,COMM & IND,1.43,AC,104100,0,104100,176500,3300,283900,99100,0,99100,153700,2300,255100,B1A2,BS AND,,,
7447,47-1-0-53-0,7717-88-5720,SNGL FAM SUB,5.59,AC,177000,0,177000,278400,400,455800,158200,0,158200,242000,400,400600,A2,AG/LTD,,,
7448,32-11-0-2-0,6778-88-2504,SNGL FAM SUB,5.25,AC,125300,0,125300,346600,40800,512700,112000,0,112000,281900,36300,430200,A2,AG/LTD,,,
7449,47-1-0-53-A,7717-89-8178,SNGL FAM SUB,6,AC,184000,0,184000,0,0,184000,164400,0,164400,0,0,164400,A2,AG/LTD,,,
7450,63-1-0-180-B,7724-03-4434,SNGL FAM SUB,1.228,AC,169900,0,169900,16000,500,186400,147800,0,147800,14200,500,162500,R3,RES/GEN,,,
7451,45-1-0-118-0,6797-78-8048,SNGL FAM SUB,2,AC,83900,0,83900,85300,0,169200,74900,0,74900,70500,0,145400,A2,AG/LTD,,,
7452,63-26-0-E-0,7724-01-1941,SNGL FAM SUB,1.28,AC,68400,0,68400,0,0,68400,59400,0,59400,0,0,59400,R1,RES/LTD,,,
7453,51-8-0-5-0,6735-49-6628,SNGL FAM SUB,3.43,AC,48500,0,48500,1900,6000,56400,47600,0,47600,2100,5000,54700,A1,AG/GEN,,,
7454,12-1-0-34-D,6831-14-4233,SNGL FAM SUB,1.03,AC,42300,0,42300,94300,800,137400,39700,0,39700,78500,800,119000,A1,AG/GEN,,,
7455,39-4-0-5-0,6726-57-5793,SNGL FAM SUB,5.02,AC,63300,0,63300,0,0,63300,62100,0,62100,0,0,62100,A1,AG/GEN,,,
7456,39-4-0-6-0,6726-57-7679,SNGL FAM SUB,5,AC,63200,0,63200,397100,0,460300,62000,0,62000,338900,0,400900,A1,AG/GEN,,,
7458,63-1-0-187-0,7714-92-7383,SNGL FAM SUB,1.929,AC,146300,0,146300,162200,0,308500,127300,0,127300,144900,0,272200,R1,RES/LTD,,,
7459,26-1-0-4-0,6709-84-1125,AG 20-100 AC,72.16,AC,264200,190200,74000,123800,21600,409600,262200,193900,68300,100100,21700,384000,A1,AG/GEN,,,
7460,48-13-0-A-0,7726-69-8822,SNGL FAM SUB,2.27,AC,126100,0,126100,162400,0,288500,112600,0,112600,135300,0,247900,A2,AG/LTD,,,
7461,48-13-0-B-0,7727-60-9370,SNGL FAM SUB,10.91,AC,335300,0,335300,0,0,335300,299800,0,299800,0,0,299800,A2,AG/LTD,,,
7462,48-13-0-C-0,7726-79-2595,SNGL FAM SUB,16.834,AC,487000,0,487000,0,0,487000,435500,0,435500,0,0,435500,A2,AG/LTD,,,
7463,48-13-0-F-0,7727-71-1263,COMM & IND,10.64,AC,535700,0,535700,0,0,535700,496300,0,496300,0,0,496300,A2,AG/LTD,,,
7464,13-7-0-3-0,6842-93-6354,SNGL FAM SUB,4.5,AC,74800,0,74800,0,0,74800,73300,0,73300,0,0,73300,A1,AG/GEN,,,
7465,13-1-0-27-A,6842-90-3782,SNGL FAM SUB,2.781,AC,65300,0,65300,0,0,65300,64100,0,64100,0,0,64100,A1,AG/GEN,,,
7466,47-11-0-1-0,7716-27-9880,SNGL FAM SUB,2.85,AC,130500,0,130500,94500,1400,226400,116500,0,116500,79700,1400,197600,A2,AG/LTD,,,
7468,63-1-0-186-0,7714-92-6499,SNGL FAM SUB,1.042,AC,123000,0,123000,69100,0,192100,107000,0,107000,58900,0,165900,R3,RES/GEN,,,
7469,9-6-0-3-0,5891-88-3574,SNGL FAM SUB,1,AC,38800,0,38800,102200,17800,158800,38000,0,38000,89200,16100,143300,A1,AG/GEN,,,
7470,47-1-0-31-0,7716-78-0648,SNGL FAM SUB,3.879,AC,448800,0,448800,49000,600,498400,408100,0,408100,39500,600,448200,A2,AG/LTD,,,
7471,45-1-0-117-0,6797-78-9291,SNGL FAM SUB,3.15,AC,99800,0,99800,62100,0,161900,89000,0,89000,53100,0,142100,A2,AG/LTD,,,
7472,48-1-0-29-0,7726-69-4816,SNGL FAM SUB,3.11,AC,156000,0,156000,149500,26300,331800,139400,0,139400,126200,22500,288100,A2,AG/LTD,,,
7473,4-1-0-42-B,6814-51-3741,AG 20-100 AC,34.79,AC,124600,108600,16000,0,0,124600,122100,107300,14800,0,0,122100,A1,AG/GEN,,,
7474,1-1-0-34-0,6814-42-2551,AG 20-100 AC,20,AC,133300,124100,9200,0,2400,135700,133200,124700,8500,0,2300,135500,A1,AG/GEN,,,
7477,49-1-0-4-0,6716-42-8931,SNGL FAM SUB,7.5,AC,75200,0,75200,186100,8200,269500,73800,0,73800,158100,8200,240100,A1,AG/GEN,,,
7478,49-1-0-5-0,6716-42-4241,SNGL FAM SUB,1.19,AC,3600,0,3600,0,0,3600,3600,0,3600,0,0,3600,A1,AG/GEN,,,
7479,49-1-0-6-0,6716-42-5547,SNGL FAM SUB,5.02,AC,35700,0,35700,0,0,35700,35100,0,35100,0,0,35100,A1,AG/GEN,,,
7480,1-1-0-31-0,6814-32-5920,SNGL FAM SUB,5.33,AC,61800,0,61800,170300,3500,235600,60700,0,60700,147500,3500,211700,A1,AG/GEN,,,
7481,50-5-0-2-0,6726-44-0975,SNGL FAM SUB,8.91,AC,73300,0,73300,445300,0,518600,69800,0,69800,375200,0,445000,A1,AG/GEN,,,
7482,66-3-0-1-0,7723-46-2817,SNGL FAM SUB,4.036,AC,370500,0,370500,365500,42200,778200,323000,0,323000,318900,39900,681800,R1,RES/LTD,,,
7483,57-9-0-5-0,7706-53-8519,SNGL FAM SUB,2.56,AC,157500,0,157500,0,0,157500,136900,0,136900,0,0,136900,A2,AG/LTD,,,
7484,57-9-0-6-0,7706-64-1623,AG 20-100 AC,41.43,AC,1073000,0,1073000,240200,25700,1338900,933800,0,933800,204800,22800,1161400,A2,AG/LTD,,,
7486,21-4-0-2-0,6759-47-5107,SNGL FAM SUB,5.02,AC,101300,0,101300,103600,11000,215900,91700,0,91700,86100,11000,188800,A2,AG/LTD,,,
7335,64-1-0-32-0,7723-69-3662,SNGL FAM SUB,4.924,AC,275500,0,275500,305200,1500,582200,239800,0,239800,262100,1500,503400,A2,AG/LTD,,,
7336,64-12-B-21-0,7723-59-9727,SNGL FAM SUB,0,AC,77000,0,77000,225500,9500,312000,67000,0,67000,193000,8200,268200,R1,RES/LTD,,,
7337,64-12-G-7-0,7723-59-6544,SNGL FAM SUB,0,AC,77000,0,77000,257000,0,334000,67000,0,67000,217800,0,284800,R1,RES/LTD,,,
7338,58-21-B-5-0,7716-23-5737,SNGL FAM SUB,1.486,AC,310000,0,310000,434700,2000,746700,285000,0,285000,405000,2000,692000,A2,AG/LTD,,,
7339,62-18-0-12-0,7704-64-3065,SNGL FAM SUB,3.3,AC,226100,0,226100,208600,0,434700,200300,0,200300,184700,0,385000,A2,AG/LTD,,,
7340,46-21-B-7-0,7708-90-8437,SNGL FAM SUB,2.41,AC,127400,0,127400,249300,500,377200,115800,0,115800,209700,500,326000,A2,AG/LTD,,,
7341,19-1-0-50-0,6830-87-6990,SNGL FAM SUB,13.19,AC,98700,55100,43600,131100,6600,236400,96700,44600,52100,103300,5400,205400,A1,AG/GEN,,,
7342,19-7-0-B-0,6830-96-6405,SNGL FAM SUB,12.62,AC,98800,0,98800,37200,5100,141100,92100,0,92100,30600,3300,126000,A1,AG/GEN,,,
7343,13-1-0-41-A,6841-85-8075,SNGL FAM SUB,3,AC,67200,0,67200,59900,300,127400,66000,0,66000,53000,300,119300,A1,AG/GEN,,,
7345,19-1-0-55-0,6830-64-4553,SNGL FAM SUB,11.22,AC,131900,0,131900,483900,2000,617800,124500,0,124500,407000,2000,533500,A1,AG/GEN,,,
7346,18-1-0-4-0,6811-70-6173,SNGL FAM SUB,3.01,AC,50100,0,50100,34900,1300,86300,49100,0,49100,30200,1300,80600,A1,AG/GEN,,,
7348,19-1-0-50-D,6830-67-6325,SNGL FAM SUB,11.75,AC,87700,59500,28200,0,0,87700,84000,50100,33900,0,0,84000,A1,AG/GEN,,,
7349,19-1-0-50-A,6830-97-0412,AG 20-100 AC,22.29,AC,161500,0,161500,44300,17400,223200,129700,0,129700,36900,16500,183100,A1,AG/GEN,,,
7350,41-2-0-7-0,6748-41-1834,SNGL FAM SUB,1.84,AC,62400,0,62400,180700,2200,245300,57800,0,57800,149700,2200,209700,A1,AG/GEN,,,
7351,19-7-0-C-0,6830-96-2911,SNGL FAM SUB,11.71,AC,92600,0,92600,6000,1000,99600,81300,0,81300,6100,1000,88400,A1,AG/GEN,,,
7352,19-1-0-50-E,6830-57-9603,SNGL FAM SUB,11.75,AC,87700,72300,15400,0,0,87700,84000,66200,17800,0,0,84000,A1,AG/GEN,,,
7353,31-3-0-A-0,6778-49-7948,SNGL FAM SUB,2.534,AC,89400,0,89400,135500,3600,228500,79900,0,79900,111500,2500,193900,A2,AG/LTD,,,
7356,13-9-0-10-0,6841-65-3048,SNGL FAM SUB,3.92,AC,72700,0,72700,0,0,72700,71300,0,71300,0,0,71300,A1,AG/GEN,,,
7357,13-9-0-9-A,6841-64-3716,SNGL FAM SUB,4.46,AC,79500,0,79500,144400,1400,225300,78000,0,78000,117500,1400,196900,A1,AG/GEN,,,
7358,46-21-A-8-0,7718-00-0746,SNGL FAM SUB,2.17,AC,122200,0,122200,242500,1300,366000,111000,0,111000,203200,1300,315500,A2,AG/LTD,,,
7359,46-9-0-B-3A,7707-67-6821,SNGL FAM SUB,5.899,AC,167900,0,167900,294600,11300,473800,152700,0,152700,249800,11300,413800,A2,AG/LTD,,,
7360,62-18-0-17-0,7704-64-7106,SNGL FAM SUB,3.05,AC,220300,0,220300,321700,14300,556300,200300,0,200300,293200,14700,508200,A2,AG/LTD,,,
7361,5-1-0-77-0,6823-65-7551,SNGL FAM SUB,5.128,AC,60800,0,60800,74300,2400,137500,59600,0,59600,65400,1800,126800,A1,AG/GEN,,,
7362,46-1-0-120-0,7707-72-5163,SNGL FAM SUB,2,AC,121800,0,121800,255900,25100,402800,108800,0,108800,215300,22100,346200,RR,RES/RUR,,,
7364,11-9-0-B-0,6822-54-5069,SNGL FAM SUB,10.87,AC,90000,0,90000,380000,0,470000,88400,0,88400,338100,0,426500,A1,AG/GEN,,,
7392,42-16-A-3-0,6757-93-9699,SNGL FAM SUB,0.991,AC,81500,0,81500,0,30200,111700,74000,0,74000,0,25400,99400,R1,RES/LTD,,,
7393,30-1-0-75-0,6758-98-2585,SNGL FAM SUB,2.17,AC,68500,0,68500,144700,0,213200,62100,0,62100,120000,0,182100,A2,AG/LTD,,,
7394,58-1-0-22-0,7716-54-7654,SNGL FAM SUB,3.658,AC,155700,0,155700,130100,15500,301300,135300,0,135300,112700,12700,260700,A2,AG/LTD,,,
7395,18-5-0-B-1,6820-40-1026,SNGL FAM SUB,4.15,AC,58500,0,58500,181400,33800,273700,56900,0,56900,149100,27700,233700,A1,AG/GEN,,,
7396,55-12-0-B-1,6785-54-0451,SNGL FAM SUB,10,AC,174900,107700,67200,591800,0,766700,155900,95800,60100,492800,0,648700,A2,AG/LTD,,,
7397,55-12-0-B-2,6785-53-0814,SNGL FAM SUB,16.172,AC,243300,235800,7500,0,0,243300,217400,210500,6900,0,0,217400,A2,AG/LTD,,,
7400,63-9-0-1-0,7724-11-5518,AG 20-100 AC,41.962,AC,1128800,0,1128800,0,0,1128800,981900,0,981900,0,0,981900,A2,AG/LTD,,,
7401,32-1-0-61-0,6789-14-2077,SNGL FAM SUB,3.09,AC,94200,0,94200,0,0,94200,84200,0,84200,0,0,84200,A2,AG/LTD,,,
7402,18-4-0-4-F,6820-30-8741,SNGL FAM SUB,9.62,AC,87300,0,87300,0,0,87300,85400,0,85400,0,0,85400,A1,AG/GEN,,,
7403,26-1-0-2-A,6709-34-7504,AG 20-100 AC,31.5,AC,98800,84300,14500,0,0,98800,94500,81100,13400,0,0,94500,A1,AG/GEN,,,
7404,56-9-0-C-0,6786-80-4343,SNGL FAM SUB,14.66,AC,227200,0,227200,425000,10000,662200,202700,0,202700,359400,10000,572100,A2,AG/LTD,,,
7405,12-1-0-53-A,6832-37-3421,SNGL FAM SUB,10.5,AC,101500,0,101500,214100,0,315600,99000,0,99000,192900,0,291900,A1,AG/GEN,,,
7406,58-21-C-5-0,7716-22-1627,SNGL FAM SUB,2.16,AC,310000,0,310000,255100,68800,633900,285000,0,285000,234900,58200,578100,R3,RES/GEN,,,
7411,18-4-0-3-C,6820-00-6376,SNGL FAM SUB,3,AC,52000,0,52000,157800,200,210000,50000,0,50000,129600,200,179800,A1,AG/GEN,,,
7412,18-4-0-3-F,6820-00-4344,SNGL FAM SUB,3.01,AC,52100,0,52100,122200,0,174300,50100,0,50100,100200,0,150300,A1,AG/GEN,,,
7498,56-10-0-B-0,6796-92-9195,SNGL FAM SUB,0.48,AC,9800,0,9800,0,0,9800,8500,0,8500,0,0,8500,A2,AG/LTD,,,
7499,56-10-0-E-0,6796-92-9002,SNGL FAM SUB,2.34,AC,122200,0,122200,106000,300,228500,106200,0,106200,90000,300,196500,A2,AG/LTD,,,
7500,46-1-0-73-C,7707-62-6527,SNGL FAM SUB,2.5,AC,133200,0,133200,135800,18300,287300,119000,0,119000,114900,15800,249700,RR,RES/RUR,,,
7501,2-3-0-12-0,6824-24-6060,SNGL FAM SUB,4.09,AC,51700,0,51700,296300,39300,387300,50600,0,50600,260100,33400,344100,A1,AG/GEN,,,
7502,45-1-0-124-A,6797-77-3081,COMM & IND,1,AC,100400,0,100400,148100,1700,250200,93000,0,93000,143700,2000,238700,B1,BUS/GEN,,,
7503,10-1-0-23-0,6801-75-5145,SNGL FAM SUB,0.948,AC,40500,40100,400,0,0,40500,37800,37400,400,0,0,37800,A1,AG/GEN,,,
7504,9-7-0-B-0,6802-13-0482,AG 20-100 AC,27.974,AC,59100,44600,14500,0,0,59100,55900,42400,13500,0,0,55900,A1,AG/GEN,,,
7505,9-7-0-C-0,6802-14-2819,AG 20-100 AC,24.824,AC,99000,49200,49800,280900,5000,384900,95100,37500,57600,250100,5000,350200,A1,AG/GEN,,,
7506,46-23-0-23-0,7707-84-7103,SNGL FAM SUB,3.458,AC,181500,0,181500,248900,0,430400,165000,0,165000,213500,0,378500,A2,AG/LTD,,,
7507,9-7-0-A-0,6802-24-5175,AG 20-100 AC,59.219,AC,121500,94200,27300,0,0,121500,118400,93200,25200,0,0,118400,A1,AG/GEN,,,
7508,46-21-A-6-0,7708-90-3847,SNGL FAM SUB,2.24,AC,123700,0,123700,274500,800,399000,112400,0,112400,232200,800,345400,A2,AG/LTD,,,
7509,62-9-0-4-0,7714-29-0686,SNGL FAM SUB,5.257,AC,309000,0,309000,423300,4100,736400,268700,0,268700,397000,4200,669900,A2,AG/LTD,,,
7510,28-22-0-A-0,6738-09-7341,AG 20-100 AC,22.443,AC,166700,0,166700,164800,13200,344700,161700,0,161700,135200,12900,309800,A1,AG/GEN,,,
7511,58-22-A-17-0,7715-37-5473,SNGL FAM SUB,2.974,AC,365000,0,365000,827800,0,1192800,335000,0,335000,800800,0,1135800,A2,AG/LTD,,,
7512,39-1-0-4-0,6728-20-9839,SNGL FAM SUB,3,AC,51000,0,51000,0,0,51000,50000,0,50000,0,0,50000,A1,AG/GEN,,,
7513,55-1-0-82-0,6785-76-7497,SNGL FAM SUB,3.65,AC,106700,0,106700,70200,400,177300,95200,0,95200,58500,400,154100,A2,AG/LTD,,,
7514,48-10-0-C-0,7728-50-6821,COMM & IND,11.53,AC,1431200,0,1431200,0,7100,1438300,1362800,0,1362800,0,6100,1368900,M2,INDUS/G,,,
7515,55-1-0-82-A,6785-76-6643,SNGL FAM SUB,2.366,AC,89000,0,89000,80400,500,169900,79400,0,79400,66200,500,146100,A2,AG/LTD,,,
7516,55-1-0-82-B,6785-76-7269,SNGL FAM SUB,1.25,AC,73600,0,73600,60800,2500,136900,65700,0,65700,50200,2500,118400,A2,AG/LTD,,,
7517,60-9-0-8-0,6784-17-4900,SNGL FAM SUB,11.392,AC,381900,376100,5800,0,7500,389400,340700,335800,4900,0,5800,346500,A2,AG/LTD,,,
7518,60-9-0-9-0,6784-18-3219,SNGL FAM SUB,11,AC,374000,368500,5500,0,0,374000,333600,328800,4800,0,0,333600,A2,AG/LTD,,,
7519,60-9-0-10-0,6784-08-5370,SNGL FAM SUB,5.646,AC,250200,0,250200,574600,7500,832300,223200,0,223200,475100,7300,705600,A2,AG/LTD,,,
7520,60-9-0-B-0,6784-09-2439,SNGL FAM SUB,14.8,AC,526500,0,526500,399800,0,926300,470300,0,470300,334400,0,804700,A2,AG/LTD,,,
7521,60-9-0-C-0,6784-19-1060,AG 20-100 AC,30.65,AC,755300,583900,171400,353600,41600,1150500,673300,520900,152400,295300,40400,1009000,A2,AG/LTD,,,
7522,55-1-0-29-0,6785-56-6295,COMM & IND,1.07,AC,107400,0,107400,218400,3500,329300,99500,0,99500,216400,2800,318700,B1,BUS/GEN,,,
7523,33-4-0-27-0,6798-53-1349,SNGL FAM SUB,5.44,AC,138000,0,138000,208100,2800,348900,123100,0,123100,179100,2800,305000,A2,AG/LTD,,,
7524,37-1-0-6-0,6706-29-6622,COMM & IND,0.98,AC,13300,0,13300,0,0,13300,12900,0,12900,0,0,12900,M2,INDUS/G,,,
7525,47-1-0-5-0,7718-31-5825,SNGL FAM SUB,0.2,AC,3400,0,3400,0,0,3400,3000,0,3000,0,0,3000,A2,AG/LTD,,,
7526,18-4-0-2-E,6729-39-2379,SNGL FAM SUB,12.372,AC,101400,0,101400,195800,0,297200,100500,0,100500,165000,0,265500,A1,AG/GEN,,,
7527,62-2-B-3-0,7704-94-8090,SNGL FAM SUB,0,AC,115000,0,115000,217400,2400,334800,100000,0,100000,200700,2400,303100,R1,RES/LTD,,,
7528,58-23-0-7-0,7716-97-6393,SNGL FAM SUB,8.618,AC,410600,0,410600,0,0,410600,356900,0,356900,0,0,356900,A2,AG/LTD,,,
7529,5-13-0-27-0,6813-62-3870,SNGL FAM SUB,8.165,AC,65800,0,65800,0,0,65800,64400,0,64400,0,0,64400,A1,AG/GEN,,,
7530,47-13-0-B-0,7727-11-1917,SNGL FAM SUB,4,AC,211200,0,211200,0,0,211200,188600,0,188600,0,0,188600,A2,AG/LTD,,,
7531,43-1-0-88-B,6777-00-3720,SNGL FAM SUB,2,AC,84500,0,84500,198000,3000,285500,75500,0,75500,166400,3000,244900,A2,AG/LTD,,,
7532,17-1-0-86-C,6719-17-0402,SNGL FAM SUB,6,AC,68500,0,68500,185900,3200,257600,65500,0,65500,151900,3200,220600,A1,AG/GEN,,,
7534,39-6-0-13-0,6726-17-4405,SNGL FAM SUB,3.248,AC,51400,0,51400,156100,600,208100,50400,0,50400,133700,600,184700,A1,AG/GEN,,,
7535,12-1-0-58-0,6832-51-6800,AG 20-100 AC,25.868,AC,211800,119200,92600,124500,12000,348300,206700,118500,88200,113500,9500,329700,A1,AG/GEN,,,
7536,62-17-A-5-0,7714-05-3995,SNGL FAM SUB,0,AC,115000,0,115000,296600,1000,412600,100000,0,100000,274800,1000,375800,R1,RES/LTD,,,
7538,57-1-0-35-B,7705-39-3299,SNGL FAM SUB,11.16,AC,431100,0,431100,0,0,431100,375300,0,375300,0,0,375300,A2,AG/LTD,,,
7539,62-13-B-3-0,7714-05-6288,SNGL FAM SUB,0,AC,63300,0,63300,0,0,63300,35000,0,35000,0,0,35000,R1,RES/LTD,,,
7540,62-4-E-10-0,7714-05-8213,SNGL FAM SUB,0,AC,115000,0,115000,201900,0,316900,100000,0,100000,187600,0,287600,R1,RES/LTD,,,
7541,62-4-E-11-0,7714-05-7069,SNGL FAM SUB,0,AC,115000,0,115000,0,0,115000,100000,0,100000,0,0,100000,R1,RES/LTD,,,
7542,58-1-0-93-0,7726-26-0000,AG 20-100 AC,39.78,AC,2923100,0,2923100,0,0,2923100,5890600,0,5890600,0,0,5890600,RPUD,RES/PUD,,,
7543,62-4-C-16-0,7714-04-3776,SNGL FAM SUB,0,AC,115000,0,115000,354000,1000,470000,100000,0,100000,325400,1000,426400,R1,RES/LTD,,,
7544,29-15-0-B-0,6749-80-1802,AG 20-100 AC,27.352,AC,261300,0,261300,164200,16400,441900,255400,0,255400,135100,16400,406900,A1,AG/GEN,,,
7545,62-21-0-2-0,7704-98-4678,SNGL FAM SUB,8.01,AC,378700,0,378700,333000,800,712500,329200,0,329200,304200,800,634200,A2,AG/LTD,,,
7546,47-25-0-9-0,7727-01-3115,SNGL FAM SUB,3.1,AC,149700,0,149700,400200,1300,551200,133600,0,133600,337300,1500,472400,A2,AG/LTD,,,
7547,42-2-0-2-0,6767-05-3123,COMM & IND,1.525,AC,152000,0,152000,171300,10700,334000,146200,0,146200,133100,13100,292400,RO,RES/OF,,,
7548,16-1-0-13-0,5890-36-5993,SNGL FAM SUB,17.11,AC,80000,0,80000,183800,68300,332100,78300,0,78300,164700,61300,304300,A1,AG/GEN,,,
7549,16-1-0-15-0,5890-26-9530,SNGL FAM SUB,16,AC,68000,0,68000,0,0,68000,66000,0,66000,0,0,66000,A1,AG/GEN,,,
7551,39-1-0-81-0,6726-47-0458,SNGL FAM SUB,13.079,AC,100400,0,100400,406800,0,507200,98400,0,98400,342700,0,441100,A1,AG/GEN,,,
7552,39-1-0-82-0,6726-48-0177,SNGL FAM SUB,3.131,AC,51800,0,51800,181600,9200,242600,50800,0,50800,154900,9800,215500,A1,AG/GEN,,,
7553,1-1-0-9-0,6814-36-8142,AG 20-100 AC,29.929,AC,185700,132400,53300,109000,14600,309300,179800,124600,55200,96000,13700,289500,A1,AG/GEN,,,
7554,2-1-0-7-0,6814-86-0873,COMM & IND,8.87,AC,220400,0,220400,0,0,220400,214100,0,214100,0,0,214100,B1A1,BS & AG,,,
7555,58-3-C-4-0,7726-17-9036,SNGL FAM SUB,0,AC,88000,0,88000,147100,8900,244000,80000,0,80000,126300,10400,216700,RN,RESIDEN,,,
7556,19-3-0-1-0,6820-97-4165,AG 20-100 AC,75.65,AC,404700,310300,94400,205300,42700,652700,395600,306300,89300,169600,43300,608500,A1,AG/GEN,,,
7557,64-1-0-78-0,7734-43-8182,COMM & IND,1.4,AC,151800,0,151800,106400,0,258200,140600,0,140600,103900,0,244500,B1,BUS/GEN,,,
7558,38-1-0-123-0,6717-33-2052,AG 20-100 AC,79.281,AC,278300,163800,114500,75300,39800,393400,272800,162900,109900,64300,35800,372900,A1,AG/GEN,,,
7559,38-1-0-128-0,6717-22-3257,SNGL FAM SUB,5.5,AC,42400,39900,2500,0,0,42400,41500,39200,2300,0,0,41500,A1,AG/GEN,,,
7560,57-1-0-43-0,7715-13-1160,SNGL FAM SUB,9.504,AC,389700,0,389700,209000,40200,638900,338800,0,338800,180400,34600,553800,A2,AG/LTD,,,
7563,57-10-0-12-0,7705-56-2798,SNGL FAM SUB,6.49,AC,273000,0,273000,428800,0,701800,247200,0,247200,408400,0,655600,A2,AG/LTD,,,
7564,57-10-0-13-0,7705-57-2048,SNGL FAM SUB,4.97,AC,241500,0,241500,451600,8400,701500,220500,0,220500,424100,7400,652000,A2,AG/LTD,,,
7565,57-10-0-14-0,7705-57-3356,SNGL FAM SUB,5.55,AC,265000,0,265000,414300,9700,689000,240000,0,240000,386000,10100,636100,A2,AG/LTD,,,
7566,57-10-0-15-0,7705-57-4609,SNGL FAM SUB,7.34,AC,265000,0,265000,851100,0,1116100,240000,0,240000,754800,0,994800,A2,AG/LTD,,,
7567,57-10-0-16-0,7705-58-5088,SNGL FAM SUB,7.74,AC,265000,0,265000,1026700,143800,1435500,240000,0,240000,932900,133300,1306200,A2,AG/LTD,,,
7568,57-10-0-17-0,7705-58-7664,SNGL FAM SUB,5.91,AC,265000,0,265000,514500,0,779500,240000,0,240000,495400,0,735400,A2,AG/LTD,,,
7571,61-3-0-H-0,6794-87-0803,AG > 100 AC,218.643,AC,106300,0,106300,0,0,106300,93500,0,93500,0,0,93500,A2,AG/LTD,,,
7572,62-1-0-2-A,7704-08-4042,SNGL FAM SUB,1.24,AC,130400,0,130400,11400,0,141800,113300,0,113300,9800,0,123100,A2,AG/LTD,,,
7573,64-4-2-13-0,7724-94-4227,SNGL FAM SUB,0,AC,20200,0,20200,0,0,20200,17600,0,17600,0,0,17600,RN,RESIDEN,,,
7574,56-1-0-2-0,6786-83-2596,AG 20-100 AC,25.66,AC,307900,0,307900,0,0,307900,274600,0,274600,0,0,274600,A2,AG/LTD,,,
7575,55-6-0-1-0,6785-26-3972,SNGL FAM SUB,2.8,AC,94900,0,94900,65600,500,161000,84700,0,84700,54600,500,139800,A2,AG/LTD,,,
7576,55-1-0-46-0,6786-53-5163,SNGL FAM SUB,1,AC,70100,0,70100,65600,1400,137100,62600,0,62600,54800,1400,118800,A2,AG/LTD,,,
7577,55-1-0-49-0,6786-53-7079,SNGL FAM SUB,1.26,AC,74400,0,74400,343400,0,417800,66400,0,66400,282100,0,348500,A2,AG/LTD,,,
7578,56-1-0-16-0,6786-84-3948,SNGL FAM SUB,1.39,AC,76300,0,76300,147900,600,224800,68100,0,68100,120100,600,188800,A2,AG/LTD,,,
7579,55-1-0-62-0,6786-66-1074,SNGL FAM SUB,3.3,AC,104800,0,104800,150500,0,255300,93700,0,93700,125100,0,218800,A2,AG/LTD,,,
7580,45-4-0-3-0,6796-58-1191,SNGL FAM SUB,2.01,AC,99400,0,99400,334700,14200,448300,88600,0,88600,271800,12000,372400,A2,AG/LTD,,,
7581,14-3-0-4-0,6851-29-6005,SNGL FAM SUB,4.15,AC,76800,0,76800,156700,26100,259600,75200,0,75200,130300,23600,229100,A1,AG/GEN,,,
7582,14-3-0-18-0,6851-38-5303,SNGL FAM SUB,3.21,AC,68300,0,68300,96800,22700,187800,66900,0,66900,80400,21800,169100,A1,AG/GEN,,,
7583,46-1-0-99-0,7707-89-8804,SNGL FAM SUB,0.93,AC,91900,0,91900,32000,8800,132700,82100,0,82100,28600,9400,120100,A2,AG/LTD,,,
7584,46-1-0-52-0,7706-48-7481,SNGL FAM SUB,16,AC,347200,339700,7500,0,0,347200,301900,295000,6900,0,0,301900,A2,AG/LTD,,,
7585,57-1-0-67-A,7706-66-4709,AG 20-100 AC,20,AC,499400,490200,9200,0,0,499400,433500,425000,8500,0,0,433500,A2,AG/LTD,,,
7586,57-5-0-4-0,7706-57-5162,AG 20-100 AC,56.16,AC,1355000,1179400,175600,1037500,111500,2504000,1178800,1025700,153100,883800,96200,2158800,A2,AG/LTD,,,
7587,62-6-0-E-0,7704-55-8754,Place of Worship,3.52,AC,207800,0,207800,436300,20300,664400,180700,0,180700,422400,13500,616600,A2,AG/LTD,,,
7588,57-1-0-53-0,7715-09-0111,SNGL FAM SUB,8.862,AC,516000,0,516000,110900,0,626900,448600,0,448600,94600,0,543200,A2,AG/LTD,,,
7589,50-5-0-3-0,6726-44-3638,SNGL FAM SUB,8.26,AC,70300,0,70300,308900,0,379200,66900,0,66900,306000,0,372900,A1,AG/GEN,,,
7487,21-4-0-3-0,6759-47-7452,SNGL FAM SUB,6.49,AC,105900,0,105900,222700,4500,333100,95500,0,95500,184400,4100,284000,A2,AG/LTD,,,
7488,30-10-0-1-0,6759-47-1040,SNGL FAM SUB,4.34,AC,93900,0,93900,193400,2400,289700,84600,0,84600,161600,2400,248600,A1,AG/GEN,,,
7489,5-13-0-9-0,6813-53-9906,SNGL FAM SUB,8.66,AC,67600,0,67600,233600,40900,342100,66200,0,66200,196900,12000,275100,A1,AG/GEN,,,
7490,13-8-0-3-0,6842-90-7580,SNGL FAM SUB,1.522,AC,54400,0,54400,74400,4500,133300,53400,0,53400,69000,4500,126900,A1,AG/GEN,,,
7491,12-1-0-48-0,6831-46-5501,AG 20-100 AC,52.4,AC,224900,199600,25300,0,0,224900,220100,197700,22400,0,0,220100,A1,AG/GEN,,,
7492,13-1-0-19-0,6841-66-0900,SNGL FAM SUB,4,AC,75900,0,75900,51100,200,127200,74500,0,74500,44800,200,119500,A1,AG/GEN,,,
7493,57-1-0-22-A,7706-01-3765,SNGL FAM SUB,1.1,AC,97500,0,97500,203000,8400,308900,84800,0,84800,169400,8400,262600,A2,AG/LTD,,,
7494,57-1-0-22-B,7706-01-3664,SNGL FAM SUB,0.39,AC,10300,0,10300,0,0,10300,8900,0,8900,0,0,8900,A2,AG/LTD,,,
7496,25-1-0-5-B,6709-00-2610,AG 20-100 AC,20.05,AC,86400,0,86400,67000,14600,168000,84700,0,84700,56100,11000,151800,A1,AG/GEN,,,
7497,56-1-0-75-A,7706-02-0264,SNGL FAM SUB,2.1,AC,110500,0,110500,156100,5000,271600,96100,0,96100,132100,5000,233200,A2,AG/LTD,,,
7590,39-1-0-55-0,6717-93-0232,SNGL FAM SUB,0.61,AC,26000,0,26000,91000,600,117600,25500,0,25500,77800,600,103900,A1,AG/GEN,,,
7591,39-1-0-58-0,6716-79-7981,AG 20-100 AC,30,AC,123000,0,123000,0,0,123000,120000,0,120000,0,0,120000,A1,AG/GEN,,,
7592,20-1-0-84-A,6840-70-0269,SNGL FAM SUB,2.98,AC,73000,0,73000,223600,3500,300100,71500,0,71500,188300,3500,263300,A1,AG/GEN,,,
7593,26-2-0-3-H,6709-81-8166,SNGL FAM SUB,8.05,AC,81800,0,81800,0,0,81800,80300,0,80300,0,0,80300,A1,AG/GEN,,,
7594,39-7-0-B-0,6717-81-0109,SNGL FAM SUB,5,AC,61200,0,61200,0,0,61200,60000,0,60000,0,0,60000,A1,AG/GEN,,,
7595,46-14-0-6-0,7708-81-9887,SNGL FAM SUB,7.5,AC,182600,0,182600,160400,1800,344800,166000,0,166000,134500,1800,302300,A2,AG/LTD,,,
7596,27-16-0-5-0,6728-29-3458,AG 20-100 AC,20,AC,135700,0,135700,139200,2600,277500,133000,0,133000,93000,2600,228600,A1,AG/GEN,,,
7597,42-1-0-92-0,6767-14-1134,SNGL FAM SUB,1.422,AC,73200,0,73200,143900,4200,221300,65400,0,65400,118500,4000,187900,R3,RES/GEN,,,
7598,27-1-0-72-0,6728-37-9844,SNGL FAM SUB,8.45,AC,89800,0,89800,0,0,89800,88200,0,88200,0,0,88200,A1,AG/GEN,,,
7599,39-1-0-49-0,6717-81-6211,SNGL FAM SUB,9.895,AC,88600,0,88600,197800,6800,293200,86900,0,86900,164500,7300,258700,A1,AG/GEN,,,
7600,39-1-0-49-A,6717-80-3730,SNGL FAM SUB,2,AC,44400,0,44400,0,20700,65100,43500,0,43500,0,18100,61600,A1,AG/GEN,,,
7601,16-1-0-67-0,6800-05-9029,SNGL FAM SUB,5,AC,57200,0,57200,104300,0,161500,54000,0,54000,90500,0,144500,A1,AG/GEN,,,
7602,51-1-0-5-0,6726-82-5535,SNGL FAM SUB,5.06,AC,61500,0,61500,150700,0,212200,60300,0,60300,132700,0,193000,A1,AG/GEN,,,
7604,39-1-0-53-0,6717-93-1271,SNGL FAM SUB,0.38,AC,17700,0,17700,0,0,17700,17300,0,17300,0,0,17300,A1,AG/GEN,,,
7605,39-1-0-54-0,6717-93-0421,SNGL FAM SUB,0.75,AC,32000,0,32000,99300,700,132000,31400,0,31400,85300,700,117400,A1,AG/GEN,,,
7606,47-1-0-92-0,7727-10-2316,SNGL FAM SUB,3.89,AC,148100,0,148100,206000,700,354800,132300,0,132300,176300,700,309300,A2,AG/LTD,,,
7607,39-7-0-D-0,6717-70-3973,SNGL FAM SUB,5.38,AC,63300,0,63300,233100,19000,315400,62100,0,62100,203200,16100,281400,A1,AG/GEN,,,
7608,39-7-0-A-0,6717-81-0676,SNGL FAM SUB,5,AC,61200,0,61200,6800,1400,69400,60000,0,60000,7000,1500,68500,A1,AG/GEN,,,
7609,39-7-0-F-0,6717-71-3652,AG 20-100 AC,20.79,AC,110000,0,110000,71900,1000,182900,107300,0,107300,58800,1000,167100,A1,AG/GEN,,,
7610,20-1-0-36-0,6840-31-6048,AG 20-100 AC,36.53,AC,249600,232800,16800,0,0,249600,243200,227700,15500,0,0,243200,A1,AG/GEN,,,
7611,20-1-0-84-0,6749-59-7935,AG 20-100 AC,71.07,AC,654800,566900,87900,975900,105100,1735800,631500,551600,79900,831900,99900,1563300,A1,AG/GEN,,,
7612,39-7-0-C-0,6717-80-0831,SNGL FAM SUB,4.75,AC,59800,0,59800,0,0,59800,58600,0,58600,0,0,58600,A1,AG/GEN,,,
7613,51-1-0-6-0,6726-71-6925,AG 20-100 AC,25.672,AC,152300,0,152300,99700,1500,253500,149000,0,149000,83400,1500,233900,A1,AG/GEN,,,
7614,30-13-A-1-0,6769-30-6562,SNGL FAM SUB,2.436,AC,86900,0,86900,672000,0,758900,83000,0,83000,619800,0,702800,A2,AG/LTD,,,
7615,30-13-A-2-0,6769-30-4405,SNGL FAM SUB,3.197,AC,106400,0,106400,490000,31800,628200,101700,0,101700,452400,31200,585300,A2,AG/LTD,,,
7616,30-13-A-3-0,6769-20-9915,SNGL FAM SUB,3.88,AC,106400,0,106400,297600,1200,405200,101700,0,101700,267900,1300,370900,A2,AG/LTD,,,
7617,30-13-A-4-0,6769-31-3035,SNGL FAM SUB,8.84,AC,145600,0,145600,269500,6500,421600,139100,0,139100,229300,5000,373400,A2,AG/LTD,,,
7618,30-13-A-5-0,6769-31-7055,SNGL FAM SUB,5.573,AC,134400,0,134400,536700,0,671100,128400,0,128400,471600,0,600000,A2,AG/LTD,,,
7619,30-13-A-6-0,6769-31-9425,SNGL FAM SUB,4.838,AC,134400,0,134400,241200,103200,478800,128400,0,128400,218600,96600,443600,A2,AG/LTD,,,
7620,30-13-A-11-0,6769-32-6325,SNGL FAM SUB,8.98,AC,212000,0,212000,466300,25600,703900,202000,0,202000,425700,25000,652700,A2,AG/LTD,,,
7621,30-13-A-12-0,6769-32-6919,SNGL FAM SUB,8.72,AC,212000,0,212000,1345100,0,1557100,202000,0,202000,1271400,0,1473400,A2,AG/LTD,,,
7622,30-13-A-13-0,6769-33-2032,SNGL FAM SUB,8.46,AC,212000,0,212000,734800,0,946800,202000,0,202000,638800,0,840800,A2,AG/LTD,,,
7623,30-13-A-14-0,6769-22-9704,SNGL FAM SUB,8.41,AC,212000,0,212000,0,0,212000,202000,0,202000,0,0,202000,A2,AG/LTD,,,
7624,30-13-A-15-0,6769-22-5466,SNGL FAM SUB,8.59,AC,212000,0,212000,633200,33900,879100,202000,0,202000,583800,30300,816100,A2,AG/LTD,,,
7625,30-13-A-16-0,6769-22-1342,SNGL FAM SUB,8.36,AC,212000,0,212000,659800,0,871800,202000,0,202000,595800,0,797800,A2,AG/LTD,,,
7626,30-13-A-17-0,6769-21-1361,SNGL FAM SUB,9,AC,190800,0,190800,0,0,190800,181800,0,181800,0,0,181800,A2,AG/LTD,,,
7627,30-13-A-18-0,6769-21-6651,SNGL FAM SUB,8.32,AC,212000,0,212000,904300,24000,1140300,202000,0,202000,0,0,202000,A2,AG/LTD,,,
7628,30-13-A-19-0,6769-31-0796,SNGL FAM SUB,8.37,AC,212000,0,212000,837500,57800,1107300,202000,0,202000,763000,0,965000,A2,AG/LTD,,,
7629,30-13-A-20-0,6769-31-4945,SNGL FAM SUB,8.54,AC,212000,0,212000,0,0,212000,202000,0,202000,0,0,202000,A2,AG/LTD,,,
7630,30-13-A-21-0,6769-11-6790,SNGL FAM SUB,15.21,AC,181300,0,181300,0,0,181300,172700,0,172700,0,0,172700,A2,AG/LTD,,,
7631,30-13-A-22-0,6769-12-4328,SNGL FAM SUB,13.17,AC,145800,0,145800,0,0,145800,139300,0,139300,0,0,139300,A2,AG/LTD,,,
7632,30-13-B-1-0,6769-43-0554,SNGL FAM SUB,9.08,AC,180000,0,180000,408900,52600,641500,172000,0,172000,381300,44800,598100,A2,AG/LTD,,,
7633,30-13-B-2-0,6769-33-7845,SNGL FAM SUB,9.82,AC,180000,0,180000,318100,1200,499300,172000,0,172000,289500,1300,462800,A2,AG/LTD,,,
7634,30-13-B-3-0,6769-33-1811,SNGL FAM SUB,9.22,AC,180000,0,180000,360700,3600,544300,172000,0,172000,324900,2500,499400,A2,AG/LTD,,,
7635,30-13-B-4-0,6769-23-6540,SNGL FAM SUB,9.9,AC,180000,0,180000,591300,58400,829700,172000,0,172000,531800,50000,753800,A2,AG/LTD,,,
7636,30-13-B-5-0,6769-24-6379,SNGL FAM SUB,9.42,AC,180000,0,180000,584900,36700,801600,172000,0,172000,533700,30400,736100,A2,AG/LTD,,,
7637,30-13-B-6-0,6769-34-1548,SNGL FAM SUB,8.65,AC,180000,0,180000,321700,22500,524200,172000,0,172000,292300,20100,484400,A2,AG/LTD,,,
7638,30-13-B-7-0,6769-34-6445,SNGL FAM SUB,9,AC,180000,0,180000,298700,8600,487300,172000,0,172000,274100,7600,453700,A2,AG/LTD,,,
7639,30-13-B-8-0,6769-44-0623,SNGL FAM SUB,11.89,AC,180000,0,180000,521100,7900,709000,172000,0,172000,475400,8200,655600,A2,AG/LTD,,,
7640,30-13-B-9-0,6769-35-9321,SNGL FAM SUB,9.43,AC,180000,0,180000,292200,2000,474200,172000,0,172000,267200,2100,441300,A2,AG/LTD,,,
7641,30-13-B-10-0,6769-35-9907,SNGL FAM SUB,9.18,AC,180000,0,180000,300700,3100,483800,172000,0,172000,267800,3400,443200,A2,AG/LTD,,,
7642,30-13-B-11-0,6769-36-3146,SNGL FAM SUB,8.48,AC,162000,0,162000,0,0,162000,154800,0,154800,0,0,154800,A2,AG/LTD,,,
7643,30-13-B-12-0,6769-35-3562,SNGL FAM SUB,9.1,AC,180000,0,180000,0,0,180000,172000,0,172000,0,0,172000,A2,AG/LTD,,,
7644,30-13-B-13-0,6769-25-9527,SNGL FAM SUB,12.19,AC,180000,0,180000,304600,16000,500600,172000,0,172000,279600,13900,465500,A2,AG/LTD,,,
7645,30-13-B-14-0,6769-25-4369,SNGL FAM SUB,12.09,AC,180000,0,180000,246500,8900,435400,172000,0,172000,225500,6500,404000,A2,AG/LTD,,,
7646,30-13-B-15-0,6769-23-0690,SNGL FAM SUB,10.25,AC,180000,0,180000,0,0,180000,172000,0,172000,0,0,172000,A2,AG/LTD,,,
7647,30-13-B-16-0,6769-13-4631,SNGL FAM SUB,10.45,AC,162000,0,162000,0,0,162000,154800,0,154800,0,0,154800,A2,AG/LTD,,,
7648,30-13-B-17-0,6769-13-2041,SNGL FAM SUB,9.42,AC,162000,0,162000,0,0,162000,154800,0,154800,0,0,154800,A2,AG/LTD,,,
7649,30-13-B-18-0,6769-13-9020,SNGL FAM SUB,9.24,AC,162000,0,162000,0,0,162000,154800,0,154800,0,0,154800,A2,AG/LTD,,,
7650,31-18-0-7-0,6769-41-2634,SNGL FAM SUB,4.535,AC,128800,0,128800,339600,800,469200,123100,0,123100,311100,800,435000,A2,AG/LTD,,,
7651,31-18-0-9-0,6769-42-5270,SNGL FAM SUB,2.209,AC,95200,0,95200,232900,1600,329700,91000,0,91000,210800,1700,303500,A2,AG/LTD,,,
7652,31-18-0-10-0,6769-42-0098,SNGL FAM SUB,2.64,AC,106400,0,106400,334700,1200,442300,101700,0,101700,305700,1300,408700,A2,AG/LTD,,,
7653,47-1-0-41-A,7716-98-0911,COMM & IND,1.164,AC,790200,0,790200,481700,45000,1316900,718300,0,718300,455500,30300,1204100,MPUD,MIXPUD,,,
7655,30-1-0-108-0,6769-14-6680,AG 20-100 AC,44.15,AC,459400,304500,154900,406800,700,866900,437800,290200,147600,369900,700,808400,A2,AG/LTD,,,
7656,47-1-0-21-A,7716-38-5108,SNGL FAM SUB,12.086,AC,372400,0,372400,340500,46000,758900,332300,0,332300,289000,40100,661400,A2,AG/LTD,,,
7657,47-1-0-22-0,7716-37-8727,SNGL FAM SUB,0.913,AC,94900,0,94900,0,0,94900,84700,0,84700,0,0,84700,A2,AG/LTD,,,
7658,42-3-0-3-0,6767-03-9931,SNGL FAM SUB,0.679,AC,70000,0,70000,144600,5100,219700,65000,0,65000,122100,5100,192200,R3,RES/GEN,,,
7659,28-1-0-103-0,6738-56-9625,SNGL FAM SUB,10,AC,110500,0,110500,152500,0,263000,108600,0,108600,126100,0,234700,A1,AG/GEN,,,
7660,63-3-E-1-0,7714-81-6569,SNGL FAM SUB,0,AC,70000,0,70000,347100,8100,425200,60000,0,60000,298300,8400,366700,R1,RES/LTD,,,
7661,63-3-B-F-0,7714-81-5598,SNGL FAM SUB,0.502,AC,9600,0,9600,0,0,9600,8300,0,8300,0,0,8300,R1,RES/LTD,,,
7662,28-6-0-1-0,6739-00-0270,SNGL FAM SUB,1,AC,40000,0,40000,66800,400,107200,39500,0,39500,56100,400,96000,A1,AG/GEN,,,
7663,47-1-0-14-0,7716-39-1540,SNGL FAM SUB,18.586,AC,635400,0,635400,0,3500,638900,566700,0,566700,0,3500,570200,A2,AG/LTD,,,
7664,43-6-0-2-C,6767-74-2263,SNGL FAM SUB,1.784,AC,73000,0,73000,90000,0,163000,65200,0,65200,74000,0,139200,A2,AG/LTD,,,
7665,43-7-0-6-0,6777-09-4712,SNGL FAM SUB,3.136,AC,69700,0,69700,0,0,69700,62100,0,62100,0,0,62100,A2,AG/LTD,,,
7666,43-7-0-6-A,6777-08-2709,SNGL FAM SUB,1,AC,64100,0,64100,129700,57100,250900,57200,0,57200,110100,48600,215900,A2,AG/LTD,,,
7667,67-2-D-24-0,7723-55-8899,SNGL FAM SUB,0,AC,184000,0,184000,530100,2500,716600,160000,0,160000,437600,2500,600100,R1,RES/LTD,,,
7668,38-10-0-2-0,6707-89-3484,SNGL FAM SUB,1,AC,38800,0,38800,0,0,38800,38000,0,38000,0,0,38000,A1,AG/GEN,,,
7669,38-10-0-3-0,6707-88-9925,SNGL FAM SUB,1,AC,33700,0,33700,5000,0,38700,33000,0,33000,5000,0,38000,A1,AG/GEN,,,
7670,4-6-0-6-0,6813-43-8793,SNGL FAM SUB,8.323,AC,66300,0,66300,166400,0,232700,65000,0,65000,139900,0,204900,A1,AG/GEN,,,
7671,38-1-0-19-0,6708-70-7248,SNGL FAM SUB,7,AC,69400,0,69400,0,0,69400,68000,0,68000,0,0,68000,A1,AG/GEN,,,
7672,19-1-0-50-C,6830-67-8963,SNGL FAM SUB,11.75,AC,90200,77800,12400,0,0,90200,84000,72500,11500,0,0,84000,A1,AG/GEN,,,
7673,57-26-0-2-0,7706-51-9467,SNGL FAM SUB,8.29,AC,340700,0,340700,706600,13500,1060800,296500,0,296500,609500,13500,919500,A2,AG/LTD,,,
7674,55-14-0-15-0,6786-20-9628,SNGL FAM SUB,9.42,AC,225400,0,225400,762300,35300,1023000,201400,0,201400,620300,32600,854300,A2,AG/LTD,,,
7675,5-3-0-27-0,6824-11-6696,SNGL FAM SUB,3.41,AC,55500,0,55500,259000,0,314500,54400,0,54400,218900,0,273300,A1,AG/GEN,,,
7676,2-3-0-19-0,6824-23-1107,SNGL FAM SUB,6.2,AC,61400,0,61400,0,0,61400,60100,0,60100,0,0,60100,A1,AG/GEN,,,
7677,5-3-0-2-0,6823-18-9306,SNGL FAM SUB,1.66,AC,48800,0,48800,268000,2000,318800,47800,0,47800,221100,2000,270900,A1,AG/GEN,,,
7678,67-1-0-14-A,7733-36-8201,SNGL FAM SUB,1.108,AC,265000,0,265000,490900,0,755900,220000,0,220000,396400,0,616400,R1,RES/LTD,,,
7679,56-1-0-6-0,6796-03-4922,AG 20-100 AC,45.259,AC,637600,615700,21900,0,10500,648100,637900,616800,21100,0,10500,648400,A2,AG/LTD,,,
7680,55-19-0-11-0,6776-86-7369,SNGL FAM SUB,2.512,AC,91000,0,91000,247600,21800,360400,81200,0,81200,205100,20700,307000,A2,AG/LTD,,,
7681,29-1-0-20-0,6749-11-7570,SNGL FAM SUB,16.66,AC,143000,135300,7700,0,0,143000,142200,135100,7100,0,0,142200,A1,AG/GEN,,,
7682,29-1-0-60-0,6749-21-8296,SNGL FAM SUB,5,AC,64600,62300,2300,0,0,64600,85100,83000,2100,0,0,85100,A1,AG/GEN,,,
7683,28-1-0-106-0,6738-86-5416,AG 20-100 AC,27.876,AC,61400,0,61400,142900,0,204300,58800,0,58800,123800,0,182600,A1,AG/GEN,,,
7684,28-1-0-111-0,6738-88-7546,AG 20-100 AC,55,AC,25400,0,25400,0,0,25400,23400,0,23400,0,0,23400,A1,AG/GEN,,,
7685,29-1-0-21-0,6748-18-5018,AG > 100 AC,524,AC,1527800,1221300,306500,300400,81200,1909400,1464600,1183900,280700,246300,73600,1784500,A1,AG/GEN,,,
7687,16-1-0-62-0,6800-15-8637,SNGL FAM SUB,1.87,AC,42800,0,42800,118100,1500,162400,41900,0,41900,104300,1500,147700,A1,AG/GEN,,,
7688,10-1-0-45-0,6811-32-0782,AG > 100 AC,212.8,AC,687500,546200,141300,115000,600,803100,673400,542500,130900,101000,600,775000,A1,AG/GEN,,,
7689,16-1-0-61-0,6800-16-9003,SNGL FAM SUB,5,AC,56300,15600,40700,137900,2000,196200,55100,15400,39700,117700,2000,174800,A1,AG/GEN,,,
7690,16-1-0-61-A,6800-25-9674,AG 20-100 AC,54,AC,137200,111600,25600,0,22200,159400,135000,112000,23000,0,17900,152900,A1,AG/GEN,,,
7691,47-1-0-101-0,7727-23-4492,SNGL FAM SUB,11.71,AC,106600,0,106600,0,0,106600,98800,0,98800,0,0,98800,B1A2,BS AND,,,
7692,48-1-0-31-0,7726-49-4478,AG 20-100 AC,52.36,AC,2111200,2085400,25800,0,0,2111200,1885000,1862600,22400,0,0,1885000,A2,AG/LTD,,,
7693,48-1-0-31-A,7726-49-9155,SNGL FAM SUB,5.14,AC,208000,0,208000,205000,600,413600,185900,0,185900,174000,600,360500,A2,AG/LTD,,,
7695,16-1-0-60-0,6800-37-0869,SNGL FAM SUB,15.32,AC,96800,50900,45900,297600,42600,437000,95300,51200,44100,263700,37900,396900,A1,AG/GEN,,,
7696,16-1-0-60-A,6800-38-4583,AG 20-100 AC,24.53,AC,112000,99800,12200,0,0,112000,105100,94600,10500,0,0,105100,A1,AG/GEN,,,
7697,16-1-0-60-B,6800-27-8651,SNGL FAM SUB,0.65,AC,2400,0,2400,0,0,2400,2300,0,2300,0,0,2300,A1,AG/GEN,,,
7698,47-1-0-33-0,7716-79-8168,COMM & IND,1.676,AC,1181900,0,1181900,41500,0,1223400,1074500,0,1074500,41500,0,1116000,B1,BUS/GEN,,,
7699,47-4-0-3-0,7727-33-5992,COMM & IND,1.24,AC,84700,84100,600,0,0,84700,80700,80200,500,0,0,80700,B1,BUS/GEN,,,
7700,58-3-A-16-0,7726-26-3378,SNGL FAM SUB,0,AC,88000,0,88000,148900,1300,238200,80000,0,80000,128600,1300,209900,RN,RESIDEN,,,
7701,7-1-0-12-0,6842-49-0895,SNGL FAM SUB,2,AC,47600,0,47600,0,0,47600,47000,0,47000,0,0,47000,A1,AG/GEN,,,
7702,62-16-0-B-5,7704-52-1667,AG 20-100 AC,48.99,AC,1084400,1060700,23700,0,8100,1092500,935700,914800,20900,0,8100,943800,A2,AG/LTD,,,
7703,62-16-0-C-3,7704-32-4099,AG 20-100 AC,87.3,AC,523800,481000,42800,0,0,523800,349200,311800,37400,0,0,349200,A2,AG/LTD,,,
7704,67-2-D-5-0,7723-55-7452,SNGL FAM SUB,0,AC,184000,0,184000,340900,1400,526300,160000,0,160000,260500,1400,421900,R1,RES/LTD,,,
7705,31-1-0-49-A,6769-85-2620,SNGL FAM SUB,5,AC,103400,0,103400,281200,70300,454900,92700,0,92700,233400,8000,334100,A2,AG/LTD,,,
7707,64-1-0-74-A,7734-33-7164,COMM & IND,38.88,AC,3639000,0,3639000,14243700,637900,18520600,3368200,0,3368200,14243700,553100,18165000,B1,BUS/GEN,,,
7708,67-9-0-A-0,7733-24-2833,SNGL FAM SUB,11.1,AC,553800,548700,5100,0,0,553800,481400,0,481400,0,0,481400,A2,AG/LTD,,,
7710,28-1-0-73-0,6739-15-7198,AG 20-100 AC,41.31,AC,265800,0,265800,64900,2200,332900,263000,0,263000,56400,2200,321600,A1,AG/GEN,,,
7711,28-1-0-74-0,6739-25-7249,SNGL FAM SUB,2.1,AC,55300,0,55300,0,0,55300,53300,0,53300,0,0,53300,A1,AG/GEN,,,
7712,56-12-0-B-0,6796-33-6826,AG 20-100 AC,22.06,AC,629200,446800,182400,766600,40100,1435900,546600,387500,159100,636800,40100,1223500,A2,AG/LTD,,,
7713,56-12-0-C-0,6796-14-5249,AG 20-100 AC,43.02,AC,615500,594200,21300,0,0,615500,535500,517100,18400,0,0,535500,A2,AG/LTD,,,
7714,56-12-0-E-0,6796-00-0910,AG 20-100 AC,69.68,AC,929300,894300,35000,0,0,929300,828300,798400,29900,0,0,828300,A2,AG/LTD,,,
7718,67-9-0-D-0,7733-24-7479,SNGL FAM SUB,0.25,AC,2000,1900,100,0,0,2000,1800,1700,100,0,0,1800,A2,AG/LTD,,,
7719,67-9-0-G-0,7733-34-1327,SNGL FAM SUB,0.18,AC,1500,1400,100,0,0,1500,1300,1200,100,0,0,1300,A2,AG/LTD,,,
7720,67-1-0-16-0,7733-21-0368,AG 20-100 AC,78.5,AC,423900,384300,39600,0,0,423900,369000,335300,33700,0,0,369000,A2,AG/LTD,,,
7721,67-1-0-16-A,7733-12-3338,AG 20-100 AC,22,AC,833400,822700,10700,0,0,833400,724300,714900,9400,0,0,724300,A2,AG/LTD,,,
7722,67-1-0-17-0,7733-22-8734,AG 20-100 AC,39.88,AC,1588000,1085400,502600,1054300,19100,2661400,1380500,943700,436800,904600,19600,2304700,A2,AG/LTD,,,
7723,67-1-0-18-0,7733-33-2600,SNGL FAM SUB,7.85,AC,376500,197100,179400,124100,21000,521600,327300,171300,156000,105000,21000,453300,A2,AG/LTD,,,
7724,67-5-0-1-0,7733-13-9100,SNGL FAM SUB,9.55,AC,495900,491400,4500,0,0,495900,431000,426900,4100,0,0,431000,A2,AG/LTD,,,
7725,67-5-0-2-0,7733-23-2966,AG 20-100 AC,27.35,AC,1032500,843300,189200,125300,118700,1276500,898800,734400,164400,104900,99000,1102700,A2,AG/LTD,,,
7726,67-9-0-C-0,7733-24-1429,SNGL FAM SUB,0.866,AC,7000,6600,400,0,0,7000,6100,5700,400,0,0,6100,A2,AG/LTD,,,
7728,62-16-0-A-4,7704-72-0343,COMM & IND,13.77,AC,522900,0,522900,0,0,522900,484100,0,484100,0,0,484100,A2,AG/LTD,,,
7729,28-1-0-73-E,6739-25-5476,SNGL FAM SUB,3,AC,60800,0,60800,0,0,60800,60300,0,60300,0,0,60300,A1,AG/GEN,,,
7730,58-23-0-3-0,7716-86-6691,SNGL FAM SUB,4.725,AC,231100,0,231100,397000,1200,629300,201000,0,201000,337200,1300,539500,A2,AG/LTD,,,
7731,9-1-0-36-A,5892-51-5944,SNGL FAM SUB,1.02,AC,38900,0,38900,172500,0,211400,38100,0,38100,149900,0,188000,A1,AG/GEN,,,
7732,9-1-0-36-B,5892-52-4141,SNGL FAM SUB,0.98,AC,34200,0,34200,0,0,34200,33500,0,33500,0,0,33500,A1,AG/GEN,,,
7733,26-21-0-1-0,6709-96-2651,SNGL FAM SUB,3.199,AC,51100,0,51100,147700,1400,200200,51200,0,51200,124900,1500,177600,A1,AG/GEN,,,
7734,26-1-0-8-0,6709-96-4317,SNGL FAM SUB,4.458,AC,60300,0,60300,207000,16500,283800,58700,0,58700,169900,16000,244600,A1,AG/GEN,,,
7735,17-1-0-18-T,6709-88-5855-9999,AG > 100 AC,182.8,AC,194400,0,194400,0,0,194400,183500,0,183500,0,0,183500,A1,AG/GEN,,,
7736,26-21-0-2-0,6709-85-7592,AG 20-100 AC,23.733,AC,126700,73500,53200,353000,0,479700,97900,0,97900,295900,0,393800,A1,AG/GEN,,,
7737,26-21-0-3-0,6709-95-4430,SNGL FAM SUB,3.165,AC,51700,0,51700,0,0,51700,109900,0,109900,0,0,109900,A1,AG/GEN,,,
7738,17-1-0-26-0,6709-69-1654,AG 20-100 AC,21.366,AC,16700,0,16700,0,0,16700,14200,0,14200,0,0,14200,A1,AG/GEN,,,
7739,26-1-0-67-B,6719-06-2338,SNGL FAM SUB,5.5,AC,66100,0,66100,0,0,66100,65000,0,65000,0,0,65000,A1,AG/GEN,,,
7740,47-15-0-2-0,7718-51-9354,SNGL FAM SUB,0.947,AC,98400,0,98400,204500,500,303400,87900,0,87900,170100,500,258500,A2,AG/LTD,,,
7741,51-6-0-B-2,6745-05-2968,AG > 100 AC,155.83,AC,613300,538000,75300,0,0,613300,548500,481900,66600,0,0,548500,A1,AG/GEN,,,
7742,52-1-0-2-0,6745-25-0164,AG > 100 AC,146.34,AC,292700,223800,68900,0,0,292700,292700,230400,62300,0,0,292700,A1,AG/GEN,,,
7744,25-1-0-5-D,6708-09-6323,AG 20-100 AC,74.83,AC,213600,119600,94000,953500,113600,1280700,210200,122100,88100,887500,111200,1208900,A1,AG/GEN,,,
7745,25-1-0-6-0,5798-57-7606,AG > 100 AC,103.326,AC,943400,0,943400,0,0,943400,923700,0,923700,0,0,923700,A1,AG/GEN,,,
7746,58-1-0-87-0,7716-95-6029,Roads,1.159,AC,0,0,0,0,0,0,0,0,0,0,0,0,RPUD,RES/PUD,,,
7748,11-1-0-52-0,6822-53-7354,SNGL FAM SUB,3.11,AC,50500,0,50500,143300,5700,199500,49600,0,49600,120100,13600,183300,A1,AG/GEN,,,
7749,60-4-0-5-0,6784-19-9095,SNGL FAM SUB,5.22,AC,241600,0,241600,588400,26000,856000,215600,0,215600,479800,26000,721400,A2,AG/LTD,,,
7750,42-1-0-116-A,6767-10-3247,SNGL FAM SUB,18.086,AC,279500,0,279500,545500,125300,950300,206900,0,206900,446300,117000,770200,A2R3,AGRIC.R,,,
7752,31-14-0-2-0,6768-96-1871,SNGL FAM SUB,4.406,AC,106700,0,106700,274400,900,382000,95300,0,95300,225400,1000,321700,A2,AG/LTD,,,
7753,31-14-0-3-0,6768-86-8880,SNGL FAM SUB,3.258,AC,92300,0,92300,213800,4000,310100,82500,0,82500,175800,4000,262300,A2,AG/LTD,,,
7754,50-5-0-4-0,6726-44-6522,SNGL FAM SUB,8.26,AC,70300,0,70300,0,0,70300,66900,0,66900,0,0,66900,A1,AG/GEN,,,
7755,62-17-B-3-0,7714-05-0911,SNGL FAM SUB,0,AC,115000,0,115000,166700,2500,284200,100000,0,100000,151200,2500,253700,R1,RES/LTD,,,
7756,62-2-A-8-0,7704-94-2046,SNGL FAM SUB,0,AC,115000,0,115000,284600,800,400400,100000,0,100000,257500,800,358300,R1,RES/LTD,,,
7758,62-2-A-9-0,7704-94-1161,SNGL FAM SUB,0,AC,115000,0,115000,142200,500,257700,100000,0,100000,130100,500,230600,R1,RES/LTD,,,
7759,10-5-0-3-0,6812-36-3977,SNGL FAM SUB,2.243,AC,46000,0,46000,144700,14700,205400,45200,0,45200,124200,13600,183000,A1,AG/GEN,,,
7760,58-2-0-1-0,7726-26-7836,SNGL FAM SUB,1.331,AC,132000,0,132000,168700,11100,311800,120000,0,120000,145000,9800,274800,R3,RES/GEN,,,
7761,43-1-0-81-0,6777-01-6250,SNGL FAM SUB,4.593,AC,121800,0,121800,228400,19500,369700,109000,0,109000,188200,16800,314000,A2,AG/LTD,,,
7762,33-4-0-9-0,6798-63-3270,SNGL FAM SUB,2.02,AC,90800,0,90800,248300,5000,344100,81000,0,81000,204500,5000,290500,A2,AG/LTD,,,
7763,58-2-0-2-0,7726-26-7754,SNGL FAM SUB,0,AC,88000,0,88000,198800,0,286800,80000,0,80000,170700,0,250700,RN,RESIDEN,,,
7764,58-2-0-3-0,7726-26-8604,SNGL FAM SUB,0,AC,88000,0,88000,0,0,88000,80000,0,80000,0,0,80000,RN,RESIDEN,,,
7765,32-6-0-B-0,6778-72-9035,SNGL FAM SUB,5.64,AC,117000,0,117000,0,0,117000,104500,0,104500,0,0,104500,A2,AG/LTD,,,
7766,9-1-0-9-0,5892-64-9992,SNGL FAM SUB,5,AC,42500,0,42500,0,0,42500,40500,0,40500,0,0,40500,A1,AG/GEN,,,
7767,33-4-0-5-0,6798-53-8608,SNGL FAM SUB,2.1,AC,91900,0,91900,189800,1500,283200,82000,0,82000,154200,1500,237700,A2,AG/LTD,,,
7768,18-1-0-21-0,6719-67-8441,AG 20-100 AC,44.05,AC,190100,119000,71100,308200,26700,525000,188700,120900,67800,266600,23400,478700,A1,AG/GEN,,,
7769,18-1-0-22-0,6810-50-8979,SNGL FAM SUB,5,AC,63500,16100,47400,397200,2300,463000,60000,15200,44800,331600,2300,393900,A1,AG/GEN,,,
7770,18-1-0-22-A,6719-68-2286,SNGL FAM SUB,1.58,AC,7600,6900,700,0,0,7600,7100,6400,700,0,0,7100,A1,AG/GEN,,,
7772,28-1-0-100-A,6738-55-3933,SNGL FAM SUB,4,AC,70300,0,70300,112100,10400,192800,69300,0,69300,91900,10500,171700,A1,AG/GEN,,,
7773,27-1-0-80-C,6728-54-0565,SNGL FAM SUB,2,AC,44400,0,44400,74000,0,118400,43500,0,43500,77900,0,121400,A1,AG/GEN,,,
7774,20-3-0-2-0,6840-35-1383,SNGL FAM SUB,8,AC,101300,0,101300,0,0,101300,95800,0,95800,0,0,95800,A1,AG/GEN,,,
7775,32-1-0-24-0,6779-81-1887,AG 20-100 AC,52.14,AC,594400,570000,24400,0,0,594400,531800,509600,22200,0,0,531800,A2,AG/LTD,,,
7776,32-1-0-57-0,6788-09-5314,AG 20-100 AC,49.67,AC,536400,512900,23500,0,0,536400,476800,455600,21200,0,0,476800,A2,AG/LTD,,,
7777,41-1-0-8-C,6757-09-7378,SNGL FAM SUB,2,AC,56900,0,56900,165900,2200,225000,52700,0,52700,139700,2200,194600,A1,AG/GEN,,,
7778,38-3-0-6-0,6717-25-0194,SNGL FAM SUB,18,AC,107200,98900,8300,0,0,107200,105100,97400,7700,0,0,105100,A1,AG/GEN,,,
7779,38-3-0-8-0,6717-25-6772,AG 20-100 AC,27,AC,136500,124100,12400,0,0,136500,133500,122000,11500,0,0,133500,A1,AG/GEN,,,
7780,44-20-0-1-0,6787-52-0857,SNGL FAM SUB,3.6,AC,111200,0,111200,279000,16700,406900,99300,0,99300,224000,15000,338300,A2,AG/LTD,,,
7782,44-1-0-34-B,6787-13-5464,SNGL FAM SUB,1.23,AC,73700,0,73700,127000,0,200700,65800,0,65800,104800,0,170600,A2,AG/LTD,,,
7783,27-5-0-3-C,6728-76-1771,SNGL FAM SUB,5.54,AC,68800,0,68800,0,0,68800,67500,0,67500,0,0,67500,A1,AG/GEN,,,
7785,44-20-0-2-0,6787-42-8717,SNGL FAM SUB,3.61,AC,111300,0,111300,361000,2600,474900,99400,0,99400,293700,2800,395900,A2,AG/LTD,,,
7786,4-2-0-31-0,6814-40-7792,SNGL FAM SUB,3.37,AC,52300,0,52300,193400,2500,248200,51200,0,51200,164000,2500,217700,A1,AG/GEN,,,
7787,30-1-0-19-0,6759-11-6450,SNGL FAM SUB,7.45,AC,64500,0,64500,0,0,64500,61800,0,61800,0,0,61800,A1,AG/GEN,,,
7788,32-1-0-22-0,6779-91-0410,SNGL FAM SUB,6.6,AC,144700,77700,67000,167200,900,312800,129400,69800,59600,134200,900,264500,A2,AG/LTD,,,
7789,32-1-0-23-0,6779-81-9272,SNGL FAM SUB,3,AC,92900,0,92900,0,0,92900,83000,0,83000,0,0,83000,A2,AG/LTD,,,
7790,25-1-0-8-0,6708-15-8579,SNGL FAM SUB,6.76,AC,65300,0,65300,142500,18900,226700,63900,0,63900,121900,17300,203100,A1,AG/GEN,,,
7791,25-1-0-8-A,6708-46-7097,Academic-Private,152.25,AC,495600,0,495600,0,0,495600,486100,0,486100,0,0,486100,A1,AG/GEN,,,
7945,47-25-0-5-0,7717-90-8588,SNGL FAM SUB,1.2,AC,126200,0,126200,322700,1800,450700,112600,0,112600,270100,1300,384000,A2,AG/LTD,,,
7946,30-1-0-70-0,6759-80-7593,SNGL FAM SUB,1.01,AC,48700,0,48700,207400,0,256100,45000,0,45000,177200,0,222200,A2,AG/LTD,,,
7947,55-19-0-9-0,6776-86-5017,SNGL FAM SUB,2.224,AC,87000,0,87000,242300,1500,330800,77700,0,77700,198000,1500,277200,A2,AG/LTD,,,
7948,55-19-0-10-0,6776-86-5324,SNGL FAM SUB,2.072,AC,84900,0,84900,341200,0,426100,75800,0,75800,294600,0,370400,A2,AG/LTD,,,
7949,57-1-0-75-B,7706-65-2960,SNGL FAM SUB,9.047,AC,376700,0,376700,515900,0,892600,327600,0,327600,428400,0,756000,A2,AG/LTD,,,
7950,45-1-0-74-0,6796-88-1664,AG > 100 AC,314.05,AC,5336100,4774300,561800,698400,133500,6168000,4642700,4150400,492300,584200,133500,5360400,A2,AG/LTD,,,
7951,56-1-0-60-0,6796-55-7173,SNGL FAM SUB,1.98,AC,169000,0,169000,896400,30000,1095400,146900,0,146900,765600,30000,942500,A2,AG/LTD,,,
7952,56-1-0-50-0,6796-25-2287,AG 20-100 AC,71,AC,141000,0,141000,102600,1500,245100,124100,0,124100,86600,1500,212200,A2,AG/LTD,,,
7953,56-1-0-50-A,6796-35-6918,AG 20-100 AC,23,AC,33800,0,33800,0,0,33800,29300,0,29300,0,0,29300,A2,AG/LTD,,,
7954,56-1-0-51-0,6796-26-1427,AG 20-100 AC,45.2,AC,21300,0,21300,0,0,21300,19300,0,19300,0,0,19300,A2,AG/LTD,,,
8112,12-14-0-G-0,6821-77-6509,SNGL FAM SUB,14.49,AC,80800,0,80800,0,0,80800,78200,0,78200,0,0,78200,A1,AG/GEN,,,
8113,5-1-0-22-0,6812-99-8585,SNGL FAM SUB,4.12,AC,55600,0,55600,183300,19500,258400,54600,0,54600,159700,19500,233800,A1,AG/GEN,,,
8114,58-1-0-50-0,7715-62-3891,SNGL FAM SUB,3.07,AC,138600,0,138600,81700,1000,221300,120500,0,120500,69500,1000,191000,A2,AG/LTD,,,
8115,6-1-0-60-A,6832-49-9602,SNGL FAM SUB,11.7,AC,95200,0,95200,0,0,95200,92900,0,92900,0,0,92900,A1,AG/GEN,,,
8116,6-1-0-60-B,6832-59-7964,SNGL FAM SUB,1.89,AC,9300,0,9300,0,0,9300,9100,0,9100,0,0,9100,A1,AG/GEN,,,
8117,6-1-0-60-E,6833-60-2389,SNGL FAM SUB,1.19,AC,5800,0,5800,0,0,5800,5700,0,5700,0,0,5700,A1,AG/GEN,,,
8118,39-1-0-61-0,6716-88-7509,AG 20-100 AC,22.3,AC,127100,116800,10300,0,0,127100,124400,114900,9500,0,0,124400,A1,AG/GEN,,,
8119,39-1-0-62-0,6726-08-0414,AG 20-100 AC,20,AC,135700,126500,9200,0,0,135700,133000,124500,8500,0,0,133000,A1,AG/GEN,,,
8120,42-1-0-28-0,6766-08-7140,SNGL FAM SUB,4.144,AC,109100,0,109100,379300,27000,515400,97600,0,97600,343800,21100,462500,A2,AG/LTD,,,
8121,42-1-0-29-0,6766-08-4183,SNGL FAM SUB,1.569,AC,19200,0,19200,0,0,19200,17100,0,17100,0,0,17100,A2,AG/LTD,,,
8122,42-19-0-9-0,6766-18-8376,SNGL FAM SUB,1.55,AC,64500,0,64500,0,0,64500,58800,0,58800,0,0,58800,R3A2,RES GEN,,,
8123,42-19-0-10-0,6766-18-9152,SNGL FAM SUB,2.56,AC,80600,0,80600,0,0,80600,72000,0,72000,0,0,72000,R3A2,RES GEN,,,
8124,58-3-A-26-0,7726-27-2060,SNGL FAM SUB,0,AC,88000,0,88000,164200,2200,254400,80000,0,80000,135500,2200,217700,RN,RESIDEN,,,
8125,17-1-0-20-A,6709-68-4840,SNGL FAM SUB,1.27,AC,40300,0,40300,164300,4100,208700,39500,0,39500,140600,4400,184500,A1,AG/GEN,,,
8126,6-1-0-14-0,6823-93-2421,SNGL FAM SUB,17.96,AC,99900,0,99900,0,0,99900,98100,0,98100,0,0,98100,A1,AG/GEN,,,
7792,25-1-0-8-B,6708-16-0037,AG 20-100 AC,43.1,AC,129300,108100,21200,0,0,129300,129300,110900,18400,0,0,129300,A1,AG/GEN,,,
7794,32-1-0-33-D,6778-66-7382,SNGL FAM SUB,2,AC,76600,0,76600,154500,5400,236500,68400,0,68400,125400,3900,197700,A2,AG/LTD,,,
7795,32-1-0-33-0,6778-76-0834,SNGL FAM SUB,3.001,AC,89100,0,89100,93300,12300,194700,79600,0,79600,77800,9700,167100,A2,AG/LTD,,,
7796,30-1-0-10-B,6759-53-1576,SNGL FAM SUB,2.11,AC,65100,0,65100,165900,1000,232000,61400,0,61400,140600,1000,203000,A2,AG/LTD,,,
7797,57-10-0-32-0,7705-57-9051,SNGL FAM SUB,3.35,AC,230000,0,230000,317900,0,547900,210000,0,210000,298100,0,508100,A2,AG/LTD,,,
7798,16-1-0-87-0,6800-31-3339,SNGL FAM SUB,4.261,AC,57100,0,57100,65400,2100,124600,55900,0,55900,52400,900,109200,A1,AG/GEN,,,
7799,63-18-0-2-A,7714-44-1740,SNGL FAM SUB,2.52,AC,156000,0,156000,26500,800,183300,135700,0,135700,21800,800,158300,R3,RES/GEN,,,
7800,62-4-D-11-0,7714-04-9771,SNGL FAM SUB,0,AC,115000,0,115000,185800,5200,306000,100000,0,100000,169400,3600,273000,R1,RES/LTD,,,
7801,62-4-D-12-0,7714-04-9862,SNGL FAM SUB,0,AC,80500,0,80500,0,0,80500,80000,0,80000,0,0,80000,R1,RES/LTD,,,
7802,62-1-0-31-B,7714-14-1731,SNGL FAM SUB,1,AC,25600,0,25600,0,0,25600,22300,0,22300,0,0,22300,R1,RES/LTD,,,
7803,47-1-0-11-0,7717-23-6575,SNGL FAM SUB,1.27,AC,97200,0,97200,68800,500,166500,86700,0,86700,59300,500,146500,A2,AG/LTD,,,
7804,14-2-0-14-0,6851-27-6700,SNGL FAM SUB,3.27,AC,68800,0,68800,174400,2000,245200,67400,0,67400,164600,2100,234100,A1,AG/GEN,,,
7805,47-25-0-6-0,7717-90-9744,SNGL FAM SUB,1.05,AC,127600,0,127600,302900,1800,432300,114000,0,114000,253400,1300,368700,A2,AG/LTD,,,
7806,58-22-A-12-0,7715-28-9155,SNGL FAM SUB,4.724,AC,480000,0,480000,1166300,17000,1663300,440000,0,440000,1055700,12800,1508500,A2,AG/LTD,,,
7807,2-1-0-8-0,6814-87-5025,COMM & IND,16.72,AC,376600,0,376600,0,0,376600,365800,0,365800,0,0,365800,B1A1,BS & AG,,,
7808,67-3-F-7-0,7723-54-2302,SNGL FAM SUB,0,AC,92000,0,92000,0,0,92000,80000,0,80000,0,0,80000,R1,RES/LTD,,,
7809,67-3-F-8-0,7723-54-1135,SNGL FAM SUB,0,AC,92000,0,92000,0,0,92000,80000,0,80000,0,0,80000,R1,RES/LTD,,,
7810,67-3-F-9-0,7723-53-0966,SNGL FAM SUB,0,AC,184000,0,184000,428000,4900,616900,160000,0,160000,363600,4300,527900,R1,RES/LTD,,,
7812,62-4-E-1-0,7714-04-7537,SNGL FAM SUB,0,AC,115000,0,115000,232400,800,348200,100000,0,100000,213100,800,313900,R1,RES/LTD,,,
7813,62-3-D-5-0,7714-04-6089,SNGL FAM SUB,0,AC,115000,0,115000,294300,22100,431400,100000,0,100000,268000,18600,386600,R1,RES/LTD,,,
7814,44-2-0-7-0,6787-73-6912,SNGL FAM SUB,1.48,AC,73200,0,73200,0,0,73200,65400,0,65400,0,0,65400,A2,AG/LTD,,,
7816,6-9-0-19-0,6833-61-4323,SNGL FAM SUB,2.28,AC,46400,0,46400,14700,3700,64800,45500,0,45500,17300,2500,65300,A1,AG/GEN,,,
7817,2-3-0-13-0,6824-24-4156,SNGL FAM SUB,4.04,AC,53800,0,53800,0,0,53800,52600,0,52600,0,0,52600,A1,AG/GEN,,,
7818,2-3-0-14-0,6824-24-2236,SNGL FAM SUB,3.79,AC,52400,0,52400,0,0,52400,51300,0,51300,0,0,51300,A1,AG/GEN,,,
7819,64-15-A-6-0,7733-37-4550,SNGL FAM SUB,0,AC,265000,0,265000,490700,16200,771900,220000,0,220000,431200,16800,668000,R1,RES/LTD,,,
7820,63-11-0-A-6,7714-54-9952,SNGL FAM SUB,4,AC,195800,0,195800,333800,19500,549100,170300,0,170300,280700,16700,467700,A2,AG/LTD,,,
7823,45-18-0-2-0,6797-47-6293,SNGL FAM SUB,8.012,AC,200000,0,200000,291300,0,491300,180000,0,180000,272500,0,452500,A2,AG/LTD,,,
7824,45-18-0-4-0,6797-46-4530,SNGL FAM SUB,8.012,AC,170000,0,170000,409800,71200,651000,153000,0,153000,407900,16500,577400,A2,AG/LTD,,,
7825,45-18-0-5-0,6797-35-9646,SNGL FAM SUB,8.228,AC,240000,0,240000,437600,53000,730600,216000,0,216000,395100,50100,661200,A2,AG/LTD,,,
7826,45-18-0-10-0,6797-44-5145,SNGL FAM SUB,8.012,AC,200000,0,200000,590100,17400,807500,180000,0,180000,545600,15900,741500,A2,AG/LTD,,,
7827,45-18-0-11-0,6797-44-2750,SNGL FAM SUB,9.928,AC,240000,0,240000,341000,4300,585300,216000,0,216000,312100,3900,532000,A2,AG/LTD,,,
7828,45-18-0-12-0,6797-34-8638,SNGL FAM SUB,9.874,AC,240000,0,240000,612300,2500,854800,216000,0,216000,560100,2700,778800,A2,AG/LTD,,,
7829,45-18-0-13-0,6797-34-2593,SNGL FAM SUB,8.012,AC,200000,0,200000,332400,2600,535000,180000,0,180000,303300,2800,486100,A2,AG/LTD,,,
7830,45-18-0-14-0,6797-34-6107,SNGL FAM SUB,3.278,AC,170000,0,170000,416300,20000,606300,153000,0,153000,381800,16800,551600,A2,AG/LTD,,,
7831,45-18-0-16-0,6797-33-1968,SNGL FAM SUB,4.524,AC,200000,0,200000,297100,3300,500400,180000,0,180000,272600,2800,455400,A2,AG/LTD,,,
7832,45-18-0-18-0,6797-24-3281,SNGL FAM SUB,8.012,AC,200000,0,200000,360000,1000,561000,180000,0,180000,328400,1000,509400,A2,AG/LTD,,,
7833,45-18-0-19-0,6797-14-8164,SNGL FAM SUB,8.012,AC,200000,0,200000,329200,6700,535900,180000,0,180000,306400,5700,492100,A2,AG/LTD,,,
7834,45-18-0-20-0,6797-13-4654,SNGL FAM SUB,8.012,AC,200000,0,200000,606100,3400,809500,180000,0,180000,551300,0,731300,A2,AG/LTD,,,
7835,45-18-0-21-0,6797-13-7352,SNGL FAM SUB,8.012,AC,200000,0,200000,524900,19400,744300,180000,0,180000,481200,18700,679900,A2,AG/LTD,,,
7836,45-18-0-22-0,6797-23-2335,SNGL FAM SUB,8.127,AC,200000,0,200000,426000,100400,726400,180000,0,180000,387800,90200,658000,A2,AG/LTD,,,
7838,45-18-0-24-0,6797-23-9315,SNGL FAM SUB,4.739,AC,200000,0,200000,294800,16600,511400,180000,0,180000,271500,16300,467800,A2,AG/LTD,,,
7839,45-18-0-26-0,6797-33-5217,SNGL FAM SUB,5.01,AC,200000,0,200000,380500,2300,582800,180000,0,180000,351000,1600,532600,A2,AG/LTD,,,
7840,45-18-0-27-0,6797-33-7288,SNGL FAM SUB,5.321,AC,200000,0,200000,324800,3600,528400,180000,0,180000,302400,3200,485600,A2,AG/LTD,,,
7841,45-18-0-28-0,6797-43-1208,SNGL FAM SUB,8.012,AC,200000,0,200000,286900,22900,509800,180000,0,180000,269100,21600,470700,A2,AG/LTD,,,
7842,45-18-0-29-0,6797-43-4265,SNGL FAM SUB,8.012,AC,200000,0,200000,264700,0,464700,180000,0,180000,242100,0,422100,A2,AG/LTD,,,
7843,45-18-0-30-0,6797-43-8231,SNGL FAM SUB,8.498,AC,200000,0,200000,650800,43600,894400,180000,0,180000,560700,41400,782100,A2,AG/LTD,,,
7844,45-18-0-31-0,6797-53-0426,SNGL FAM SUB,5.187,AC,200000,0,200000,403600,0,603600,180000,0,180000,353700,0,533700,A2,AG/LTD,,,
7845,45-18-0-36-0,6797-55-4355,SNGL FAM SUB,3.087,AC,170000,0,170000,361100,17000,548100,153000,0,153000,335200,17700,505900,A2,AG/LTD,,,
7846,45-18-0-37-0,6797-55-4770,SNGL FAM SUB,5.554,AC,200000,0,200000,480000,41000,721000,180000,0,180000,436900,34800,651700,A2,AG/LTD,,,
7847,45-18-0-38-0,6797-56-1272,SNGL FAM SUB,9.542,AC,200000,0,200000,384100,25000,609100,180000,0,180000,350600,22900,553500,A2,AG/LTD,,,
7848,45-18-0-39-0,6797-56-3718,SNGL FAM SUB,8.012,AC,200000,0,200000,483100,31600,714700,180000,0,180000,443800,31300,655100,A2,AG/LTD,,,
7849,45-18-0-40-0,6797-57-5210,SNGL FAM SUB,3.926,AC,170000,0,170000,306900,3500,480400,153000,0,153000,281600,2900,437500,A2,AG/LTD,,,
7850,62-20-B-6-0,7714-15-5860,SNGL FAM SUB,0,AC,115000,0,115000,256400,18600,390000,100000,0,100000,233600,15800,349400,R1,RES/LTD,,,
7851,26-4-0-2-B2,6719-41-6344,SNGL FAM SUB,2,AC,46000,0,46000,221400,1800,269200,44000,0,44000,179400,1800,225200,A1,AG/GEN,,,
7852,62-18-0-16-0,7704-63-8604,SNGL FAM SUB,3.51,AC,231000,0,231000,399600,83300,713900,200300,0,200300,395000,80200,675500,A2,AG/LTD,,,
7853,13-1-0-39-B,6841-94-0324,SNGL FAM SUB,3.144,AC,63500,0,63500,253900,4400,321800,57200,0,57200,241600,3100,301900,A1,AG/GEN,,,
7855,30-1-0-74-A,6758-99-0092,SNGL FAM SUB,1.48,AC,60000,0,60000,168500,10900,239400,54900,0,54900,138700,8800,202400,A2,AG/LTD,,,
7856,51-2-0-1-0,6736-41-3611,SNGL FAM SUB,2.183,AC,41500,0,41500,53000,0,94500,40700,0,40700,45900,0,86600,A1,AG/GEN,,,
7857,51-3-0-D-0,6736-40-5934,SNGL FAM SUB,1.317,AC,36700,0,36700,0,0,36700,35900,0,35900,0,0,35900,A1,AG/GEN,,,
7858,51-9-0-A-0,6736-50-1947,SNGL FAM SUB,2.65,AC,45000,0,45000,57600,0,102600,44100,0,44100,50900,0,95000,A1,AG/GEN,,,
7859,31-17-0-8-0,6779-53-2440,SNGL FAM SUB,8.205,AC,126000,0,126000,175900,25200,327100,112300,0,112300,142700,20400,275400,A2,AG/LTD,,,
7860,15-1-0-6-0,5880-78-1038,SNGL FAM SUB,2,AC,36100,0,36100,9600,3500,49200,34400,0,34400,10100,3500,48000,A1,AG/GEN,,,
7861,39-1-0-68-B,6726-06-5459,SNGL FAM SUB,0.52,AC,3200,0,3200,0,0,3200,3100,0,3100,0,0,3100,A1,AG/GEN,,,
7862,50-1-0-3-0,6726-06-6390,SNGL FAM SUB,3.83,AC,56100,0,56100,89300,500,145900,55000,0,55000,76100,500,131600,A1,AG/GEN,,,
7863,43-18-0-1-0,6777-39-9169,SNGL FAM SUB,3,AC,98900,0,98900,157300,100,256300,88400,0,88400,130000,100,218500,A2,AG/LTD,,,
7865,44-16-0-3-0,6788-20-8512,SNGL FAM SUB,1.64,AC,116100,0,116100,179600,11300,307000,103500,0,103500,162200,12500,278200,A2,AG/LTD,,,
7866,19-1-0-62-0,6830-81-0787,SNGL FAM SUB,19.41,AC,176400,166500,9900,0,7600,184000,164000,155700,8300,0,7600,171600,A1,AG/GEN,,,
7867,19-1-0-59-0,6830-82-4637,SNGL FAM SUB,2.046,AC,64200,0,64200,190200,9000,263400,60800,0,60800,156200,9000,226000,A1,AG/GEN,,,
7868,7-1-0-4-0,6843-20-2980,SNGL FAM SUB,12.22,AC,92700,0,92700,137400,2500,232600,90400,0,90400,123700,1900,216000,A1,AG/GEN,,,
7869,51-2-0-1-C,6736-41-2236,SNGL FAM SUB,1.72,AC,38900,0,38900,1800,0,40700,38200,0,38200,2100,0,40300,A1,AG/GEN,,,
7870,51-1-0-52-C,6736-51-0860,SNGL FAM SUB,4.189,AC,52800,0,52800,0,0,52800,51700,0,51700,0,0,51700,A1,AG/GEN,,,
7871,51-1-0-53-0,6736-52-4469,SNGL FAM SUB,5.75,AC,59600,0,59600,300000,1300,360900,58400,0,58400,263800,1300,323500,A1,AG/GEN,,,
7872,39-6-0-4-0,6726-17-6252,SNGL FAM SUB,1,AC,38800,0,38800,0,0,38800,38000,0,38000,0,0,38000,A1,AG/GEN,,,
7873,39-6-0-5-0,6726-17-7335,SNGL FAM SUB,1,AC,38800,0,38800,105000,0,143800,38000,0,38000,85300,0,123300,A1,AG/GEN,,,
7874,39-6-0-6-0,6726-17-7570,SNGL FAM SUB,1,AC,38800,0,38800,173200,5100,217100,38000,0,38000,146100,5100,189200,A1,AG/GEN,,,
7876,13-1-0-39-0,6841-94-4548,SNGL FAM SUB,1.4,AC,53400,0,53400,42000,4100,99500,52400,0,52400,37400,3600,93400,A1,AG/GEN,,,
7877,57-10-0-22-0,7705-77-3278,SNGL FAM SUB,5.46,AC,265000,0,265000,501100,200,766300,240000,0,240000,465000,200,705200,A2,AG/LTD,,,
7878,50-1-0-4-A,6726-06-5021,SNGL FAM SUB,4,AC,55600,0,55600,154200,11800,221600,54500,0,54500,137200,11500,203200,A1,AG/GEN,,,
7879,40-1-0-4-0,6738-30-4236,SNGL FAM SUB,19.16,AC,148300,0,148300,0,0,148300,144300,0,144300,0,0,144300,A1,AG/GEN,,,
7880,51-2-0-1-B,6736-41-5610,SNGL FAM SUB,3.03,AC,46300,0,46300,64600,38500,149400,45400,0,45400,55500,32500,133400,A1,AG/GEN,,,
7881,15-5-0-22-0,5789-69-4113,SNGL FAM SUB,8.12,AC,64400,0,64400,0,0,64400,62900,0,62900,0,0,62900,A1,AG/GEN,,,
7882,16-1-0-27-0,5890-42-0821,AG 20-100 AC,21.75,AC,55300,0,55300,0,0,55300,54400,0,54400,0,0,54400,A1,AG/GEN,,,
7883,51-1-0-40-C,6726-92-7365,SNGL FAM SUB,6.7,AC,70700,0,70700,81800,4100,156600,69400,0,69400,68800,4100,142300,A1,AG/GEN,,,
7884,58-23-0-6-0,7716-97-6011,SNGL FAM SUB,3.647,AC,207000,0,207000,400700,1500,609200,180100,0,180100,339500,1500,521100,A2,AG/LTD,,,
7885,44-19-0-12-0,6778-80-3686,SNGL FAM SUB,18.7,AC,180100,0,180100,89200,7500,276800,160300,0,160300,72000,7500,239800,A2,AG/LTD,,,
7886,62-17-A-2-0,7714-05-2702,SNGL FAM SUB,0,AC,115000,0,115000,233900,0,348900,100000,0,100000,192700,0,292700,R1,RES/LTD,,,
7887,13-16-0-A-1,6842-83-1203,SNGL FAM SUB,6.239,AC,69700,0,69700,174400,20500,264600,68400,0,68400,151100,18600,238100,A1,AG/GEN,,,
7888,13-1-0-35-A,6841-98-2421,SNGL FAM SUB,4.684,AC,81200,0,81200,21400,0,102600,79700,0,79700,19600,0,99300,A1,AG/GEN,,,
7889,21-5-0-4-0,6850-42-9598,SNGL FAM SUB,2.61,AC,90000,0,90000,151000,700,241700,81000,0,81000,139300,800,221100,A2,AG/LTD,,,
7890,20-1-0-74-A,6850-17-0081,SNGL FAM SUB,10.494,AC,65500,0,65500,0,0,65500,63000,0,63000,0,0,63000,A1,AG/GEN,,,
7891,20-1-0-73-0,6850-05-4459,AG 20-100 AC,36.03,AC,127900,0,127900,0,0,127900,125500,0,125500,0,0,125500,A1,AG/GEN,,,
7892,33-4-0-24-0,6798-42-7979,SNGL FAM SUB,5.3,AC,136000,0,136000,342900,1200,480100,121400,0,121400,283900,1200,406500,A2,AG/LTD,,,
7893,6-1-0-12-A,6823-83-9919,SNGL FAM SUB,2,AC,44800,0,44800,123700,2800,171300,44000,0,44000,105100,2800,151900,A1,AG/GEN,,,
7894,13-1-0-35-0,6841-99-9218,AG 20-100 AC,42.488,AC,292900,226400,66500,6300,0,299200,287300,223100,64200,10000,0,297300,A1,AG/GEN,,,
7895,55-1-0-21-0,6785-26-1788,SNGL FAM SUB,1,AC,70100,0,70100,102800,1500,174400,62600,0,62600,84300,1500,148400,A2,AG/LTD,,,
7896,20-1-0-74-0,6850-06-3429,SNGL FAM SUB,8,AC,29400,0,29400,0,0,29400,28000,0,28000,0,0,28000,A1,AG/GEN,,,
7897,29-1-0-87-A,6749-86-6690,SNGL FAM SUB,1,AC,54000,0,54000,100900,500,155400,49900,0,49900,83700,500,134100,A1,AG/GEN,,,
7898,29-1-0-73-D,6749-64-0525,SNGL FAM SUB,2.035,AC,57300,0,57300,9100,5600,72000,52800,0,52800,8600,4800,66200,A1,AG/GEN,,,
7899,29-1-0-50-A,6748-69-7853,SNGL FAM SUB,1,AC,10000,0,10000,0,0,10000,9900,0,9900,0,0,9900,A1,AG/GEN,,,
7900,29-2-0-2-B,6748-69-6935,SNGL FAM SUB,1.02,AC,54200,0,54200,113700,0,167900,50100,0,50100,94300,0,144400,A1,AG/GEN,,,
7901,55-1-0-61-0,6786-74-3976,AG 20-100 AC,21.23,AC,375600,0,375600,67400,3000,446000,335700,0,335700,55600,3000,394300,A2,AG/LTD,,,
7902,38-1-0-39-C,6707-63-0496,SNGL FAM SUB,1.01,AC,38900,0,38900,136400,1000,176300,38100,0,38100,115300,1000,154400,A1,AG/GEN,,,
7903,29-1-0-67-0,6749-54-1683,SNGL FAM SUB,4.5,AC,80300,0,80300,0,0,80300,75500,0,75500,0,0,75500,A1,AG/GEN,,,
7904,56-3-0-5-0,6785-83-2255,SNGL FAM SUB,2.67,AC,95300,0,95300,0,0,95300,85100,0,85100,0,0,85100,A2,AG/LTD,,,
7905,30-1-0-107-T,6769-02-0861-9999,AG > 100 AC,240.1,AC,1975100,1698500,276600,141000,15500,2131600,1789200,1534200,255000,121200,15500,1925900,A2,AG/LTD,,,
7906,22-1-0-1-B,6769-58-8863,SNGL FAM SUB,3,AC,85300,0,85300,232700,19500,337500,79100,0,79100,190300,15800,285200,A2,AG/LTD,,,
7907,13-1-0-50-0,6841-36-0429,AG 20-100 AC,47.22,AC,202500,0,202500,0,0,202500,198700,0,198700,0,0,198700,A1,AG/GEN,,,
7908,13-1-0-49-0,6841-37-7354,SNGL FAM SUB,3,AC,67200,0,67200,170500,3500,241200,66000,0,66000,147900,3500,217400,A1,AG/GEN,,,
7909,38-1-0-41-0,6707-43-8473,SNGL FAM SUB,16.5,AC,117900,0,117900,0,0,117900,115500,0,115500,0,0,115500,A1,AG/GEN,,,
7910,9-3-0-1-0,5892-74-8407,SNGL FAM SUB,7,AC,60400,0,60400,0,3500,63900,59000,0,59000,0,3500,62500,A1,AG/GEN,,,
7911,56-3-0-6-0,6785-83-1480,SNGL FAM SUB,3.55,AC,108600,0,108600,78600,1500,188700,97000,0,97000,63100,1500,161600,A2,AG/LTD,,,
7912,56-3-0-4-0,6785-83-2184,SNGL FAM SUB,2.67,AC,95300,0,95300,0,0,95300,85100,0,85100,0,0,85100,A2,AG/LTD,,,
7914,31-1-0-63-A,6779-45-2532,SNGL FAM SUB,1.45,AC,70600,0,70600,148900,4400,223900,63000,0,63000,123400,3100,189500,A2,AG/LTD,,,
7916,31-1-0-69-A,6779-36-5625,SNGL FAM SUB,4.26,AC,101300,0,101300,191200,1500,294000,90500,0,90500,160000,1500,252000,A2,AG/LTD,,,
7917,31-1-0-36-A,6768-78-6465,SNGL FAM SUB,3,AC,85300,0,85300,273400,0,358700,79100,0,79100,0,0,79100,A2,AG/LTD,,,
7918,56-1-0-3-0,6786-93-2403,SNGL FAM SUB,6.76,AC,132100,129000,3100,0,0,132100,117800,114900,2900,0,0,117800,A2,AG/LTD,,,
7919,55-1-0-56-A,6786-66-6332,SNGL FAM SUB,1.23,AC,73900,0,73900,129600,400,203900,66000,0,66000,106600,400,173000,A2,AG/LTD,,,
7920,56-1-0-28-0,6785-82-9740,SNGL FAM SUB,3.26,AC,105800,0,105800,373800,3000,482600,94500,0,94500,300800,0,395300,A2,AG/LTD,,,
7921,22-1-0-2-B,6769-59-8038,SNGL FAM SUB,1.02,AC,61200,0,61200,133400,1000,195600,55300,0,55300,109200,1000,165500,A2,AG/LTD,,,
7922,31-1-0-50-A,6769-87-0298,SNGL FAM SUB,1.44,AC,66500,0,66500,92300,700,159500,60400,0,60400,77700,700,138800,A2,AG/LTD,,,
7923,29-14-0-3-0,6749-41-6585,SNGL FAM SUB,2.95,AC,73100,0,73100,0,0,73100,68200,0,68200,0,0,68200,A1,AG/GEN,,,
7924,22-1-0-1-0,6769-59-2153,SNGL FAM SUB,5.21,AC,105400,0,105400,0,0,105400,96800,0,96800,0,0,96800,A2,AG/LTD,,,
7925,22-1-0-2-0,6769-68-2700,SNGL FAM SUB,1.46,AC,66700,0,66700,82900,0,149600,60600,0,60600,68900,0,129500,A2,AG/LTD,,,
7926,22-1-0-3-0,6769-68-4603,SNGL FAM SUB,1.33,AC,65100,0,65100,0,0,65100,59100,0,59100,0,0,59100,A2,AG/LTD,,,
7927,31-12-0-1-0,6769-46-4535,AG 20-100 AC,74.569,AC,495200,0,495200,0,0,495200,462300,0,462300,0,0,462300,A2,AG/LTD,,,
7928,22-1-0-8-B,6769-68-5844,SNGL FAM SUB,1.38,AC,65700,0,65700,134700,17500,217900,59700,0,59700,111400,14300,185400,A2,AG/LTD,,,
7929,13-1-0-49-A,6841-37-9170,SNGL FAM SUB,5,AC,83500,0,83500,205600,34800,323900,82000,0,82000,185700,29600,297300,A1,AG/GEN,,,
7930,55-1-0-56-0,6786-66-6085,SNGL FAM SUB,4.07,AC,116500,0,116500,30500,1000,148000,104000,0,104000,28400,1000,133400,A2,AG/LTD,,,
7931,63-1-0-181-0,7714-92-8718,SNGL FAM SUB,2.987,AC,168600,0,168600,0,0,168600,146700,0,146700,0,0,146700,R3,RES/GEN,,,
7932,55-1-0-57-0,6786-75-0980,SNGL FAM SUB,1.2,AC,73400,0,73400,47900,500,121800,65500,0,65500,39600,500,105600,A2,AG/LTD,,,
7933,42-1-0-76-A,6768-01-1562,SNGL FAM SUB,4.03,AC,90400,0,90400,202800,24200,317400,81400,0,81400,173500,21000,275900,A2,AG/LTD,,,
7934,44-8-0-A-0,6787-12-1205,SNGL FAM SUB,4.964,AC,124800,0,124800,182600,59800,367200,111400,0,111400,153800,49800,315000,A2,AG/LTD,,,
7935,44-8-0-C-0,6787-11-4956,SNGL FAM SUB,10.97,AC,207700,202400,5300,0,0,207700,185200,180500,4700,0,0,185200,A2,AG/LTD,,,
7936,44-8-0-B-0,6787-11-1509,SNGL FAM SUB,3.626,AC,106300,91300,15000,0,3000,109300,94900,81500,13400,0,3000,97900,A2,AG/LTD,,,
7937,43-1-0-87-0,6776-39-1567,SNGL FAM SUB,4.22,AC,116500,0,116500,216600,2500,335600,104100,0,104100,182000,2500,288600,A2,AG/LTD,,,
7938,42-1-0-76-0,6768-10-6594,AG > 100 AC,142.136,AC,1434900,1312600,122300,127300,8000,1570200,1310600,1200400,110200,108200,8000,1426800,A2,AG/LTD,,,
7939,42-1-0-76-B,6768-01-4437,SNGL FAM SUB,3.99,AC,90000,0,90000,67600,0,157600,81000,0,81000,66600,0,147600,A2,AG/LTD,,,
7940,44-1-0-19-0,6787-01-4866,SNGL FAM SUB,15.699,AC,249600,242100,7500,0,0,249600,222900,216200,6700,0,0,222900,A2,AG/LTD,,,
7941,44-29-0-2-0,6777-61-9215,SNGL FAM SUB,11.253,AC,198300,0,198300,0,0,198300,177400,0,177400,0,0,177400,A2,AG/LTD,,,
7942,44-1-0-14-0,6777-60-2153,AG 20-100 AC,25.37,AC,362500,0,362500,877500,10000,1250000,323400,0,323400,725400,10000,1058800,A2,AG/LTD,,,
7955,56-1-0-66-0,6796-76-9883,AG 20-100 AC,30,AC,413100,398900,14200,0,0,413100,359600,346800,12800,0,0,359600,A2,AG/LTD,,,
7956,5-1-0-75-A,6823-77-3737,SNGL FAM SUB,8.57,AC,76300,0,76300,103900,15300,195500,75000,0,75000,94000,13000,182000,A1,AG/GEN,,,
7957,57-12-0-2-0,7706-04-2765,SNGL FAM SUB,6,AC,239900,0,239900,340200,1000,581100,208800,0,208800,285300,1000,495100,A2,AG/LTD,,,
7958,31-17-0-1-0,6779-32-9904,SNGL FAM SUB,1.677,AC,73800,0,73800,147200,58100,279100,65900,0,65900,120100,53300,239300,A2,AG/LTD,,,
7959,55-8-0-4-0,6785-59-4398,SNGL FAM SUB,0.82,AC,69000,0,69000,231400,22900,323300,61600,0,61600,187600,19300,268500,A2,AG/LTD,,,
7961,29-1-0-37-A,6748-52-4855,SNGL FAM SUB,5,AC,91600,0,91600,294600,5500,391700,87500,0,87500,179500,5500,272500,A1,AG/GEN,,,
7962,62-13-A-6-0,7714-05-4780,SNGL FAM SUB,0,AC,115000,0,115000,271400,0,386400,100000,0,100000,224000,0,324000,R1,RES/LTD,,,
7963,57-1-0-20-0,6796-93-9275,AG 20-100 AC,75,AC,1702000,1177700,524300,129300,1500,1832800,1477600,1020700,456900,109800,1500,1588900,A2,AG/LTD,,,
7964,63-4-0-1-0,7714-96-4033,SNGL FAM SUB,0,AC,158400,0,158400,560400,0,718800,144000,0,144000,511700,0,655700,A2,AG/LTD,,,
7965,4-3-0-11-0,6813-03-0875,SNGL FAM SUB,4.73,AC,59600,0,59600,134000,18200,211800,58300,0,58300,129600,13700,201600,A1,AG/GEN,,,
7966,55-1-0-35-0,6785-57-1923,SNGL FAM SUB,4.5,AC,127900,0,127900,158200,21200,307300,114100,0,114100,129500,17600,261200,A2,AG/LTD,,,
7968,21-1-0-34-0,6759-38-2325,SNGL FAM SUB,9.96,AC,151800,0,151800,0,3000,154800,138600,0,138600,0,3000,141600,B1A2,BS AND,,,
7970,13-1-0-44-A,6841-73-6783,SNGL FAM SUB,4.81,AC,82100,0,82100,183700,0,265800,80600,0,80600,163800,0,244400,A1,AG/GEN,,,
7971,20-1-0-85-0,6749-69-8235,AG 20-100 AC,28.968,AC,216800,202400,14400,0,0,216800,211500,199100,12400,0,0,211500,A1,AG/GEN,,,
7972,4-6-0-3-0,6813-42-8744,SNGL FAM SUB,8.58,AC,67300,0,67300,279800,0,347100,65900,0,65900,235700,0,301600,A1,AG/GEN,,,
7974,63-1-0-78-B,7713-97-3958,SNGL FAM SUB,2.5,AC,198000,0,198000,0,0,198000,172100,0,172100,0,0,172100,A2,AG/LTD,,,
7975,39-1-0-86-0,6727-40-9136,AG > 100 AC,376.57,AC,1389500,1214100,175400,0,0,1389500,1370700,1208800,161900,0,0,1370700,A1,AG/GEN,,,
7976,62-1-0-34-0,7714-09-1243,AG 20-100 AC,29.9,AC,766600,752300,14300,0,0,766600,666900,654100,12800,0,0,666900,A2,AG/LTD,,,
7978,62-9-0-1-0,7714-18-1706,SNGL FAM SUB,10.441,AC,500600,0,500600,516600,186300,1203500,435200,0,435200,483900,175500,1094600,A2,AG/LTD,,,
7979,62-9-0-8-0,7714-09-4287,SNGL FAM SUB,11.341,AC,523300,256400,266900,375200,61500,960000,455000,223000,232000,366500,57200,878700,A2,AG/LTD,,,
7980,44-16-0-2-0,6788-20-6159,SNGL FAM SUB,3.39,AC,129000,0,129000,222300,10600,361900,115000,0,115000,203600,10700,329300,A2,AG/LTD,,,
7981,20-1-0-6-0,6840-27-9144,AG 20-100 AC,24.8,AC,139800,128400,11400,0,0,139800,131800,121300,10500,0,0,131800,A1,AG/GEN,,,
7982,20-5-0-C-0,6840-28-6521,AG 20-100 AC,70.99,AC,424500,288100,136400,180500,50600,655600,412700,285200,127500,155600,43000,611300,A1,AG/GEN,,,
7983,20-5-0-A-0,6840-19-5995,AG 20-100 AC,95.2,AC,713200,665300,47900,0,14500,727700,695000,654200,40800,0,13500,708500,A1,AG/GEN,,,
7984,19-1-0-12-0,6830-15-6514,SNGL FAM SUB,5.4,AC,86600,0,86600,172300,29500,288400,82000,0,82000,146100,26400,254500,A1,AG/GEN,,,
7985,20-5-0-B-1,6840-18-5101,SNGL FAM SUB,4,AC,79400,0,79400,410600,0,490000,74800,0,74800,344800,0,419600,A1,AG/GEN,,,
7986,20-5-0-G-0,6840-08-0595,AG 20-100 AC,64.65,AC,483400,451600,31800,0,2400,485800,471900,444200,27700,0,2400,474300,A1,AG/GEN,,,
7987,20-5-0-B-0,6840-18-2566,SNGL FAM SUB,11.26,AC,140000,81000,59000,166800,7000,313800,135100,80800,54300,138600,7000,280700,A1,AG/GEN,,,
7988,12-1-0-52-0,6832-31-1743,SNGL FAM SUB,2.625,AC,52900,0,52900,132300,3500,188700,51400,0,51400,115400,3500,170300,A1,AG/GEN,,,
7989,45-1-0-72-0,6797-60-2386,SNGL FAM SUB,5.46,AC,156300,0,156300,370100,33700,560100,139400,0,139400,296200,27500,463100,A2,AG/LTD,,,
7990,43-20-0-32-0,6768-61-3617,SNGL FAM SUB,3.01,AC,96800,0,96800,211400,0,308200,88000,0,88000,184800,0,272800,A2,AG/LTD,,,
7991,21-4-0-10-0,6759-37-8237,SNGL FAM SUB,4.79,AC,98800,0,98800,240900,2000,341700,89300,0,89300,204300,2000,295600,A2,AG/LTD,,,
7992,38-1-0-39-B,6707-63-3312,SNGL FAM SUB,3.55,AC,45100,0,45100,0,0,45100,44200,0,44200,0,0,44200,A1,AG/GEN,,,
7993,12-7-0-3-0,6821-86-3913,SNGL FAM SUB,4.88,AC,58300,0,58300,36300,800,95400,57700,0,57700,32300,800,90800,A1,AG/GEN,,,
7994,12-14-0-D-2,6821-87-5605,SNGL FAM SUB,10.36,AC,65700,0,65700,0,0,65700,63300,0,63300,0,0,63300,A1,AG/GEN,,,
7995,12-7-0-4-0,6821-76-8078,SNGL FAM SUB,17.42,AC,102700,0,102700,12000,7900,122600,98600,0,98600,10600,7900,117100,A1,AG/GEN,,,
7996,13-14-0-B-0,6851-02-2631,SNGL FAM SUB,5.04,AC,83800,0,83800,317300,22200,423300,82300,0,82300,278800,18600,379700,A1,AG/GEN,,,
7997,6-1-0-10-A,6823-73-5559,SNGL FAM SUB,1.67,AC,43100,0,43100,126600,10600,180300,42400,0,42400,111100,9600,163100,A1,AG/GEN,,,
7998,57-1-0-73-0,7706-83-3078,SNGL FAM SUB,2.5,AC,196000,0,196000,402100,11600,609700,170400,0,170400,344500,10400,525300,A2,AG/LTD,,,
8000,11-3-0-3-0,6822-43-4212,SNGL FAM SUB,4.435,AC,57200,0,57200,230500,6500,294200,56200,0,56200,203500,6500,266200,A1,AG/GEN,,,
8001,58-3-C-1-0,7726-16-6821,SNGL FAM SUB,0,AC,88000,0,88000,122800,7600,218400,80000,0,80000,102000,6600,188600,RN,RESIDEN,,,
8002,50-3-0-4-0,6716-86-7581,SNGL FAM SUB,10.6,AC,92600,0,92600,0,0,92600,90800,0,90800,0,0,90800,A1,AG/GEN,,,
8003,46-23-0-30-0,7707-84-6775,SNGL FAM SUB,2.566,AC,165000,0,165000,322400,1600,489000,150000,0,150000,276300,1800,428100,A2,AG/LTD,,,
8005,39-1-0-37-0,6727-04-6267,SNGL FAM SUB,11.041,AC,72900,0,72900,253700,2000,328600,71500,0,71500,215700,2000,289200,A1,AG/GEN,,,
8006,51-8-0-8-0,6735-49-1236,SNGL FAM SUB,3.43,AC,48500,0,48500,0,0,48500,47600,0,47600,0,0,47600,A1,AG/GEN,,,
8007,32-1-0-51-B,6788-04-0097,SNGL FAM SUB,1.25,AC,67700,0,67700,189600,100,257400,60400,0,60400,160600,100,221100,A2,AG/LTD,,,
8008,39-1-0-91-0,6727-23-0588,SNGL FAM SUB,12.449,AC,102900,0,102900,0,5800,108700,101000,0,101000,0,6400,107400,A1,AG/GEN,,,
8009,39-1-0-91-B,6727-13-6277,SNGL FAM SUB,1.541,AC,41800,0,41800,137600,400,179800,41000,0,41000,123400,400,164800,A1,AG/GEN,,,
8010,39-2-0-3-0,6716-87-4018,SNGL FAM SUB,11.3,AC,91300,0,91300,0,0,91300,89500,0,89500,0,0,89500,A1,AG/GEN,,,
8011,38-1-0-12-A,6707-89-9235,SNGL FAM SUB,1,AC,38800,0,38800,72200,600,111600,38000,0,38000,61800,700,100500,A1,AG/GEN,,,
8012,21-1-0-13-0,6850-54-8026,SNGL FAM SUB,5,AC,96400,0,96400,0,0,96400,87500,0,87500,0,0,87500,A2,AG/LTD,,,
8013,38-1-0-51-0,6707-60-4787,SNGL FAM SUB,16,AC,115300,0,115300,135000,300,250600,113000,0,113000,109500,300,222800,A1,AG/GEN,,,
8014,67-10-0-16-0,7733-15-9315,SNGL FAM SUB,5.622,AC,430100,0,430100,1186400,95600,1712100,360500,0,360500,961700,88900,1411100,R1,RES/LTD,,,
8015,67-10-0-17-0,7733-15-4681,SNGL FAM SUB,2.731,AC,391000,0,391000,1461100,141600,1993700,327800,0,327800,1174000,127000,1628800,R1,RES/LTD,,,
8016,47-25-0-3-0,7717-90-7147,SNGL FAM SUB,1.88,AC,140800,0,140800,252200,700,393700,125700,0,125700,209700,500,335900,A2,AG/LTD,,,
8017,31-1-0-54-0,6769-87-4473,SNGL FAM SUB,2.19,AC,75700,0,75700,152200,1500,229400,69400,0,69400,126700,1500,197600,A2,AG/LTD,,,
8018,64-1-0-46-0,7734-02-5953,Parsonage,1.818,AC,156400,0,156400,238000,21300,415700,136000,0,136000,214500,19100,369600,A2,AG/LTD,,,
8019,67-12-0-10-0,7723-45-4535,SNGL FAM SUB,3.85,AC,390000,0,390000,1186700,79600,1656300,340000,0,340000,323000,46600,709600,R1,RES/LTD,,,
8020,48-1-0-38-0,7727-74-8004,COMM & IND,199.1,AC,9422400,0,9422400,549700,145600,10117700,8978700,0,8978700,538700,144800,9662200,M2,INDUS/G,,,
8021,10-7-0-B-0,6801-72-4069,SNGL FAM SUB,9.22,AC,75600,71300,4300,0,0,75600,70900,66900,4000,0,0,70900,A1,AG/GEN,,,
8022,67-1-0-14-D,7733-26-6015,SNGL FAM SUB,0.374,AC,18000,0,18000,0,0,18000,15000,0,15000,0,0,15000,R1,RES/LTD,,,
8023,67-11-B-7-0,7733-26-5114,SNGL FAM SUB,0,AC,265000,0,265000,637900,14700,917600,220000,0,220000,507300,14400,741700,R1,RES/LTD,,,
8024,5-10-0-1-0,6814-70-5390,AG 20-100 AC,25.95,AC,154200,0,154200,48500,300,203000,151300,0,151300,43000,300,194600,A1,AG/GEN,,,
8025,44-18-0-5-0,6786-28-6957,SNGL FAM SUB,3,AC,100300,0,100300,0,0,100300,89600,0,89600,0,0,89600,A2,AG/LTD,,,
8026,29-13-0-6-0,6748-41-3905,SNGL FAM SUB,2,AC,64000,0,64000,136900,3100,204000,59300,0,59300,113300,3300,175900,A1,AG/GEN,,,
8027,30-1-0-112-B,6759-63-3734,SNGL FAM SUB,2.25,AC,69400,0,69400,0,0,69400,62900,0,62900,0,0,62900,A2,AG/LTD,,,
8028,63-1-0-135-A,7715-72-2382,SNGL FAM SUB,0.95,AC,109300,0,109300,71800,800,181900,95100,0,95100,60900,800,156800,A2,AG/LTD,,,
8029,44-10-0-2-A,6787-43-8354,SNGL FAM SUB,1,AC,70100,0,70100,112900,100,183100,62600,0,62600,92500,100,155200,A2,AG/LTD,,,
8030,44-18-0-4-0,6786-38-0697,SNGL FAM SUB,3.35,AC,105600,0,105600,0,0,105600,94300,0,94300,0,0,94300,A2,AG/LTD,,,
8032,12-1-0-53-0,6832-37-1620,SNGL FAM SUB,10.94,AC,101500,0,101500,259200,4500,365200,99000,0,99000,229600,4900,333500,A1,AG/GEN,,,
8033,9-1-0-53-A,5891-45-6560,AG > 100 AC,106.59,AC,218700,169600,49100,0,0,218700,213200,167900,45300,0,0,213200,A1,AG/GEN,,,
8034,18-5-0-A-4,6820-42-3854,SNGL FAM SUB,2.87,AC,51200,0,51200,191700,0,242900,49200,0,49200,160700,0,209900,A1,AG/GEN,,,
8035,26-2-0-3-A,6709-91-4087,SNGL FAM SUB,3.81,AC,55900,0,55900,163400,23900,243200,54900,0,54900,141900,23900,220700,A1,AG/GEN,,,
8036,17-1-0-86-0,6719-16-9448,AG 20-100 AC,38.63,AC,155900,0,155900,0,0,155900,205100,358200,-153100,0,0,205100,A1,AG/GEN,,,
8037,17-1-0-86-B,6719-08-7021,SNGL FAM SUB,2.63,AC,49800,0,49800,194100,1100,245000,47000,0,47000,161100,1100,209200,A1,AG/GEN,,,
8038,26-1-0-41-0,6718-56-0999,SNGL FAM SUB,19.4,AC,132600,0,132600,149900,3300,285800,130000,0,130000,128600,3300,261900,A1,AG/GEN,,,
8039,62-13-A-12-0,7714-05-7514,SNGL FAM SUB,0,AC,115000,0,115000,266700,800,382500,100000,0,100000,242200,800,343000,R1,RES/LTD,,,
8040,57-1-0-36-0,7705-79-6464,AG > 100 AC,127.404,AC,3987700,0,3987700,0,0,3987700,3465400,0,3465400,0,0,3465400,A2,AG/LTD,,,
8041,12-14-0-D-1,6831-08-1166,SNGL FAM SUB,1.88,AC,46700,0,46700,0,0,46700,46400,0,46400,0,0,46400,A1,AG/GEN,,,
8042,42-1-0-80-0,6767-38-5335,SNGL FAM SUB,10,AC,163300,0,163300,155800,37500,356600,145800,0,145800,130900,38000,314700,A2,AG/LTD,,,
8043,42-1-0-80-A,6767-38-9787,SNGL FAM SUB,9.735,AC,154000,0,154000,0,0,154000,137300,0,137300,0,0,137300,A2,AG/LTD,,,
8044,27-1-0-12-B,6719-61-1147,SNGL FAM SUB,1,AC,30000,0,30000,0,0,30000,28500,0,28500,0,0,28500,A1,AG/GEN,,,
8045,12-14-0-A-0,6821-98-9575,SNGL FAM SUB,10,AC,97500,0,97500,0,0,97500,90800,0,90800,0,0,90800,A1,AG/GEN,,,
8046,56-1-0-1-0,6786-94-2206,SNGL FAM SUB,2.31,AC,90800,0,90800,45400,0,136200,81100,0,81100,36700,0,117800,A2,AG/LTD,,,
8047,63-30-0-B-0,7714-69-2971,SNGL FAM SUB,2.32,AC,135300,0,135300,452000,0,587300,117700,0,117700,387200,0,504900,A2,AG/LTD,,,
8048,31-1-0-45-A,6769-95-2730,SNGL FAM SUB,3.967,AC,96700,0,96700,10400,5500,112600,87400,0,87400,9800,4900,102100,A2,AG/LTD,,,
8049,31-1-0-45-B,6769-85-7573,SNGL FAM SUB,2.66,AC,81300,0,81300,255900,23100,360300,75000,0,75000,211900,19400,306300,A2,AG/LTD,,,
8050,56-1-0-1-D,6786-84-7783,SNGL FAM SUB,1.06,AC,71000,0,71000,147600,500,219100,63400,0,63400,120900,500,184800,A2,AG/LTD,,,
8051,26-1-0-33-0,6708-72-4413,SNGL FAM SUB,5,AC,32100,29800,2300,0,0,32100,31500,29400,2100,0,0,31500,A1,AG/GEN,,,
8052,12-1-0-26-B,6821-96-6170,AG 20-100 AC,28.51,AC,150800,0,150800,0,0,150800,148300,0,148300,0,0,148300,A1,AG/GEN,,,
8053,63-1-0-179-0,7724-02-5965,SNGL FAM SUB,0.5,AC,83800,0,83800,0,0,83800,72900,0,72900,0,0,72900,R3,RES/GEN,,,
8054,63-32-0-E-0,7723-08-0602,SNGL FAM SUB,10.34,AC,426900,0,426900,901100,0,1328000,371200,0,371200,767800,0,1139000,A2,AG/LTD,,,
8055,14-3-0-17-0,6851-38-3599,SNGL FAM SUB,3.36,AC,69600,0,69600,140000,1100,210700,68200,0,68200,90800,1300,160300,A1,AG/GEN,,,
8056,30-2-0-5-0,6758-35-9154,SNGL FAM SUB,7.34,AC,94200,0,94200,183000,2700,279900,86700,0,86700,155600,2700,245000,A2,AG/LTD,,,
8057,64-12-G-2-0,7723-59-5421,SNGL FAM SUB,0,AC,77000,0,77000,243300,6500,326800,67000,0,67000,216400,6500,289900,R1,RES/LTD,,,
8058,50-5-0-23-0,6726-31-0232,SNGL FAM SUB,8.29,AC,70400,0,70400,543500,12200,626100,67000,0,67000,473800,12600,553400,A1,AG/GEN,,,
8059,55-1-0-39-0,6786-50-9736,SNGL FAM SUB,1.2,AC,66400,0,66400,0,0,66400,59200,0,59200,0,0,59200,A2,AG/LTD,,,
8060,55-1-0-40-0,6786-60-2751,SNGL FAM SUB,2,AC,86600,0,86600,119600,500,206700,77300,0,77300,96200,500,174000,A2,AG/LTD,,,
8061,55-1-0-41-0,6786-51-6251,AG 20-100 AC,28.5,AC,485400,292800,192600,370900,54900,911200,433900,261500,172400,308600,47200,789700,A2,AG/LTD,,,
8062,58-7-0-5-0,7716-63-3784,SNGL FAM SUB,4,AC,194000,0,194000,133600,2700,330300,168800,0,168800,112800,2700,284300,A2,AG/LTD,,,
8063,12-1-0-21-0,6821-99-8094,SNGL FAM SUB,5,AC,67100,0,67100,0,0,67100,66700,0,66700,0,0,66700,A1,AG/GEN,,,
8064,42-1-0-27-0,6766-18-2193,SNGL FAM SUB,6.974,AC,135400,0,135400,198100,12100,345600,123200,0,123200,163100,12100,298400,B1,BUS/GEN,,,
8067,28-1-0-82-0,6739-33-8905,SNGL FAM SUB,6.29,AC,82300,0,82300,0,0,82300,80700,0,80700,0,0,80700,A1,AG/GEN,,,
8068,28-1-0-83-0,6739-34-4283,SNGL FAM SUB,2.5,AC,57900,0,57900,90300,100,148300,56400,0,56400,74900,100,131400,A1,AG/GEN,,,
8069,50-1-0-6-A,6726-24-3676,AG 20-100 AC,51.22,AC,244700,182700,62000,146500,3500,394700,238900,179600,59300,124000,3500,366400,A1,AG/GEN,,,
8070,39-1-0-74-A,6726-27-5219,SNGL FAM SUB,1.08,AC,39300,0,39300,0,0,39300,38500,0,38500,0,0,38500,A1,AG/GEN,,,
8071,11-6-0-3-A,6821-26-0189,SNGL FAM SUB,3,AC,52000,0,52000,0,0,52000,51000,0,51000,0,0,51000,A1,AG/GEN,,,
8072,11-8-0-1-0,6821-16-8388,SNGL FAM SUB,1.02,AC,40100,0,40100,132100,2400,174600,38100,0,38100,113400,2100,153600,A1,AG/GEN,,,
8075,53-1-0-2-0,6766-36-6757,SNGL FAM SUB,5.021,AC,120400,0,120400,251500,10000,381900,107600,0,107600,210800,10000,328400,A2,AG/LTD,,,
8077,47-17-0-A-2,7718-21-7308,SNGL FAM SUB,4.92,AC,165600,0,165600,322500,500,488600,148000,0,148000,273400,500,421900,A2,AG/LTD,,,
8079,6-1-0-10-C,6823-74-6033,SNGL FAM SUB,3,AC,49900,0,49900,112400,3000,165300,49000,0,49000,97600,3000,149600,A1,AG/GEN,,,
8080,6-1-0-15-A,6823-83-3742,SNGL FAM SUB,1.04,AC,39900,0,39900,34900,1700,76500,39200,0,39200,31200,1700,72100,A1,AG/GEN,,,
8081,12-1-0-17-0,6832-01-1619,SNGL FAM SUB,19,AC,143100,0,143100,143000,2000,288100,139800,0,139800,125600,2000,267400,A1,AG/GEN,,,
8082,18-5-0-A-7,6820-50-1426,AG 20-100 AC,39,AC,169800,151800,18000,0,0,169800,164800,148200,16600,0,0,164800,A1,AG/GEN,,,
8083,27-1-0-76-A,6728-45-5714,SNGL FAM SUB,1,AC,38800,0,38800,121400,200,160400,38000,0,38000,101900,200,140100,A1,AG/GEN,,,
8084,47-1-0-17-0,7716-27-5742,SNGL FAM SUB,5,AC,190200,0,190200,196600,100,386900,170000,0,170000,164400,100,334500,A2,AG/LTD,,,
8085,43-1-0-8-D,6767-67-6787,SNGL FAM SUB,0.98,AC,11800,0,11800,0,3300,15100,10500,0,10500,0,3800,14300,A2,AG/LTD,,,
8086,43-11-0-1-0,6767-67-5949,SNGL FAM SUB,1.96,AC,83900,0,83900,251800,13400,349100,75000,0,75000,211800,11900,298700,A2,AG/LTD,,,
8087,55-1-0-19-A,6785-17-7087,SNGL FAM SUB,1.11,AC,71600,0,71600,55800,300,127700,64000,0,64000,46500,300,110800,A2,AG/LTD,,,
8088,28-1-0-72-A,6739-16-0264,SNGL FAM SUB,1.26,AC,49000,0,49000,82600,500,132100,46700,0,46700,68400,500,115600,A1,AG/GEN,,,
8090,63-1-0-114-B,7715-51-7653,SNGL FAM SUB,3.75,AC,157600,0,157600,28900,800,187300,137000,0,137000,25300,800,163100,A2,AG/LTD,,,
8091,5-3-0-19-0,6824-10-9036,SNGL FAM SUB,3.62,AC,65400,0,65400,0,0,65400,64100,0,64100,0,0,64100,A1,AG/GEN,,,
8092,63-32-0-D-0,7723-08-3792,Roads,0.83,AC,0,0,0,0,0,0,0,0,0,0,0,0,A2,AG/LTD,,,
8093,63-32-0-F-0,7713-99-6033,SNGL FAM SUB,10,AC,417300,0,417300,504200,0,921500,362800,0,362800,430300,0,793100,A2,AG/LTD,,,
8094,5-6-0-F-0,6813-76-3243,SNGL FAM SUB,2.23,AC,46000,0,46000,14300,100,60400,45200,0,45200,16800,100,62100,A1,AG/GEN,,,
8095,12-14-0-F-0,6821-78-9147,SNGL FAM SUB,14.49,AC,80600,0,80600,0,0,80600,78200,0,78200,0,0,78200,A1,AG/GEN,,,
8096,48-2-B-5-0,7726-68-6248,SNGL FAM SUB,0,AC,130000,0,130000,159900,600,290500,117000,0,117000,143000,600,260600,R1,RES/LTD,,,
8097,62-6-0-F-0,7704-83-6656,SNGL FAM SUB,5.99,AC,278100,0,278100,152900,3000,434000,241700,0,241700,134900,3000,379600,A2,AG/LTD,,,
8098,17-1-0-102-0,6810-55-0158,SNGL FAM SUB,12.01,AC,95500,0,95500,85200,2700,183400,93100,0,93100,71300,2700,167100,A1,AG/GEN,,,
8100,50-1-0-5-0,6726-25-4958,AG 20-100 AC,27.35,AC,179900,128700,51200,63900,2200,246000,176300,127100,49200,54900,2200,233400,A1,AG/GEN,,,
8101,5-1-0-79-0,6823-64-5892,SNGL FAM SUB,7.306,AC,71900,0,71900,0,0,71900,70500,0,70500,0,0,70500,A1,AG/GEN,,,
8102,17-1-0-102-A,6810-55-1502,SNGL FAM SUB,3,AC,52000,0,52000,176200,28700,256900,49000,0,49000,147200,23700,219900,A1,AG/GEN,,,
8103,67-2-D-9-0,7723-54-8891,SNGL FAM SUB,0,AC,184000,0,184000,384900,6500,575400,160000,0,160000,332100,4700,496800,R1,RES/LTD,,,
8104,67-2-D-17-0,7723-64-0799,SNGL FAM SUB,0,AC,184000,0,184000,524200,0,708200,160000,0,160000,491000,0,651000,R1,RES/LTD,,,
8105,17-6-0-A-0,6800-95-8435,AG 20-100 AC,83.71,AC,181300,141800,39500,0,0,181300,174300,138600,35700,0,0,174300,A1,AG/GEN,,,
8106,5-6-0-C-0,6813-66-3349,SNGL FAM SUB,4.22,AC,47700,0,47700,0,0,47700,46900,0,46900,0,0,46900,A1,AG/GEN,,,
8107,5-6-0-D-0,6813-66-4084,SNGL FAM SUB,4.22,AC,43400,0,43400,0,0,43400,42600,0,42600,0,0,42600,A1,AG/GEN,,,
8108,19-1-0-26-0,6739-18-3297,SNGL FAM SUB,3.81,AC,73300,0,73300,6300,8000,87600,70400,0,70400,5500,8000,83900,A1,AG/GEN,,,
8110,17-1-0-101-A,6810-45-3332,SNGL FAM SUB,6.37,AC,70600,0,70600,53300,4500,128400,67500,0,67500,76800,4800,149100,A1,AG/GEN,,,
8111,67-10-0-21-0,7733-05-9937,SNGL FAM SUB,2.14,AC,323000,0,323000,631000,10500,964500,270800,0,270800,510100,10900,791800,R1,RES/LTD,,,
8127,12-14-0-C-0,6821-88-1748,SNGL FAM SUB,14.49,AC,80600,0,80600,0,0,80600,78200,0,78200,0,0,78200,A1,AG/GEN,,,
8128,31-9-0-2-0,6768-67-9829,SNGL FAM SUB,3.364,AC,89600,0,89600,83100,4500,177200,79100,0,79100,70800,4500,154400,A2,AG/LTD,,,
8129,31-9-0-4-0,6768-78-0391,SNGL FAM SUB,5.656,AC,115100,0,115100,0,0,115100,107300,0,107300,0,0,107300,A2,AG/LTD,,,
8130,31-9-0-1-0,6768-67-7767,SNGL FAM SUB,3,AC,85300,0,85300,0,0,85300,79100,0,79100,0,0,79100,A2,AG/LTD,,,
8131,17-1-0-101-0,6810-45-4802,SNGL FAM SUB,2.36,AC,48200,0,48200,19100,100,67400,45500,0,45500,15700,100,61300,A1,AG/GEN,,,
8301,41-1-0-6-A,6748-51-2002,SNGL FAM SUB,2.48,AC,68700,0,68700,154200,2000,224900,63800,0,63800,128200,2000,194000,A1,AG/GEN,,,
8302,14-2-0-3-0,6851-25-8601,SNGL FAM SUB,7.1,AC,82500,0,82500,183100,1500,267100,81000,0,81000,172200,1600,254800,A1,AG/GEN,,,
8303,46-10-0-B-0,7707-25-6557,SNGL FAM SUB,2.64,AC,136400,0,136400,109300,100,245800,121900,0,121900,90700,100,212700,A2,AG/LTD,,,
8304,64-12-B-9-0,7724-60-3350,SNGL FAM SUB,0,AC,27000,0,27000,0,0,27000,23500,0,23500,0,0,23500,R1,RES/LTD,,,
8305,64-12-B-10-0,7724-60-3169,SNGL FAM SUB,0,AC,77000,0,77000,233000,1000,311000,67000,0,67000,197400,1000,265400,R1,RES/LTD,,,
8306,32-1-0-6-A,6779-95-7657,SNGL FAM SUB,2.15,AC,80700,0,80700,12200,1800,94700,72000,0,72000,11900,1800,85700,A2,AG/LTD,,,
8307,46-10-0-C-0,7707-25-4636,SNGL FAM SUB,4.55,AC,177800,0,177800,147800,69200,394800,158700,0,158700,123200,66300,348200,A2,AG/LTD,,,
8308,46-16-0-B-0,7707-71-2032,SNGL FAM SUB,4.78,AC,182900,0,182900,295800,6800,485500,163200,0,163200,246000,6800,416000,A2,AG/LTD,,,
8309,46-10-0-C-1,7707-25-3857,SNGL FAM SUB,1.51,AC,110600,0,110600,158400,3000,272000,98800,0,98800,132400,3000,234200,A2,AG/LTD,,,
8312,11-1-0-53-0,6822-24-1116,SNGL FAM SUB,6.01,AC,65300,0,65300,319400,0,384700,64100,0,64100,282200,0,346300,A1,AG/GEN,,,
8314,59-1-0-31-0,7726-56-7627,SNGL FAM SUB,0.682,AC,98400,0,98400,0,0,98400,89500,0,89500,0,0,89500,R3,RES/GEN,,,
8315,15-5-0-1-0,5789-76-4729,SNGL FAM SUB,8.01,AC,67500,0,67500,0,0,67500,66000,0,66000,0,0,66000,A1,AG/GEN,,,
8316,24-2-0-1-A,5789-74-1819,SNGL FAM SUB,10.57,AC,27000,0,27000,0,0,27000,26400,0,26400,0,0,26400,A1,AG/GEN,,,
8317,29-1-0-32-0,6748-34-6068,AG 20-100 AC,38,AC,354900,269100,85800,227700,23900,606500,343500,265300,78200,189500,23400,556400,A1,AG/GEN,,,
8318,29-11-0-1-0,6749-32-1704,SNGL FAM SUB,3.295,AC,67100,0,67100,288300,4000,359400,62600,0,62600,239800,4000,306400,A1,AG/GEN,,,
8319,15-5-0-26-0,5789-77-1800,SNGL FAM SUB,8.15,AC,64500,0,64500,216400,0,280900,63000,0,63000,193200,0,256200,A1,AG/GEN,,,
8320,46-14-0-7-0,7708-91-6922,SNGL FAM SUB,3.464,AC,137500,0,137500,239900,6100,383500,125000,0,125000,204800,4400,334200,A2,AG/LTD,,,
8321,62-13-C-1-0,7714-05-1244,SNGL FAM SUB,0,AC,115000,0,115000,262900,32400,410300,100000,0,100000,234900,26800,361700,R1,RES/LTD,,,
8322,63-7-0-C-0,7723-17-1156,SNGL FAM SUB,10.66,AC,442700,0,442700,0,0,442700,384800,0,384800,0,0,384800,A2,AG/LTD,,,
8323,66-1-0-5-0,7713-96-1690,SNGL FAM SUB,4.14,AC,171800,0,171800,0,0,171800,149500,0,149500,0,0,149500,A2,AG/LTD,,,
8495,67-10-0-9-0,7733-06-5030,SNGL FAM SUB,2.5,AC,323000,0,323000,1014200,136800,1474000,270800,0,270800,839300,120500,1230600,R1,RES/LTD,,,
8497,60-1-0-5-0,6784-17-4366,SNGL FAM SUB,12.551,AC,414400,0,414400,1673600,89200,2177200,369700,101000,268700,1587500,79100,2036300,A2,AG/LTD,,,
8498,60-1-0-6-0,6784-16-5804,SNGL FAM SUB,8.691,AC,50400,0,50400,0,0,50400,45200,41400,3800,0,0,45200,A2,AG/LTD,,,
8501,42-1-0-19-A,6757-90-0774,General Gov,0,AC,0,0,0,2000,0,2000,0,0,0,2000,0,2000,A2,AG/LTD,,,
8502,62-20-D-A-0,7714-06-5540,Cmn Area/Open Spc,0,AC,0,0,0,0,0,0,0,0,0,0,0,0,R1,RES/LTD,,,
8503,64-1-0-32-A,7723-69-2459,TAXED -SCC,0.573,AC,0,0,0,0,0,0,0,0,0,0,0,0,A2,AG/LTD,,,
8505,64-12-C-5-A,7724-50-7129,TAXED -SCC,0,AC,0,0,0,0,0,0,0,0,0,0,0,0,R1,RES/LTD,,,
8507,15-1-0-39-0,5789-39-4288,TAXED -SCC,0.25,AC,0,0,0,0,0,0,0,0,0,0,0,0,A1,AG/GEN,,,
8508,42-1-0-81-0,6767-27-8782,General Gov,0,AC,5000,0,5000,0,4000,9000,5000,0,5000,0,4000,9000,A2,AG/LTD,,,
8510,55-1-0-97-0,6785-45-9507,TAXED -SCC,0.119,AC,0,0,0,0,0,0,0,0,0,0,0,0,A2,AG/LTD,,,
8511,67-3-G-C-0,7723-54-7181,TAXED -SCC,0,AC,0,0,0,0,0,0,0,0,0,0,0,0,R1,RES/LTD,,,
8512,67-3-G-D-0,7723-63-2818,TAXED -SCC,0,AC,0,0,0,0,0,0,0,0,0,0,0,0,R1,RES/LTD,,,
8513,67-2-B-6-A,7723-46-9260,TAXED -SCC,0,AC,0,0,0,0,0,0,0,0,0,0,0,0,R1,RES/LTD,,,
8515,46-1-0-125-0,7717-01-4666,SNGL FAM SUB,13.79,AC,349700,0,349700,0,0,349700,312200,0,312200,0,0,312200,A2,AG/LTD,,,
8516,64-12-B-7-0,7724-60-2513,SNGL FAM SUB,0,AC,77000,0,77000,156000,3500,236500,67000,0,67000,137300,3500,207800,R1,RES/LTD,,,
8132,20-1-0-1-0,6831-90-9722,SNGL FAM SUB,9,AC,113600,0,113600,213200,5000,331800,111100,0,111100,175500,5000,291600,RR,RES/RUR,,,
8133,67-13-B-12-0,7733-36-0920,SNGL FAM SUB,0,AC,265000,0,265000,521800,0,786800,220000,0,220000,411600,0,631600,R1,RES/LTD,,,
8134,28-1-0-84-0,6739-33-6188,SNGL FAM SUB,18,AC,117300,0,117300,443900,17700,578900,112500,0,112500,362800,20900,496200,A1,AG/GEN,,,
8135,28-1-0-85-0,6739-32-0184,AG 20-100 AC,30,AC,147400,0,147400,240000,51600,439000,137900,0,137900,205400,45100,388400,A1,AG/GEN,,,
8136,12-1-0-20-0,6831-08-1862,SNGL FAM SUB,1.38,AC,42900,0,42900,113900,34600,191400,42500,0,42500,98400,29100,170000,A1,AG/GEN,,,
8137,62-19-0-B-3,7704-34-9878,AG 20-100 AC,23.65,AC,625100,355700,269400,677900,161400,1464400,535800,298500,237300,594200,144300,1274300,A2,AG/LTD,,,
8139,31-9-0-5-0,6768-78-3357,SNGL FAM SUB,3,AC,85300,0,85300,407100,0,492400,79100,0,79100,270900,0,350000,A2,AG/LTD,,,
8140,38-1-0-73-0,6717-04-2349,SNGL FAM SUB,5.25,AC,62600,0,62600,15100,0,77700,61400,0,61400,17700,0,79100,A1,AG/GEN,,,
8141,50-5-0-34-0,6726-33-0044,SNGL FAM SUB,8.28,AC,72300,0,72300,116200,3500,192000,69700,0,69700,99500,3600,172800,A1,AG/GEN,,,
8142,58-1-0-45-B,7715-83-0468,SNGL FAM SUB,1.25,AC,113500,0,113500,143800,19900,277200,98700,0,98700,121500,17000,237200,A2,AG/LTD,,,
8143,58-20-0-B-0,7715-73-8509,SNGL FAM SUB,1.29,AC,119700,0,119700,0,0,119700,104100,0,104100,0,0,104100,A2,AG/LTD,,,
8144,56-3-0-3-0,6785-83-3013,SNGL FAM SUB,2.67,AC,95300,0,95300,0,0,95300,85100,0,85100,0,0,85100,A2,AG/LTD,,,
8145,64-9-0-5-0,7724-91-3594,SNGL FAM SUB,2.92,AC,207300,0,207300,231800,8500,447600,180200,0,180200,194200,8500,382900,A2,AG/LTD,,,
8146,58-12-0-C-0,7726-27-8377,SNGL FAM SUB,0.805,AC,330300,0,330300,27800,400,358500,300300,0,300300,22200,400,322900,R3,RES/GEN,,,
8147,12-1-0-42-0,6831-04-6859,SNGL FAM SUB,1.5,AC,43800,0,43800,149900,34500,228200,43400,0,43400,124600,29000,197000,A1,AG/GEN,,,
8148,6-1-0-15-0,6823-83-4594,SNGL FAM SUB,1,AC,39700,0,39700,47500,800,88000,39000,0,39000,42100,800,81900,A1,AG/GEN,,,
8149,4-1-0-67-0,6813-23-2034,AG 20-100 AC,45.383,AC,20900,0,20900,0,0,20900,19300,0,19300,0,0,19300,A1,AG/GEN,,,
8150,54-3-0-H-0,6766-95-6175,AG 20-100 AC,83.3,AC,949600,909600,40000,0,19100,968700,849700,814100,35600,0,17300,867000,A2,AG/LTD,,,
8151,54-3-0-I-1,6766-85-8421,AG 20-100 AC,38,AC,514100,426100,88000,343500,18200,875800,458500,380100,78400,289000,15900,763400,A2,AG/LTD,,,
8152,38-1-0-100-0,6707-88-4482,SNGL FAM SUB,1,AC,38800,0,38800,126400,16200,181400,38000,0,38000,108300,13600,159900,A1,AG/GEN,,,
8153,58-2-0-32-0,7726-36-6016,SNGL FAM SUB,0,AC,42600,0,42600,0,0,42600,38800,0,38800,0,0,38800,RN,RESIDEN,,,
8154,58-2-0-14-0,7726-35-4957,SNGL FAM SUB,0,AC,88000,0,88000,0,0,88000,80000,0,80000,0,0,80000,RN,RESIDEN,,,
8155,58-2-0-27-0,7726-36-3580,SNGL FAM SUB,0,AC,42600,0,42600,0,0,42600,38800,0,38800,0,0,38800,RN,RESIDEN,,,
8156,58-2-0-33-0,7726-26-9961,SNGL FAM SUB,0,AC,88000,0,88000,0,0,88000,80000,0,80000,0,0,80000,RN,RESIDEN,,,
8157,58-2-0-34-0,7726-27-9061,SNGL FAM SUB,0,AC,88000,0,88000,0,0,88000,80000,0,80000,0,0,80000,RN,RESIDEN,,,
8158,58-2-0-35-0,7726-36-1916,SNGL FAM SUB,0,AC,65900,0,65900,0,0,65900,59900,0,59900,0,0,59900,RN,RESIDEN,,,
8159,58-2-0-36-0,7726-36-2905,SNGL FAM SUB,0,AC,65900,0,65900,0,0,65900,59900,0,59900,0,0,59900,RN,RESIDEN,,,
8160,58-2-0-37-0,7726-36-3915,SNGL FAM SUB,0,AC,65900,0,65900,0,0,65900,59900,0,59900,0,0,59900,RN,RESIDEN,,,
8161,63-1-0-178-0,7724-02-8737,MultiFamily,5,AC,205800,0,205800,0,0,205800,179100,0,179100,0,0,179100,R3,RES/GEN,,,
8162,43-9-0-A-0,6778-42-3139,SNGL FAM SUB,2.19,AC,81200,0,81200,190600,19100,290900,72600,0,72600,159700,16900,249200,A2,AG/LTD,,,
8163,28-1-0-72-0,6739-16-2270,SNGL FAM SUB,2.32,AC,56700,0,56700,73100,1700,131500,55000,0,55000,61000,1800,117800,A1,AG/GEN,,,
8164,45-1-0-6-0,6788-90-4922,COMM & IND,0.9,AC,228200,0,228200,244100,66200,538500,211300,0,211300,240800,46900,499000,B1,BUS/GEN,,,
8165,58-5-0-1-B,7726-36-7913,SNGL FAM SUB,3,AC,243000,0,243000,0,0,243000,220900,0,220900,0,0,220900,A2,AG/LTD,,,
8166,58-5-0-1-0,7726-46-8420,AG 20-100 AC,45.122,AC,2539000,2518200,20800,0,0,2539000,1561600,1542400,19200,0,0,1561600,A2,AG/LTD,,,
8167,63-5-0-5-A,7724-14-7658,SNGL FAM SUB,1.516,AC,148000,0,148000,0,0,148000,128700,0,128700,0,0,128700,A2,AG/LTD,,,
8168,58-5-0-1-A,7726-36-9704,SNGL FAM SUB,5,AC,405000,0,405000,0,0,405000,368200,0,368200,0,0,368200,A2,AG/LTD,,,
8169,11-1-0-35-G,6821-24-0956,SNGL FAM SUB,6.1,AC,69100,0,69100,60300,500,129900,71200,0,71200,56400,500,128100,A1,AG/GEN,,,
8170,12-14-0-H-0,6821-77-1171,SNGL FAM SUB,14.49,AC,77200,0,77200,0,0,77200,78200,0,78200,0,0,78200,A1,AG/GEN,,,
8171,27-5-0-2-0,6728-77-0479,SNGL FAM SUB,1.45,AC,41800,0,41800,113600,1500,156900,40900,0,40900,97600,1100,139600,A1,AG/GEN,,,
8172,17-1-0-103-0,6810-56-4111,SNGL FAM SUB,5,AC,63500,0,63500,249000,39700,352200,62000,0,62000,178200,32400,272600,A1,AG/GEN,,,
8173,17-1-0-66-0,6810-34-1784,SNGL FAM SUB,4.9,AC,60900,0,60900,47000,600,108500,59500,0,59500,38100,600,98200,A1,AG/GEN,,,
8174,12-1-0-22-0,6831-08-3781,SNGL FAM SUB,1.21,AC,41600,0,41600,0,0,41600,41100,0,41100,0,0,41100,A1,AG/GEN,,,
8175,6-1-0-24-0,6823-90-4469,SNGL FAM SUB,2.01,AC,48500,0,48500,76700,1500,126700,47100,0,47100,67100,1500,115700,A1,AG/GEN,,,
8177,43-1-0-91-0,6776-47-3228,SNGL FAM SUB,5.76,AC,76500,73800,2700,0,0,76500,68100,65700,2400,0,0,68100,A2,AG/LTD,,,
8178,46-9-0-B-6A,7707-87-3666,SNGL FAM SUB,1.92,AC,102300,0,102300,188400,600,291300,93000,0,93000,159800,600,253400,A2,AG/LTD,,,
8180,58-1-0-53-0,7725-09-2062,SNGL FAM SUB,1.83,AC,131300,0,131300,81800,1200,214300,114100,0,114100,69900,1200,185200,A2,AG/LTD,,,
8181,43-15-0-3-0,6768-90-6631,SNGL FAM SUB,4.35,AC,92000,0,92000,171800,45900,309700,83600,0,83600,149900,44100,277600,A2,AG/LTD,,,
8182,56-1-0-15-C,6785-85-5030,SNGL FAM SUB,1.13,AC,72200,0,72200,199800,400,272400,64400,0,64400,161700,400,226500,A2,AG/LTD,,,
8183,46-18-0-B-0,7708-00-5347,SNGL FAM SUB,4.23,AC,166000,0,166000,251000,53800,470800,148400,0,148400,209900,47700,406000,A2,AG/LTD,,,
8186,63-1-0-100-A,7715-40-2238,SNGL FAM SUB,0.32,AC,6500,0,6500,0,0,6500,5700,0,5700,0,0,5700,RR,RES/RUR,,,
8190,45-1-0-86-0,6797-85-0816,SNGL FAM SUB,3.72,AC,117800,0,117800,466900,2100,586800,105200,0,105200,377700,2200,485100,A2,AG/LTD,,,
8191,45-1-0-87-0,6797-76-7007,SNGL FAM SUB,2.43,AC,99300,0,99300,287400,24300,411000,88700,0,88700,235300,21200,345200,A2,AG/LTD,,,
8192,63-27-0-3-0,7715-71-3441,SNGL FAM SUB,0.96,AC,108200,0,108200,125300,400,233900,94100,0,94100,106300,400,200800,A2,AG/LTD,,,
8193,63-33-0-5-0,7715-60-2929,SNGL FAM SUB,3.21,AC,153500,0,153500,174600,800,328900,133400,0,133400,146200,800,280400,A2,AG/LTD,,,
8194,63-33-0-2-0,7715-61-1427,SNGL FAM SUB,2.73,AC,143700,0,143700,176700,700,321100,124900,0,124900,149500,700,275100,A2,AG/LTD,,,
8195,63-33-0-4-0,7715-61-4372,SNGL FAM SUB,2.6,AC,141000,0,141000,136400,2700,280100,122600,0,122600,118600,2700,243900,A2,AG/LTD,,,
8196,63-1-0-13-0,7715-21-6198,SNGL FAM SUB,6.32,AC,251300,0,251300,0,0,251300,218700,0,218700,0,0,218700,A2,AG/LTD,,,
8198,63-1-0-150-0,7714-79-7612,SNGL FAM SUB,6.07,AC,116100,0,116100,0,0,116100,100900,0,100900,0,0,100900,A2,AG/LTD,,,
8199,63-1-0-94-A,7714-59-0616,SNGL FAM SUB,0.99,AC,108400,0,108400,202300,2100,312800,94300,0,94300,169700,2100,266100,A2,AG/LTD,,,
8200,63-1-0-94-0,7714-49-8541,SNGL FAM SUB,2.047,AC,129800,0,129800,497000,1500,628300,112800,0,112800,436900,1500,551200,A2,AG/LTD,,,
8201,58-1-0-34-0,7715-32-1791,SNGL FAM SUB,3.85,AC,190100,0,190100,270800,500,461400,165400,0,165400,228800,500,394700,A2,AG/LTD,,,
8202,57-1-0-45-0,7715-04-8965,SNGL FAM SUB,2,AC,122700,121800,900,0,0,122700,106700,105800,900,0,0,106700,A2,AG/LTD,,,
8203,63-27-0-4-0,7715-71-4548,SNGL FAM SUB,0.954,AC,107600,0,107600,203500,0,311100,93600,0,93600,173000,0,266600,A2,AG/LTD,,,
8204,63-27-0-5-0,7715-71-5700,SNGL FAM SUB,0.999,AC,108300,0,108300,270700,0,379000,94200,0,94200,234300,0,328500,A2,AG/LTD,,,
8205,63-27-0-13-0,7715-71-9252,Roads,1.69,AC,0,0,0,0,0,0,0,0,0,0,0,0,A2,AG/LTD,,,
8206,63-27-0-7-0,7715-81-2249,SNGL FAM SUB,3.075,AC,151600,0,151600,0,0,151600,131800,0,131800,0,0,131800,A2,AG/LTD,,,
8207,56-1-0-15-F,6785-86-3281,SNGL FAM SUB,3,AC,97700,0,97700,106000,3200,206900,87200,0,87200,86900,3200,177300,A2,AG/LTD,,,
8208,32-13-0-2-0,6778-77-7968,SNGL FAM SUB,5.62,AC,130600,0,130600,264100,46700,441400,116800,0,116800,216700,38700,372200,A2,AG/LTD,,,
8209,63-1-0-101-0,7715-40-9568,SNGL FAM SUB,2,AC,101700,0,101700,0,0,101700,88400,0,88400,0,0,88400,A2,AG/LTD,,,
8210,58-1-0-31-0,7715-23-9825,AG 20-100 AC,25.53,AC,1206700,0,1206700,167700,4600,1379000,661800,0,661800,142400,4600,808800,A2,AG/LTD,,,
8211,58-1-0-31-A,7715-33-2344,SNGL FAM SUB,3.485,AC,180500,0,180500,872900,21700,1075100,157000,0,157000,769200,21100,947300,A2,AG/LTD,,,
8212,38-1-0-5-0,6708-90-4930,SNGL FAM SUB,10.24,AC,85900,0,85900,123300,2800,212000,84200,0,84200,105000,2800,192000,A1,AG/GEN,,,
8213,63-21-0-1-0,7715-91-8534,SNGL FAM SUB,5.25,AC,163600,0,163600,0,0,163600,142100,0,142100,0,0,142100,A2,AG/LTD,,,
8215,63-2-0-1-A,7723-37-4656,SNGL FAM SUB,0.946,AC,161500,0,161500,0,0,161500,140500,0,140500,0,0,140500,A2R1,AG LTD/,,,
8216,56-1-0-15-E,6785-86-2037,SNGL FAM SUB,3.5,AC,104600,0,104600,99000,0,203600,93400,0,93400,81100,0,174500,A2,AG/LTD,,,
8217,45-15-0-1-0,6797-62-5586,SNGL FAM SUB,7.57,AC,175900,0,175900,85300,0,261200,156300,0,156300,68000,0,224300,A2,AG/LTD,,,
8218,45-1-0-84-0,6797-75-5497,SNGL FAM SUB,5.33,AC,145100,0,145100,357000,46700,548800,129600,0,129600,290700,39200,459500,A2,AG/LTD,,,
8219,58-1-0-43-A,7715-72-5911,SNGL FAM SUB,3.36,AC,150500,0,150500,90800,3200,244500,130900,0,130900,78100,3000,212000,A2,AG/LTD,,,
8220,6-9-0-3-0,6833-71-7776,SNGL FAM SUB,2.39,AC,47000,0,47000,114200,400,161600,46100,0,46100,90600,400,137100,A1,AG/GEN,,,
8221,57-1-0-45-A,7715-14-4355,SNGL FAM SUB,5.026,AC,235800,0,235800,189200,35500,460500,205000,0,205000,158400,29300,392700,A2,AG/LTD,,,
8222,56-1-0-15-G,6785-85-9610,SNGL FAM SUB,3.01,AC,97800,0,97800,91500,700,190000,87300,0,87300,75100,700,163100,A2,AG/LTD,,,
8223,63-1-0-98-0,7715-50-5189,SNGL FAM SUB,1.53,AC,119200,0,119200,167500,4000,290700,103700,0,103700,141300,4000,249000,A2,AG/LTD,,,
8224,63-1-0-99-0,7715-50-4540,SNGL FAM SUB,2.8,AC,145100,0,145100,154100,1000,300200,126200,0,126200,129400,1000,256600,A2,AG/LTD,,,
8225,58-3-D-4-0,7726-26-1619,SNGL FAM SUB,0,AC,92400,0,92400,170900,15400,278700,84000,0,84000,141200,13000,238200,RN,RESIDEN,,,
8227,63-27-0-9-0,7715-80-1993,SNGL FAM SUB,3.161,AC,159200,0,159200,355900,0,515100,138400,0,138400,335900,0,474300,A2,AG/LTD,,,
8228,63-27-0-10-0,7715-71-7077,SNGL FAM SUB,3,AC,155900,0,155900,455500,17400,628800,135500,0,135500,403700,16100,555300,A2,AG/LTD,,,
8229,63-27-0-6-0,7715-71-7485,SNGL FAM SUB,3.012,AC,156100,0,156100,0,0,156100,135700,0,135700,0,0,135700,A2,AG/LTD,,,
8230,63-27-0-8-0,7715-81-5243,SNGL FAM SUB,3.038,AC,156700,0,156700,137600,0,294300,136200,0,136200,121100,0,257300,A2,AG/LTD,,,
8231,63-21-0-1-A,7715-91-6625,SNGL FAM SUB,1.937,AC,46200,0,46200,0,0,46200,40200,0,40200,0,0,40200,A2,AG/LTD,,,
8233,43-11-0-2-0,6767-68-8175,SNGL FAM SUB,3,AC,98900,0,98900,209200,30100,338200,88400,0,88400,178600,25100,292100,A2,AG/LTD,,,
8234,19-1-0-36-B,6831-01-6005,SNGL FAM SUB,1.13,AC,41000,0,41000,156300,2800,200100,40500,0,40500,130600,3000,174100,A1,AG/GEN,,,
8235,27-7-0-2-F,6718-79-2990,SNGL FAM SUB,2.89,AC,49400,0,49400,139100,1500,190000,48400,0,48400,117200,1500,167100,A1,AG/GEN,,,
8236,44-16-0-12-0,6787-49-1209,SNGL FAM SUB,6.02,AC,148400,0,148400,254300,0,402700,132300,0,132300,234800,0,367100,A2,AG/LTD,,,
8237,15-1-0-31-0,5789-28-4832,SNGL FAM SUB,13.08,AC,76400,0,76400,176100,3700,256200,74200,0,74200,151200,3700,229100,A1,AG/GEN,,,
8239,58-4-E-7-0,7716-56-6103,SNGL FAM SUB,0,AC,92400,0,92400,527200,65800,685400,84000,0,84000,463200,55200,602400,A2,AG/LTD,,,
8242,26-2-0-3-J,6709-71-8548,SNGL FAM SUB,7.493,AC,76400,0,76400,289000,1200,366600,77000,0,77000,238800,1200,317000,A1,AG/GEN,,,
8243,64-12-A-9-0,7724-50-5217,SNGL FAM SUB,0,AC,77000,0,77000,194300,1500,272800,67000,0,67000,168200,1500,236700,R1,RES/LTD,,,
8244,46-24-0-3-0,7707-45-4666,SNGL FAM SUB,8.43,AC,194500,0,194500,446100,1000,641600,173800,0,173800,371500,1000,546300,A2,AG/LTD,,,
8245,12-5-0-2-0,6832-35-1863,SNGL FAM SUB,2.25,AC,45500,0,45500,176000,1500,223000,45300,0,45300,157000,1500,203800,A1,AG/GEN,,,
8246,16-5-0-7-0,5890-45-6770,SNGL FAM SUB,1.72,AC,41400,0,41400,0,0,41400,40500,0,40500,0,0,40500,A1,AG/GEN,,,
8247,16-5-0-8-0,5890-45-7867,SNGL FAM SUB,1.01,AC,38900,0,38900,113100,1000,153000,38100,0,38100,92700,1000,131800,A1,AG/GEN,,,
8248,26-7-0-6-0,6708-84-9888,SNGL FAM SUB,3.01,AC,50100,0,50100,0,0,50100,49100,0,49100,0,0,49100,A1,AG/GEN,,,
8249,26-7-0-7-0,6708-85-8009,SNGL FAM SUB,3.74,AC,54100,0,54100,303100,2500,359700,53100,0,53100,262100,2500,317700,A1,AG/GEN,,,
8250,26-7-0-12-0,6708-84-8787,SNGL FAM SUB,6.35,AC,58300,0,58300,0,0,58300,57100,0,57100,0,0,57100,A1,AG/GEN,,,
8252,45-18-0-7-0,6797-45-6990,SNGL FAM SUB,5.039,AC,200000,0,200000,312100,45100,557200,180000,0,180000,284300,45200,509500,A2,AG/LTD,,,
8253,44-1-0-10-0,6787-16-0006,AG > 100 AC,502.376,AC,5230800,4890200,340600,1880000,406900,7517700,4656500,4349400,307100,1533500,352800,6542800,A1RP,AG GEN,,,
8260,31-11-0-9-0,6779-41-2530,SNGL FAM SUB,6.66,AC,132000,0,132000,0,0,132000,117800,0,117800,0,0,117800,A2,AG/LTD,,,
8261,6-1-0-48-0,6832-28-4726,SNGL FAM SUB,7.18,AC,74000,0,74000,0,0,74000,72000,0,72000,0,0,72000,A1,AG/GEN,,,
8262,58-4-A-3-0,7716-57-0110,SNGL FAM SUB,0,AC,105600,0,105600,359400,2000,467000,96000,0,96000,305000,2000,403000,A2,AG/LTD,,,
8264,64-4-2-1-0,7724-93-3079,SNGL FAM SUB,0.458,AC,70000,0,70000,221800,0,291800,60000,0,60000,195600,0,255600,RN,RESIDEN,,,
8266,56-1-0-70-0,6796-95-1275,SNGL FAM SUB,3.52,AC,125900,124300,1600,0,0,125900,109500,108000,1500,0,0,109500,A2,AG/LTD,,,
8267,42-1-0-77-0,6767-09-0775,COMM & IND,22.7,AC,1532600,0,1532600,341100,73500,1947200,1472900,0,1472900,306900,73000,1852800,A2,AG/LTD,,,
8268,45-5-0-5-0,6797-67-7502,COMM & IND,5.4,AC,440200,0,440200,445300,15800,901300,419100,0,419100,434000,17800,870900,M1,INDUS/L,,,
8269,58-4-D-19-0,7716-56-0275,SNGL FAM SUB,0,AC,20100,0,20100,0,0,20100,18300,0,18300,0,0,18300,A2,AG/LTD,,,
8270,38-7-0-C-1,6717-09-3217,SNGL FAM SUB,5.02,AC,61300,0,61300,123400,0,184700,60100,0,60100,99300,0,159400,A1,AG/GEN,,,
8271,4-1-0-7-0,6803-44-6951,SNGL FAM SUB,1.97,AC,44300,0,44300,79400,1000,124700,43300,0,43300,69800,1000,114100,A1,AG/GEN,,,
8272,26-2-0-3-L,6709-81-5064,SNGL FAM SUB,8.02,AC,81600,0,81600,0,0,81600,80100,0,80100,0,0,80100,A1,AG/GEN,,,
8273,39-1-0-92-A,6727-13-6994,SNGL FAM SUB,0.868,AC,33700,0,33700,124600,25400,183700,33000,0,33000,108400,21900,163300,A1,AG/GEN,,,
8274,62-20-B-2-0,7714-15-3337,SNGL FAM SUB,0,AC,115000,0,115000,290300,0,405300,100000,0,100000,271600,0,371600,R1,RES/LTD,,,
8275,63-19-0-B-0,7724-05-4230,SNGL FAM SUB,1.24,AC,207900,0,207900,530500,6300,744700,189000,0,189000,484200,5800,679000,A2,AG/LTD,,,
8276,64-12-C-7-0,7724-50-8386,SNGL FAM SUB,0,AC,77000,0,77000,177700,600,255300,67000,0,67000,159700,600,227300,R1,RES/LTD,,,
8277,63-11-0-A-7,7714-45-6690,SNGL FAM SUB,5.502,AC,236200,0,236200,363700,41000,640900,158500,0,158500,318100,39400,516000,R3,RES/GEN,,,
8278,63-11-0-A-9,7714-46-6142,SNGL FAM SUB,4.737,AC,215600,0,215600,0,0,215600,187500,0,187500,0,0,187500,R3,RES/GEN,,,
8279,67-11-C-4-0,7733-26-4779,SNGL FAM SUB,1.035,AC,265000,0,265000,508600,0,773600,220000,0,220000,468800,0,688800,R1,RES/LTD,,,
8280,46-23-0-32-0,7707-85-8195,SNGL FAM SUB,2.04,AC,165000,0,165000,273700,0,438700,150000,0,150000,230600,0,380600,A2,AG/LTD,,,
8282,13-1-0-47-0,6841-45-8381,AG 20-100 AC,34.2,AC,107900,92100,15800,0,0,107900,106300,91800,14500,0,0,106300,A1,AG/GEN,,,
8284,44-1-0-70-0,6786-78-0622,Place of Worship,4.71,AC,128700,0,128700,0,0,128700,114900,0,114900,0,0,114900,A2,AG/LTD,,,
8285,58-22-A-5-0,7715-26-8993,SNGL FAM SUB,2.88,AC,383300,0,383300,451500,2000,836800,351800,0,351800,422400,2000,776200,A2,AG/LTD,,,
8286,55-1-0-18-0,6785-16-8568,SNGL FAM SUB,1.066,AC,71000,0,71000,157500,0,228500,63400,0,63400,131500,0,194900,A2,AG/LTD,,,
8287,58-2-0-8-0,7726-36-0233,SNGL FAM SUB,0,AC,88000,0,88000,161600,5500,255100,80000,0,80000,135700,5500,221200,RN,RESIDEN,,,
8288,58-6-0-5-0,7726-12-3056,SNGL FAM SUB,0.97,AC,94600,0,94600,125400,400,220400,82300,0,82300,111400,400,194100,A2,AG/LTD,,,
8289,29-2-0-2-C,6749-60-7124,SNGL FAM SUB,1.07,AC,54700,0,54700,393700,0,448400,50600,0,50600,0,0,50600,A1,AG/GEN,,,
8290,63-1-0-115-0,7715-51-4127,SNGL FAM SUB,6,AC,210400,0,210400,5000,0,215400,182800,0,182800,5000,0,187800,A2,AG/LTD,,,
8291,29-2-0-2-A,6749-60-5163,SNGL FAM SUB,1.06,AC,54600,0,54600,1000,0,55600,50500,0,50500,1000,0,51500,A1,AG/GEN,,,
8292,63-1-0-58-0,7714-33-5841,SNGL FAM SUB,0.5,AC,57600,0,57600,0,0,57600,50100,0,50100,0,0,50100,R3,RES/GEN,,,
8296,20-11-0-5-0,6841-91-1880,SNGL FAM SUB,2,AC,58600,0,58600,135600,27700,221900,57500,0,57500,125200,24100,206800,A1,AG/GEN,,,
8297,31-17-0-7-0,6779-43-8539,SNGL FAM SUB,8.218,AC,137000,0,137000,226800,62700,426500,122200,0,122200,184900,52800,359900,A2,AG/LTD,,,
8298,27-1-0-18-0,6718-66-1006,SNGL FAM SUB,9,AC,64200,0,64200,0,0,64200,63000,0,63000,0,0,63000,A1,AG/GEN,,,
8299,45-18-0-15-0,6797-33-7910,SNGL FAM SUB,4.596,AC,200000,0,200000,397700,1500,599200,180000,0,180000,365100,1500,546600,A2,AG/LTD,,,
8300,11-1-0-24-0,6821-05-9273,AG 20-100 AC,25.97,AC,175300,0,175300,137600,24400,337300,175300,0,175300,108600,20500,304400,A1,AG/GEN,,,
8324,63-1-0-82-0,7723-07-5484,SNGL FAM SUB,7.46,AC,483500,0,483500,1256600,69600,1809700,420400,0,420400,1066200,60000,1546600,A2,AG/LTD,,,
8325,57-20-E-3-0,7715-29-2053,SNGL FAM SUB,1.936,AC,365000,0,365000,318100,1600,684700,335000,0,335000,286800,1600,623400,A2,AG/LTD,,,
8326,27-1-0-80-0,6728-64-2780,SNGL FAM SUB,12,AC,100400,0,100400,169800,1600,271800,98500,0,98500,144100,1700,244300,A1,AG/GEN,,,
8327,55-1-0-5-0,6786-15-3955,SNGL FAM SUB,8.5,AC,173600,0,173600,0,0,173600,154900,0,154900,0,0,154900,A2,AG/LTD,,,
8328,27-1-0-80-A,6728-44-7615,SNGL FAM SUB,1.34,AC,40900,0,40900,103000,900,144800,40000,0,40000,87900,900,128800,A1,AG/GEN,,,
8330,4-1-0-14-0,6803-54-4676,SNGL FAM SUB,10,AC,90100,0,90100,109900,0,200000,83000,0,83000,97200,0,180200,A1,AG/GEN,,,
8331,58-4-D-2-0,7716-56-2326,SNGL FAM SUB,1.72,AC,101200,0,101200,749000,0,850200,92000,0,92000,637100,0,729100,A2,AG/LTD,,,
8333,58-4-D-6-0,7716-56-4474,SNGL FAM SUB,0,AC,10000,0,10000,0,0,10000,9100,0,9100,0,0,9100,A2,AG/LTD,,,
8337,58-4-E-2-0,7716-56-1067,SNGL FAM SUB,0,AC,20100,0,20100,0,0,20100,18300,0,18300,0,0,18300,A2,AG/LTD,,,
8339,58-4-E-4-0,7716-56-3029,SNGL FAM SUB,0,AC,92400,0,92400,192600,2000,287000,84000,0,84000,160600,2000,246600,A2,AG/LTD,,,
8341,58-4-D-13-0,7716-56-4360,SNGL FAM SUB,0.84,AC,92400,0,92400,148700,400,241500,84000,0,84000,123300,400,207700,A2,AG/LTD,,,
8342,57-1-0-75-0,7706-73-0950,SNGL FAM SUB,17.35,AC,687900,0,687900,1246600,106200,2040700,597800,0,597800,1047300,93600,1738700,A2,AG/LTD,,,
8343,57-1-0-78-0,7706-73-5990,SNGL FAM SUB,2.844,AC,175400,0,175400,0,0,175400,152400,0,152400,0,0,152400,A2,AG/LTD,,,
8344,26-1-0-57-A,6719-33-1490,AG 20-100 AC,25.82,AC,153000,102500,50500,278100,4200,435300,149700,101100,48600,237800,4200,391700,A1,AG/GEN,,,
8345,26-1-0-57-B,6719-22-4608,SNGL FAM SUB,3,AC,50000,48500,1500,0,0,50000,49000,47700,1300,0,0,49000,A1,AG/GEN,,,
8346,44-1-0-28-0,6787-02-5780,SNGL FAM SUB,2.68,AC,92300,0,92300,138600,5000,235900,82400,0,82400,112500,5000,199900,A2,AG/LTD,,,
8347,44-1-0-30-0,6787-12-1894,SNGL FAM SUB,2.14,AC,88100,0,88100,0,0,88100,78700,0,78700,0,0,78700,A2,AG/LTD,,,
8348,44-1-0-28-A,6787-02-8796,SNGL FAM SUB,1.966,AC,85400,0,85400,259500,500,345400,76200,0,76200,216300,500,293000,A2,AG/LTD,,,
8349,57-1-0-11-A,7706-33-6679,SNGL FAM SUB,5.979,AC,265000,0,265000,883000,10900,1158900,230600,0,230600,745200,9600,985400,A2,AG/LTD,,,
8350,32-4-0-9-0,6779-65-0217,SNGL FAM SUB,7.97,AC,139400,0,139400,231800,0,371200,124100,0,124100,195300,0,319400,A2,AG/LTD,,,
8351,42-21-0-3-0,6767-10-5762,SNGL FAM SUB,7.986,AC,131300,0,131300,206600,1000,338900,120500,0,120500,169700,1000,291200,A2,AG/LTD,,,
8352,9-1-0-15-0,5892-63-9300,SNGL FAM SUB,3.173,AC,46600,0,46600,274500,0,321100,45600,0,45600,245300,0,290900,A1,AG/GEN,,,
8353,57-10-0-2-0,7705-86-6220,SNGL FAM SUB,4.17,AC,230000,0,230000,204500,1300,435800,210000,0,210000,195100,1300,406400,A2,AG/LTD,,,
8354,32-10-1-8-0,6778-68-9192,SNGL FAM SUB,2.18,AC,84300,0,84300,188000,15100,287400,75300,0,75300,153400,13600,242300,A2,AG/LTD,,,
8355,46-22-0-D-0,7706-97-2820,SNGL FAM SUB,10.637,AC,359200,0,359200,892200,126100,1377500,320500,0,320500,753600,113400,1187500,A2,AG/LTD,,,
8356,58-1-0-52-0,7715-98-8969,SNGL FAM SUB,8.19,AC,323700,0,323700,0,0,323700,281300,0,281300,0,0,281300,A2,AG/LTD,,,
8357,50-5-0-12-0,6726-41-2763,SNGL FAM SUB,12,AC,87500,0,87500,463300,0,550800,83700,0,83700,419000,0,502700,A1,AG/GEN,,,
8358,1-1-0-9-B,6814-55-2946,SNGL FAM SUB,6.5,AC,71200,0,71200,0,0,71200,69900,0,69900,0,0,69900,A1,AG/GEN,,,
8359,58-2-0-17-0,7726-36-3203,SNGL FAM SUB,0,AC,88000,0,88000,149700,700,238400,80000,0,80000,127100,700,207800,RN,RESIDEN,,,
8360,58-2-0-29-0,7726-36-4372,SNGL FAM SUB,0,AC,42600,0,42600,0,0,42600,38800,0,38800,0,0,38800,RN,RESIDEN,,,
8361,58-23-0-1-0,7716-87-8201,SNGL FAM SUB,9.329,AC,333700,0,333700,617000,24800,975500,290300,0,290300,521200,23900,835400,A2,AG/LTD,,,
8362,39-1-0-60-0,6716-78-4818,AG 20-100 AC,29.52,AC,90300,76700,13600,0,0,90300,88600,76100,12500,0,0,88600,A1,AG/GEN,,,
8363,39-1-0-60-A,6716-87-1936,AG 20-100 AC,26.381,AC,80700,68500,12200,0,0,80700,79100,67900,11200,0,0,79100,A1,AG/GEN,,,
8364,18-8-0-3-0,6820-20-1496,SNGL FAM SUB,2.277,AC,47700,0,47700,140300,1400,189400,45700,0,45700,84800,1500,132000,A1,AG/GEN,,,
8365,45-2-0-1-0,6787-84-2071,SNGL FAM SUB,1.28,AC,74100,0,74100,154500,200,228800,66200,0,66200,126500,200,192900,A2,AG/LTD,,,
8366,32-10-1-2-0,6778-78-8917,SNGL FAM SUB,1.51,AC,74600,0,74600,165300,4000,243900,66700,0,66700,134500,4000,205200,A2,AG/LTD,,,
8367,32-2-0-3-E,6778-87-1787,SNGL FAM SUB,3.32,AC,97500,0,97500,132200,5100,234800,87100,0,87100,108800,5100,201000,A2,AG/LTD,,,
8368,32-13-0-1-0,6778-77-9870,SNGL FAM SUB,2.81,AC,90200,0,90200,0,0,90200,80500,0,80500,0,0,80500,A2,AG/LTD,,,
8369,62-4-E-6-0,7714-05-4180,SNGL FAM SUB,0,AC,115000,0,115000,197400,300,312700,100000,0,100000,182800,300,283100,R1,RES/LTD,,,
8370,62-3-D-8-0,7714-04-8387,SNGL FAM SUB,0.54,AC,115000,0,115000,192400,19000,326400,100000,0,100000,178600,16400,295000,R1,RES/LTD,,,
8371,25-1-0-10-0,5799-35-1235,SNGL FAM SUB,7.6,AC,69200,0,69200,0,0,69200,67700,0,67700,0,0,67700,A1,AG/GEN,,,
8372,25-1-0-9-0,5799-15-4055,SNGL FAM SUB,6.86,AC,65800,0,65800,150500,0,216300,64400,0,64400,131400,0,195800,A1,AG/GEN,,,
8373,15-1-0-8-A,5880-73-2804,AG 20-100 AC,93.48,AC,211000,167900,43100,0,0,211000,206100,166400,39700,0,0,206100,A1,AG/GEN,,,
8374,15-1-0-8-B,5799-17-0347,SNGL FAM SUB,1.589,AC,40600,0,40600,0,0,40600,39800,0,39800,0,0,39800,A1,AG/GEN,,,
8375,24-1-0-2-0,5789-92-7388,AG > 100 AC,100,AC,250000,200500,49500,0,0,250000,250000,207200,42800,0,0,250000,A1,AG/GEN,,,
8376,24-1-0-6-0,5799-05-5288,SNGL FAM SUB,12.392,AC,85500,0,85500,406100,0,491600,83600,0,83600,366900,0,450500,A1,AG/GEN,,,
8377,25-1-0-11-0,5799-15-3625,SNGL FAM SUB,4.145,AC,53300,0,53300,0,0,53300,52200,0,52200,0,0,52200,A1,AG/GEN,,,
8379,25-1-0-13-0,5799-14-3332,SNGL FAM SUB,9.371,AC,73100,0,73100,256100,0,329200,71500,0,71500,219200,0,290700,A1,AG/GEN,,,
8380,25-1-0-14-0,5799-12-2802,AG 20-100 AC,90,AC,50100,4200,45900,0,0,50100,43100,4400,38700,0,0,43100,A1,AG/GEN,,,
8381,24-1-0-5-0,5799-05-8527,SNGL FAM SUB,6.218,AC,62800,0,62800,0,0,62800,61500,0,61500,0,0,61500,A1,AG/GEN,,,
8382,14-1-0-6-0,6851-29-7865,AG 20-100 AC,57.88,AC,148400,0,148400,0,0,148400,145500,0,145500,0,0,145500,A1,AG/GEN,,,
8383,14-1-0-6-A,6852-20-9857,SNGL FAM SUB,0.59,AC,1500,0,1500,0,0,1500,1500,0,1500,0,0,1500,A1,AG/GEN,,,
8384,58-1-0-90-0,7726-27-7030,SNGL FAM SUB,1,AC,88000,0,88000,87500,0,175500,80000,0,80000,74400,0,154400,R3,RES/GEN,,,
8386,15-5-0-25-0,5789-67-6963,SNGL FAM SUB,8.06,AC,64200,0,64200,0,2500,66700,62700,0,62700,0,2500,65200,A1,AG/GEN,,,
8387,58-2-0-20-0,7726-36-2544,SNGL FAM SUB,0,AC,96800,0,96800,151500,67200,315500,88000,0,88000,126300,65400,279700,RN,RESIDEN,,,
8389,57-19-0-A-0,7706-12-7990,SNGL FAM SUB,6.13,AC,243300,0,243300,0,0,243300,211800,0,211800,0,0,211800,A2,AG/LTD,,,
8390,57-19-0-B-0,7706-22-2833,SNGL FAM SUB,11.65,AC,388500,0,388500,308200,98300,795000,338200,0,338200,267400,81600,687200,A2,AG/LTD,,,
8391,12-18-0-D-0,6831-49-6516,AG 20-100 AC,24.51,AC,174600,0,174600,412000,7000,593600,168800,0,168800,371000,6000,545800,A1,AG/GEN,,,
8392,14-3-0-13-0,6851-48-1653,SNGL FAM SUB,4.37,AC,75400,0,75400,187200,9100,271700,73900,0,73900,137600,500,212000,A1,AG/GEN,,,
8393,27-1-0-52-0,6729-14-2789,AG 20-100 AC,90.89,AC,319500,277600,41900,0,0,319500,318100,279500,38600,0,0,318100,A1,AG/GEN,,,
8394,47-15-0-1-0,7718-61-0151,SNGL FAM SUB,3.045,AC,133800,0,133800,203500,600,337900,119500,0,119500,171600,600,291700,A2,AG/LTD,,,
8395,10-1-0-25-0,6801-76-4068,AG 20-100 AC,70.801,AC,259800,102400,157400,312000,128300,700100,197600,123500,74100,268500,111800,577900,A1,AG/GEN,,,
8397,45-1-0-81-0,6797-92-1016,AG 20-100 AC,24.764,AC,423800,316900,106900,909500,51100,1384400,377900,282100,95800,744200,46600,1168700,A2,AG/LTD,,,
8398,45-1-0-82-0,6797-83-0510,SNGL FAM SUB,17.13,AC,314600,306500,8100,0,0,314600,281400,274100,7300,0,0,281400,A2,AG/LTD,,,
8399,56-2-0-2-0,6795-88-2034,SNGL FAM SUB,13.67,AC,407500,252300,155200,455400,34400,897300,353900,218900,135000,382500,32900,769300,A2,AG/LTD,,,
8400,31-17-0-5-0,6779-43-2714,SNGL FAM SUB,8.003,AC,143900,0,143900,198300,5000,347200,128600,0,128600,161800,5000,295400,A2,AG/LTD,,,
8401,26-1-0-42-0,6718-38-8500,AG 20-100 AC,40,AC,144000,0,144000,0,0,144000,140000,0,140000,0,0,140000,A1,AG/GEN,,,
8402,67-2-C-14-0,7723-54-6735,SNGL FAM SUB,0,AC,184000,0,184000,331800,21500,537300,160000,0,160000,285300,22400,467700,R1,RES/LTD,,,
8403,33-4-0-30-0,6798-52-9948,SNGL FAM SUB,3.17,AC,106600,0,106600,275300,4100,386000,95200,0,95200,231100,3800,330100,A2,AG/LTD,,,
8404,58-21-D-2-0,7716-42-0559,SNGL FAM SUB,3.065,AC,346800,0,346800,627700,700,975200,318300,0,318300,583800,700,902800,R3,RES/GEN,,,
8405,50-5-0-5-0,6726-44-8394,SNGL FAM SUB,9.74,AC,77100,0,77100,535600,0,612700,73500,0,73500,481300,0,554800,A1,AG/GEN,,,
8406,50-5-0-24-0,6726-31-2676,SNGL FAM SUB,10.12,AC,78900,0,78900,415600,6700,501200,75200,0,75200,355500,7400,438100,A1,AG/GEN,,,
8407,38-3-0-3-0,6717-17-8403,AG 20-100 AC,21.5,AC,122900,111900,11000,0,0,122900,120000,110800,9200,0,0,120000,A1,AG/GEN,,,
8408,38-4-0-1-0,6717-27-8853,AG 20-100 AC,71.3,AC,316300,241600,74700,194000,40600,550900,308900,240700,68200,164700,40600,514200,A1,AG/GEN,,,
8409,13-1-0-2-0,6842-63-1684,AG 20-100 AC,44.589,AC,163300,142700,20600,0,0,163300,160500,141500,19000,0,0,160500,A1,AG/GEN,,,
8410,43-1-0-58-A,6768-82-2106,SNGL FAM SUB,1.079,AC,71200,0,71200,161700,1500,234400,63600,0,63600,132200,1500,197300,A2,AG/LTD,,,
8411,51-1-0-49-B,6736-54-0066,AG 20-100 AC,51.39,AC,157300,0,157300,0,3000,160300,154200,0,154200,0,3000,157200,A1,AG/GEN,,,
8412,51-1-0-49-0,6736-54-8551,SNGL FAM SUB,10,AC,85300,0,85300,0,0,85300,83700,0,83700,0,0,83700,A1,AG/GEN,,,
8413,42-8-2-1-0,6767-18-7288,SNGL FAM SUB,0,AC,60000,0,60000,185700,19200,264900,55000,0,55000,154300,16700,226000,A2,AG/LTD,,,
8414,51-1-0-26-B,6735-28-9953,SNGL FAM SUB,9.91,AC,88700,0,88700,161600,35000,285300,87000,0,87000,138300,30400,255700,A1,AG/GEN,,,
8415,19-4-0-C-3,6830-39-1092,AG 20-100 AC,40.112,AC,293000,220700,72300,221600,2300,516900,287200,225900,61300,187400,2300,476900,A1,AG/GEN,,,
8416,62-2-C-2-0,7714-04-3103,SNGL FAM SUB,0,AC,115000,0,115000,190600,0,305600,100000,0,100000,174400,0,274400,R1,RES/LTD,,,
8417,62-3-C-22-0,7714-04-4120,SNGL FAM SUB,0,AC,115000,0,115000,0,6900,121900,100000,0,100000,0,5800,105800,R1,RES/LTD,,,
8418,31-16-0-A-0,6778-07-1958,SNGL FAM SUB,2.07,AC,80300,0,80300,272100,0,352400,71600,0,71600,224400,0,296000,A2,AG/LTD,,,
8419,26-2-0-3-F,6709-82-6533,SNGL FAM SUB,7.827,AC,77900,0,77900,162400,2400,242700,79000,0,79000,132600,2600,214200,A1,AG/GEN,,,
8420,31-1-0-14-0,6769-42-6720,AG 20-100 AC,25.471,AC,315400,213100,102300,706800,16300,1038500,285100,210600,74500,566200,9600,860900,A2,AG/LTD,,,
8421,5-8-0-B-0,6813-67-8681,SNGL FAM SUB,11.38,AC,91600,0,91600,0,0,91600,89900,0,89900,0,0,89900,A1,AG/GEN,,,
8423,63-1-0-108-0,7715-31-8509,SNGL FAM SUB,2.81,AC,162700,0,162700,133600,12500,308800,141500,0,141500,112600,12500,266600,A2,AG/LTD,,,
8424,58-3-D-1-0,7726-26-3612,SNGL FAM SUB,0,AC,92400,0,92400,145200,1700,239300,84000,0,84000,120100,1700,205800,RN,RESIDEN,,,
8425,11-1-0-31-0,6811-64-6143,AG 20-100 AC,36.5,AC,147900,131100,16800,0,0,147900,147800,132300,15500,0,0,147800,A1,AG/GEN,,,
8426,11-1-0-32-0,6811-74-7607,AG 20-100 AC,41,AC,159100,140200,18900,0,0,159100,155800,138400,17400,0,0,155800,A1,AG/GEN,,,
8427,15-1-0-11-0,5880-96-2069,SNGL FAM SUB,18,AC,72600,0,72600,0,0,72600,71000,0,71000,0,0,71000,A1,AG/GEN,,,
8428,66-1-0-10-0,7723-44-2530,SNGL FAM SUB,3.967,AC,390000,0,390000,578400,0,968400,340000,0,340000,547000,0,887000,R1,RES/LTD,,,
8429,67-2-D-16-0,7723-64-0673,SNGL FAM SUB,0,AC,184000,0,184000,246900,0,430900,160000,0,160000,211600,0,371600,R1,RES/LTD,,,
8430,44-2-0-9-0,6787-73-4829,SNGL FAM SUB,3.14,AC,96100,0,96100,0,0,96100,85800,0,85800,0,0,85800,A2,AG/LTD,,,
8431,67-10-0-6-0,7733-06-5937,SNGL FAM SUB,2.26,AC,323000,0,323000,0,24600,347600,270800,0,270800,0,21300,292100,R1,RES/LTD,,,
8432,67-10-0-7-0,7733-06-5544,SNGL FAM SUB,1.94,AC,323000,0,323000,878200,57800,1259000,270800,0,270800,685600,51100,1007500,R1,RES/LTD,,,
8435,12-5-0-1-0,6832-36-2261,SNGL FAM SUB,2.22,AC,50300,0,50300,186700,2000,239000,49400,0,49400,162000,2000,213400,A1,AG/GEN,,,
8436,45-1-0-113-0,6798-60-1565,SNGL FAM SUB,4.37,AC,106100,0,106100,195800,3500,305400,94700,0,94700,160800,3500,259000,A2,AG/LTD,,,
8438,45-1-0-113-C,6797-69-8971,SNGL FAM SUB,11.35,AC,202400,0,202400,177500,32900,412800,180500,0,180500,145400,28700,354600,A2,AG/LTD,,,
8439,45-1-0-129-A,6797-69-1471,SNGL FAM SUB,4.502,AC,110000,0,110000,192700,0,302700,104300,0,104300,157700,0,262000,A2,AG/LTD,,,
8440,45-1-0-10-A,6797-28-7729,COMM & IND,2.616,AC,262600,0,262600,107300,2000,371900,243300,0,243300,100200,2000,345500,B1,BUS/GEN,,,
8441,67-2-B-8-0,7723-45-9799,SNGL FAM SUB,0,AC,184000,0,184000,312500,19200,515700,160000,0,160000,260500,16200,436700,R1,RES/LTD,,,
8442,45-1-0-11-0,6797-29-4132,COMM & IND,0.93,AC,93400,0,93400,97000,0,190400,86500,0,86500,81500,0,168000,B1,BUS/GEN,,,
8443,46-9-0-B-3B,7707-67-9623,SNGL FAM SUB,5.906,AC,168000,0,168000,0,0,168000,152800,0,152800,0,0,152800,A2,AG/LTD,,,
8444,43-20-0-14-0,6768-42-4369,SNGL FAM SUB,4.34,AC,96800,0,96800,184200,31900,312900,88000,0,88000,161200,26800,276000,A2,AG/LTD,,,
8445,43-20-0-15-0,6768-42-0368,SNGL FAM SUB,6.26,AC,110000,0,110000,228900,2800,341700,100000,0,100000,200500,2300,302800,A2,AG/LTD,,,
8446,43-20-0-16-0,6768-32-8108,SNGL FAM SUB,6.85,AC,110000,0,110000,205700,0,315700,100000,0,100000,182600,0,282600,A2,AG/LTD,,,
8447,43-20-0-17-0,6768-31-8802,SNGL FAM SUB,5.37,AC,110000,0,110000,149300,400,259700,100000,0,100000,130400,400,230800,A2,AG/LTD,,,
8448,43-20-0-21-0,6768-41-5097,SNGL FAM SUB,5.95,AC,110000,0,110000,200900,0,310900,100000,0,100000,171800,0,271800,A2,AG/LTD,,,
8449,43-20-0-28-0,6768-51-2273,SNGL FAM SUB,5.33,AC,110000,0,110000,142700,8000,260700,100000,0,100000,124800,8300,233100,A2,AG/LTD,,,
8450,45-1-0-10-0,6797-28-8953,COMM & IND,0.486,AC,48800,0,48800,63100,0,111900,45200,0,45200,62200,0,107400,B1,BUS/GEN,,,
8451,47-1-0-80-G,7726-08-4157,COMM & IND,0.298,AC,220300,0,220300,52700,0,273000,209400,0,209400,49500,0,258900,B1,BUS/GEN,,,
8452,55-1-0-44-0,6786-52-1654,SNGL FAM SUB,16.39,AC,282500,274800,7700,0,0,282500,251900,244900,7000,0,0,251900,A2,AG/LTD,,,
8453,55-1-0-44-A,6786-52-9377,SNGL FAM SUB,6.5,AC,160900,88100,72800,240000,22000,422900,143500,78500,65000,201700,22000,367200,A2,AG/LTD,,,
8454,43-20-0-20-0,6768-30-7894,SNGL FAM SUB,8.84,AC,129800,0,129800,140900,1000,271700,118000,0,118000,125600,1000,244600,A2,AG/LTD,,,
8455,44-1-0-32-0,6787-13-3176,SNGL FAM SUB,0.6,AC,9500,0,9500,0,0,9500,8500,0,8500,0,0,8500,A2,AG/LTD,,,
8456,44-1-0-32-A,6787-12-4938,SNGL FAM SUB,1.25,AC,74100,0,74100,98400,8500,181000,66100,0,66100,81500,8500,156100,A2,AG/LTD,,,
8457,45-1-0-13-0,6797-19-9288,COMM & IND,4.99,AC,418500,0,418500,153400,7500,579400,393200,0,393200,153300,5600,552100,B1,BUS/GEN,,,
8458,55-1-0-65-0,6786-64-3184,SNGL FAM SUB,1.904,AC,85000,0,85000,607400,98900,791300,75900,0,75900,488700,90300,654900,A2,AG/LTD,,,
8459,58-22-A-8-0,7715-27-3532,SNGL FAM SUB,3.176,AC,383300,0,383300,0,0,383300,351800,0,351800,0,0,351800,R3,RES/GEN,,,
8460,30-1-0-122-0,6759-36-8638,MultiFamily,3.39,AC,82900,0,82900,104900,2000,189800,74800,0,74800,87200,2000,164000,A2,AG/LTD,,,
8461,47-1-0-80-A,7726-08-4046,COMM & IND,0.45,AC,312900,0,312900,92700,6300,411900,284500,0,284500,89600,6400,380500,B1,BUS/GEN,,,
8462,55-1-0-45-B,6786-42-7947,SNGL FAM SUB,2.13,AC,88700,87700,1000,0,0,88700,79200,78300,900,0,0,79200,A2,AG/LTD,,,
8463,12-7-0-1-0,6821-97-1629,SNGL FAM SUB,6.54,AC,76800,0,76800,181100,2400,260300,68300,0,68300,148400,2600,219300,A1,AG/GEN,,,
8464,12-7-0-2-0,6821-87-8315,SNGL FAM SUB,2.01,AC,41700,0,41700,0,0,41700,41400,0,41400,0,0,41400,A1,AG/GEN,,,
8465,18-4-0-3-B,6820-00-8480,SNGL FAM SUB,3,AC,52000,0,52000,156100,6200,214300,50000,0,50000,130600,6200,186800,A1,AG/GEN,,,
8466,47-1-0-86-0,7726-27-9448,SNGL FAM SUB,0.5,AC,220400,0,220400,0,0,220400,200400,0,200400,0,0,200400,R3,RES/GEN,,,
8467,58-12-0-B-0,7726-27-7169,SNGL FAM SUB,0.67,AC,128400,0,128400,0,0,128400,116700,0,116700,1900,300,118900,R3,RES/GEN,,,
8468,62-13-A-5-0,7714-05-5543,SNGL FAM SUB,0,AC,115000,0,115000,138200,0,253200,100000,0,100000,125100,0,225100,R1,RES/LTD,,,
8469,55-14-0-25-0,6786-31-4894,SNGL FAM SUB,10.7,AC,245600,0,245600,524900,70700,841200,219600,0,219600,430100,66900,716600,A2,AG/LTD,,,
8470,47-19-0-1-0,7728-00-5670,AG 20-100 AC,67.13,AC,986600,955500,31100,0,42200,1028800,882200,853700,28500,0,38700,920900,A2,AG/LTD,,,
8484,58-15-0-1-0,7716-86-5181,SNGL FAM SUB,5,AC,237200,0,237200,288900,39800,565900,206300,0,206300,244400,35800,486500,A2,AG/LTD,,,
8485,58-23-0-4-0,7716-86-6336,SNGL FAM SUB,4.736,AC,231300,0,231300,335100,800,567200,201200,0,201200,283600,800,485600,A2,AG/LTD,,,
8486,18-4-0-2-C,6729-29-5063,SNGL FAM SUB,10,AC,89100,0,89100,0,10200,99300,87500,0,87500,0,10000,97500,A1,AG/GEN,,,
8487,64-15-B-3-0,7733-37-0239,SNGL FAM SUB,0,AC,265000,0,265000,452800,0,717800,220000,0,220000,399400,0,619400,R1,RES/LTD,,,
8488,63-1-0-93-0,7714-86-4856,SNGL FAM SUB,3.5,AC,14300,0,14300,0,0,14300,12400,0,12400,0,0,12400,A2,AG/LTD,,,
8489,63-4-0-2-0,7714-96-4225,SNGL FAM SUB,0,AC,198000,0,198000,359000,0,557000,180000,0,180000,349700,0,529700,A2,AG/LTD,,,
8491,63-4-0-7-0,7714-97-7023,SNGL FAM SUB,1.313,AC,198000,0,198000,563100,0,761100,180000,0,180000,528200,0,708200,A2,AG/LTD,,,
8493,63-4-0-9-0,7714-97-8487,SNGL FAM SUB,1.545,AC,198000,0,198000,456100,0,654100,180000,0,180000,434500,0,614500,A2,AG/LTD,,,
8517,63-3-D-1-0,7714-81-9870,SNGL FAM SUB,0,AC,70000,0,70000,306500,0,376500,60000,0,60000,274500,0,334500,R1,RES/LTD,,,
8518,63-3-B-D-0,7714-81-9839,SNGL FAM SUB,0.227,AC,5400,0,5400,0,0,5400,4700,0,4700,0,0,4700,R1,RES/LTD,,,
8519,26-1-0-72-0,6719-44-8908,SNGL FAM SUB,16.4,AC,84600,37500,47100,0,13700,98300,82700,38200,44500,0,12400,95100,A1,AG/GEN,,,
8520,11-1-0-47-A,6822-30-9542,SNGL FAM SUB,3.14,AC,52800,0,52800,330000,23800,406600,51900,0,51900,255000,22000,328900,A1,AG/GEN,,,
8524,11-1-0-46-0,6822-40-3380,SNGL FAM SUB,1.47,AC,42800,0,42800,0,0,42800,41100,0,41100,0,0,41100,A1,AG/GEN,,,
8525,18-2-0-5-0,6820-09-2918,SNGL FAM SUB,1.46,AC,8800,0,8800,0,0,8800,8800,0,8800,0,0,8800,A1,AG/GEN,,,
8526,11-1-0-47-0,6822-30-9020,AG 20-100 AC,24.86,AC,164900,0,164900,176400,1600,342900,169200,0,169200,145900,1600,316700,A1,AG/GEN,,,
8527,58-4-C-1-0,7716-56-0744,SNGL FAM SUB,0,AC,10000,0,10000,0,0,10000,9100,0,9100,0,0,9100,A2,AG/LTD,,,
8528,58-21-C-6-0,7716-12-9494,SNGL FAM SUB,4.291,AC,365000,0,365000,421300,70800,857100,335000,0,335000,382000,65500,782500,R3,RES/GEN,,,
8529,58-21-C-2-0,7716-23-5026,SNGL FAM SUB,1.489,AC,310000,0,310000,677700,0,987700,285000,0,285000,615200,0,900200,R3,RES/GEN,,,
8530,13-1-0-4-0,6842-65-3122,AG 20-100 AC,44.79,AC,192800,136200,56600,153600,45000,391400,192700,135700,57000,138400,39900,371000,A1,AG/GEN,,,
8531,54-1-0-12-0,6776-10-3913,AG 20-100 AC,68.43,AC,892700,0,892700,0,0,892700,799300,0,799300,0,0,799300,A2,AG/LTD,,,
8532,4-2-0-16-0,6814-20-8581,SNGL FAM SUB,2.988,AC,50200,0,50200,148000,17600,215800,49200,0,49200,133500,15000,197700,A1,AG/GEN,,,
8533,62-18-0-21-0,7704-73-3349,SNGL FAM SUB,3.4,AC,228400,0,228400,366600,1600,596600,200300,0,200300,324500,1600,526400,A2,AG/LTD,,,
8534,19-1-0-23-A,6830-10-4357,SNGL FAM SUB,0.341,AC,2600,0,2600,0,0,2600,2100,0,2100,0,0,2100,A1,AG/GEN,,,
8535,19-5-0-8-0,6830-10-5450,SNGL FAM SUB,0.649,AC,52600,0,52600,164400,100,217100,48600,0,48600,135300,100,184000,A1,AG/GEN,,,
8536,11-1-0-34-B,6821-12-1660,SNGL FAM SUB,1.51,AC,43100,0,43100,10700,300,54100,41300,0,41300,10000,300,51600,A1,AG/GEN,,,
8537,2-3-0-5-0,6824-33-2569,SNGL FAM SUB,3.54,AC,49200,0,49200,226500,8700,284400,48100,0,48100,215700,7300,271100,A1,AG/GEN,,,
8538,30-1-0-73-A,6758-89-9807,SNGL FAM SUB,1.81,AC,64000,0,64000,13200,4000,81200,58300,0,58300,11900,4000,74200,A2,AG/LTD,,,
8540,58-21-A-1-0,7716-53-6704,SNGL FAM SUB,1.077,AC,263500,0,263500,202400,500,466400,242300,0,242300,191900,500,434700,A2,AG/LTD,,,
8541,45-1-0-58-A,6797-08-5222,SNGL FAM SUB,5.58,AC,149100,0,149100,133300,46300,328700,133100,0,133100,111400,39300,283800,A2,AG/LTD,,,
8543,45-1-0-19-B,6797-08-4954,SNGL FAM SUB,2.21,AC,89200,0,89200,227000,40500,356700,79700,0,79700,188200,33400,301300,A2,AG/LTD,,,
8544,32-2-0-3-D,6778-87-4626,SNGL FAM SUB,3.65,AC,102300,0,102300,87800,4700,194800,91400,0,91400,73900,2900,168200,A2,AG/LTD,,,
8545,44-1-0-63-0,6786-48-8015,SNGL FAM SUB,0.95,AC,66600,0,66600,138800,0,205400,59500,0,59500,116200,0,175700,A2,AG/LTD,,,
8546,43-6-0-3-0,6767-64-9727,SNGL FAM SUB,1.37,AC,69400,0,69400,268900,0,338300,62000,0,62000,226900,0,288900,A2,AG/LTD,,,
8547,43-6-0-3-A,6767-64-8618,SNGL FAM SUB,1.5,AC,71300,0,71300,113000,500,184800,63700,0,63700,93600,500,157800,A2,AG/LTD,,,
8549,64-1-0-33-0,7723-59-1584,SNGL FAM SUB,0.46,AC,12100,0,12100,0,0,12100,10500,0,10500,0,0,10500,R1,RES/LTD,,,
8550,64-12-D-4-0,7723-59-3513,SNGL FAM SUB,0,AC,77000,0,77000,326100,3500,406600,67000,0,67000,289100,3500,359600,R1,RES/LTD,,,
8551,31-8-0-8-0,6779-51-1594,SNGL FAM SUB,1.49,AC,66200,0,66200,0,0,66200,59000,0,59000,0,0,59000,A2,AG/LTD,,,
8552,38-1-0-53-0,6707-60-9058,SNGL FAM SUB,2,AC,44400,0,44400,104700,300,149400,43500,0,43500,89000,300,132800,A1,AG/GEN,,,
8553,33-1-0-3-D,6798-05-2297,SNGL FAM SUB,5,AC,60900,0,60900,59300,0,120200,54400,0,54400,49600,0,104000,A2,AG/LTD,,,
8554,43-20-0-8-0,6768-62-0326,SNGL FAM SUB,3.55,AC,96800,0,96800,180700,32200,309700,88000,0,88000,158800,29100,275900,A2,AG/LTD,,,
8555,43-20-0-9-0,6768-52-7366,SNGL FAM SUB,3.16,AC,96800,0,96800,189100,52400,338300,88000,0,88000,173600,49700,311300,A2,AG/LTD,,,
8556,45-1-0-97-0,6797-98-7407,SNGL FAM SUB,6.42,AC,148100,0,148100,159800,2100,310000,132500,0,132500,130200,2100,264800,A2,AG/LTD,,,
8557,39-1-0-40-0,6727-02-0752,SNGL FAM SUB,4,AC,55600,0,55600,52100,0,107700,54500,0,54500,45000,0,99500,A1,AG/GEN,,,
8558,38-1-0-69-0,6717-03-3975,SNGL FAM SUB,5,AC,47500,0,47500,0,0,47500,46500,0,46500,0,0,46500,A1,AG/GEN,,,
8559,27-1-0-12-C,6719-51-3479,SNGL FAM SUB,2.76,AC,50600,0,50600,155200,500,206300,48600,0,48600,118800,500,167900,A1,AG/GEN,,,
8560,53-1-0-3-A,6766-36-2442,SNGL FAM SUB,2,AC,82600,0,82600,379200,45400,507200,73800,0,73800,304400,47000,425200,A2,AG/LTD,,,
8561,29-10-0-H-1,6749-95-2727,SNGL FAM SUB,4.46,AC,86900,0,86900,498200,0,585100,84200,0,84200,410400,0,494600,A1,AG/GEN,,,
8562,29-17-0-1-0,6749-60-6467,SNGL FAM SUB,1,AC,54000,0,54000,126700,8500,189200,49900,0,49900,105600,6900,162400,A1,AG/GEN,,,
8563,43-10-0-B-1,6767-65-6766,SNGL FAM SUB,3.33,AC,90700,0,90700,0,0,90700,81000,0,81000,0,0,81000,A2,AG/LTD,,,
8564,58-3-B-3-0,7726-17-0014,SNGL FAM SUB,0,AC,88000,0,88000,158800,12300,259100,80000,0,80000,130700,10400,221100,RN,RESIDEN,,,
8565,44-1-0-59-0,6786-37-4147,SNGL FAM SUB,6.201,AC,148600,0,148600,201200,39300,389100,132800,0,132800,170300,35700,338800,A2,AG/LTD,,,
8566,42-3-0-12-0,6767-04-8854,SNGL FAM SUB,0.696,AC,70000,0,70000,290900,300,361200,65000,0,65000,240300,300,305600,R3,RES/GEN,,,
8567,46-1-0-76-C,7707-43-1467,SNGL FAM SUB,1.332,AC,65900,0,65900,0,0,65900,58900,0,58900,0,0,58900,RR,RES/RUR,,,
8568,46-1-0-76-D,7707-32-3888,SNGL FAM SUB,4.76,AC,151700,0,151700,150300,21100,323100,139700,0,139700,126000,18600,284300,A2,AG/LTD,,,
8569,46-1-0-76-D2,7707-33-5414,SNGL FAM SUB,18.71,AC,502800,0,502800,0,0,502800,449700,0,449700,0,0,449700,RR,RES/RUR,,,
8570,63-25-0-A-0,7723-47-1633,SNGL FAM SUB,2.95,AC,217800,0,217800,49500,500,267800,189400,0,189400,42900,500,232800,A2R1,AG LTD/,,,
8571,58-4-D-1-0,7716-56-0359,SNGL FAM SUB,0,AC,10000,0,10000,0,0,10000,9100,0,9100,0,0,9100,A2,AG/LTD,,,
8572,63-1-0-188-0,7714-91-8799,SNGL FAM SUB,4.15,AC,229100,0,229100,0,0,229100,199400,0,199400,0,0,199400,R1,RES/LTD,,,
8573,27-1-0-7-0,6719-70-2710,SNGL FAM SUB,1.93,AC,44500,0,44500,8500,7600,60600,43600,0,43600,8400,7600,59600,A1,AG/GEN,,,
8574,33-1-0-3-G,6788-95-9532,SNGL FAM SUB,5,AC,60900,0,60900,0,0,60900,54400,0,54400,0,0,54400,A2,AG/LTD,,,
8575,29-13-0-1-0,6748-52-0301,SNGL FAM SUB,1.79,AC,61900,0,61900,219300,28500,309700,57300,0,57300,178700,23300,259300,A1,AG/GEN,,,
8576,42-1-0-90-F,6767-15-1772,State Exmm,2.49,AC,200700,0,200700,438900,2500,642100,193000,0,193000,430700,2500,626200,A2R3,AGRIC.R,,,
8577,42-1-0-90-H,6767-05-6678,SNGL FAM SUB,1.18,AC,115500,0,115500,0,0,115500,107300,0,107300,0,0,107300,R3,RES/GEN,,,
8578,42-1-0-94-0,6767-14-5129,SNGL FAM SUB,3.34,AC,96300,0,96300,400900,14500,511700,88400,0,88400,341000,14500,443900,A2,AG/LTD,,,
8579,42-6-0-2-A,6767-03-9231,COMM & IND,0.132,AC,31800,0,31800,127900,0,159700,30600,0,30600,118100,0,148700,B1,BUS/GEN,,,
8580,42-19-0-4-0,6766-19-6181,SNGL FAM SUB,2.33,AC,81900,0,81900,228800,1800,312500,71100,0,71100,184700,2700,258500,R3A2,RES GEN,,,
8581,42-20-0-C-0,6767-24-4781,SNGL FAM SUB,11.87,AC,162900,0,162900,276000,22400,461300,145000,0,145000,227500,19300,391800,A2,AG/LTD,,,
8582,42-22-0-1-0,6767-14-7270,SNGL FAM SUB,2.31,AC,84100,0,84100,0,5000,89100,76000,0,76000,0,5000,81000,A2,AG/LTD,,,
8583,42-24-0-B-0,6767-05-6859,SNGL FAM SUB,1.48,AC,157500,0,157500,0,0,157500,146300,0,146300,0,0,146300,R3,RES/GEN,,,
8584,42-24-0-C-0,6767-16-0002,SNGL FAM SUB,2.38,AC,186200,0,186200,0,0,186200,171000,0,171000,0,0,171000,A2,AG/LTD,,,
8585,42-24-0-D-0,6767-16-3021,General Gov,2.77,AC,215100,0,215100,833500,12500,1061100,206900,0,206900,771000,12600,990500,A2,AG/LTD,,,
8586,30-2-0-1-0,6758-35-9891,SNGL FAM SUB,7.4,AC,94600,0,94600,0,0,94600,87100,0,87100,0,0,87100,A2,AG/LTD,,,
8587,42-1-0-66-A,6757-98-6404,COMM & IND,1.77,AC,239100,0,239100,589400,106500,935000,229900,0,229900,553900,109300,893100,B1,BUS/GEN,,,
8588,43-11-0-7-0,6767-88-0267,SNGL FAM SUB,2,AC,84500,0,84500,162800,24700,272000,75500,0,75500,139200,20900,235600,A2,AG/LTD,,,
8589,46-1-0-76-0,7707-44-6109,AG 20-100 AC,30.15,AC,670300,556900,113400,119800,13200,803300,598500,497600,100900,101700,13900,714100,A2RR,AG& RUR,,,
8591,62-1-0-30-0,7714-03-7569,COMM & IND,0.709,AC,93100,0,93100,279900,0,373000,84600,0,84600,264500,0,349100,B1,BUS/GEN,,,
8592,44-16-0-19-0,6787-39-2096,SNGL FAM SUB,3.09,AC,129000,0,129000,200100,21800,350900,115000,0,115000,181300,18700,315000,A2,AG/LTD,,,
8595,42-21-0-5-0,6767-00-8625,SNGL FAM SUB,1.05,AC,68600,0,68600,199800,15200,283600,55700,0,55700,164300,12900,232900,R1,RES/LTD,,,
8596,26-10-0-B-0,6719-11-5259,SNGL FAM SUB,0.68,AC,33300,0,33300,0,0,33300,32600,0,32600,0,0,32600,B1A1,BS & AG,,,
8598,27-1-0-12-0,6719-61-2228,SNGL FAM SUB,3,AC,50000,0,50000,122400,800,173200,49000,0,49000,104400,800,154200,A1,AG/GEN,,,
8599,44-3-0-3-A,6777-81-1330,SNGL FAM SUB,1.22,AC,73600,0,73600,140200,1500,215300,65700,0,65700,114100,1500,181300,A2,AG/LTD,,,
8600,45-1-0-119-0,6797-77-8900,SNGL FAM SUB,3,AC,97700,0,97700,34500,1400,133600,87200,0,87200,29600,1400,118200,A2,AG/LTD,,,
8601,13-12-0-B-0,6841-99-1824,SNGL FAM SUB,4.807,AC,82100,0,82100,202800,0,284900,80600,0,80600,177700,0,258300,A1,AG/GEN,,,
8602,42-1-0-114-0,6767-00-8913,COMM & IND,0.421,AC,74300,0,74300,118400,0,192700,71400,0,71400,103100,0,174500,RO,RES/OF,,,
8603,55-1-0-8-0,6786-25-1526,SNGL FAM SUB,16.946,AC,299700,0,299700,0,0,299700,284500,0,284500,0,0,284500,A2,AG/LTD,,,
8604,44-1-0-60-0,6786-47-2647,SNGL FAM SUB,13.775,AC,246400,239600,6800,0,18000,264400,219700,213800,5900,0,18000,237700,A2,AG/LTD,,,
8605,55-1-0-52-0,6786-36-1129,SNGL FAM SUB,5.42,AC,113600,0,113600,0,0,113600,101400,0,101400,0,0,101400,A2,AG/LTD,,,
8606,63-33-0-3-0,7715-61-3488,SNGL FAM SUB,2.12,AC,131200,0,131200,183400,300,314900,114100,0,114100,154000,300,268400,A2,AG/LTD,,,
8607,32-10-1-11-0,6778-68-5458,SNGL FAM SUB,1.48,AC,74200,0,74200,168500,16500,259200,66300,0,66300,137600,15600,219500,A2,AG/LTD,,,
8608,13-12-0-C-0,6841-89-6266,SNGL FAM SUB,15.109,AC,100600,0,100600,340400,0,441000,98600,0,98600,289900,0,388500,RR,RES/RUR,,,
8609,55-2-0-5-0,6785-35-8068,SNGL FAM SUB,1.4,AC,89300,0,89300,133800,400,223500,79700,0,79700,109900,400,190000,R1,RES/LTD,,,
8610,44-15-1-27-0,6786-28-3143,SNGL FAM SUB,8.5,AC,168800,0,168800,514400,0,683200,150300,0,150300,458500,0,608800,A2,AG/LTD,,,
8611,42-1-0-3-0,6757-58-0923,SNGL FAM SUB,3.08,AC,83100,0,83100,331400,0,414500,63500,0,63500,270400,0,333900,A2,AG/LTD,,,
8612,42-1-0-4-0,6757-58-1885,SNGL FAM SUB,3.08,AC,83100,0,83100,166400,2900,252400,86300,0,86300,128500,800,215600,A2,AG/LTD,,,
8613,13-12-0-A-0,6842-80-9117,SNGL FAM SUB,16.047,AC,112500,0,112500,299400,0,411900,110400,0,110400,267300,0,377700,RR,RES/RUR,,,
8614,63-1-0-126-0,7715-60-5985,SNGL FAM SUB,1.5,AC,118600,0,118600,171700,4800,295100,103200,0,103200,146800,4300,254300,A2,AG/LTD,,,
8615,38-1-0-21-0,6707-79-5484,SNGL FAM SUB,19.86,AC,125600,0,125600,0,0,125600,122900,0,122900,0,0,122900,A1,AG/GEN,,,
8616,43-10-0-C-0,6767-65-6549,SNGL FAM SUB,4.64,AC,109600,0,109600,64600,0,174200,98000,0,98000,53700,0,151700,A2,AG/LTD,,,
8617,63-25-0-B-0,7723-47-0978,SNGL FAM SUB,1.03,AC,163400,0,163400,121300,2700,287400,142100,0,142100,101800,2800,246700,A2,AG/LTD,,,
8618,67-13-C-11-0,7733-36-6405,SNGL FAM SUB,0,AC,265000,0,265000,486100,8700,759800,220000,0,220000,427700,9000,656700,R1,RES/LTD,,,
8619,55-1-0-33-0,6785-66-1539,COMM & IND,4.27,AC,168500,0,168500,90400,19400,278300,156100,0,156100,89400,13600,259100,B1A2,BS AND,,,
8620,55-1-0-91-0,6785-66-4118,COMM & IND,0.42,AC,51000,0,51000,142200,40600,233800,47200,0,47200,143300,24100,214600,B1,BUS/GEN,,,
8621,58-1-0-30-0,7715-35-9468,SNGL FAM SUB,1.74,AC,310000,0,310000,378700,69600,758300,285000,0,285000,346100,61400,692500,A2,AG/LTD,,,
8622,6-9-0-18-0,6833-61-4588,SNGL FAM SUB,2.15,AC,45700,0,45700,109900,0,155600,44800,0,44800,92500,0,137300,A1,AG/GEN,,,
8623,19-8-0-1-0,6820-83-8099,SNGL FAM SUB,4.08,AC,68000,0,68000,159200,11900,239100,62300,0,62300,130900,10100,203300,A1,AG/GEN,,,
8624,19-8-0-2-0,6820-82-4944,SNGL FAM SUB,4.09,AC,68100,0,68100,0,0,68100,62300,0,62300,0,0,62300,A1,AG/GEN,,,
8625,19-8-0-3-0,6820-82-0709,SNGL FAM SUB,4.08,AC,54400,0,54400,0,0,54400,51800,0,51800,0,0,51800,A1,AG/GEN,,,
8626,58-1-0-30-B,7715-44-2623,SNGL FAM SUB,2,AC,141400,0,141400,357900,17900,517200,123000,0,123000,303300,15400,441700,A2,AG/LTD,,,
8627,14-3-0-16-0,6851-38-2884,SNGL FAM SUB,4,AC,72400,0,72400,154600,13300,240300,71000,0,71000,149200,11800,232000,A1,AG/GEN,,,
8628,33-4-0-4-0,6798-53-6727,SNGL FAM SUB,2.06,AC,91300,0,91300,159300,1300,251900,81500,0,81500,130300,1300,213100,A2,AG/LTD,,,
8629,58-4-H-8-0,7716-56-8806,SNGL FAM SUB,0,AC,20100,0,20100,0,0,20100,18300,0,18300,0,0,18300,A2,AG/LTD,,,
8630,63-5-0-3-0,7724-14-9493,SNGL FAM SUB,0.934,AC,126600,0,126600,165100,2300,294000,110000,0,110000,143100,2300,255400,A2,AG/LTD,,,
8631,26-1-0-62-A,6719-24-9597,SNGL FAM SUB,2.9,AC,51400,0,51400,102900,2000,156300,48500,0,48500,84700,2000,135200,A1,AG/GEN,,,
8632,44-16-0-5-0,6788-30-1422,SNGL FAM SUB,3.02,AC,129000,0,129000,256500,1000,386500,115000,0,115000,237700,1000,353700,A2,AG/LTD,,,
8633,13-9-0-6-0,6841-74-0507,SNGL FAM SUB,3.28,AC,69700,0,69700,110300,3000,183000,68400,0,68400,105400,3000,176800,A1,AG/GEN,,,
8634,49-2-0-4-A,6716-13-3627,AG 20-100 AC,60.999,AC,354800,242600,112200,480600,5800,841200,347200,240300,106900,416500,5800,769500,A1,AG/GEN,,,
8635,64-4-2-38-0,7724-93-5797,SNGL FAM SUB,0,AC,20200,0,20200,0,0,20200,17600,0,17600,0,0,17600,RN,RESIDEN,,,
8636,64-4-2-25-0,7724-93-6917,SNGL FAM SUB,0,AC,70000,0,70000,248600,4600,323200,60000,0,60000,212800,4300,277100,RN,RESIDEN,,,
8637,64-4-2-37-0,7724-93-6637,SNGL FAM SUB,0,AC,16200,0,16200,0,0,16200,14100,0,14100,0,0,14100,RN,RESIDEN,,,
8638,64-5-4-1-0,7724-93-8953,SNGL FAM SUB,0,AC,20200,0,20200,0,0,20200,17600,0,17600,0,0,17600,RN,RESIDEN,,,
8639,64-5-4-2-0,7724-94-8063,SNGL FAM SUB,0,AC,20200,0,20200,0,0,20200,17600,0,17600,0,0,17600,RN,RESIDEN,,,
8640,64-12-B-5-0,7724-60-2678,SNGL FAM SUB,0.985,AC,111700,0,111700,194100,2000,307800,97200,0,97200,164800,2000,264000,R1,RES/LTD,,,
8641,57-1-0-19-0,7706-14-5721,SNGL FAM SUB,1.28,AC,88700,0,88700,19600,0,108300,77100,0,77100,17000,0,94100,A2,AG/LTD,,,
8642,6-1-0-13-0,6833-03-3179,SNGL FAM SUB,4.82,AC,10800,0,10800,0,0,10800,10800,0,10800,0,0,10800,A1,AG/GEN,,,
8643,6-1-0-3-0,6833-07-3561,SNGL FAM SUB,14,AC,57600,0,57600,0,0,57600,55500,0,55500,0,0,55500,A1,AG/GEN,,,
8644,15-1-0-19-0,5880-54-3282,AG 20-100 AC,97.43,AC,199900,155000,44900,0,0,199900,194900,153500,41400,0,0,194900,A1,AG/GEN,,,
8645,46-1-0-79-0,7708-70-5371,SNGL FAM SUB,2,AC,115200,0,115200,215600,300,331100,102900,0,102900,180200,300,283400,A2,AG/LTD,,,
8647,29-3-0-7-0,6749-73-5380,SNGL FAM SUB,3.29,AC,76300,0,76300,1000,200,77500,72600,0,72600,7000,500,80100,A1,AG/GEN,,,
8648,29-1-0-70-A,6749-73-2524,SNGL FAM SUB,1,AC,54000,0,54000,0,0,54000,49900,0,49900,0,0,49900,A1,AG/GEN,,,
8649,29-1-0-76-0,6749-46-3260,AG 20-100 AC,34.5,AC,202000,0,202000,0,0,202000,206400,0,206400,0,0,206400,A1,AG/GEN,,,
8650,28-1-0-50-0,6738-26-6093,SNGL FAM SUB,9,AC,114600,0,114600,140600,700,255900,112300,0,112300,120200,800,233300,A1,AG/GEN,,,
8651,30-1-0-63-0,6759-53-6550,SNGL FAM SUB,6.67,AC,116100,0,116100,0,0,116100,108900,0,108900,0,0,108900,A2,AG/LTD,,,
8652,30-1-0-21-0,6759-41-3714,SNGL FAM SUB,2.543,AC,69300,0,69300,0,0,69300,65900,0,65900,0,0,65900,A2,AG/LTD,,,
8653,30-1-0-40-0,6758-34-4966,SNGL FAM SUB,5,AC,91600,0,91600,302400,2000,396000,83100,0,83100,251100,2000,336200,A2,AG/LTD,,,
8654,32-1-0-45-A,6778-72-5761,SNGL FAM SUB,13.36,AC,188900,0,188900,245800,58900,493600,168400,0,168400,204000,52200,424600,A2,AG/LTD,,,
8655,32-6-0-C-0,6778-72-7276,SNGL FAM SUB,5.47,AC,115100,0,115100,0,0,115100,102800,0,102800,0,0,102800,A2,AG/LTD,,,
8656,30-1-0-74-C,6758-99-0261,SNGL FAM SUB,1.26,AC,57200,0,57200,179200,500,236900,52600,0,52600,146900,500,200000,A2,AG/LTD,,,
8657,46-1-0-97-0,7717-09-3831,SNGL FAM SUB,1.053,AC,93600,0,93600,273500,4400,371500,83600,0,83600,229800,4400,317800,A2,AG/LTD,,,
8658,29-12-0-7-0,6748-68-7088,SNGL FAM SUB,1,AC,54000,0,54000,81100,500,135600,49900,0,49900,67400,500,117800,A1,AG/GEN,,,
8659,27-2-0-8-0,6719-60-6084,SNGL FAM SUB,1.833,AC,43500,0,43500,229100,0,272600,42600,0,42600,208300,0,250900,A1,AG/GEN,,,
8660,58-21-A-9-0,7716-43-3766,SNGL FAM SUB,1.319,AC,310000,0,310000,289600,1000,600600,285000,0,285000,262300,1000,548300,A2,AG/LTD,,,
8661,26-1-0-12-C,6709-93-2759,SNGL FAM SUB,2,AC,46000,0,46000,257500,0,303500,44000,0,44000,216800,0,260800,A1,AG/GEN,,,
8662,64-1-0-35-0,7724-61-7676,SNGL FAM SUB,17.593,AC,849700,0,849700,0,0,849700,738900,0,738900,0,0,738900,R1,RES/LTD,,,
8663,59-1-0-10-0,7726-66-8845,COMM & IND,1.973,AC,1185200,0,1185200,730700,0,1915900,1131300,0,1131300,694100,0,1825400,B1,BUS/GEN,,,
8664,57-1-0-79-B,7706-62-1579,AG 20-100 AC,25,AC,717100,556100,161000,0,25400,742500,673900,556700,117200,30800,82800,787500,A2,AG/LTD,,,
8666,58-2-0-15-0,7726-36-4165,SNGL FAM SUB,0,AC,105600,0,105600,302900,0,408500,96000,0,96000,237200,0,333200,RN,RESIDEN,,,
8670,58-3-A-12-0,7726-16-9560,General Gov,0,AC,20100,0,20100,3300,0,23400,18300,0,18300,3300,0,21600,RN,RESIDEN,,,
8672,64-4-1-34-0,7724-92-1926,SNGL FAM SUB,0.791,AC,171800,0,171800,0,0,171800,159100,0,159100,0,0,159100,RO,RES/OF,,,
8675,57-1-0-55-0,7715-29-1722,SNGL FAM SUB,5.102,AC,576000,0,576000,1251400,108800,1936200,528000,0,528000,1141700,97700,1767400,A2,AG/LTD,,,
8676,17-9-0-6-A,6810-03-9923,SNGL FAM SUB,3.4,AC,54300,0,54300,0,0,54300,51200,0,51200,0,0,51200,A1,AG/GEN,,,
8677,67-1-0-13-0,7723-87-2815,AG 20-100 AC,95.758,AC,3303700,3259600,44100,0,0,3303700,2872700,2832000,40700,0,0,2872700,A2R1,AG LTD/,,,
8678,67-1-0-12-0,7723-84-1396,AG > 100 AC,383.94,AC,8024300,7489700,534600,777700,199300,9001300,6976600,6507400,469200,655000,183500,7815100,A2R1,AG LTD/,,,
8679,67-1-0-12-A,7723-81-1087,AG 20-100 AC,99.3,AC,48100,0,48100,0,0,48100,42500,0,42500,0,0,42500,A2,AG/LTD,,,
8682,27-5-0-3-B,6728-66-9743,SNGL FAM SUB,5.44,AC,65900,0,65900,294300,0,360200,64600,0,64600,244200,0,308800,A1,AG/GEN,,,
8683,29-1-0-45-0,6748-69-9220,SNGL FAM SUB,3.59,AC,79100,0,79100,185800,24300,289200,75500,0,75500,159700,19800,255000,A1,AG/GEN,,,
8684,28-1-0-41-0,6728-76-9739,AG 20-100 AC,24.43,AC,160300,0,160300,0,0,160300,157400,0,157400,0,0,157400,A1,AG/GEN,,,
8685,27-5-0-1-0,6728-67-2585,SNGL FAM SUB,2.8,AC,50700,0,50700,0,0,50700,49700,0,49700,0,0,49700,A1,AG/GEN,,,
8686,27-6-0-4-0,6728-56-8707,SNGL FAM SUB,12.5,AC,103200,0,103200,0,0,103200,101300,0,101300,0,0,101300,A1,AG/GEN,,,
8688,38-1-0-10-B,6707-99-6485,SNGL FAM SUB,0.99,AC,38400,0,38400,0,0,38400,37600,0,37600,0,0,37600,A1,AG/GEN,,,
8689,63-8-0-1-0,7724-07-6095,AG > 100 AC,100.46,AC,2330700,2204800,125900,0,0,2330700,2029300,1917400,111900,0,0,2029300,A2,AG/LTD,,,
8690,6-1-0-55-B,6832-39-2373,AG 20-100 AC,66.81,AC,276800,214700,62100,373900,43100,693800,266600,199600,67000,332300,44100,643000,A1,AG/GEN,,,
8691,64-12-G-6-0,7723-58-5917,SNGL FAM SUB,0.5,AC,77000,0,77000,199200,700,276900,67000,0,67000,176100,700,243800,R1,RES/LTD,,,
8692,16-1-0-38-0,5890-66-1208,SNGL FAM SUB,5,AC,51300,0,51300,0,0,51300,50000,0,50000,0,0,50000,A1,AG/GEN,,,
8852,12-1-0-6-B,6822-74-5468,COMM & IND,1.13,AC,38400,0,38400,44200,0,82600,37300,0,37300,43600,0,80900,B1,BUS/GEN,,,
8853,6-1-0-38-0,6822-87-5544,SNGL FAM SUB,3,AC,56600,0,56600,183300,1000,240900,55000,0,55000,160600,1000,216600,A1,AG/GEN,,,
8854,12-15-0-B-0,6832-12-2487,SNGL FAM SUB,8.9,AC,93800,0,93800,284000,45500,423300,91500,0,91500,251200,39000,381700,A1,AG/GEN,,,
8855,12-15-0-D-0,6832-14-6368,SNGL FAM SUB,13.49,AC,92100,85900,6200,0,0,92100,91700,86000,5700,0,0,91700,A1,AG/GEN,,,
8856,12-1-0-6-0,6822-95-0607,AG > 100 AC,166.1,AC,879500,761500,118000,132800,19600,1031900,868600,759300,109300,115800,18100,1002500,A1,AG/GEN,,,
8857,10-1-0-41-0,6811-57-0798,AG 20-100 AC,85,AC,202900,163700,39200,0,0,202900,201900,165800,36100,0,0,201900,A1,AG/GEN,,,
8858,17-1-0-88-0,6719-38-7088,AG 20-100 AC,40.31,AC,145300,0,145300,0,0,145300,141100,0,141100,0,0,141100,A1,AG/GEN,,,
8859,30-1-0-55-0,6759-50-4415,SNGL FAM SUB,18.43,AC,196700,188200,8500,0,0,196700,194600,186800,7800,0,0,194600,A2,AG/LTD,,,
8860,30-1-0-52-0,6758-69-0884,SNGL FAM SUB,6,AC,61500,58400,3100,0,0,61500,56100,53500,2600,0,0,56100,A2,AG/LTD,,,
8861,17-1-0-64-0,6810-25-4630,AG 20-100 AC,52.5,AC,170600,146400,24200,0,0,170600,168800,146500,22300,0,0,168800,A1,AG/GEN,,,
8862,42-8-2-9-0,6767-28-5155,SNGL FAM SUB,0.88,AC,60000,0,60000,146000,0,206000,55000,0,55000,123100,0,178100,A2,AG/LTD,,,
8863,43-1-0-4-0,6767-68-5841,AG 20-100 AC,47.407,AC,540400,518500,21900,0,0,540400,483600,463500,20100,0,0,483600,A2,AG/LTD,,,
8864,58-4-A-15-0,7716-56-3969,SNGL FAM SUB,0,AC,20100,0,20100,0,0,20100,18300,0,18300,0,0,18300,A2,AG/LTD,,,
8865,58-4-C-10-0,7716-56-6732,SNGL FAM SUB,0,AC,20100,0,20100,0,0,20100,18300,0,18300,0,0,18300,A2,AG/LTD,,,
8866,58-4-C-11-0,7716-56-6654,SNGL FAM SUB,0,AC,20100,0,20100,0,0,20100,18300,0,18300,0,0,18300,A2,AG/LTD,,,
9018,58-22-A-16-0,7715-37-9844,SNGL FAM SUB,3.94,AC,480000,0,480000,1239000,76600,1795600,440000,0,440000,1202800,63800,1706600,A2,AG/LTD,,,
9019,58-22-A-18-0,7715-47-2340,SNGL FAM SUB,5.063,AC,398400,0,398400,767200,0,1165600,364800,0,364800,737500,0,1102300,A2,AG/LTD,,,
9021,58-25-A-1-0,7715-34-9803,SNGL FAM SUB,2.603,AC,325500,0,325500,685100,77900,1088500,299300,0,299300,642700,70500,1012500,RR,RES/RUR,,,
9022,58-25-A-2-0,7715-34-6616,SNGL FAM SUB,2.001,AC,325500,0,325500,643000,23000,991500,299300,0,299300,585200,23000,907500,RR,RES/RUR,,,
9023,58-25-A-3-0,7715-34-3525,SNGL FAM SUB,2.002,AC,325500,0,325500,313900,0,639400,299300,0,299300,287500,0,586800,RR,RES/RUR,,,
9024,58-25-A-4-0,7715-34-0403,SNGL FAM SUB,2.01,AC,325500,0,325500,1084600,8100,1418200,299300,0,299300,980100,7400,1286800,RR,RES/RUR,,,
9025,58-25-A-5-0,7715-24-6363,SNGL FAM SUB,2.658,AC,325500,0,325500,353600,0,679100,299300,0,299300,335700,0,635000,RR,RES/RUR,,,
9026,58-25-A-6-0,7715-24-4456,SNGL FAM SUB,2.539,AC,325500,0,325500,462100,15300,802900,299300,0,299300,441400,13700,754400,RR,RES/RUR,,,
9027,58-25-A-7-0,7715-24-3604,SNGL FAM SUB,3.094,AC,325500,0,325500,423700,197600,946800,299300,0,299300,397200,164600,861100,RR,RES/RUR,,,
9028,58-25-A-8-0,7715-24-1854,SNGL FAM SUB,3.223,AC,325500,0,325500,429700,0,755200,299300,0,299300,401800,0,701100,RR,RES/RUR,,,
8693,43-1-0-86-0,6776-39-9455,AG 20-100 AC,31.16,AC,406300,244300,162000,577300,126800,1110400,363000,219000,144000,475500,122100,960600,A2,AG/LTD,,,
8694,16-1-0-76-B,5890-91-6874,SNGL FAM SUB,0.94,AC,3400,0,3400,0,0,3400,3300,0,3300,0,0,3300,A1,AG/GEN,,,
8695,16-1-0-76-C,5890-91-6478,SNGL FAM SUB,13.5,AC,71500,0,71500,170400,800,242700,71800,0,71800,151500,800,224100,A1,AG/GEN,,,
8696,16-1-0-39-0,5890-54-4483,SNGL FAM SUB,5.04,AC,16300,0,16300,0,0,16300,15100,0,15100,0,0,15100,A1,AG/GEN,,,
8697,16-1-0-76-A,6800-01-2747,SNGL FAM SUB,5.65,AC,60200,0,60200,9700,7500,77400,58900,0,58900,9500,5400,73800,A1,AG/GEN,,,
8698,39-1-0-49-C,6717-80-4690,SNGL FAM SUB,2.88,AC,49300,0,49300,81200,1700,132200,48300,0,48300,73000,1700,123000,A1,AG/GEN,,,
8699,47-1-0-93-A,7727-10-5928,SNGL FAM SUB,0.506,AC,60100,0,60100,149600,2400,212100,53700,0,53700,124600,2400,180700,A2,AG/LTD,,,
8700,47-22-0-C-1,7717-89-0954,SNGL FAM SUB,3.662,AC,144300,0,144300,6600,100,151000,128900,0,128900,6700,100,135700,A2,AG/LTD,,,
8701,16-1-0-72-0,6800-03-6200,SNGL FAM SUB,1.54,AC,41300,0,41300,97900,0,139200,40200,0,40200,86900,0,127100,A1,AG/GEN,,,
8702,51-1-0-39-0,6736-01-0785,SNGL FAM SUB,1.5,AC,41900,0,41900,107100,1700,150700,41000,0,41000,90900,1700,133600,A1,AG/GEN,,,
8703,46-1-0-23-0,7707-14-0867,SNGL FAM SUB,1.52,AC,110900,0,110900,182900,5200,299000,99000,0,99000,152100,5200,256300,A2,AG/LTD,,,
8704,16-1-0-35-0,5890-70-0844,AG 20-100 AC,20.634,AC,125200,0,125200,180700,49200,355100,122600,0,122600,160600,41900,325100,A1,AG/GEN,,,
8705,16-1-0-76-0,6800-01-7597,SNGL FAM SUB,16.12,AC,77400,0,77400,0,0,77400,73500,0,73500,0,0,73500,A1,AG/GEN,,,
8706,16-1-0-77-0,5890-90-2552,AG 20-100 AC,36.07,AC,63300,41200,22100,0,0,63300,62100,42000,20100,0,0,62100,A1,AG/GEN,,,
8707,9-1-0-60-0,5891-87-8646,SNGL FAM SUB,4.747,AC,52300,0,52300,80000,600,132900,51100,0,51100,69700,600,121400,A1,AG/GEN,,,
8708,17-3-0-1-0,6709-39-3874,SNGL FAM SUB,5.002,AC,61200,0,61200,170900,0,232100,60000,0,60000,166900,0,226900,A1,AG/GEN,,,
8709,17-3-0-1-A,6800-30-8575,SNGL FAM SUB,2.25,AC,45800,0,45800,102200,29800,177800,44900,0,44900,88900,28000,161800,A1,AG/GEN,,,
8710,16-1-0-37-0,5890-52-4984,AG 20-100 AC,41.9,AC,107500,87600,19900,0,0,107500,104800,86900,17900,0,0,104800,A1,AG/GEN,,,
8711,16-1-0-39-B,5890-63-4863,SNGL FAM SUB,14.74,AC,77000,31200,45800,195800,27200,300000,74200,30300,43900,171500,23500,269200,A1,AG/GEN,,,
8712,26-2-0-3-E,6709-82-5205,SNGL FAM SUB,8.584,AC,81900,0,81900,0,0,81900,83500,0,83500,0,0,83500,A1,AG/GEN,,,
8713,9-1-0-61-A,5891-87-6945,SNGL FAM SUB,3.303,AC,47100,0,47100,236700,22100,305900,46100,0,46100,208200,22100,276400,A1,AG/GEN,,,
8714,32-1-0-51-0,6778-94-6310,SNGL FAM SUB,1.23,AC,67400,0,67400,7500,0,74900,60200,0,60200,7500,0,67700,A2,AG/LTD,,,
8715,44-1-0-19-B,6777-92-8686,SNGL FAM SUB,4.529,AC,118800,0,118800,275600,21900,416300,106000,0,106000,230600,18500,355100,A2,AG/LTD,,,
8716,16-1-0-8-0,5891-60-5075,SNGL FAM SUB,9,AC,67600,0,67600,30400,1800,99800,62000,0,62000,33900,1800,97700,A1,AG/GEN,,,
8717,19-7-0-A-0,6830-86-6185,SNGL FAM SUB,4.79,AC,75100,0,75100,17000,2000,94100,68200,0,68200,27700,2000,97900,A1,AG/GEN,,,
8718,30-1-0-27-0,6758-49-1741,SNGL FAM SUB,3.086,AC,74400,0,74400,104500,800,179700,69500,18700,50800,87000,800,157300,A2,AG/LTD,,,
8719,30-1-0-25-0,6759-40-2103,SNGL FAM SUB,6.5,AC,104300,0,104300,226800,40400,371500,101600,49400,52200,193900,42600,338100,A2,AG/LTD,,,
8720,39-1-0-93-0,6727-14-8679,SNGL FAM SUB,1.409,AC,41300,0,41300,88700,700,130700,40500,0,40500,75600,700,116800,A1,AG/GEN,,,
8721,30-1-0-27-A,6758-49-0482,SNGL FAM SUB,3.708,AC,80200,0,80200,145200,3100,228500,75400,0,75400,122200,0,197600,A2,AG/LTD,,,
8722,47-23-0-4-0,7717-22-6751,SNGL FAM SUB,2.034,AC,110600,0,110600,268400,15600,394600,98700,0,98700,234800,14100,347600,A2,AG/LTD,,,
8723,58-4-H-38-0,7716-66-0366,SNGL FAM SUB,0,AC,10000,0,10000,0,0,10000,9100,0,9100,0,0,9100,A2,AG/LTD,,,
8724,29-1-0-37-0,6748-54-6124,SNGL FAM SUB,10.22,AC,140300,0,140300,168700,24200,333200,131400,0,131400,140200,20400,292000,A1,AG/GEN,,,
8725,25-1-0-5-A,5799-70-6981,SNGL FAM SUB,10.65,AC,82900,0,82900,293100,8300,384300,82300,0,82300,251000,8600,341900,A1,AG/GEN,,,
8726,31-1-0-48-0,6769-85-5769,SNGL FAM SUB,1.23,AC,63900,0,63900,106200,17200,187300,57900,0,57900,90300,14600,162800,A2,AG/LTD,,,
8727,55-1-0-28-0,6785-56-0698,AG 20-100 AC,26.6,AC,511700,359200,152500,530100,58400,1100200,457300,321500,135800,433800,51000,942100,A2,AG/LTD,,,
8732,55-1-0-31-0,6785-56-8684,COMM & IND,2.37,AC,143000,0,143000,96300,0,239300,132500,0,132500,95800,0,228300,RO,RES/OF,,,
8733,43-7-0-3-0,6777-09-0433,SNGL FAM SUB,4.136,AC,95800,0,95800,11800,1000,108600,85400,0,85400,12300,1000,98700,A2,AG/LTD,,,
8734,43-7-0-2-0,6767-99-9421,SNGL FAM SUB,4.136,AC,95800,0,95800,232600,0,328400,85400,0,85400,198400,0,283800,A2,AG/LTD,,,
8735,43-7-0-1-0,6767-99-8422,SNGL FAM SUB,4.136,AC,95800,0,95800,48800,500,145100,85400,0,85400,40400,500,126300,A2,AG/LTD,,,
8736,43-7-0-4-0,6777-09-1443,SNGL FAM SUB,4.136,AC,95800,0,95800,91300,4700,191800,85400,0,85400,70900,2900,159200,A2,AG/LTD,,,
8737,54-2-0-5-0,6776-14-8050,AG 20-100 AC,21.4,AC,194500,121000,73500,608400,3400,806300,173600,107700,65900,507800,2500,683900,A2,AG/LTD,,,
8738,54-2-0-6-0,6776-23-8883,SNGL FAM SUB,11.72,AC,134600,0,134600,393700,2200,530500,120100,0,120100,329500,1600,451200,A2,AG/LTD,,,
8739,54-2-0-7-0,6776-23-6375,SNGL FAM SUB,6.04,AC,109600,0,109600,287200,0,396800,97800,0,97800,235700,0,333500,A2,AG/LTD,,,
8740,54-2-0-14-0,6776-23-1245,SNGL FAM SUB,7.019,AC,124900,0,124900,414900,0,539800,111400,0,111400,352000,0,463400,A2,AG/LTD,,,
8742,28-1-0-37-0,6728-95-9928,SNGL FAM SUB,18.5,AC,136800,0,136800,42600,500,179900,134300,0,134300,37700,500,172500,A1,AG/GEN,,,
8743,20-1-0-24-A,6840-31-2968,SNGL FAM SUB,1.52,AC,59100,0,59100,84300,2500,145900,55300,0,55300,68400,2500,126200,A1,AG/GEN,,,
8744,20-1-0-8-0,6840-36-7236,SNGL FAM SUB,3.422,AC,70100,0,70100,266900,0,337000,67500,0,67500,224300,0,291800,A1,AG/GEN,,,
8745,12-1-0-25-0,6821-97-9814,SNGL FAM SUB,5.15,AC,68000,0,68000,143700,0,211700,67700,0,67700,119200,0,186900,A1,AG/GEN,,,
8746,29-1-0-52-0,6749-60-9125,SNGL FAM SUB,1.811,AC,62100,0,62100,0,1700,63800,57900,0,57900,0,0,57900,A1,AG/GEN,,,
8747,28-1-0-26-B,6729-91-5217,SNGL FAM SUB,1.01,AC,40100,0,40100,8600,0,48700,39600,0,39600,8600,0,48200,A1,AG/GEN,,,
8748,16-1-0-19-0,5890-34-0386,SNGL FAM SUB,8.47,AC,65700,0,65700,0,0,65700,64100,0,64100,0,0,64100,A1,AG/GEN,,,
8749,12-1-0-32-A,6831-02-6818,SNGL FAM SUB,2,AC,47600,0,47600,152400,4500,204500,47800,0,47800,125700,4500,178000,A1,AG/GEN,,,
8750,16-1-0-10-0,5890-69-4250,SNGL FAM SUB,3.242,AC,46900,0,46900,95000,100,142000,45800,0,45800,82500,100,128400,A1,AG/GEN,,,
8751,46-16-0-F-1,7707-82-1093,SNGL FAM SUB,9.733,AC,292900,0,292900,0,92300,385200,261300,0,261300,0,83200,344500,A2,AG/LTD,,,
8752,46-16-0-F-2,7707-82-5634,SNGL FAM SUB,4.593,AC,178800,0,178800,441200,0,620000,159500,0,159500,366900,0,526400,A2,AG/LTD,,,
8754,17-1-0-83-A,6719-09-0312,SNGL FAM SUB,5,AC,61500,0,61500,0,0,61500,60000,0,60000,0,0,60000,A1,AG/GEN,,,
8755,17-1-0-83-B,6719-09-2618,SNGL FAM SUB,1.03,AC,40200,0,40200,118900,1000,160100,38200,0,38200,94500,1000,133700,A1,AG/GEN,,,
8756,20-11-0-18-0,6851-00-0659,SNGL FAM SUB,3.04,AC,64200,0,64200,172800,2000,239000,61300,0,61300,149100,2000,212400,A1,AG/GEN,,,
8757,1-1-0-20-D,6804-97-0785,SNGL FAM SUB,16.429,AC,110500,63100,47400,157800,4100,272400,108400,62800,45600,140500,4100,253000,A1,AG/GEN,,,
8758,31-2-0-2-B,6769-50-0102,SNGL FAM SUB,6,AC,115800,0,115800,531400,0,647200,104600,0,104600,447200,0,551800,A2,AG/LTD,,,
8759,31-2-0-2-C,6769-51-9751,AG 20-100 AC,28.013,AC,276400,202900,73500,633000,0,909400,252300,185700,66600,562100,0,814400,A2,AG/LTD,,,
8761,46-1-0-26-B,7707-13-8603,SNGL FAM SUB,11.3,AC,273700,0,273700,0,100,273800,244200,0,244200,0,100,244300,A2,AG/LTD,,,
8762,46-1-0-32-0,7707-22-3982,SNGL FAM SUB,14.63,AC,309200,0,309200,0,0,309200,275900,0,275900,0,0,275900,A2,AG/LTD,,,
8763,46-1-0-27-A,7707-23-0388,SNGL FAM SUB,15.197,AC,377300,0,377300,0,900,378200,336800,0,336800,0,900,337700,A2RR,AG& RUR,,,
8764,46-1-0-34-0,7707-43-9002,SNGL FAM SUB,9.34,AC,289200,186100,103100,138500,7000,434700,258500,166500,92000,114300,7000,379800,RR,RES/RUR,,,
8765,32-1-0-53-0,6788-04-1412,SNGL FAM SUB,2.4,AC,84300,0,84300,171700,1000,257000,75300,0,75300,147000,1000,223300,A2,AG/LTD,,,
8767,39-2-0-2-0,6716-96-3547,AG 20-100 AC,40.71,AC,176000,155200,20800,0,0,176000,172200,154700,17500,0,0,172200,A1,AG/GEN,,,
8768,39-2-0-2-A,6716-97-4478,SNGL FAM SUB,5.2,AC,62300,0,62300,345400,7500,415200,61100,0,61100,302800,7000,370900,A1,AG/GEN,,,
8770,30-1-0-58-0,6759-51-6596,SNGL FAM SUB,5.28,AC,77900,0,77900,105800,300,184000,71400,0,71400,84800,300,156500,A2,AG/LTD,,,
8772,30-1-0-59-0,6759-51-2573,SNGL FAM SUB,3.36,AC,70100,0,70100,0,0,70100,64500,0,64500,0,0,64500,A2,AG/LTD,,,
8773,30-1-0-22-0,6759-41-4243,SNGL FAM SUB,1.43,AC,58300,0,58300,111900,0,170200,54400,0,54400,93300,0,147700,A2,AG/LTD,,,
8774,30-1-0-41-0,6758-35-2175,SNGL FAM SUB,2,AC,64000,0,64000,293100,0,357100,60300,0,60300,245400,0,305700,A2,AG/LTD,,,
8775,30-1-0-57-0,6759-40-3889,SNGL FAM SUB,1.23,AC,56300,0,56300,198200,0,254500,52300,0,52300,163500,0,215800,A2,AG/LTD,,,
8776,30-1-0-62-0,6759-52-1768,SNGL FAM SUB,1.98,AC,63800,0,63800,53600,0,117400,60100,0,60100,45100,0,105200,A2,AG/LTD,,,
8777,13-1-0-3-E,6842-74-0973,SNGL FAM SUB,6.85,AC,68300,0,68300,11100,700,80100,68300,0,68300,11600,700,80600,A1,AG/GEN,,,
8778,46-1-0-36-B,7707-42-1931,SNGL FAM SUB,2.02,AC,121600,0,121600,274000,55300,450900,108600,0,108600,229200,49000,386800,A2RR,AG& RUR,,,
8779,46-1-0-36-0,7707-42-4934,MultiFamily,2.75,AC,138900,0,138900,174100,300,313300,124100,0,124100,144800,300,269200,RR,RES/RUR,,,
8780,46-1-0-36-A,7707-32-7658,SNGL FAM SUB,4.09,AC,167600,0,167600,259700,300,427600,149600,0,149600,216000,300,365900,A2,AG/LTD,,,
8783,57-20-C-5-0,7716-00-9749,SNGL FAM SUB,3.7,AC,427100,0,427100,688400,2000,1117500,392000,0,392000,633100,2000,1027100,A2,AG/LTD,,,
8784,19-1-0-60-0,6830-63-4577,SNGL FAM SUB,3.71,AC,79700,0,79700,0,0,79700,75400,0,75400,0,0,75400,A1,AG/GEN,,,
8785,44-19-0-11-0,6778-90-2622,SNGL FAM SUB,10,AC,155000,0,155000,214800,14400,384200,138200,0,138200,178300,13400,329900,A2,AG/LTD,,,
8786,28-1-0-45-0,6738-72-3965,SNGL FAM SUB,10.003,AC,106800,0,106800,0,0,106800,105700,0,105700,0,0,105700,A1,AG/GEN,,,
8787,50-5-0-30-0,6726-34-3481,SNGL FAM SUB,8.83,AC,78700,0,78700,189400,3800,271900,76100,0,76100,165800,3900,245800,A1,AG/GEN,,,
8788,50-1-0-16-0,6726-45-5708,SNGL FAM SUB,17,AC,93000,85200,7800,0,0,93000,91000,83800,7200,0,0,91000,A1,AG/GEN,,,
8789,67-2-E-12-0,7723-64-1196,SNGL FAM SUB,0,AC,184000,0,184000,337200,800,522000,160000,0,160000,282300,800,443100,R1,RES/LTD,,,
8790,46-23-0-15-0,7707-93-5382,SNGL FAM SUB,2.117,AC,165000,0,165000,156200,15600,336800,150000,0,150000,130700,13300,294000,A2,AG/LTD,,,
8791,42-7-0-A-0,6757-55-8219,AG > 100 AC,136.62,AC,4759500,0,4759500,0,0,4759500,1240500,1182200,58300,0,400,1240900,R3,RES/GEN,,,
8792,42-7-0-D-0,6757-53-8767,AG 20-100 AC,43.07,AC,1482200,0,1482200,0,5200,1487400,404900,386500,18400,0,5200,410100,R3,RES/GEN,,,
8793,42-7-0-E-0,6757-63-3290,AG 20-100 AC,26.7,AC,929400,0,929400,0,5500,934900,277700,266300,11400,0,5500,283200,R3,RES/GEN,,,
8794,42-1-0-14-0,6757-73-3469,SNGL FAM SUB,16.05,AC,561800,0,561800,0,0,561800,209300,191100,18200,0,0,209300,R3,RES/GEN,,,
8795,42-7-0-B-0,6757-84-0457,AG 20-100 AC,27.52,AC,963200,0,963200,0,5000,968200,272400,260600,11800,0,5000,277400,R3,RES/GEN,,,
8796,55-16-0-3-0,6776-64-6038,SNGL FAM SUB,4.9,AC,136000,0,136000,500000,40100,676100,121600,0,121600,217100,39600,378300,A2,AG/LTD,,,
8797,29-1-0-106-0,6759-12-4127,SNGL FAM SUB,1,AC,40500,0,40500,0,0,40500,37400,0,37400,0,0,37400,A1,AG/GEN,,,
8798,29-1-0-65-0,6749-53-0926,SNGL FAM SUB,2.5,AC,57900,0,57900,298900,200,357000,56400,0,56400,250400,200,307000,A1,AG/GEN,,,
8799,29-3-0-27-A,6749-43-3543,SNGL FAM SUB,2.987,AC,64500,0,64500,60700,500,125700,60200,0,60200,50600,500,111300,A1,AG/GEN,,,
8800,29-3-0-4-0,6749-72-4676,SNGL FAM SUB,2.34,AC,67300,0,67300,17400,0,84700,63200,0,63200,14400,0,77600,A1,AG/GEN,,,
8801,29-1-0-19-0,6749-22-8801,SNGL FAM SUB,2,AC,56000,0,56000,0,0,56000,52500,0,52500,0,0,52500,A1,AG/GEN,,,
8802,45-15-0-5-0,6797-63-2111,SNGL FAM SUB,7.57,AC,175900,0,175900,469700,10000,655600,148300,0,148300,374200,9000,531500,A2,AG/LTD,,,
8804,45-1-0-69-0,6797-53-9731,SNGL FAM SUB,10.15,AC,208500,0,208500,5000,0,213500,186500,0,186500,5000,0,191500,A2,AG/LTD,,,
8805,29-1-0-107-0,6759-12-4396,SNGL FAM SUB,1,AC,40500,0,40500,0,0,40500,37400,0,37400,0,0,37400,A1,AG/GEN,,,
8807,29-3-0-22-0,6749-53-5531,SNGL FAM SUB,3.296,AC,67100,0,67100,393200,0,460300,62600,0,62600,339800,0,402400,A1,AG/GEN,,,
8809,30-1-0-118-0,6759-55-6000,SNGL FAM SUB,3.12,AC,72000,0,72000,148200,800,221000,65300,0,65300,122000,800,188100,A2,AG/LTD,,,
8810,19-6-0-B-0,6739-17-7922,SNGL FAM SUB,1.48,AC,57600,0,57600,132100,500,190200,54400,0,54400,109400,500,164300,A1,AG/GEN,,,
8811,29-1-0-48-0,6748-69-7625,SNGL FAM SUB,3.28,AC,76200,0,76200,384200,1000,461400,72500,0,72500,319300,200,392000,A1,AG/GEN,,,
8814,29-3-0-26-A,6749-43-4256,SNGL FAM SUB,1,AC,47000,0,47000,76700,900,124600,44700,0,44700,63200,900,108800,A1,AG/GEN,,,
8815,58-3-C-2-0,7726-16-6953,SNGL FAM SUB,0,AC,88000,0,88000,145000,13800,246800,80000,0,80000,121400,11500,212900,RN,RESIDEN,,,
8816,6-1-0-10-B,6823-74-5323,SNGL FAM SUB,2.56,AC,47700,0,47700,128500,1500,177700,46800,0,46800,104900,1500,153200,A1,AG/GEN,,,
8817,45-1-0-128-0,6797-48-6355,SNGL FAM SUB,0.5,AC,57800,0,57800,173400,0,231200,51600,0,51600,141800,0,193400,A2,AG/LTD,,,
8818,46-1-0-96-0,7707-99-6345,SNGL FAM SUB,1.14,AC,95600,0,95600,125000,4000,224600,85400,0,85400,104200,4000,193600,A2,AG/LTD,,,
8819,46-1-0-96-A,7707-99-7505,SNGL FAM SUB,0.975,AC,81100,0,81100,0,25400,106500,72400,0,72400,0,19900,92300,A2,AG/LTD,,,
8820,46-21-B-2-0,7707-99-7788,SNGL FAM SUB,2.41,AC,127400,0,127400,248200,0,375600,115800,0,115800,213800,0,329600,A2,AG/LTD,,,
8821,64-7-0-C-0,7724-91-3865,SNGL FAM SUB,3,AC,210300,0,210300,255400,1000,466700,182800,0,182800,224700,1000,408500,A2,AG/LTD,,,
8822,29-1-0-33-0,6748-43-3564,SNGL FAM SUB,2,AC,64000,0,64000,0,600,64600,59800,0,59800,0,600,60400,A1,AG/GEN,,,
8823,46-1-0-83-A,7708-80-6849,SNGL FAM SUB,15,AC,338800,0,338800,210900,0,549700,302300,0,302300,182500,0,484800,A2,AG/LTD,,,
8824,56-1-0-45-0,6796-20-6326,AG 20-100 AC,30.2,AC,428100,413600,14500,0,0,428100,372400,359500,12900,0,0,372400,A2,AG/LTD,,,
8825,32-10-1-1-0,6778-89-0296,SNGL FAM SUB,4.07,AC,111500,0,111500,230600,1000,343100,99700,0,99700,166700,1000,267400,A2,AG/LTD,,,
8826,55-14-0-19-0,6786-40-6670,SNGL FAM SUB,13.256,AC,238500,0,238500,420200,63700,722400,213100,0,213100,342300,58700,614100,A2,AG/LTD,,,
8827,67-2-A-4-0,7723-56-5366,SNGL FAM SUB,0.871,AC,184000,0,184000,296900,1800,482700,160000,0,160000,250000,1800,411800,R1,RES/LTD,,,
8828,47-1-0-19-0,7716-27-7986,SNGL FAM SUB,2,AC,121200,0,121200,147300,0,268500,108200,0,108200,125100,0,233300,A2,AG/LTD,,,
8829,57-1-0-63-0,7716-16-1513,SNGL FAM SUB,2.06,AC,123200,0,123200,358500,29600,511300,110000,0,110000,301100,25300,436400,A2,AG/LTD,,,
8830,47-1-0-18-0,7716-27-7597,SNGL FAM SUB,2.01,AC,122000,0,122000,144400,100,266500,109000,0,109000,120800,100,229900,A2,AG/LTD,,,
8831,27-2-0-2-0,6719-60-0159,SNGL FAM SUB,1.816,AC,43400,0,43400,174000,0,217400,42500,0,42500,157800,0,200300,A1,AG/GEN,,,
8832,40-4-0-F-0,6737-62-8956,SNGL FAM SUB,3,AC,63200,0,63200,119300,1300,183800,62000,0,62000,103100,1300,166400,A1,AG/GEN,,,
8835,30-1-0-103-0,6768-18-6941,AG 20-100 AC,20.61,AC,248900,185400,63500,300700,800,550400,224200,165900,58300,236900,800,461900,A2,AG/LTD,,,
8836,2-3-0-10-0,6824-24-7673,SNGL FAM SUB,3.99,AC,58900,0,58900,381200,0,440100,50200,0,50200,354200,0,404400,A1,AG/GEN,,,
8837,2-3-0-11-0,6824-24-6513,SNGL FAM SUB,3.96,AC,66500,0,66500,202600,2500,271600,53700,0,53700,159500,2500,215700,A1,AG/GEN,,,
8838,42-1-0-87-0,6767-07-3152,SNGL FAM SUB,0.77,AC,58700,0,58700,196000,18900,273600,53000,0,53000,165000,15700,233700,R3,RES/GEN,,,
8839,42-1-0-87-A,6767-07-6155,SNGL FAM SUB,0.58,AC,9900,0,9900,0,0,9900,7000,0,7000,0,0,7000,R3,RES/GEN,,,
8840,12-1-0-12-0,6832-05-4663,AG 20-100 AC,38.94,AC,181400,163400,18000,0,0,181400,177800,161200,16600,0,0,177800,A1,AG/GEN,,,
8841,12-1-0-6-A,6822-75-4027,SNGL FAM SUB,2.91,AC,55900,0,55900,173600,2500,232000,54300,0,54300,152900,2500,209700,A1,AG/GEN,,,
8842,46-23-0-18-0,7707-83-9378,SNGL FAM SUB,4.387,AC,165000,0,165000,332500,2500,500000,150000,0,150000,277000,2100,429100,A2,AG/LTD,,,
8843,29-1-0-37-C,6748-63-3432,AG 20-100 AC,33.81,AC,234800,218600,16200,0,1300,236100,229900,215500,14400,0,1300,231200,A1,AG/GEN,,,
8844,29-1-0-42-0,6748-62-3119,AG 20-100 AC,36.06,AC,309900,239700,70200,408100,42900,760900,305800,241000,64800,338000,38400,682200,A1,AG/GEN,,,
8845,42-2-0-3-0,6767-05-2031,SNGL FAM SUB,1.345,AC,102200,0,102200,118200,400,220800,92000,0,92000,98300,400,190700,RO,RES/OF,,,
8846,27-1-0-60-0,6729-52-4171,AG > 100 AC,133.12,AC,407300,345900,61400,0,0,407300,399400,342800,56600,0,0,399400,A1,AG/GEN,,,
8847,42-1-0-84-0,6767-07-5419,SNGL FAM SUB,3.093,AC,93400,0,93400,0,38100,131500,84200,0,84200,0,34000,118200,R3,RES/GEN,,,
8848,42-1-0-85-0,6767-07-2435,SNGL FAM SUB,1.948,AC,79800,0,79800,236600,5000,321400,71700,0,71700,196900,5000,273600,R3,RES/GEN,,,
8849,42-1-0-86-0,6767-07-4274,SNGL FAM SUB,1.65,AC,76100,0,76100,189900,42200,308200,68100,0,68100,156300,34600,259000,R3,RES/GEN,,,
8850,42-2-0-3-A,6757-94-4958,SNGL FAM SUB,2.52,AC,28900,0,28900,0,0,28900,26200,0,26200,0,0,26200,R3,RES/GEN,,,
8851,6-1-0-38-A,6822-87-5720,SNGL FAM SUB,1.68,AC,45800,45000,800,0,0,45800,44400,43700,700,0,0,44400,A1,AG/GEN,,,
8867,58-4-H-7-0,7716-56-7984,SNGL FAM SUB,0,AC,20100,0,20100,0,0,20100,18300,0,18300,0,0,18300,A2,AG/LTD,,,
8868,58-4-H-9-0,7716-56-8728,SNGL FAM SUB,0,AC,20100,0,20100,0,0,20100,18300,0,18300,0,0,18300,A2,AG/LTD,,,
8869,58-4-H-10-0,7716-56-8740,SNGL FAM SUB,0,AC,20100,0,20100,0,0,20100,18300,0,18300,0,0,18300,A2,AG/LTD,,,
8870,58-4-H-11-0,7716-56-8653,SNGL FAM SUB,0,AC,20100,0,20100,0,0,20100,18300,0,18300,0,0,18300,A2,AG/LTD,,,
8871,58-4-H-12-0,7716-56-8575,SNGL FAM SUB,0,AC,20100,0,20100,0,0,20100,18300,0,18300,0,0,18300,A2,AG/LTD,,,
8872,58-4-H-13-0,7716-56-8497,SNGL FAM SUB,0,AC,20100,0,20100,0,0,20100,18300,0,18300,0,0,18300,A2,AG/LTD,,,
8873,58-4-H-14-0,7716-56-9319,SNGL FAM SUB,0,AC,20100,0,20100,0,0,20100,18300,0,18300,0,0,18300,A2,AG/LTD,,,
8874,58-4-H-15-0,7716-56-9321,SNGL FAM SUB,0,AC,20100,0,20100,0,0,20100,18300,0,18300,0,0,18300,A2,AG/LTD,,,
8875,58-4-H-17-0,7716-56-9165,SNGL FAM SUB,0,AC,20100,0,20100,0,0,20100,18300,0,18300,0,0,18300,A2,AG/LTD,,,
8876,58-4-H-18-0,7716-56-9077,SNGL FAM SUB,0,AC,20100,0,20100,0,0,20100,18300,0,18300,0,0,18300,A2,AG/LTD,,,
8877,58-4-H-19-0,7716-56-9090,SNGL FAM SUB,0,AC,20100,0,20100,0,0,20100,18300,0,18300,0,0,18300,A2,AG/LTD,,,
8878,58-4-H-35-0,7716-66-1112,SNGL FAM SUB,0,AC,10000,0,10000,0,0,10000,9100,0,9100,0,0,9100,A2,AG/LTD,,,
8879,58-4-H-36-0,7716-66-1200,SNGL FAM SUB,0,AC,10000,0,10000,0,0,10000,9100,0,9100,0,0,9100,A2,AG/LTD,,,
8880,58-4-H-41-0,7716-56-9792,SNGL FAM SUB,1.05,AC,92400,0,92400,341800,0,434200,84000,0,84000,287900,0,371900,A2,AG/LTD,,,
8881,12-1-0-18-0,6821-99-1542,AG 20-100 AC,54.6,AC,320700,253200,67500,0,7500,328200,318200,253100,65100,0,7500,325700,A1,AG/GEN,,,
8882,42-1-0-89-0,6767-06-3894,SNGL FAM SUB,1.13,AC,69600,0,69600,308900,34900,413400,61900,0,61900,257900,28900,348700,R3,RES/GEN,,,
8883,42-25-0-D-0,6767-28-1789,SNGL FAM SUB,8.58,AC,129600,0,129600,0,0,129600,121200,0,121200,0,0,121200,A2,AG/LTD,,,
8884,4-1-0-4-0,6803-58-1986,AG 20-100 AC,40,AC,163200,144800,18400,0,0,163200,160000,143000,17000,0,0,160000,A1,AG/GEN,,,
8885,30-1-0-51-0,6758-59-4447,AG 20-100 AC,48.52,AC,354800,330900,23900,0,0,354800,354200,333400,20800,0,0,354200,A2,AG/LTD,,,
8886,41-1-0-1-0,6748-21-1664,SNGL FAM SUB,7.126,AC,109700,0,109700,874000,0,983700,107500,0,107500,751700,0,859200,A1,AG/GEN,,,
8887,42-25-0-A-0,6767-08-9960,SNGL FAM SUB,10.06,AC,152700,0,152700,0,0,152700,135100,0,135100,0,0,135100,A2,AG/LTD,,,
8888,42-25-0-B-0,6767-19-2307,SNGL FAM SUB,9.51,AC,142700,0,142700,0,0,142700,129900,0,129900,0,0,129900,A2,AG/LTD,,,
8889,42-25-0-C-0,6767-18-6867,SNGL FAM SUB,10.59,AC,157200,0,157200,0,0,157200,140000,0,140000,0,0,140000,A2,AG/LTD,,,
8890,42-25-0-E-0,6767-28-7613,SNGL FAM SUB,8.01,AC,105200,0,105200,0,0,105200,96000,0,96000,0,0,96000,A2,AG/LTD,,,
8891,29-1-0-21-A,6748-46-7896,AG > 100 AC,225.754,AC,1458700,1291500,167200,50700,1700,1511100,1443400,1297000,146400,41200,1500,1486100,A1,AG/GEN,,,
8892,29-1-0-21-B,6748-56-1490,SNGL FAM SUB,1.49,AC,53500,0,53500,0,7400,60900,49500,0,49500,0,6600,56100,A1,AG/GEN,,,
8893,42-8-1-7-0,6767-18-5343,SNGL FAM SUB,0,AC,60000,0,60000,115300,100,175400,55000,0,55000,95100,100,150200,A2,AG/LTD,,,
8894,42-8-1-8-0,6767-18-6341,SNGL FAM SUB,0,AC,60000,0,60000,130100,0,190100,55000,0,55000,107000,0,162000,A2,AG/LTD,,,
8895,42-8-2-5-0,6767-28-1271,SNGL FAM SUB,0,AC,60000,0,60000,115200,0,175200,55000,0,55000,94900,0,149900,A2,AG/LTD,,,
8896,42-8-2-6-0,6767-28-2260,SNGL FAM SUB,0,AC,60000,0,60000,187900,0,247900,55000,0,55000,151500,0,206500,A2,AG/LTD,,,
8897,42-8-2-10-0,6767-28-6154,SNGL FAM SUB,0.87,AC,60000,0,60000,168900,0,228900,55000,0,55000,141500,0,196500,A2,AG/LTD,,,
8898,42-8-2-11-0,6767-28-7163,SNGL FAM SUB,0.87,AC,60000,0,60000,163100,0,223100,55000,0,55000,138200,0,193200,A2,AG/LTD,,,
8899,42-8-2-12-0,6767-28-9130,SNGL FAM SUB,2.27,AC,78000,0,78000,161500,0,239500,71500,0,71500,136800,0,208300,A2,AG/LTD,,,
8900,42-12-0-3-0,6767-27-6805,Academic-Private,0.4,AC,2500,0,2500,0,0,2500,2400,0,2400,0,0,2400,A2,AG/LTD,,,
8901,51-1-0-40-0,6726-93-7130,AG 20-100 AC,28.45,AC,178800,165700,13100,0,0,178800,175300,163200,12100,0,0,175300,A1,AG/GEN,,,
8902,42-8-1-5-0,6767-18-3346,SNGL FAM SUB,0,AC,60000,0,60000,0,10200,70200,55000,0,55000,0,10000,65000,A2,AG/LTD,,,
8903,42-8-1-6-0,6767-18-4344,SNGL FAM SUB,0,AC,60000,0,60000,196100,0,256100,55000,0,55000,165400,0,220400,A2,AG/LTD,,,
8904,30-1-0-57-A,6759-50-3983,SNGL FAM SUB,15.64,AC,178000,170800,7200,0,0,178000,171400,164800,6600,0,0,171400,A2,AG/LTD,,,
8905,41-2-0-14-0,6748-31-8012,SNGL FAM SUB,1.83,AC,62300,0,62300,188200,0,250500,57700,0,57700,114000,0,171700,A1,AG/GEN,,,
8906,30-8-0-1-0,6759-62-8998,SNGL FAM SUB,1.28,AC,57500,0,57500,0,0,57500,52800,0,52800,0,0,52800,A2,AG/LTD,,,
8907,30-8-0-2-0,6759-72-0956,SNGL FAM SUB,1.1,AC,49800,0,49800,0,0,49800,45900,0,45900,0,0,45900,A2,AG/LTD,,,
8908,30-8-0-3-0,6759-72-2923,SNGL FAM SUB,1.28,AC,57500,0,57500,214800,25600,297900,52800,0,52800,175800,21700,250300,A2,AG/LTD,,,
8909,30-8-0-4-0,6759-72-4930,SNGL FAM SUB,1.28,AC,57500,0,57500,0,0,57500,52800,0,52800,0,0,52800,A2,AG/LTD,,,
8910,30-8-0-5-0,6759-72-5897,SNGL FAM SUB,1.1,AC,55200,0,55200,0,0,55200,50900,0,50900,0,0,50900,A2,AG/LTD,,,
8911,30-8-0-6-0,6759-72-8844,SNGL FAM SUB,2.34,AC,70500,0,70500,0,0,70500,50900,0,50900,0,0,50900,A2,AG/LTD,,,
8913,30-8-0-8-0,6759-82-0762,SNGL FAM SUB,1.52,AC,60400,0,60400,0,0,60400,55300,0,55300,0,0,55300,A2,AG/LTD,,,
8914,30-8-0-9-0,6759-82-1579,SNGL FAM SUB,1.58,AC,61200,0,61200,0,0,61200,55900,0,55900,0,0,55900,A2,AG/LTD,,,
8915,30-8-0-10-0,6759-72-6569,SNGL FAM SUB,3.41,AC,83200,0,83200,0,0,83200,75000,0,75000,0,0,75000,A2,AG/LTD,,,
8916,30-8-0-11-0,6759-72-5452,SNGL FAM SUB,3.15,AC,80100,0,80100,494300,0,574400,72300,0,72300,416800,0,489100,A2,AG/LTD,,,
8917,30-8-0-12-0,6759-72-3292,SNGL FAM SUB,3.11,AC,79600,0,79600,346100,3100,428800,71800,0,71800,293900,2900,368600,A2,AG/LTD,,,
8918,30-8-0-13-0,6759-71-0950,SNGL FAM SUB,3.36,AC,82600,0,82600,404600,0,487200,74400,0,74400,354500,0,428900,A2,AG/LTD,,,
8919,30-8-0-14-0,6759-61-9510,SNGL FAM SUB,3.31,AC,82000,0,82000,306800,0,388800,73900,0,73900,267800,0,341700,A2,AG/LTD,,,
8920,30-8-0-15-0,6759-71-0266,SNGL FAM SUB,3.18,AC,80400,0,80400,382900,2000,465300,72600,0,72600,328300,2000,402900,A2,AG/LTD,,,
8921,30-8-0-16-0,6759-71-1076,SNGL FAM SUB,3.14,AC,80000,0,80000,297400,0,377400,72200,0,72200,252000,0,324200,A2,AG/LTD,,,
8922,30-8-0-17-0,6759-70-2899,SNGL FAM SUB,3.19,AC,80600,0,80600,235800,1000,317400,72700,0,72700,195500,1000,269200,A2,AG/LTD,,,
8923,30-8-0-18-0,6759-70-4715,SNGL FAM SUB,3.11,AC,79600,0,79600,307700,5900,393200,71800,0,71800,256300,3200,331300,A2,AG/LTD,,,
8924,30-8-0-19-0,6759-70-4660,SNGL FAM SUB,3.41,AC,83200,0,83200,301700,0,384900,75000,0,75000,255900,0,330900,A2,AG/LTD,,,
8925,30-8-0-20-0,6759-70-5404,SNGL FAM SUB,3.14,AC,80000,0,80000,329000,0,409000,72200,0,72200,278900,0,351100,A2,AG/LTD,,,
8926,30-8-0-21-0,6759-70-5246,SNGL FAM SUB,3.16,AC,80200,0,80200,273500,0,353700,72400,0,72400,242800,0,315200,A2,AG/LTD,,,
8927,30-8-0-22-0,6759-70-5098,SNGL FAM SUB,3.39,AC,82900,0,82900,361600,2900,447400,74800,0,74800,323700,2900,401400,A2,AG/LTD,,,
8928,30-8-0-23-0,6758-79-6867,SNGL FAM SUB,3.96,AC,84200,0,84200,0,0,84200,75700,0,75700,0,0,75700,A2,AG/LTD,,,
8929,30-8-0-24-0,6758-69-9534,SNGL FAM SUB,4.01,AC,90200,0,90200,407400,0,497600,81200,0,81200,352800,0,434000,A2,AG/LTD,,,
8930,30-8-0-25-0,6758-69-8785,SNGL FAM SUB,3.11,AC,74200,0,74200,310300,35400,419900,66800,0,66800,264000,30200,361000,A2,AG/LTD,,,
8931,30-8-0-26-0,6758-69-8954,SNGL FAM SUB,3.11,AC,79600,0,79600,245200,0,324800,71800,0,71800,215300,0,287100,A2,AG/LTD,,,
8932,30-8-0-27-0,6759-60-7193,SNGL FAM SUB,3.31,AC,82000,0,82000,312600,0,394600,73900,0,73900,264300,0,338200,A2,AG/LTD,,,
8933,30-8-0-28-0,6759-60-7312,SNGL FAM SUB,3.22,AC,80900,0,80900,0,0,80900,73000,0,73000,0,0,73000,A2,AG/LTD,,,
8934,30-8-0-29-0,6759-60-6429,SNGL FAM SUB,3.15,AC,80100,0,80100,232100,32500,344700,72300,0,72300,192500,31800,296600,A2,AG/LTD,,,
8935,30-8-0-30-0,6759-60-5645,SNGL FAM SUB,3.17,AC,74900,0,74900,324100,0,399000,67500,0,67500,0,0,67500,A2,AG/LTD,,,
8936,30-8-0-31-0,6759-60-4881,SNGL FAM SUB,3.18,AC,80400,0,80400,0,0,80400,72600,0,72600,0,0,72600,A2,AG/LTD,,,
8937,30-8-0-32-0,6759-60-4928,SNGL FAM SUB,3.27,AC,81500,0,81500,248900,0,330400,73500,0,73500,211000,0,284500,A2,AG/LTD,,,
8938,30-8-0-33-0,6759-61-3290,SNGL FAM SUB,3.18,AC,80400,0,80400,295700,0,376100,72600,0,72600,259600,0,332200,A2,AG/LTD,,,
8939,30-8-0-34-0,6759-61-4404,SNGL FAM SUB,3.37,AC,82700,0,82700,255500,5900,344100,74500,0,74500,222200,1500,298200,A2,AG/LTD,,,
8940,30-8-0-35-0,6759-61-4793,SNGL FAM SUB,3.14,AC,80000,0,80000,239000,43100,362100,72200,0,72200,198100,42300,312600,A2,AG/LTD,,,
8941,30-8-0-36-0,6759-62-6041,SNGL FAM SUB,3.18,AC,80400,0,80400,269300,10300,360000,72600,0,72600,222400,9700,304700,A2,AG/LTD,,,
8942,30-8-0-37-0,6759-62-7275,SNGL FAM SUB,3.19,AC,80600,0,80600,206200,3000,289800,72700,0,72700,169600,3000,245300,A2,AG/LTD,,,
8943,30-8-0-38-0,6759-62-9417,SNGL FAM SUB,3.31,AC,82000,0,82000,297200,0,379200,73900,0,73900,254900,0,328800,A2,AG/LTD,,,
8944,30-8-0-39-0,6759-72-0700,SNGL FAM SUB,3.21,AC,80800,0,80800,316700,0,397500,72900,0,72900,279100,0,352000,A2,AG/LTD,,,
8945,29-1-0-43-A,6748-59-4015,SNGL FAM SUB,1.322,AC,30200,0,30200,0,0,30200,27800,0,27800,0,0,27800,A1,AG/GEN,,,
8946,44-1-0-34-0,6787-13-2551,SNGL FAM SUB,1.6,AC,79600,0,79600,279200,2300,361100,71100,0,71100,226000,2500,299600,A2,AG/LTD,,,
8947,58-4-A-7-0,7716-57-2173,SNGL FAM SUB,0,AC,20100,0,20100,0,0,20100,18300,0,18300,0,0,18300,A2,AG/LTD,,,
8948,58-4-A-9-0,7716-57-4125,SNGL FAM SUB,0,AC,20100,0,20100,0,0,20100,18300,0,18300,0,0,18300,A2,AG/LTD,,,
8949,10-1-0-4-0,6802-83-4181,AG > 100 AC,183.04,AC,378900,294500,84400,0,0,378900,366100,288300,77800,0,0,366100,A1,AG/GEN,,,
8950,10-1-0-42-0,6811-46-2087,AG 20-100 AC,88.4,AC,219100,178300,40800,0,0,219100,214400,176800,37600,0,0,214400,A1,AG/GEN,,,
8951,10-4-0-2-0,6802-61-1614,AG 20-100 AC,93.5,AC,232300,189200,43100,0,0,232300,233800,194100,39700,0,0,233800,A1,AG/GEN,,,
8952,11-1-0-35-0,6821-25-0598,SNGL FAM SUB,17.87,AC,134400,0,134400,377600,0,512000,130800,0,130800,303900,0,434700,RR,RES/RUR,,,
8953,11-1-0-35-E,6821-24-0756,SNGL FAM SUB,2.96,AC,51800,0,51800,151600,0,203400,50700,0,50700,116800,0,167500,A1,AG/GEN,,,
8955,17-1-0-31-0,6800-57-1803,AG 20-100 AC,75.18,AC,223400,188700,34700,0,0,223400,170500,144900,25600,0,0,170500,A1,AG/GEN,,,
8956,19-5-0-2-0,6739-19-7595,SNGL FAM SUB,1.645,AC,58900,0,58900,118100,1500,178500,56000,0,56000,97700,1500,155200,A1,AG/GEN,,,
8959,29-1-0-18-0,6749-22-3079,AG 20-100 AC,50,AC,357500,334400,23100,0,0,357500,365000,343700,21300,0,0,365000,A1,AG/GEN,,,
8960,30-1-0-53-0,6759-60-0028,SNGL FAM SUB,1.25,AC,9300,8700,600,0,0,9300,7800,7300,500,0,0,7800,A2,AG/LTD,,,
8961,30-1-0-54-0,6759-50-4174,SNGL FAM SUB,6,AC,86200,83400,2800,0,0,86200,79000,76400,2600,0,0,79000,A2,AG/LTD,,,
8962,30-1-0-91-A,6768-33-2033,AG > 100 AC,160,AC,1278900,1151600,127300,2500,0,1281400,1174000,1069000,105000,2500,0,1176500,A2,AG/LTD,,,
8963,30-7-0-1-0,6758-24-7132,SNGL FAM SUB,1.1,AC,55000,0,55000,0,0,55000,50900,0,50900,0,0,50900,A2,AG/LTD,,,
8964,30-7-0-2-0,6758-24-8236,SNGL FAM SUB,1.35,AC,57500,0,57500,0,0,57500,53500,0,53500,0,0,53500,A2,AG/LTD,,,
8965,30-7-0-3-0,6758-24-9471,SNGL FAM SUB,1.66,AC,60600,0,60600,0,0,60600,55500,0,55500,0,0,55500,A2,AG/LTD,,,
8966,30-7-0-4-0,6758-34-0589,SNGL FAM SUB,1.78,AC,61800,0,61800,0,0,61800,57400,0,57400,0,0,57400,A2,AG/LTD,,,
8967,30-7-0-5-0,6758-34-3400,SNGL FAM SUB,2.82,AC,44900,0,44900,0,0,44900,45200,0,45200,0,0,45200,A2,AG/LTD,,,
8968,30-7-0-6-0,6758-34-5014,SNGL FAM SUB,3.44,AC,50700,0,50700,0,0,50700,47900,0,47900,0,0,47900,A2,AG/LTD,,,
8969,30-7-0-7-0,6758-34-6291,SNGL FAM SUB,3.29,AC,49300,0,49300,0,0,49300,46500,0,46500,0,0,46500,A2,AG/LTD,,,
8970,30-7-0-8-0,6758-34-8397,SNGL FAM SUB,3.61,AC,52300,0,52300,0,0,52300,49500,0,49500,0,0,49500,A2,AG/LTD,,,
8971,30-7-0-9-0,6758-44-4124,SNGL FAM SUB,4.45,AC,59800,0,59800,0,0,59800,57400,0,57400,0,0,57400,A2,AG/LTD,,,
8972,30-7-0-10-0,6758-43-3858,SNGL FAM SUB,3.85,AC,54400,0,54400,0,0,54400,51800,0,51800,0,0,51800,A2,AG/LTD,,,
8973,30-7-0-11-0,6758-43-2638,SNGL FAM SUB,3.71,AC,53200,0,53200,0,0,53200,50500,0,50500,0,0,50500,A2,AG/LTD,,,
8974,30-7-0-12-0,6758-43-1402,SNGL FAM SUB,6.18,AC,74600,0,74600,0,0,74600,68000,0,68000,0,0,68000,A2,AG/LTD,,,
8975,30-7-0-13-0,6758-33-7492,SNGL FAM SUB,4.44,AC,59700,0,59700,0,0,59700,57300,0,57300,0,0,57300,A2,AG/LTD,,,
8976,30-7-0-14-0,6758-33-5419,SNGL FAM SUB,3.53,AC,51500,0,51500,0,0,51500,48800,0,48800,0,0,48800,A2,AG/LTD,,,
8977,30-7-0-15-0,6758-33-3627,SNGL FAM SUB,3.52,AC,51400,0,51400,0,0,51400,48700,0,48700,0,0,48700,A2,AG/LTD,,,
8978,30-7-0-16-0,6758-33-0969,SNGL FAM SUB,3.4,AC,50300,0,50300,0,0,50300,46200,0,46200,0,0,46200,A2,AG/LTD,,,
8979,43-1-0-7-A,6767-57-5607,SNGL FAM SUB,3.77,AC,110000,0,110000,259800,2000,371800,98300,0,98300,222000,2000,322300,A2,AG/LTD,,,
8980,46-1-0-27-0,7707-24-5148,SNGL FAM SUB,0.803,AC,89000,0,89000,85200,600,174800,79500,0,79500,71600,600,151700,RR,RES/RUR,,,
8981,46-4-0-1-0,7708-51-7900,AG 20-100 AC,35,AC,690800,674700,16100,0,0,690800,616300,601400,14900,0,0,616300,A2,AG/LTD,,,
8982,54-2-0-2-0,6776-12-2836,SNGL FAM SUB,5.696,AC,111500,0,111500,219800,5900,337200,99500,0,99500,179000,5200,283700,A2,AG/LTD,,,
8983,55-13-0-A-0,6785-78-6171,SNGL FAM SUB,10.91,AC,128900,123900,5000,0,0,128900,115100,110500,4600,0,0,115100,A2,AG/LTD,,,
8984,55-15-0-8-A,6785-76-1487,SNGL FAM SUB,0.445,AC,2900,0,2900,0,0,2900,2600,0,2600,0,0,2600,A2,AG/LTD,,,
8985,55-15-0-9-0,6785-76-1678,SNGL FAM SUB,3,AC,114300,0,114300,0,0,114300,102000,0,102000,0,0,102000,A2,AG/LTD,,,
8986,56-6-0-3-0,6785-87-4711,AG 20-100 AC,28.78,AC,345400,332100,13300,0,0,345400,307900,295700,12200,0,0,307900,A2,AG/LTD,,,
8991,58-4-A-2-0,7716-47-8190,SNGL FAM SUB,0,AC,20100,0,20100,0,0,20100,18300,0,18300,0,0,18300,A2,AG/LTD,,,
8992,58-4-A-5-0,7716-57-1121,SNGL FAM SUB,0,AC,20100,0,20100,0,0,20100,18300,0,18300,0,0,18300,A2,AG/LTD,,,
8993,58-4-A-10-0,7716-57-4187,SNGL FAM SUB,0,AC,20100,0,20100,0,0,20100,18300,0,18300,0,0,18300,A2,AG/LTD,,,
8994,58-4-A-16-0,7716-56-2998,SNGL FAM SUB,0,AC,20100,0,20100,0,0,20100,18300,0,18300,0,0,18300,A2,AG/LTD,,,
8995,58-4-A-17-0,7716-56-2917,SNGL FAM SUB,0,AC,10000,0,10000,0,0,10000,9100,0,9100,0,0,9100,A2,AG/LTD,,,
8996,58-4-A-18-0,7716-56-1936,SNGL FAM SUB,0,AC,10000,0,10000,0,0,10000,9100,0,9100,0,0,9100,A2,AG/LTD,,,
8997,58-4-A-20-0,7716-46-9975,SNGL FAM SUB,0,AC,10000,0,10000,0,0,10000,9100,0,9100,0,0,9100,A2,AG/LTD,,,
8998,58-4-B-1-0,7716-46-8775,SNGL FAM SUB,0,AC,10000,0,10000,0,0,10000,9100,0,9100,0,0,9100,A2,AG/LTD,,,
8999,58-4-B-2-0,7716-46-8677,SNGL FAM SUB,0,AC,10000,0,10000,0,0,10000,9100,0,9100,0,0,9100,A2,AG/LTD,,,
9000,58-4-B-4-0,7716-46-8581,SNGL FAM SUB,0,AC,10000,0,10000,0,0,10000,9100,0,9100,0,0,9100,A2,AG/LTD,,,
9001,58-4-B-6-0,7716-46-8395,SNGL FAM SUB,0,AC,10000,0,10000,0,0,10000,9100,0,9100,0,0,9100,A2,AG/LTD,,,
9002,58-4-B-7-0,7716-46-9207,SNGL FAM SUB,0,AC,10000,0,10000,0,0,10000,9100,0,9100,0,0,9100,A2,AG/LTD,,,
9003,58-4-C-2-0,7716-56-1725,SNGL FAM SUB,0,AC,10000,0,10000,0,0,10000,9100,0,9100,0,0,9100,A2,AG/LTD,,,
9006,58-4-H-6-0,7716-57-7062,SNGL FAM SUB,0,AC,20100,0,20100,0,0,20100,18300,0,18300,0,0,18300,A2,AG/LTD,,,
9007,58-4-H-40-0,7716-66-0532,SNGL FAM SUB,0,AC,10000,0,10000,0,0,10000,9100,0,9100,0,0,9100,A2,AG/LTD,,,
9008,58-4-H-45-0,7716-56-9951,SNGL FAM SUB,0,AC,10000,0,10000,0,0,10000,9100,0,9100,0,0,9100,A2,AG/LTD,,,
9009,63-1-0-113-0,7715-51-5865,SNGL FAM SUB,2.735,AC,89600,0,89600,0,0,89600,77900,0,77900,0,0,77900,A2,AG/LTD,,,
9010,63-5-0-2-0,7724-24-1311,SNGL FAM SUB,0.972,AC,135700,0,135700,93400,3400,232500,117900,0,117900,79600,3400,200900,A2,AG/LTD,,,
9011,64-4-1-2-0,7724-93-1240,SNGL FAM SUB,0,AC,70000,0,70000,177900,100,248000,60000,0,60000,152800,100,212900,RN,RESIDEN,,,
9012,17-1-0-53-0,6810-06-9904,AG 20-100 AC,28.5,AC,101700,88600,13100,0,0,101700,99800,87700,12100,0,0,99800,A1,AG/GEN,,,
9013,17-1-0-54-0,6810-16-2066,AG 20-100 AC,25,AC,89300,77800,11500,0,0,89300,87500,76900,10600,0,0,87500,A1,AG/GEN,,,
9014,30-1-0-100-A,6768-36-2806,AG 20-100 AC,38.237,AC,312800,295200,17600,0,0,312800,274300,258600,15700,0,0,274300,A2,AG/LTD,,,
9016,63-1-0-156-0,7724-27-3807,AG 20-100 AC,96.74,AC,2214000,2169400,44600,0,0,2214000,1927600,1886500,41100,0,0,1927600,A2,AG/LTD,,,
9017,58-22-A-10-0,7715-27-7737,SNGL FAM SUB,6.204,AC,456000,0,456000,1116100,75400,1647500,418000,0,418000,1037200,68200,1523400,A2,AG/LTD,,,
9029,58-25-B-1-0,7715-35-8250,SNGL FAM SUB,2.373,AC,341000,0,341000,473100,1000,815100,313500,0,313500,441900,1000,756400,RR,RES/RUR,,,
9030,58-25-B-2-0,7715-35-5075,SNGL FAM SUB,2.108,AC,341000,0,341000,386900,12000,739900,313500,0,313500,369400,12000,694900,RR,RES/RUR,,,
9031,58-25-B-3-0,7715-34-3936,SNGL FAM SUB,2.245,AC,341000,0,341000,446100,2400,789500,313500,0,313500,425300,2100,740900,RR,RES/RUR,,,
9032,58-25-B-4-0,7715-34-0789,SNGL FAM SUB,2.135,AC,341000,0,341000,826700,157200,1324900,313500,0,313500,750500,139300,1203300,RR,RES/RUR,,,
9033,58-25-B-5-0,7715-24-8863,SNGL FAM SUB,2.171,AC,341000,0,341000,695100,2500,1038600,313500,0,313500,627800,2700,944000,RR,RES/RUR,,,
9190,28-1-0-46-B,6738-42-4045,SNGL FAM SUB,17.738,AC,140300,0,140300,0,0,140300,136900,0,136900,0,0,136900,A1,AG/GEN,,,
9191,28-1-0-110-0,6738-78-6283,SNGL FAM SUB,7,AC,47400,0,47400,0,0,47400,47100,0,47100,0,0,47100,A1,AG/GEN,,,
9192,40-1-0-33-B,6738-51-7871,SNGL FAM SUB,11.659,AC,111600,0,111600,0,0,111600,109900,0,109900,0,0,109900,A1,AG/GEN,,,
9193,38-1-0-111-A,6718-30-6756,AG 20-100 AC,24,AC,133100,0,133100,0,0,133100,130000,0,130000,0,0,130000,A1,AG/GEN,,,
9194,42-1-0-6-A,6757-26-7294,SNGL FAM SUB,8,AC,23200,0,23200,0,0,23200,22400,0,22400,0,0,22400,A2,AG/LTD,,,
9196,2-3-0-35-0,6824-33-1091,SNGL FAM SUB,4.57,AC,56600,0,56600,136900,4500,198000,55400,0,55400,115400,4500,175300,A1,AG/GEN,,,
9197,46-1-0-84-0,7708-82-5173,SNGL FAM SUB,5.737,AC,175800,0,175800,0,0,175800,156900,0,156900,0,0,156900,A2,AG/LTD,,,
9200,47-21-0-1-0,7726-09-7740,COMM & IND,1.35,AC,309400,0,309400,0,0,309400,281300,0,281300,0,0,281300,B1,BUS/GEN,,,
9201,47-21-0-2-0,7726-09-7490,COMM & IND,1.64,AC,485300,0,485300,814200,39800,1339300,441100,0,441100,739500,35200,1215800,B1,BUS/GEN,,,
9202,47-21-0-3-0,7726-09-9547,COMM & IND,1.44,AC,383900,0,383900,0,0,383900,348900,0,348900,0,0,348900,B1,BUS/GEN,,,
9203,47-21-0-5-0,7726-19-1781,COMM & IND,1,AC,296800,0,296800,228200,3500,528500,269800,0,269800,224200,3500,497500,B1,BUS/GEN,,,
9204,47-21-0-9-0,7726-19-9669,COMM & IND,1,AC,484000,0,484000,0,0,484000,440000,0,440000,0,0,440000,B1,BUS/GEN,,,
9205,47-21-0-10-0,7726-19-7626,COMM & IND,1.07,AC,381000,0,381000,0,0,381000,346300,0,346300,0,0,346300,B1,BUS/GEN,,,
9206,47-21-0-11-0,7726-19-5595,COMM & IND,1.08,AC,304400,0,304400,0,0,304400,276700,0,276700,0,0,276700,B1,BUS/GEN,,,
9207,47-21-0-12-0,7726-19-4468,COMM & IND,1.15,AC,341100,0,341100,659700,19400,1020200,310100,0,310100,605200,13500,928800,B1,BUS/GEN,,,
9208,47-21-0-13-0,7726-19-3358,COMM & IND,1.16,AC,344000,0,344000,765900,41300,1151200,312700,0,312700,587200,28800,928700,B1,BUS/GEN,,,
9209,47-21-0-14-0,7726-19-2204,COMM & IND,2.23,AC,657900,0,657900,0,0,657900,598000,0,598000,0,0,598000,B1,BUS/GEN,,,
9210,47-21-0-15-0,7726-19-0007,COMM & IND,1.672,AC,494700,0,494700,2483800,100,2978600,449700,0,449700,2483800,100,2933600,B1,BUS/GEN,,,
9211,46-22-0-F-0,7706-88-7116,SNGL FAM SUB,14.016,AC,470600,0,470600,594100,10000,1074700,419800,0,419800,507800,8100,935700,A2,AG/LTD,,,
9217,57-1-0-48-0,7715-07-1722,SNGL FAM SUB,3.42,AC,251800,0,251800,0,0,251800,218900,0,218900,0,0,218900,A2,AG/LTD,,,
9401,62-7-0-D-0,7705-90-1463,AG 20-100 AC,22.14,AC,730000,0,730000,543500,55900,1329400,634900,0,634900,468300,47900,1151100,A2,AG/LTD,,,
9402,62-17-C-3-0,7714-06-2368,SNGL FAM SUB,0,AC,115000,0,115000,241200,400,356600,100000,0,100000,223900,400,324300,R1,RES/LTD,,,
9403,40-1-0-22-A,6726-87-3234,AG 20-100 AC,25.628,AC,174900,118700,56200,132800,72800,380500,171700,118100,53600,112500,64700,348900,A1,AG/GEN,,,
9404,40-1-0-23-0,6726-76-5991,SNGL FAM SUB,6.131,AC,75200,0,75200,0,0,75200,73800,0,73800,0,0,73800,A1,AG/GEN,,,
9406,47-1-0-88-0,7726-37-0484,SNGL FAM SUB,0.503,AC,221600,0,221600,22700,0,244300,201500,0,201500,17900,0,219400,R3,RES/GEN,,,
9407,40-1-0-23-B,6726-77-8522,SNGL FAM SUB,6.082,AC,77400,30900,46500,296300,2500,376200,76000,30800,45200,260600,2500,339100,A1,AG/GEN,,,
9408,15-5-0-11-0,5789-57-7879,SNGL FAM SUB,8.29,AC,65000,0,65000,345200,20000,430200,63500,0,63500,307100,17300,387900,A1,AG/GEN,,,
9409,44-1-0-17-0,6787-01-3154,SNGL FAM SUB,13.863,AC,239900,0,239900,260400,40100,540400,249900,0,249900,217000,36300,503200,A2,AG/LTD,,,
9410,42-23-0-7-0,6767-32-9175,SNGL FAM SUB,2.41,AC,91400,0,91400,298600,44200,434200,81600,0,81600,247200,37000,365800,A2,AG/LTD,,,
9411,46-23-0-13-0,7707-93-5944,SNGL FAM SUB,2.069,AC,165000,0,165000,241000,800,406800,150000,0,150000,202000,800,352800,A2,AG/LTD,,,
9412,46-23-0-33-0,7707-85-9363,SNGL FAM SUB,2.037,AC,165000,0,165000,250100,28100,443200,150000,0,150000,210100,23300,383400,A2,AG/LTD,,,
9413,63-4-0-11-0,7714-97-5542,SNGL FAM SUB,0,AC,79200,0,79200,0,18700,97900,72000,0,72000,0,16300,88300,A2,AG/LTD,,,
9414,63-4-0-10-0,7714-97-6332,SNGL FAM SUB,0,AC,158400,0,158400,400700,5100,564200,144000,0,144000,360100,4700,508800,A2,AG/LTD,,,
9415,62-17-A-4-0,7714-05-3837,SNGL FAM SUB,0,AC,115000,0,115000,228700,0,343700,100000,0,100000,199400,0,299400,R1,RES/LTD,,,
9416,55-1-0-1-C,6776-74-9362,SNGL FAM SUB,9.61,AC,214100,0,214100,782800,11200,1008100,191300,0,191300,635700,11200,838200,A2,AG/LTD,,,
9034,58-25-B-6-0,7715-24-7998,SNGL FAM SUB,2.055,AC,334800,0,334800,601800,0,936600,307800,0,307800,543100,0,850900,RR,RES/RUR,,,
9035,58-25-B-7-0,7715-25-8127,SNGL FAM SUB,2.842,AC,372000,0,372000,1005800,18000,1395800,319200,0,319200,681100,11000,1011300,RR,RES/RUR,,,
9036,58-25-B-8-0,7715-25-6357,SNGL FAM SUB,2.408,AC,334800,0,334800,408300,5500,748600,307800,0,307800,383700,4600,696100,RR,RES/RUR,,,
9037,58-25-B-9-0,7715-25-8573,SNGL FAM SUB,2.009,AC,341000,0,341000,589300,14400,944700,313500,0,313500,552900,14100,880500,RR,RES/RUR,,,
9038,58-25-B-10-0,7715-35-0683,SNGL FAM SUB,2.658,AC,401500,0,401500,377800,16000,795300,368500,0,368500,356300,15500,740300,RR,RES/RUR,,,
9039,58-25-B-11-0,7715-25-4611,SNGL FAM SUB,2.175,AC,325500,0,325500,912600,30600,1268700,299300,0,299300,856900,28800,1185000,RR,RES/RUR,,,
9040,58-25-B-11-A,7715-35-3346,Cmn Area/Open Spc,4.76,AC,0,0,0,0,0,0,0,0,0,0,0,0,RR,RES/RUR,,,
9041,58-25-B-11-B,7715-25-4113,SNGL FAM SUB,0.495,AC,7900,0,7900,0,0,7900,7200,0,7200,0,0,7200,RR,RES/RUR,,,
9043,56-1-0-35-0,6785-83-9526,SNGL FAM SUB,3.705,AC,112800,0,112800,157600,600,271000,100700,0,100700,132900,600,234200,A2,AG/LTD,,,
9044,64-12-C-5-0,7724-50-8135,SNGL FAM SUB,0,AC,20200,0,20200,0,0,20200,17600,0,17600,0,0,17600,R1,RES/LTD,,,
9045,5-1-0-65-B,6823-28-5836,SNGL FAM SUB,5,AC,57700,0,57700,50500,200,108400,56700,0,56700,44500,200,101400,A1,AG/GEN,,,
9046,21-1-0-25-C,6759-17-9917,SNGL FAM SUB,1.5,AC,59000,0,59000,120500,1000,180500,55100,0,55100,99200,1000,155300,A2,AG/LTD,,,
9047,21-1-0-26-0,6759-28-1167,SNGL FAM SUB,2.762,AC,71000,0,71000,193800,0,264800,68200,0,68200,166400,0,234600,A2,AG/LTD,,,
9048,5-16-0-2-0,6823-34-8985,SNGL FAM SUB,2,AC,44800,0,44800,134500,0,179300,44000,0,44000,117800,0,161800,A1,AG/GEN,,,
9049,5-16-0-3-0,6823-44-3865,SNGL FAM SUB,6.72,AC,68900,0,68900,0,0,68900,67600,0,67600,0,0,67600,A1,AG/GEN,,,
9050,64-15-D-1-0,7733-27-3791,SNGL FAM SUB,0,AC,251800,0,251800,751200,2000,1005000,209000,0,209000,634200,2000,845200,R1,RES/LTD,,,
9051,31-11-0-8-0,6779-32-6168,SNGL FAM SUB,1.86,AC,76500,0,76500,170400,2000,248900,68300,0,68300,138200,2000,208500,A2,AG/LTD,,,
9052,31-11-0-8-A,6779-32-8380,SNGL FAM SUB,1.8,AC,75600,0,75600,150300,2500,228400,67500,0,67500,136500,1800,205800,A2,AG/LTD,,,
9053,31-11-0-8-B,6779-31-8944,SNGL FAM SUB,1.69,AC,74000,0,74000,180500,5500,260000,66100,0,66100,148300,3900,218300,A2,AG/LTD,,,
9054,31-11-0-8-C,6779-42-0036,SNGL FAM SUB,1.63,AC,73200,0,73200,164400,0,237600,65300,0,65300,136200,0,201500,A2,AG/LTD,,,
9055,30-14-0-1-0,6758-82-3542,SNGL FAM SUB,11.99,AC,194700,0,194700,0,13200,207900,174900,0,174900,0,12700,187600,A2,AG/LTD,,,
9056,30-14-0-2-0,6758-72-8625,SNGL FAM SUB,16.8,AC,243000,0,243000,664800,10000,917800,199600,0,199600,565800,9400,774800,A2,AG/LTD,,,
9057,30-14-0-3-0,6758-72-2578,SNGL FAM SUB,10.01,AC,176500,0,176500,405800,0,582300,158800,0,158800,334000,0,492800,A2,AG/LTD,,,
9058,30-14-0-4-0,6758-62-7894,SNGL FAM SUB,11.51,AC,189900,0,189900,546200,24400,760500,169700,0,169700,452400,21400,643500,A2,AG/LTD,,,
9059,30-14-0-5-0,6758-63-3016,SNGL FAM SUB,11.49,AC,189700,0,189700,650200,39900,879800,169400,0,169400,541600,37800,748800,A2,AG/LTD,,,
9060,30-14-0-6-0,6758-53-6219,SNGL FAM SUB,12.64,AC,201100,0,201100,796600,57200,1054900,169300,0,169300,669800,49400,888500,A2,AG/LTD,,,
9061,42-1-0-75-A,6758-81-9769,General Gov,1.54,AC,10400,0,10400,0,0,10400,10000,0,10000,0,0,10000,A2,AG/LTD,,,
9062,42-1-0-30-0,6766-08-6756,AG 20-100 AC,36.14,AC,420200,0,420200,182900,1500,604600,388400,0,388400,150700,1500,540600,R3A2,RES GEN,,,
9063,19-1-0-48-0,6830-68-3621,AG > 100 AC,152.5,AC,404000,333700,70300,0,0,404000,384000,319200,64800,0,0,384000,A1,AG/GEN,,,
9064,45-2-0-2-0,6787-83-1809,SNGL FAM SUB,1.32,AC,74700,0,74700,121100,800,196600,66700,0,66700,99000,800,166500,A2,AG/LTD,,,
9066,27-5-0-5-0,6728-66-0863,SNGL FAM SUB,2.6,AC,48600,0,48600,2500,0,51100,47600,0,47600,2500,0,50100,A1,AG/GEN,,,
9067,45-7-0-B-0,6797-68-4610,SNGL FAM SUB,2.16,AC,75600,0,75600,57700,1300,134600,67500,0,67500,48600,1300,117400,A2,AG/LTD,,,
9068,4-1-0-5-0,6803-47-5701,AG 20-100 AC,96.5,AC,327200,248600,78600,154500,12800,494500,321000,247100,73900,125600,12600,459200,A1,AG/GEN,,,
9069,21-1-0-30-0,6759-37-4440,SNGL FAM SUB,2.089,AC,67500,0,67500,217600,11400,296500,61200,0,61200,180200,11000,252400,A1,AG/GEN,,,
9070,33-1-0-3-A,6788-94-3549,SNGL FAM SUB,10.42,AC,79600,0,79600,0,0,79600,71100,0,71100,0,0,71100,A2,AG/LTD,,,
9071,33-1-0-3-C,6788-95-1288,SNGL FAM SUB,5,AC,60900,0,60900,6500,400,67800,54400,0,54400,6500,400,61300,A2,AG/LTD,,,
9072,39-1-0-27-0,6727-04-9420,SNGL FAM SUB,3,AC,49000,0,49000,0,0,49000,48000,0,48000,0,0,48000,A1,AG/GEN,,,
9073,39-1-0-72-0,6726-26-5821,SNGL FAM SUB,3.6,AC,54700,0,54700,0,0,54700,53600,0,53600,0,0,53600,A1,AG/GEN,,,
9074,39-1-0-73-0,6726-26-1942,SNGL FAM SUB,5,AC,61200,0,61200,0,0,61200,60000,0,60000,0,0,60000,A1,AG/GEN,,,
9075,17-1-0-73-0,6810-10-0331,SNGL FAM SUB,2.656,AC,46500,0,46500,305000,0,351500,43900,0,43900,252800,0,296700,A1,AG/GEN,,,
9076,45-1-0-102-A,6798-71-8044,SNGL FAM SUB,1.92,AC,72300,0,72300,101200,300,173800,64500,0,64500,83100,300,147900,A2,AG/LTD,,,
9077,45-13-0-B-0,6797-79-6046,SNGL FAM SUB,0.735,AC,4200,0,4200,0,2500,6700,3700,0,3700,0,2500,6200,A2,AG/LTD,,,
9078,45-13-0-A-0,6797-78-5897,SNGL FAM SUB,1.098,AC,65200,0,65200,66800,0,132000,58200,0,58200,55300,0,113500,A2,AG/LTD,,,
9079,19-1-0-17-0,6820-91-0992,AG 20-100 AC,26.97,AC,81900,0,81900,0,0,81900,77700,0,77700,0,0,77700,A1,AG/GEN,,,
9080,39-1-0-64-0,6726-18-8314,SNGL FAM SUB,1,AC,38800,0,38800,106200,200,145200,38000,0,38000,90100,200,128300,A1,AG/GEN,,,
9081,28-1-0-16-A,6728-87-6695,SNGL FAM SUB,2.9,AC,50400,0,50400,0,6500,56900,49400,0,49400,0,5500,54900,A1,AG/GEN,,,
9082,43-18-0-2-0,6777-39-6302,SNGL FAM SUB,3,AC,88400,0,88400,0,0,88400,79000,0,79000,0,0,79000,A2,AG/LTD,,,
9083,44-2-0-3-0,6787-73-9768,SNGL FAM SUB,1.34,AC,74800,0,74800,147200,15100,237100,66800,0,66800,121400,12800,201000,A2,AG/LTD,,,
9084,51-1-0-9-0,6736-10-2647,SNGL FAM SUB,10.9,AC,94200,0,94200,0,0,94200,92500,0,92500,0,7600,100100,A1,AG/GEN,,,
9085,39-1-0-67-0,6726-16-1508,SNGL FAM SUB,1,AC,38800,0,38800,67200,400,106400,38000,0,38000,57800,400,96200,A1,AG/GEN,,,
9086,64-4-2-29-0,7724-92-5914,COMM & IND,0.43,AC,109300,0,109300,227300,400,337000,101200,0,101200,222400,400,324000,B1,BUS/GEN,,,
9087,64-4-2-30-0,7724-92-6904,COMM & IND,0.34,AC,86400,0,86400,0,0,86400,80000,0,80000,0,0,80000,B1,BUS/GEN,,,
9088,27-1-0-37-0,6728-25-1526,SNGL FAM SUB,3,AC,20900,0,20900,0,0,20900,20500,0,20500,0,0,20500,A1,AG/GEN,,,
9089,58-7-0-4-0,7716-64-3067,SNGL FAM SUB,4.03,AC,170200,0,170200,379700,11600,561500,147900,0,147900,0,33000,180900,A2,AG/LTD,,,
9090,33-1-0-3-F,6798-05-4050,SNGL FAM SUB,5,AC,60900,0,60900,98700,400,160000,54400,0,54400,79100,400,133900,A2,AG/LTD,,,
9091,33-1-0-3-E,6788-95-8013,SNGL FAM SUB,5,AC,60900,0,60900,18900,100,79900,54400,0,54400,16300,100,70800,A2,AG/LTD,,,
9092,2-1-0-22-0,6814-82-1691,SNGL FAM SUB,2.66,AC,48200,0,48200,0,0,48200,47300,0,47300,0,0,47300,A1,AG/GEN,,,
9093,39-1-0-48-A,6727-11-6060,SNGL FAM SUB,0.93,AC,36100,0,36100,72100,200,108400,35300,0,35300,61600,200,97100,A1,AG/GEN,,,
9094,50-1-0-1-B,6726-05-2618,SNGL FAM SUB,3.23,AC,51300,0,51300,114300,400,166000,50300,0,50300,99000,400,149700,A1,AG/GEN,,,
9095,20-1-0-87-0,6749-77-3787,AG 20-100 AC,39.04,AC,394600,0,394600,0,0,394600,367000,0,367000,0,0,367000,R1,RES/LTD,,,
9096,43-12-0-4-0,6767-99-5362,SNGL FAM SUB,5.26,AC,107100,0,107100,105900,0,213000,95500,0,95500,84100,0,179600,A2,AG/LTD,,,
9097,50-1-0-4-0,6726-06-1271,SNGL FAM SUB,0.64,AC,28600,0,28600,80200,8100,116900,28000,0,28000,66600,7200,101800,A1,AG/GEN,,,
9099,45-7-0-C-0,6797-68-4416,SNGL FAM SUB,2.16,AC,75600,0,75600,123600,200,199400,67500,0,67500,101600,200,169300,A2,AG/LTD,,,
9100,45-7-0-D-0,6797-68-0279,Roads,0.968,AC,0,0,0,0,0,0,0,0,0,0,0,0,A2,AG/LTD,,,
9101,17-1-0-75-0,6810-00-7162,SNGL FAM SUB,5.65,AC,66800,0,66800,175500,4300,246600,63600,0,63600,131500,4300,199400,A1,AG/GEN,,,
9102,57-1-0-49-A,7715-08-0330,SNGL FAM SUB,2.047,AC,181800,0,181800,166800,700,349300,158100,0,158100,139400,700,298200,A2,AG/LTD,,,
9103,41-2-0-15-0,6748-40-0915,SNGL FAM SUB,1.83,AC,62300,0,62300,142100,700,205100,57700,0,57700,119300,700,177700,A1,AG/GEN,,,
9104,45-7-0-A-0,6797-68-4724,SNGL FAM SUB,2.16,AC,75600,0,75600,52100,20000,147700,67500,0,67500,44100,18000,129600,A2,AG/LTD,,,
9105,45-1-0-121-A,6797-77-9654,SNGL FAM SUB,0.273,AC,19100,0,19100,35300,0,54400,17100,0,17100,28600,0,45700,A2,AG/LTD,,,
9107,29-3-0-9-A,6749-62-3186,SNGL FAM SUB,4.51,AC,87300,0,87300,117300,1100,205700,82900,0,82900,100100,1100,184100,A1,AG/GEN,,,
9109,32-10-1-22-0,6778-79-5311,SNGL FAM SUB,3.26,AC,99800,0,99800,224700,59000,383500,89300,0,89300,182900,50500,322700,A2,AG/LTD,,,
9110,33-1-0-3-B,6788-95-3513,SNGL FAM SUB,6.449,AC,71300,0,71300,30500,1700,103500,63700,0,63700,29500,1700,94900,A2,AG/LTD,,,
9111,67-10-0-18-0,7733-15-2452,SNGL FAM SUB,2.199,AC,340000,0,340000,1320000,87000,1747000,285000,0,285000,1050500,75900,1411400,R1,RES/LTD,,,
9112,43-6-0-1-A,6767-64-9059,SNGL FAM SUB,1.5,AC,70400,0,70400,153000,0,223400,62800,0,62800,69400,0,132200,A2,AG/LTD,,,
9114,58-1-0-23-A,7716-64-0100,SNGL FAM SUB,2.55,AC,91100,0,91100,137500,7400,236000,79100,0,79100,104100,7700,190900,A2,AG/LTD,,,
9115,18-6-0-2-0,6820-09-2340,SNGL FAM SUB,4.85,AC,61500,0,61500,175000,1000,237500,59900,0,59900,145200,1000,206100,A1,AG/GEN,,,
9116,32-1-0-45-0,6778-73-0473,SNGL FAM SUB,15,AC,199100,0,199100,0,0,199100,177500,0,177500,0,0,177500,A2,AG/LTD,,,
9118,39-1-0-68-A,6726-06-6690,SNGL FAM SUB,0.4,AC,2400,0,2400,0,0,2400,2400,0,2400,0,0,2400,A1,AG/GEN,,,
9120,50-1-0-3-B,6726-06-8454,SNGL FAM SUB,0.77,AC,34400,0,34400,168300,14500,217200,33600,0,33600,142700,14500,190800,A1,AG/GEN,,,
9122,50-1-0-1-0,6716-95-9828,SNGL FAM SUB,3.77,AC,55700,0,55700,79900,300,135900,54600,0,54600,68300,300,123200,A1,AG/GEN,,,
9123,32-1-0-41-0,6778-53-9143,SNGL FAM SUB,5,AC,112100,0,112100,0,0,112100,100000,0,100000,0,0,100000,A2,AG/LTD,,,
9124,32-1-0-42-0,6778-53-1466,AG 20-100 AC,26.366,AC,300600,0,300600,0,0,300600,268900,257700,11200,0,0,268900,A2,AG/LTD,,,
9125,32-1-0-43-0,6778-64-4152,AG 20-100 AC,32.855,AC,385800,0,385800,813900,0,1199700,343900,238900,105000,703100,0,1047000,A2,AG/LTD,,,
9126,32-1-0-44-0,6778-63-4084,SNGL FAM SUB,19.613,AC,252100,0,252100,0,0,252100,224700,216400,8300,0,0,224700,A2,AG/LTD,,,
9127,64-19-E-12-0,7733-47-0849,SNGL FAM SUB,0,AC,265000,0,265000,523600,0,788600,220000,0,220000,416400,0,636400,R1,RES/LTD,,,
9128,14-3-0-8-0,6851-39-8487,SNGL FAM SUB,3.2,AC,68200,0,68200,0,0,68200,66800,0,66800,0,0,66800,A1,AG/GEN,,,
9129,28-1-0-16-0,6728-88-7189,SNGL FAM SUB,12.25,AC,82400,0,82400,0,0,82400,80900,0,80900,0,0,80900,A1,AG/GEN,,,
9131,45-1-0-48-0,6796-48-2247,SNGL FAM SUB,8,AC,193300,0,193300,204500,19900,417700,172500,0,172500,165200,19700,357400,A2,AG/LTD,,,
9132,63-3-C-1-0,7714-91-3907,SNGL FAM SUB,0.69,AC,70000,0,70000,314900,15300,400200,60000,0,60000,264100,13500,337600,R1,RES/LTD,,,
9133,9-1-0-75-A,5892-85-4616,SNGL FAM SUB,1.28,AC,39800,0,39800,0,0,39800,39000,0,39000,0,0,39000,A1,AG/GEN,,,
9134,9-1-0-75-C,5892-85-4520,SNGL FAM SUB,1,AC,38800,0,38800,77700,3800,120300,38000,0,38000,66600,3800,108400,A1,AG/GEN,,,
9135,28-1-0-32-0,6738-17-1719,SNGL FAM SUB,1,AC,40000,0,40000,94000,1000,135000,39500,0,39500,78400,1000,118900,A1,AG/GEN,,,
9136,9-1-0-13-0,5892-73-2534,SNGL FAM SUB,2,,42400,0,42400,18600,0,61000,41500,0,41500,18400,0,59900,A1,AG/GEN,,,
9137,28-1-0-10-A,6729-90-9238,SNGL FAM SUB,1,AC,40000,0,40000,63300,400,103700,39500,0,39500,53400,400,93300,A1,AG/GEN,,,
9138,9-1-0-5-0,5892-75-9929,SNGL FAM SUB,3.27,AC,47000,0,47000,114300,5600,166900,45900,0,45900,102100,5600,153600,A1,AG/GEN,,,
9139,28-1-0-9-B,6729-71-5182,SNGL FAM SUB,6.22,AC,74800,0,74800,153100,800,228700,71900,0,71900,124800,800,197500,A1,AG/GEN,,,
9140,28-7-0-A-0,6729-94-8209,SNGL FAM SUB,8.8,AC,97600,0,97600,0,0,97600,97700,0,97700,0,0,97700,A1,AG/GEN,,,
9141,28-7-0-A-2,6729-94-3446,SNGL FAM SUB,1,AC,47000,0,47000,12300,800,60100,44700,0,44700,12700,800,58200,A1,AG/GEN,,,
9142,9-1-0-6-0,5892-75-9561,COMM & IND,8.273,AC,68700,0,68700,189300,70400,328400,66700,0,66700,182700,60000,309400,A1,AG/GEN,,,
9143,9-1-0-71-0,5892-73-6309,SNGL FAM SUB,2,AC,42400,0,42400,116700,500,159600,41500,0,41500,102400,500,144400,A1,AG/GEN,,,
9144,29-1-0-51-0,6748-69-9925,SNGL FAM SUB,1,AC,54000,0,54000,100600,500,155100,49900,0,49900,84400,500,134800,A1,AG/GEN,,,
9145,9-1-0-44-0,5892-40-8955,SNGL FAM SUB,14.871,AC,84700,0,84700,0,0,84700,79600,0,79600,0,0,79600,A1,AG/GEN,,,
9146,17-1-0-80-0,6810-02-0054,AG 20-100 AC,20,AC,72000,62800,9200,0,0,72000,70000,61500,8500,0,0,70000,A1,AG/GEN,,,
9147,30-5-0-A-0,6759-64-0456,SNGL FAM SUB,4.25,AC,85100,0,85100,0,0,85100,76900,0,76900,0,0,76900,A1,AG/GEN,,,
9148,27-1-0-17-0,6718-65-7475,SNGL FAM SUB,2.311,AC,46100,0,46100,0,0,46100,45200,0,45200,0,0,45200,A1,AG/GEN,,,
9149,28-1-0-9-A,6728-79-6680,AG 20-100 AC,20.655,AC,107900,0,107900,0,0,107900,107400,0,107400,0,0,107400,A1,AG/GEN,,,
9150,39-4-0-1-0,6726-47-7913,SNGL FAM SUB,4.56,AC,60500,0,60500,0,3100,63600,59400,0,59400,0,3400,62800,A1,AG/GEN,,,
9151,4-1-0-9-0,6803-44-0999,SNGL FAM SUB,2.482,AC,47200,0,47200,10000,0,57200,46200,0,46200,10000,0,56200,A1,AG/GEN,,,
9152,9-1-0-17-0,5892-63-6012,SNGL FAM SUB,0.77,AC,25400,0,25400,0,0,25400,24900,0,24900,0,0,24900,A1,AG/GEN,,,
9154,9-1-0-77-0,5892-96-7569,AG 20-100 AC,23.781,AC,90800,41100,49700,241200,17100,349100,89300,36500,52800,211400,17600,318300,A1,AG/GEN,,,
9155,9-1-0-77-D,5892-86-4621,SNGL FAM SUB,1,AC,38800,0,38800,155000,500,194300,38000,0,38000,139800,500,178300,A1,AG/GEN,,,
9157,9-1-0-12-0,5892-73-0703,SNGL FAM SUB,2.3,AC,43500,0,43500,103300,33400,180200,41900,0,41900,88700,28200,158800,A1,AG/GEN,,,
9158,9-1-0-36-0,5892-52-1554,AG 20-100 AC,31.2,AC,106100,51200,54900,68300,4300,178700,102200,49700,52500,60900,4300,167400,A1,AG/GEN,,,
9159,9-1-0-39-0,5892-42-0693,AG 20-100 AC,21.5,AC,43800,0,43800,0,0,43800,43000,0,43000,0,0,43000,A1,AG/GEN,,,
9161,27-1-0-70-A,6729-60-6774,AG 20-100 AC,22.67,AC,115600,0,115600,0,0,115600,113400,0,113400,0,0,113400,A1,AG/GEN,,,
9162,9-1-0-75-B,5892-85-3738,SNGL FAM SUB,1,AC,38800,0,38800,59400,1200,99400,38000,0,38000,52100,1200,91300,A1,AG/GEN,,,
9163,63-1-0-152-0,7714-89-6462,SNGL FAM SUB,4.7,AC,129700,0,129700,27200,200,157100,112700,0,112700,24200,200,137100,A2,AG/LTD,,,
9164,17-7-0-A-1,6801-50-1203,AG 20-100 AC,21,AC,110600,0,110600,0,0,110600,108000,0,108000,0,0,108000,A1,AG/GEN,,,
9165,30-1-0-80-0,6758-53-0079,SNGL FAM SUB,4.004,AC,130000,0,130000,529200,0,659200,112500,0,112500,487700,0,600200,A2,AG/LTD,,,
9166,9-1-0-77-A,6802-04-2539,SNGL FAM SUB,19,AC,44100,0,44100,0,0,44100,43000,0,43000,0,0,43000,A1,AG/GEN,,,
9167,27-1-0-21-0,6718-64-3506,SNGL FAM SUB,5,AC,41800,0,41800,0,0,41800,41000,0,41000,0,0,41000,A1,AG/GEN,,,
9168,17-1-0-27-0,6709-49-9554,SNGL FAM SUB,3.45,AC,52500,0,52500,0,0,52500,51500,0,51500,0,0,51500,A1,AG/GEN,,,
9169,39-4-0-2-0,6726-47-9828,SNGL FAM SUB,4.98,AC,63100,0,63100,0,0,63100,61900,0,61900,0,0,61900,A1,AG/GEN,,,
9170,20-1-0-92-B,6759-08-0218,SNGL FAM SUB,7.5,AC,109900,0,109900,120500,9700,240100,103900,0,103900,97200,7600,208700,A1,AG/GEN,,,
9171,20-1-0-92-C,6759-08-4425,SNGL FAM SUB,2.06,AC,64600,0,64600,11500,1000,77100,60400,0,60400,10900,1000,72300,A1,AG/GEN,,,
9172,9-1-0-77-C,5892-86-5265,SNGL FAM SUB,2.58,AC,44500,0,44500,115600,0,160100,43500,0,43500,95900,0,139400,A1,AG/GEN,,,
9173,9-1-0-65-0,5892-50-6967,SNGL FAM SUB,14.332,AC,73100,0,73100,0,0,73100,71300,0,71300,0,0,71300,A1,AG/GEN,,,
9174,45-1-0-43-A,6786-87-7726,SNGL FAM SUB,13,AC,272300,0,272300,969800,159300,1401400,243000,0,243000,799200,136800,1179000,A2,AG/LTD,,,
9175,17-1-0-42-A,6811-10-0518,SNGL FAM SUB,5,AC,61200,0,61200,206100,1100,268400,58000,0,58000,181400,900,240300,A1,AG/GEN,,,
9176,29-1-0-129-0,6748-98-0257,SNGL FAM SUB,2.755,AC,69600,0,69600,10000,200,79800,63600,0,63600,10000,200,73800,A1,AG/GEN,,,
9177,19-11-0-5-0,6831-50-2358,AG 20-100 AC,27.64,AC,209900,131400,78500,296500,28200,534600,201700,126600,75100,249900,24000,475600,A1,AG/GEN,,,
9178,19-11-0-7-0,6830-39-6873,SNGL FAM SUB,16.97,AC,143200,0,143200,268700,3400,415300,135700,0,135700,224000,3400,363100,A1,AG/GEN,,,
9179,46-12-0-4-0,7717-21-0099,SNGL FAM SUB,3.52,AC,138600,0,138600,335000,0,473600,123800,0,123800,286600,0,410400,A2,AG/LTD,,,
9180,13-16-0-A-2,6842-83-6302,SNGL FAM SUB,4.96,AC,62400,0,62400,177300,10500,250200,61300,0,61300,159600,11700,232600,A1,AG/GEN,,,
9182,66-2-0-A-0,7723-05-4758,SNGL FAM SUB,3,AC,388000,0,388000,322100,27400,737500,337400,0,337400,268700,26200,632300,A2,AG/LTD,,,
9184,13-15-0-2-0,6851-16-3230,SNGL FAM SUB,2.21,AC,55400,0,55400,12900,15300,83600,54300,0,54300,15400,13500,83200,A1,AG/GEN,,,
9185,66-2-0-A-1,7723-05-7460,SNGL FAM SUB,3.52,AC,201800,0,201800,265500,0,467300,175500,0,175500,232300,0,407800,A2,AG/LTD,,,
9186,43-20-0-18-0,6768-31-8513,SNGL FAM SUB,5.25,AC,110000,0,110000,232600,3100,345700,100000,0,100000,207900,3400,311300,A2,AG/LTD,,,
9188,26-1-0-66-A,6719-15-5628,SNGL FAM SUB,3,AC,32000,0,32000,0,0,32000,30000,0,30000,0,0,30000,A1,AG/GEN,,,
9189,20-1-0-88-A,6749-98-4087,SNGL FAM SUB,0.418,AC,2500,0,2500,0,0,2500,2600,0,2600,0,0,2600,A1,AG/GEN,,,
9219,46-11-0-A-1,7717-01-8793,SNGL FAM SUB,12.22,AC,318900,0,318900,0,0,318900,284800,0,284800,0,0,284800,A2,AG/LTD,,,
9220,46-11-0-A-2,7717-01-8129,SNGL FAM SUB,0.94,AC,9200,0,9200,0,0,9200,8200,0,8200,0,0,8200,A2,AG/LTD,,,
9221,46-11-0-A-3,7717-11-2703,SNGL FAM SUB,5,AC,214200,0,214200,479700,54800,748700,191200,0,191200,406900,46400,644500,A2,AG/LTD,,,
9222,46-11-0-A-4,7717-01-9183,SNGL FAM SUB,5.47,AC,200900,0,200900,0,0,200900,179600,0,179600,0,0,179600,A2,AG/LTD,,,
9223,31-15-0-1-0,6779-36-8781,SNGL FAM SUB,5.086,AC,108200,0,108200,0,0,108200,96400,0,96400,0,0,96400,A2,AG/LTD,,,
9224,31-15-0-2-0,6779-46-0489,SNGL FAM SUB,8.303,AC,143000,0,143000,92900,2500,238400,127300,0,127300,74300,2500,204100,A2,AG/LTD,,,
9225,31-15-0-3-0,6779-46-1160,SNGL FAM SUB,3.621,AC,94000,0,94000,199300,19400,312700,83900,0,83900,164800,16300,265000,A2,AG/LTD,,,
9226,31-15-0-5-0,6779-46-9039,SNGL FAM SUB,3.544,AC,100700,0,100700,96700,5100,202500,90000,0,90000,77200,5000,172200,A2,AG/LTD,,,
9227,31-15-0-6-0,6779-45-7725,SNGL FAM SUB,8.8,AC,157700,0,157700,257100,32600,447400,140700,0,140700,210500,32600,383800,A2,AG/LTD,,,
9228,31-15-0-7-0,6779-56-1257,SNGL FAM SUB,3.84,AC,105000,0,105000,105200,19400,229600,93800,0,93800,87300,17200,198300,A2,AG/LTD,,,
9229,31-15-0-8-0,6779-56-0636,SNGL FAM SUB,8.198,AC,146200,0,146200,280200,39100,465500,130600,0,130600,228300,32700,391600,A2,AG/LTD,,,
9232,47-21-0-6-0,7726-19-3880,COMM & IND,1.02,AC,302700,0,302700,0,0,302700,275200,0,275200,0,0,275200,B1,BUS/GEN,,,
9233,47-13-0-A-0,7727-11-3207,SNGL FAM SUB,3.66,AC,158600,0,158600,147300,0,305900,141700,0,141700,126200,0,267900,A2,AG/LTD,,,
9234,47-13-0-D-0,7727-11-6720,SNGL FAM SUB,9.74,AC,406900,0,406900,0,0,406900,363500,0,363500,0,0,363500,A2,AG/LTD,,,
9235,47-1-0-72-0,7726-09-9904,SNGL FAM SUB,1.96,AC,128300,0,128300,154300,2300,284900,114500,0,114500,128000,2300,244800,A2,AG/LTD,,,
9236,47-1-0-92-A,7727-10-5318,SNGL FAM SUB,17.213,AC,210200,0,210200,0,0,210200,187200,0,187200,0,0,187200,A2,AG/LTD,,,
9238,42-16-D-1-0,6757-93-2535,SNGL FAM SUB,1.9,AC,89700,0,89700,0,43000,132700,81400,0,81400,0,43000,124400,R1,RES/LTD,,,
9239,51-1-0-1-C,6726-75-9559,AG 20-100 AC,96.51,AC,364800,0,364800,0,500,365300,354700,0,354700,0,500,355200,A1,AG/GEN,,,
9240,33-4-0-8-0,6798-63-4411,SNGL FAM SUB,1.95,AC,89800,0,89800,293900,4200,387900,80200,0,80200,243500,3600,327300,A2,AG/LTD,,,
9241,66-3-0-2-0,7723-46-1519,SNGL FAM SUB,2.5,AC,390000,0,390000,0,0,390000,340000,0,340000,0,0,340000,R1,RES/LTD,,,
9242,66-3-0-3-0,7723-36-9385,SNGL FAM SUB,3.43,AC,390000,0,390000,413900,5000,808900,340000,0,340000,407500,5000,752500,R1,RES/LTD,,,
9243,62-18-0-11-0,7704-64-2393,SNGL FAM SUB,3.33,AC,226800,0,226800,532100,76800,835700,200300,0,200300,480900,65800,747000,A2,AG/LTD,,,
9244,41-2-0-17-A,6748-40-6693,MultiFamily,1.5,AC,59000,0,59000,184600,800,244400,54600,0,54600,153200,800,208600,A1,AG/GEN,,,
9245,62-19-0-B-4,7704-34-3536,AG 20-100 AC,23.53,AC,183300,0,183300,269400,38700,491400,161600,0,161600,238700,35200,435500,A2,AG/LTD,,,
9246,62-15-0-E-0,7704-13-7831,AG 20-100 AC,68.9,AC,35100,0,35100,0,0,35100,29600,0,29600,0,0,29600,A2,AG/LTD,,,
9247,6-1-0-30-A,6823-71-7210,COMM & IND,3.09,AC,145800,0,145800,0,0,145800,141500,0,141500,0,0,141500,B1,BUS/GEN,,,
9248,58-4-A-21-0,7716-46-8975,SNGL FAM SUB,0,AC,10000,0,10000,0,0,10000,9100,0,9100,0,0,9100,A2,AG/LTD,,,
9249,46-23-0-17-0,7707-83-9094,SNGL FAM SUB,6.3,AC,173300,0,173300,267600,0,440900,157500,0,157500,225200,0,382700,A2,AG/LTD,,,
9250,55-18-0-11-0,6776-96-3128,SNGL FAM SUB,5,AC,125300,0,125300,325500,43800,494600,111800,0,111800,268600,38100,418500,A2,AG/LTD,,,
9251,30-1-0-43-0,6758-37-7101,SNGL FAM SUB,7.83,AC,121000,0,121000,211300,44100,376400,114100,0,114100,178800,38600,331500,A2,AG/LTD,,,
9253,54-2-0-11-A,6776-12-5470,SNGL FAM SUB,0.4,AC,4000,0,4000,0,0,4000,3600,0,3600,0,0,3600,A2,AG/LTD,,,
9254,54-2-0-12-0,6776-12-7610,SNGL FAM SUB,3.729,AC,91700,0,91700,238800,5300,335800,81800,0,81800,197600,3700,283100,A2,AG/LTD,,,
9255,63-9-0-3-0,7724-13-3028,SNGL FAM SUB,0.631,AC,110000,0,110000,178700,3400,292100,95600,0,95600,155600,3000,254200,R3,RES/GEN,,,
9256,45-1-0-77-B,6797-70-3574,SNGL FAM SUB,2.81,AC,111300,0,111300,0,0,111300,99300,0,99300,0,0,99300,A2,AG/LTD,,,
9257,58-3-A-6-0,7726-16-3637,SNGL FAM SUB,0,AC,88000,0,88000,174400,3400,265800,80000,0,80000,150500,3400,233900,RN,RESIDEN,,,
9258,58-3-A-7-0,7726-16-4634,SNGL FAM SUB,0,AC,20100,0,20100,0,0,20100,18300,0,18300,0,0,18300,RN,RESIDEN,,,
9259,60-1-0-9-0,6784-46-3563,AG 20-100 AC,31.5,AC,107100,0,107100,0,0,107100,94500,0,94500,0,0,94500,A2,AG/LTD,,,
9260,58-18-E-4-0,7715-28-5813,SNGL FAM SUB,4.125,AC,480000,0,480000,806400,93000,1379400,440000,0,440000,779100,82700,1301800,A2,AG/LTD,,,
9261,26-5-0-A-0,6709-65-2019,SNGL FAM SUB,5.79,AC,46200,0,46200,0,0,46200,45300,0,45300,0,0,45300,A1,AG/GEN,,,
9264,55-18-0-12-0,6776-95-3901,SNGL FAM SUB,5,AC,125300,0,125300,329000,2500,456800,111800,0,111800,270100,2500,384400,A2,AG/LTD,,,
9265,55-18-0-13-0,6776-95-5611,SNGL FAM SUB,10,AC,199700,0,199700,293700,24200,517600,178700,0,178700,240800,20100,439600,A2,AG/LTD,,,
9266,62-4-E-5-0,7714-05-5030,SNGL FAM SUB,0,AC,115000,0,115000,283000,11600,409600,100000,0,100000,256800,11600,368400,R1,RES/LTD,,,
9267,46-23-0-25-0,7707-83-3454,SNGL FAM SUB,8,AC,173300,0,173300,207000,36200,416500,157500,0,157500,174600,32300,364400,A2,AG/LTD,,,
9268,6-6-0-4-0,6833-80-4855,SNGL FAM SUB,3.01,AC,59300,0,59300,222200,200,281700,58100,0,58100,193700,200,252000,A1,AG/GEN,,,
9269,33-4-0-11-0,6798-62-4728,SNGL FAM SUB,2.06,AC,91300,0,91300,181200,9800,282300,81500,0,81500,147800,9800,239100,A2,AG/LTD,,,
9270,33-4-0-28-0,6798-43-7680,SNGL FAM SUB,7.16,AC,161700,0,161700,274200,57200,493100,144300,0,144300,227900,54600,426800,A2,AG/LTD,,,
9278,15-5-0-6-0,5789-66-0977,SNGL FAM SUB,8.31,AC,68800,0,68800,0,0,68800,67200,0,67200,0,0,67200,A1,AG/GEN,,,
9279,24-2-0-6-A,5789-55-8290,SNGL FAM SUB,8.01,AC,20000,0,20000,0,0,20000,20000,0,20000,0,0,20000,A1,AG/GEN,,,
9280,45-18-0-9-0,6797-44-6923,SNGL FAM SUB,8.561,AC,240000,0,240000,480900,34000,754900,216000,0,216000,441900,9500,667400,A2,AG/LTD,,,
9281,38-7-0-C-2,6717-09-5189,SNGL FAM SUB,3.63,AC,53500,0,53500,128100,300,181900,52500,0,52500,109100,300,161900,A1,AG/GEN,,,
9282,57-11-0-6-0,7715-06-5231,SNGL FAM SUB,18.214,AC,714900,499400,215500,406500,45900,1167300,621300,434000,187300,344900,46400,1012600,A2,AG/LTD,,,
9283,67-2-D-23-0,7723-55-9700,SNGL FAM SUB,0,AC,184000,0,184000,251000,500,435500,160000,0,160000,211200,500,371700,R1,RES/LTD,,,
9284,46-22-0-A-0,7706-99-2536,SNGL FAM SUB,8.881,AC,320300,0,320300,379400,36600,736300,285700,0,285700,320200,36600,642500,A2,AG/LTD,,,
9285,62-20-B-1-0,7714-15-1353,SNGL FAM SUB,0,AC,115000,0,115000,290000,0,405000,100000,0,100000,267400,0,367400,R1,RES/LTD,,,
9286,2-3-0-6-0,6824-33-0667,SNGL FAM SUB,3.65,AC,49700,0,49700,366500,0,416200,48600,0,48600,318700,0,367300,A1,AG/GEN,,,
9287,2-3-0-7-0,6824-23-8860,SNGL FAM SUB,4.408,AC,53200,0,53200,368400,2000,423600,52000,0,52000,324400,2000,378400,A1,AG/GEN,,,
9288,2-3-0-37-0,6824-32-7955,SNGL FAM SUB,3.46,AC,48800,0,48800,254400,0,303200,47800,0,47800,215700,0,263500,A1,AG/GEN,,,
9289,4-2-0-19-0,6813-29-4929,SNGL FAM SUB,4.28,AC,57100,0,57100,281100,4500,342700,55900,0,55900,234700,3000,293600,A1,AG/GEN,,,
9290,4-2-0-21-0,6813-39-0791,SNGL FAM SUB,4.29,AC,57200,0,57200,251200,1500,309900,56000,0,56000,222500,1500,280000,A1,AG/GEN,,,
9291,4-2-0-26-0,6814-30-9636,SNGL FAM SUB,3.86,AC,54900,0,54900,235300,0,290200,53700,0,53700,201800,0,255500,A1,AG/GEN,,,
9293,42-1-0-63-0,6757-97-0281,SNGL FAM SUB,4.02,AC,102900,0,102900,387300,300,490500,91300,0,91300,321700,300,413300,R3,RES/GEN,,,
9302,63-1-0-92-T,7714-85-3361-9999,AG 20-100 AC,32.434,AC,649100,0,649100,0,9400,658500,626500,0,626500,0,8800,635300,A2,AG/LTD,,,
9314,9-1-0-50-0,5891-16-4202,AG > 100 AC,280.158,AC,574900,445700,129200,0,0,574900,560300,441200,119100,0,0,560300,A1,AG/GEN,,,
9315,9-1-0-51-0,5891-38-9763,AG > 100 AC,137.135,AC,314200,215000,99200,274200,58300,646700,306500,214200,92300,250800,50200,607500,A1,AG/GEN,,,
9319,15-1-0-9-0,5890-05-2803,AG > 100 AC,170.22,AC,366800,288300,78500,0,0,366800,360000,287700,72300,0,0,360000,A1,AG/GEN,,,
9320,14-3-0-1-0,6851-18-5754,SNGL FAM SUB,4.71,AC,78100,0,78100,139900,1200,219200,76500,0,76500,117400,1200,195100,A1,AG/GEN,,,
9321,14-3-0-2-0,6851-18-9846,SNGL FAM SUB,3.34,AC,69500,0,69500,0,0,69500,68100,0,68100,0,0,68100,A1,AG/GEN,,,
9322,14-3-0-3-0,6851-28-2954,SNGL FAM SUB,3.2,AC,68200,0,68200,92100,500,160800,66800,0,66800,77000,500,144300,A1,AG/GEN,,,
9323,32-1-0-3-0,6779-85-2968,SNGL FAM SUB,8.42,AC,148700,0,148700,37000,0,185700,132900,0,132900,30200,0,163100,A2,AG/LTD,,,
9324,27-1-0-70-0,6728-69-7647,SNGL FAM SUB,5.13,AC,31300,28900,2400,0,0,31300,30800,0,30800,0,0,30800,A1,AG/GEN,,,
9325,28-1-0-13-0,6728-98-1973,SNGL FAM SUB,19.05,AC,138700,0,138700,159900,2800,301400,133400,0,133400,132600,2900,268900,A1,AG/GEN,,,
9326,9-5-0-F-0,5892-44-7272,SNGL FAM SUB,4.25,AC,50500,0,50500,9800,0,60300,49400,0,49400,9700,0,59100,A1,AG/GEN,,,
9327,9-1-0-28-0,5892-45-4021,SNGL FAM SUB,3.19,AC,46700,0,46700,24800,0,71500,45700,0,45700,21600,0,67300,A1,AG/GEN,,,
9329,31-1-0-77-A,6779-41-7394,SNGL FAM SUB,2.009,AC,78600,0,78600,174800,59300,312700,70200,0,70200,142400,48600,261200,A2,AG/LTD,,,
9331,32-9-0-4-0,6779-61-3333,SNGL FAM SUB,6.99,AC,105900,0,105900,341700,0,447600,94400,0,94400,278700,0,373100,A2,AG/LTD,,,
9332,5-1-0-64-0,6823-38-4434,SNGL FAM SUB,6.87,AC,69600,0,69600,0,0,69600,68400,0,68400,0,0,68400,A1,AG/GEN,,,
9333,9-1-0-48-0,5892-20-6416,SNGL FAM SUB,2.596,AC,34800,33600,1200,0,0,34800,34100,33000,1100,0,0,34100,A1,AG/GEN,,,
9334,5-1-0-66-0,6823-39-3361,SNGL FAM SUB,16.5,AC,110800,0,110800,0,0,110800,108800,0,108800,0,0,108800,A1,AG/GEN,,,
9335,5-1-0-65-C,6823-28-3409,SNGL FAM SUB,2.4,AC,44400,0,44400,110000,0,154400,43700,0,43700,95700,0,139400,A1,AG/GEN,,,
9336,5-1-0-32-A,6813-93-1956,AG 20-100 AC,20.11,AC,116900,0,116900,0,0,116900,114700,0,114700,0,0,114700,A1,AG/GEN,,,
9337,5-1-0-65-0,6823-29-9201,SNGL FAM SUB,9.6,AC,83600,0,83600,0,0,83600,82000,0,82000,0,0,82000,A1,AG/GEN,,,
9338,5-1-0-64-A,6823-28-7014,SNGL FAM SUB,1,AC,39700,0,39700,2000,800,42500,39000,0,39000,2000,800,41800,A1,AG/GEN,,,
9339,5-9-0-1-0,6814-81-2722,SNGL FAM SUB,2.19,AC,45800,0,45800,0,0,45800,45000,0,45000,0,0,45000,A1,AG/GEN,,,
9340,5-9-0-4-A,6814-72-7344,SNGL FAM SUB,2.39,AC,46800,0,46800,0,0,46800,46000,0,46000,0,0,46000,A1,AG/GEN,,,
9341,5-9-0-3-0,6814-72-9092,SNGL FAM SUB,2.19,AC,45800,0,45800,0,0,45800,45000,0,45000,0,0,45000,A1,AG/GEN,,,
9342,5-9-0-4-0,6814-72-8168,SNGL FAM SUB,2,AC,44800,0,44800,209000,12600,266400,44000,0,44000,188900,12600,245500,A1,AG/GEN,,,
9343,6-1-0-9-B,6823-76-7043,SNGL FAM SUB,1,AC,35700,0,35700,60800,4800,101300,35100,0,35100,53400,5100,93600,A1,AG/GEN,,,
9344,5-1-0-3-0,6813-69-7991,SNGL FAM SUB,2.723,AC,48500,0,48500,153300,600,202400,47600,0,47600,127000,600,175200,A1,AG/GEN,,,
9345,31-8-0-1-0,6779-41-8002,SNGL FAM SUB,3.49,AC,100000,0,100000,21400,0,121400,89300,0,89300,17600,0,106900,A2,AG/LTD,,,
9346,38-10-0-1-0,6707-89-1635,SNGL FAM SUB,1,AC,38800,0,38800,92500,200,131500,38000,0,38000,79100,200,117300,A1,AG/GEN,,,
9347,5-1-0-64-B,6823-28-9195,SNGL FAM SUB,2,AC,44800,0,44800,29500,600,74900,44000,0,44000,32800,600,77400,A1,AG/GEN,,,
9348,5-1-0-12-0,6813-75-3661,SNGL FAM SUB,15,AC,104000,0,104000,50300,0,154300,102000,0,102000,44300,0,146300,A1,AG/GEN,,,
9349,5-1-0-35-0,6813-85-8130,AG 20-100 AC,40,AC,155000,0,155000,0,0,155000,152000,0,152000,0,0,152000,A1,AG/GEN,,,
9350,32-1-0-3-A,6779-85-2522,SNGL FAM SUB,1,AC,64100,0,64100,110800,1200,176100,57200,0,57200,90100,1300,148600,A2,AG/LTD,,,
9352,5-3-0-5-0,6823-29-0274,SNGL FAM SUB,3.25,AC,56800,0,56800,125100,4000,185900,55600,0,55600,106000,4000,165600,A1,AG/GEN,,,
9353,13-1-0-3-C,6842-75-3450,SNGL FAM SUB,8.1,AC,75000,0,75000,10100,0,85100,74500,0,74500,10100,0,84600,A1,AG/GEN,,,
9355,13-1-0-22-0,6841-65-7590,SNGL FAM SUB,3.1,AC,66300,0,66300,74000,9100,149400,56900,0,56900,62700,21700,141300,A1,AG/GEN,,,
9356,55-6-0-3-0,6785-26-6863,SNGL FAM SUB,2.72,AC,93800,0,93800,27400,0,121200,83800,0,83800,23300,0,107100,A2,AG/LTD,,,
9357,20-12-0-6-0,6840-98-0841,SNGL FAM SUB,10.3,AC,108700,0,108700,196100,14200,319000,101000,0,101000,193100,15100,309200,A1,AG/GEN,,,
9358,62-13-A-7-0,7714-05-5852,SNGL FAM SUB,0,AC,115000,0,115000,255600,2500,373100,100000,0,100000,216700,2500,319200,R1,RES/LTD,,,
9359,62-13-A-8-0,7714-05-6954,SNGL FAM SUB,0,AC,115000,0,115000,268400,9300,392700,100000,0,100000,227600,8600,336200,R1,RES/LTD,,,
9360,30-1-0-26-0,6759-20-7013,AG 20-100 AC,54.115,AC,263900,239000,24900,0,0,263900,256700,233700,23000,0,0,256700,A1A2,AG GEN/,,,
9361,15-1-0-32-B,5789-28-0190,SNGL FAM SUB,2,AC,33700,0,33700,0,0,33700,32000,0,32000,0,0,32000,A1,AG/GEN,,,
9362,42-14-0-B-0,6767-12-0400,COMM & IND,0.456,AC,74300,0,74300,197400,0,271700,71400,0,71400,185000,0,256400,B1,BUS/GEN,,,
9363,54-5-0-12-0,6766-62-3859,SNGL FAM SUB,6.035,AC,205400,0,205400,256700,22300,484400,191400,0,191400,238000,21400,450800,A2,AG/LTD,,,
9364,54-5-0-16-0,6766-64-4010,SNGL FAM SUB,5.341,AC,127400,0,127400,0,0,127400,105600,0,105600,0,0,105600,A2,AG/LTD,,,
9365,54-5-0-17-0,6766-63-0973,SNGL FAM SUB,5.114,AC,127400,0,127400,347100,4000,478500,118800,0,118800,313900,2900,435600,A2,AG/LTD,,,
9366,54-5-0-19-0,6766-54-9453,SNGL FAM SUB,5.096,AC,127400,0,127400,306600,0,434000,118800,0,118800,282600,0,401400,A2,AG/LTD,,,
9367,54-5-0-20-0,6766-64-4729,SNGL FAM SUB,5.076,AC,2300,0,2300,0,0,2300,2200,0,2200,0,0,2200,A2,AG/LTD,,,
9368,46-1-0-111-A,7707-96-2975,SNGL FAM SUB,16.03,AC,347700,0,347700,0,0,347700,310300,0,310300,0,0,310300,A2,AG/LTD,,,
9369,58-16-0-1-0,7726-05-4168,SNGL FAM SUB,0.593,AC,163800,0,163800,171200,900,335900,157500,0,157500,143700,900,302100,RN,RESIDEN,,,
9371,19-1-0-61-0,6830-80-7931,AG 20-100 AC,60.701,AC,263000,234700,28300,0,5500,268500,252500,226600,25900,0,5500,258000,A1,AG/GEN,,,
9372,19-1-0-58-0,6830-82-6517,SNGL FAM SUB,2.935,AC,72600,0,72600,211700,500,284800,70000,0,70000,181800,500,252300,A1,AG/GEN,,,
9373,18-1-0-51-0,6810-98-2534,SNGL FAM SUB,6,AC,68500,0,68500,117000,1700,187200,68000,0,68000,97000,1700,166700,A1,AG/GEN,,,
9374,18-1-0-64-0,6820-75-4779,AG 20-100 AC,94.447,AC,355100,311000,44100,0,0,355100,351200,311000,40200,0,0,351200,A1,AG/GEN,,,
9375,18-1-0-65-0,6820-64-9533,AG > 100 AC,111.777,AC,396600,305100,91500,34800,100,431500,391500,306300,85200,28300,100,419900,A1,AG/GEN,,,
9376,18-1-0-66-0,6820-54-1211,SNGL FAM SUB,9.64,AC,97400,93000,4400,0,0,97400,95000,90900,4100,0,0,95000,A1,AG/GEN,,,
9377,58-8-0-3-D,7726-00-4795,SNGL FAM SUB,5.89,AC,587200,0,587200,54000,2000,643200,206300,0,206300,151100,2000,359400,RPUD,RES/PUD,,,
9378,50-1-0-19-0,6725-59-5172,SNGL FAM SUB,3.07,AC,71100,0,71100,99900,500,171500,69600,0,69600,102900,500,173000,A1,AG/GEN,,,
9379,46-1-0-20-A,7707-05-4185,SNGL FAM SUB,1,AC,99000,0,99000,130900,6200,236100,88400,0,88400,108200,5500,202100,A2,AG/LTD,,,
9380,44-1-0-62-0,6786-48-6443,SNGL FAM SUB,2.46,AC,92100,0,92100,163800,0,255900,82300,0,82300,138400,0,220700,A2,AG/LTD,,,
9381,18-1-0-65-B,6820-64-0013,SNGL FAM SUB,8.034,AC,78800,0,78800,80500,3700,163000,80200,0,80200,67300,3700,151200,A1,AG/GEN,,,
9382,44-1-0-61-0,6786-39-8446,AG 20-100 AC,66.09,AC,896400,794300,102100,82800,40400,1019600,802400,712000,90400,69900,37000,909300,A2,AG/LTD,,,
9383,1-1-0-20-A,6804-87-0381,SNGL FAM SUB,1.224,AC,40800,0,40800,112300,6800,159900,40100,0,40100,97900,6800,144800,A1,AG/GEN,,,
9384,30-11-0-5-A,6758-22-3701,SNGL FAM SUB,1.49,AC,14800,0,14800,0,0,14800,15500,0,15500,0,0,15500,A2,AG/LTD,,,
9385,30-11-0-6-0,6758-22-3855,SNGL FAM SUB,3,AC,73600,0,73600,156000,0,229600,70700,0,70700,128600,0,199300,A2,AG/LTD,,,
9386,30-11-0-6-A,6758-22-4908,SNGL FAM SUB,1.5,AC,14900,0,14900,0,0,14900,15600,0,15600,0,0,15600,A2,AG/LTD,,,
9387,47-24-0-2-0,7718-51-1236,SNGL FAM SUB,4.6,AC,160200,0,160200,267200,3200,430600,143100,0,143100,225300,3200,371600,A2,AG/LTD,,,
9388,18-1-0-64-B,6820-65-2371,SNGL FAM SUB,5.26,AC,64800,0,64800,161300,2400,228500,63600,0,63600,131900,2400,197900,A1,AG/GEN,,,
9389,42-1-0-42-0,6767-02-6525,COMM & IND,0.65,AC,81200,0,81200,252700,0,333900,78100,0,78100,230800,0,308900,B1,BUS/GEN,,,
9390,42-15-0-1-0,6757-62-5418,SNGL FAM SUB,3.58,AC,92200,0,92200,0,0,92200,79400,0,79400,0,0,79400,A2,AG/LTD,,,
9391,42-15-0-2-0,6757-62-3248,SNGL FAM SUB,3.52,AC,91500,0,91500,0,0,91500,78800,0,78800,0,0,78800,A2,AG/LTD,,,
9392,42-1-0-13-0,6757-52-9572,SNGL FAM SUB,14.14,AC,231800,0,231800,781300,51400,1064500,206100,0,206100,668900,49300,924300,A2,AG/LTD,,,
9393,32-5-0-A-0,6778-86-0415,SNGL FAM SUB,3,AC,92900,0,92900,150600,11000,254500,83000,0,83000,124100,7900,215000,A2,AG/LTD,,,
9394,42-15-0-8-0,6757-61-3245,SNGL FAM SUB,3.65,AC,163600,0,163600,0,0,163600,142600,0,142600,0,0,142600,A2,AG/LTD,,,
9395,38-1-0-72-0,6707-94-9838,SNGL FAM SUB,9.462,AC,82000,0,82000,0,0,82000,83000,0,83000,0,0,83000,A1,AG/GEN,,,
9396,63-1-0-17-0,7714-37-5349,SNGL FAM SUB,6.213,AC,255300,0,255300,292700,5600,553600,222100,0,222100,248000,5600,475700,A2,AG/LTD,,,
9398,15-1-0-5-A,5880-57-1583,AG 20-100 AC,35,AC,75000,0,75000,0,0,75000,70000,55100,14900,0,0,70000,A1,AG/GEN,,,
9399,15-1-0-5-B,5880-58-9172,SNGL FAM SUB,15.879,AC,77600,0,77600,0,0,77600,77600,70900,6700,0,0,77600,A1,AG/GEN,,,
9400,62-20-E-2-0,7714-16-3002,SNGL FAM SUB,0,AC,115000,0,115000,307100,0,422100,100000,0,100000,279900,0,379900,R1,RES/LTD,,,
9417,15-1-0-1-0,5891-00-7710,AG > 100 AC,645,AC,1126400,829100,297300,0,0,1126400,1096500,822400,274100,0,0,1096500,A1,AG/GEN,,,
9418,13-1-0-1-D,6842-43-8610,AG > 100 AC,306.26,AC,783300,642100,141200,0,0,783300,767900,637700,130200,0,0,767900,A1,AG/GEN,,,
9419,13-1-0-1-G,6842-31-1799,SNGL FAM SUB,0.3,AC,800,700,100,0,0,800,800,700,100,0,0,800,A1,AG/GEN,,,
9420,13-1-0-7-0,6842-61-2850,AG 20-100 AC,38.54,AC,139000,121200,17800,0,0,139000,136300,119900,16400,0,0,136300,A1,AG/GEN,,,
9421,15-1-0-21-A,5880-62-2043,AG > 100 AC,100,AC,225700,179600,46100,0,0,225700,220500,178000,42500,0,0,220500,A1,AG/GEN,,,
9422,1-4-0-2-0,6814-12-7953,AG 20-100 AC,40.37,AC,140000,121400,18600,0,0,140000,137300,120100,17200,0,0,137300,A1,AG/GEN,,,
9423,13-1-0-1-F,6842-31-6498,SNGL FAM SUB,2.08,AC,5400,4400,1000,0,0,5400,5300,4400,900,0,0,5300,A1,AG/GEN,,,
9424,13-1-0-28-0,6842-81-8143,AG 20-100 AC,41.907,AC,236200,0,236200,0,0,236200,231500,213700,17800,0,0,231500,A1,AG/GEN,,,
9425,30-1-0-110-0,6759-86-1719,AG 20-100 AC,50.75,AC,264300,240900,23400,0,0,264300,238500,216900,21600,0,0,238500,A2,AG/LTD,,,
9427,22-1-0-11-0,6769-68-9861,SNGL FAM SUB,2.11,AC,74700,0,74700,128400,0,203100,68400,0,68400,106500,0,174900,A2,AG/LTD,,,
9428,55-1-0-1-B,6776-84-7732,SNGL FAM SUB,8,AC,170900,0,170900,459100,0,630000,152900,0,152900,374200,0,527100,A2,AG/LTD,,,
9429,54-2-0-11-0,6776-12-5251,SNGL FAM SUB,3.4,AC,88300,0,88300,372000,14000,474300,78800,0,78800,303400,14000,396200,A2,AG/LTD,,,
9430,62-16-0-B-3,7704-54-5347,AG 20-100 AC,20.99,AC,626600,446600,180000,709800,0,1336400,533800,0,533800,631200,0,1165000,A2,AG/LTD,,,
9431,15-1-0-18-0,5880-56-7634,AG 20-100 AC,77.427,AC,187800,105700,82100,15000,48600,251400,184700,106100,78600,15000,44100,243800,A1,AG/GEN,,,
9432,38-1-0-4-A,6708-81-3487,AG 20-100 AC,26.72,AC,157100,0,157100,0,0,157100,153700,0,153700,0,0,153700,A1,AG/GEN,,,
9434,45-16-0-21-0,6798-42-7224,SNGL FAM SUB,4.91,AC,119200,0,119200,352800,0,472000,106300,0,106300,289100,0,395400,A2,AG/LTD,,,
9435,39-1-0-38-0,6727-03-0564,SNGL FAM SUB,1.76,AC,43100,0,43100,171500,6300,220900,42200,0,42200,106800,3100,152100,A1,AG/GEN,,,
9436,12-1-0-36-0,6831-23-4809,SNGL FAM SUB,3.403,AC,62600,0,62600,266400,0,329000,58200,0,58200,226300,0,284500,A1,AG/GEN,,,
9437,44-16-0-8-0,6787-39-4834,SNGL FAM SUB,3.26,AC,129000,0,129000,244100,25200,398300,115000,0,115000,221900,24700,361600,A2,AG/LTD,,,
9438,43-1-0-56-0,6768-80-6074,AG 20-100 AC,25.75,AC,352300,259100,93200,175100,37600,565000,315100,232100,83000,148600,32700,496400,A2,AG/LTD,,,
9439,18-1-0-38-0,6820-62-9862,AG 20-100 AC,60,AC,155500,0,155500,0,500,156000,150000,0,150000,0,500,150500,A1,AG/GEN,,,
9440,18-1-0-36-0,6820-72-1434,SNGL FAM SUB,12.5,AC,72100,0,72100,0,0,72100,72800,0,72800,0,0,72800,A1,AG/GEN,,,
9441,18-1-0-37-0,6820-62-9574,SNGL FAM SUB,17.57,AC,95100,0,95100,0,0,95100,100600,0,100600,0,0,100600,A1,AG/GEN,,,
9442,43-15-0-4-0,6778-00-2521,SNGL FAM SUB,3.83,AC,92000,0,92000,126500,6300,224800,83600,0,83600,111900,6300,201800,A2,AG/LTD,,,
9443,43-1-0-8-0,6767-78-9887,SNGL FAM SUB,10.04,AC,195700,0,195700,645500,27900,869100,175000,0,175000,548800,25000,748800,A2,AG/LTD,,,
9444,28-1-0-36-0,6738-07-4009,SNGL FAM SUB,1.84,AC,46700,0,46700,122000,0,168700,45200,0,45200,104900,0,150100,A1,AG/GEN,,,
9445,18-1-0-20-0,6719-58-9078,SNGL FAM SUB,10.12,AC,89700,0,89700,173100,6400,269200,88200,0,88200,142000,5400,235600,A1,AG/GEN,,,
9446,28-1-0-86-0,6739-23-9783,SNGL FAM SUB,6.5,AC,83600,0,83600,92500,3600,179700,82100,0,82100,77100,3600,162800,A1,AG/GEN,,,
9447,17-1-0-10-0,6800-41-8802,AG > 100 AC,138.92,AC,453000,340300,112700,514800,32400,1000200,451000,322300,128700,481100,28400,960500,A1,AG/GEN,,,
9448,12-1-0-41-0,6831-14-2816,SNGL FAM SUB,6.954,AC,89300,0,89300,18000,500,107800,85900,0,85900,18000,500,104400,A1,AG/GEN,,,
9449,12-1-0-43-0,6831-15-9205,AG 20-100 AC,21,AC,101900,0,101900,0,0,101900,98700,0,98700,0,0,98700,A1,AG/GEN,,,
9450,43-1-0-11-0,6767-77-0460,AG 20-100 AC,26.285,AC,358300,221700,136600,184600,1500,544400,320500,198100,122400,150300,8600,479400,A2,AG/LTD,,,
9451,43-1-0-9-0,6767-77-9886,SNGL FAM SUB,2.5,AC,91700,0,91700,176400,63800,331900,82000,0,82000,144700,56100,282800,A2,AG/LTD,,,
9455,28-1-0-36-B,6738-06-5704,SNGL FAM SUB,3.03,AC,53200,0,53200,176400,33300,262900,52100,0,52100,151500,28900,232500,A1,AG/GEN,,,
9456,28-1-0-36-C,6738-05-3735,SNGL FAM SUB,19.98,AC,130800,0,130800,0,0,130800,128700,0,128700,0,0,128700,A1,AG/GEN,,,
9457,12-1-0-41-A,6831-24-3398,SNGL FAM SUB,7.693,AC,94300,0,94300,74100,4500,172900,91700,0,91700,61400,4500,157600,A1,AG/GEN,,,
9458,12-1-0-41-E,6831-34-2066,SNGL FAM SUB,3.147,AC,61500,0,61500,243300,56300,361100,59600,0,59600,203800,46700,310100,A1,AG/GEN,,,
9459,28-1-0-87-B,6739-33-0188,SNGL FAM SUB,11.78,AC,113700,0,113700,205600,0,319300,124600,0,124600,170500,0,295100,A1,AG/GEN,,,
9460,67-2-E-4-0,7723-65-2574,SNGL FAM SUB,0,AC,184000,0,184000,324000,45300,553300,160000,0,160000,276700,42900,479600,R1,RES/LTD,,,
9461,56-1-0-45-D,6796-20-4867,SNGL FAM SUB,9.09,AC,192000,187500,4500,0,0,192000,166900,163000,3900,0,0,166900,A2,AG/LTD,,,
9462,56-1-0-45-C,6796-21-9000,SNGL FAM SUB,12,AC,234900,229000,5900,0,0,234900,204300,199200,5100,0,0,204300,A2,AG/LTD,,,
9463,56-1-0-45-A,6796-41-3543,SNGL FAM SUB,18.2,AC,341800,211400,130400,216000,0,557800,297200,183800,113400,185800,0,483000,A2,AG/LTD,,,
9464,56-1-0-45-B,6796-42-1830,SNGL FAM SUB,1.815,AC,7700,0,7700,0,0,7700,6900,0,6900,0,0,6900,A2,AG/LTD,,,
9465,56-11-0-A-0,6796-21-6541,SNGL FAM SUB,10.41,AC,264500,259400,5100,0,0,264500,230100,225600,4500,0,0,230100,A2,AG/LTD,,,
9466,56-11-0-B-0,6796-31-7051,SNGL FAM SUB,11.75,AC,213600,207800,5800,0,0,213600,185700,180700,5000,0,0,185700,A2,AG/LTD,,,
9467,56-11-0-C-0,6796-31-4680,SNGL FAM SUB,12.89,AC,340700,196800,143900,299600,92800,733100,296200,171300,124900,259600,87900,643700,A2,AG/LTD,,,
9468,5-3-0-7-0,6823-29-2662,SNGL FAM SUB,3.29,AC,57000,0,57000,369100,0,426100,55900,0,55900,320300,0,376200,A1,AG/GEN,,,
9469,26-7-0-2-0,6708-94-6357,SNGL FAM SUB,3,AC,50000,0,50000,288900,9700,348600,49000,0,49000,247300,4900,301200,A1,AG/GEN,,,
9470,11-8-0-2-0,6821-26-1504,SNGL FAM SUB,5,AC,63600,0,63600,10000,4300,77900,63000,0,63000,9900,3800,76700,A1,AG/GEN,,,
9471,9-1-0-46-A,5892-30-9474,SNGL FAM SUB,1,AC,38800,0,38800,80700,15200,134700,38000,0,38000,70500,13100,121600,A1,AG/GEN,,,
9472,6-1-0-47-0,6832-17-9872,SNGL FAM SUB,3.73,AC,62600,0,62600,125200,1500,189300,60800,0,60800,109200,1500,171500,A1,AG/GEN,,,
9473,67-10-0-12-0,7733-05-6014,SNGL FAM SUB,3.5,AC,340000,0,340000,2717800,76800,3134600,285000,0,285000,1442900,44000,1771900,R1,RES/LTD,,,
9474,45-1-0-23-0,6788-80-9223,SNGL FAM SUB,1.44,AC,23600,0,23600,0,0,23600,21100,0,21100,0,0,21100,A2,AG/LTD,,,
9475,29-1-0-4-0,6749-35-1111,SNGL FAM SUB,2,AC,20800,0,20800,0,0,20800,21200,0,21200,0,0,21200,A1,AG/GEN,,,
9476,29-1-0-5-0,6749-35-2135,SNGL FAM SUB,3,AC,29400,0,29400,0,0,29400,31200,0,31200,0,0,31200,A1,AG/GEN,,,
9477,29-1-0-6-0,6749-35-2045,SNGL FAM SUB,5,AC,45600,0,45600,0,0,45600,49100,0,49100,0,0,49100,A1,AG/GEN,,,
9478,29-1-0-7-0,6749-25-5412,SNGL FAM SUB,6,AC,53200,0,53200,0,0,53200,56900,0,56900,0,0,56900,A1,AG/GEN,,,
9479,12-1-0-34-J,6831-04-4168,SNGL FAM SUB,1.02,AC,40200,0,40200,109500,6900,156600,39700,0,39700,92500,6900,139100,A1,AG/GEN,,,
9480,5-5-0-E-0,6823-56-1640,SNGL FAM SUB,4,AC,55000,0,55000,27800,6000,88800,54000,0,54000,31200,5200,90400,A1,AG/GEN,,,
9481,20-1-0-25-B,6840-21-8568,SNGL FAM SUB,2,AC,63800,0,63800,165000,1000,229800,60300,0,60300,136500,1000,197800,A1,AG/GEN,,,
9482,13-1-0-39-A,6841-94-2764,SNGL FAM SUB,1.87,AC,57400,0,57400,163900,2000,223300,56400,0,56400,141900,2000,200300,A1,AG/GEN,,,
9483,13-1-0-37-A,6841-94-9903,SNGL FAM SUB,3.06,AC,62800,0,62800,96600,400,159800,61500,0,61500,84200,400,146100,A1,AG/GEN,,,
9484,28-1-0-58-B,6738-18-4806,SNGL FAM SUB,1,AC,40000,0,40000,91200,900,132100,39500,0,39500,71200,900,111600,A1,AG/GEN,,,
9485,30-1-0-64-0,6759-53-9450,SNGL FAM SUB,1.03,AC,54400,0,54400,24500,0,78900,50200,0,50200,26300,0,76500,A2,AG/LTD,,,
9486,30-6-0-1-0,6759-53-4969,SNGL FAM SUB,1.5,AC,59000,0,59000,500,0,59500,55100,0,55100,500,0,55600,A2,AG/LTD,,,
9487,5-5-0-B-0,6823-47-7853,SNGL FAM SUB,9.732,AC,80000,0,80000,215500,2800,298300,78600,0,78600,186500,3100,268200,A1,AG/GEN,,,
9489,12-1-0-70-A,6831-53-3056,SNGL FAM SUB,1.42,AC,51100,0,51100,89700,7800,148600,48000,0,48000,74700,8000,130700,A1,AG/GEN,,,
9490,58-4-A-6-0,7716-57-2102,SNGL FAM SUB,0,AC,20100,0,20100,0,0,20100,18300,0,18300,0,0,18300,A2,AG/LTD,,,
9491,12-14-0-E-1,6831-07-2938,SNGL FAM SUB,1.18,AC,41400,0,41400,84300,400,126100,40900,0,40900,67600,400,108900,A1,AG/GEN,,,
9492,12-14-0-E-2,6821-88-7283,SNGL FAM SUB,4.9,AC,56400,0,56400,0,0,56400,56100,0,56100,0,0,56100,A1,AG/GEN,,,
9494,28-1-0-71-B,6739-05-2990,SNGL FAM SUB,1,AC,47000,0,47000,72600,400,120000,44700,0,44700,60300,400,105400,A1,AG/GEN,,,
9495,20-1-0-41-0,6840-33-8063,SNGL FAM SUB,4.1,AC,76100,0,76100,27700,0,103800,70400,0,70400,22700,0,93100,A1,AG/GEN,,,
9496,28-1-0-58-D,6738-19-4116,SNGL FAM SUB,1,AC,40000,0,40000,81200,0,121200,39500,0,39500,67500,0,107000,A1,AG/GEN,,,
9497,12-1-0-72-0,6831-52-6731,SNGL FAM SUB,4.27,AC,71500,0,71500,84300,3000,158800,68600,0,68600,70500,3000,142100,A1,AG/GEN,,,
9498,28-1-0-6-0,6729-73-4716,AG 20-100 AC,24.84,AC,176200,0,176200,0,0,176200,167200,0,167200,0,0,167200,A1,AG/GEN,,,
9499,16-1-0-22-0,5890-33-5981,SNGL FAM SUB,8,AC,64000,0,64000,47300,600,111900,62500,0,62500,43600,600,106700,A1,AG/GEN,,,
9500,12-1-0-72-A,6831-52-9604,SNGL FAM SUB,2.5,AC,61600,0,61600,100500,200,162300,56400,0,56400,83400,200,140000,A1,AG/GEN,,,
9501,5-5-0-A-0,6823-47-3706,SNGL FAM SUB,14.492,AC,55900,0,55900,0,0,55900,54900,0,54900,0,0,54900,A1,AG/GEN,,,
9502,28-1-0-95-0,6738-27-4055,SNGL FAM SUB,2.404,AC,59800,0,59800,291600,0,351400,58400,0,58400,226300,0,284700,A1,AG/GEN,,,
9503,67-2-D-14-0,7723-54-9355,SNGL FAM SUB,0,AC,184000,0,184000,355600,2500,542100,160000,0,160000,300500,2500,463000,R1,RES/LTD,,,
9504,46-23-0-20-0,7707-94-1029,SNGL FAM SUB,4.039,AC,179900,0,179900,202000,45100,427000,163500,0,163500,169000,37900,370400,A2,AG/LTD,,,
9505,67-13-B-13-0,7733-27-9024,SNGL FAM SUB,0,AC,265000,0,265000,430700,0,695700,220000,0,220000,384400,0,604400,R1,RES/LTD,,,
9506,9-1-0-24-0,5892-64-2462,SNGL FAM SUB,13,AC,61100,0,61100,0,0,61100,58500,0,58500,0,0,58500,A1,AG/GEN,,,
9507,57-1-0-54-0,7706-90-7475,SNGL FAM SUB,3.188,AC,254600,0,254600,0,0,254600,221400,0,221400,0,0,221400,A2,AG/LTD,,,
9508,67-2-D-15-0,7723-64-0419,SNGL FAM SUB,0,AC,184000,0,184000,414200,26900,625100,160000,0,160000,345500,22800,528300,R1,RES/LTD,,,
9509,46-1-0-16-0,7707-15-6160,Place of Worship,10,AC,329000,0,329000,1617800,128700,2075500,294100,0,294100,1540600,89400,1924100,A2,AG/LTD,,,
9510,46-10-0-D-0,7707-25-0752,SNGL FAM SUB,5.38,AC,196200,0,196200,0,0,196200,175100,0,175100,0,0,175100,A2,AG/LTD,,,
9511,46-1-0-6-0,7707-27-5615,AG 20-100 AC,31.55,AC,479100,463600,15500,0,0,479100,427500,414000,13500,0,0,427500,A2,AG/LTD,,,
9512,46-1-0-31-0,7707-23-9604,SNGL FAM SUB,5.066,AC,191700,0,191700,85000,500,277200,171300,0,171300,72100,500,243900,A2RR,AG& RUR,,,
9514,46-1-0-15-0,7707-25-8469,SNGL FAM SUB,1.788,AC,105800,0,105800,163500,1100,270400,94500,0,94500,135700,1100,231300,A2,AG/LTD,,,
9516,57-1-0-42-0,7705-84-9503,AG 20-100 AC,34.36,AC,201500,0,201500,240300,10000,451800,175200,0,175200,204200,10000,389400,A2,AG/LTD,,,
9518,62-9-0-6-0,7715-10-2075,SNGL FAM SUB,5.65,AC,318900,0,318900,355000,0,673900,277300,0,277300,327200,0,604500,A2,AG/LTD,,,
9519,47-17-0-A-8,7717-39-0004,SNGL FAM SUB,4.76,AC,162900,0,162900,235000,27700,425600,145600,0,145600,198400,22800,366800,A2,AG/LTD,,,
9520,2-3-0-22-0,6824-23-8104,SNGL FAM SUB,3.51,AC,50900,0,50900,281400,2700,335000,49800,0,49800,239900,1900,291600,A1,AG/GEN,,,
9521,2-3-0-24-0,6824-22-4749,SNGL FAM SUB,4.35,AC,52900,0,52900,175000,1500,229400,51800,0,51800,147500,1500,200800,A1,AG/GEN,,,
9522,54-1-0-2-A,6766-35-9494,AG 20-100 AC,24.05,AC,493300,394600,98700,297200,500,791000,440200,352100,88100,246700,500,687400,A2,AG/LTD,,,
9523,4-1-0-8-0,6803-44-3900,SNGL FAM SUB,3.044,AC,50500,0,50500,137200,1200,188900,49200,0,49200,118200,1200,168600,A1,AG/GEN,,,
9525,17-1-0-37-0,6800-88-5361,AG 20-100 AC,58.34,AC,170900,30500,140400,268400,117200,556500,170700,46500,124200,225900,117400,514000,A1,AG/GEN,,,
9526,19-10-0-C-0,6820-93-9485,SNGL FAM SUB,4.49,AC,70700,0,70700,7000,500,78200,64600,0,64600,6600,500,71700,A1,AG/GEN,,,
9527,68-1-0-3-0,7733-85-7860,SNGL FAM SUB,0.7,AC,4800,0,4800,0,0,4800,4100,0,4100,0,0,4100,A2,AG/LTD,,,
9528,68-1-0-2-C,7733-85-8386,SNGL FAM SUB,2,AC,13600,0,13600,0,0,13600,11800,0,11800,0,0,11800,A2,AG/LTD,,,
9529,19-1-0-11-0,6820-84-9551,AG > 100 AC,128.9,AC,611300,484200,127100,0,5300,616600,584500,464800,119700,0,4800,589300,A1,AG/GEN,,,
9532,55-15-0-4-0,6785-67-9579,SNGL FAM SUB,3.46,AC,121600,0,121600,250700,0,372300,108500,0,108500,204200,0,312700,A2,AG/LTD,,,
9533,16-1-0-26-0,5890-33-5459,SNGL FAM SUB,1.99,AC,32700,0,32700,0,0,32700,31500,0,31500,0,0,31500,A1,AG/GEN,,,
9535,16-1-0-25-0,5890-33-8686,SNGL FAM SUB,2.58,AC,38700,0,38700,59400,2000,100100,38000,0,38000,50600,2000,90600,A1,AG/GEN,,,
9536,38-1-0-87-0,6707-85-8074,SNGL FAM SUB,9,AC,60200,0,60200,0,0,60200,59000,0,59000,0,0,59000,A1,AG/GEN,,,
9537,4-1-0-48-A,6803-96-7116,SNGL FAM SUB,10,AC,85600,0,85600,322100,4400,412100,84000,0,84000,287800,4400,376200,A1,AG/GEN,,,
9538,4-1-0-48-D,6803-96-3459,SNGL FAM SUB,4.03,AC,55200,0,55200,8600,10500,74300,54200,0,54200,8500,9400,72100,A1,AG/GEN,,,
9539,9-1-0-64-0,5892-61-6202,SNGL FAM SUB,15.72,AC,77500,0,77500,245000,2400,324900,74800,0,74800,208600,3600,287000,A1,AG/GEN,,,
9541,29-1-0-88-0,6749-86-8501,SNGL FAM SUB,1.24,AC,56400,0,56400,0,0,56400,52300,0,52300,0,0,52300,A1,AG/GEN,,,
9542,29-1-0-88-A,6749-86-9306,SNGL FAM SUB,1.65,AC,60500,0,60500,271400,1300,333200,56300,0,56300,223900,1300,281500,A1,AG/GEN,,,
9543,55-1-0-6-0,6786-15-0180,SNGL FAM SUB,16.5,AC,239700,0,239700,0,0,239700,214200,0,214200,0,0,214200,A2,AG/LTD,,,
9544,63-26-0-C-0,7714-92-9129,SNGL FAM SUB,1.28,AC,37900,0,37900,0,0,37900,32900,0,32900,0,0,32900,R1,RES/LTD,,,
9545,63-26-0-D-0,7724-02-0035,SNGL FAM SUB,1.28,AC,37900,0,37900,0,0,37900,32900,0,32900,0,0,32900,R1,RES/LTD,,,
9546,67-7-0-1-A,7723-56-7952,SNGL FAM SUB,0.8,AC,140900,140500,400,0,0,140900,122500,122200,300,0,0,122500,R1,RES/LTD,,,
9547,67-8-0-1-0,7723-57-4016,SNGL FAM SUB,2.282,AC,224000,222800,1200,0,0,224000,194800,193800,1000,0,0,194800,R1,RES/LTD,,,
9548,67-8-0-2-0,7723-57-6013,SNGL FAM SUB,2.515,AC,232800,231600,1200,0,0,232800,202300,201200,1100,0,0,202300,R1,RES/LTD,,,
9549,67-8-0-3-0,7723-57-7270,SNGL FAM SUB,0.46,AC,97200,0,97200,174900,0,272100,84500,0,84500,151400,0,235900,R1,RES/LTD,,,
9550,26-1-0-31-0,6708-72-2925,SNGL FAM SUB,10,AC,51000,46400,4600,0,0,51000,50000,45700,4300,0,0,50000,A1,AG/GEN,,,
9551,63-26-0-F-0,7724-01-2747,SNGL FAM SUB,1.28,AC,37900,0,37900,0,0,37900,32900,0,32900,0,0,32900,R1,RES/LTD,,,
9552,64-1-0-30-A,7723-57-7666,SNGL FAM SUB,18.43,AC,689300,680700,8600,0,0,689300,599000,591200,7800,0,0,599000,R1,RES/LTD,,,
9553,54-4-0-10-0,6776-53-6728,SNGL FAM SUB,9.537,AC,156300,0,156300,238200,12300,406800,139400,0,139400,202700,12300,354400,A2,AG/LTD,,,
9554,26-1-0-46-0,6719-21-0240,COMM & IND,10.48,AC,136200,0,136200,94900,48400,279500,132000,0,132000,93200,47100,272300,A1B1,AG GEN/,,,
9555,30-3-0-C-0,6768-39-4726,SNGL FAM SUB,2.044,AC,73900,0,73900,213400,800,288100,67600,0,67600,181500,800,249900,A2,AG/LTD,,,
9556,68-1-0-4-0,7733-86-6047,SNGL FAM SUB,1,AC,6800,0,6800,0,0,6800,5900,0,5900,0,0,5900,A2,AG/LTD,,,
9559,42-6-0-5-A,6767-03-9498,COMM & IND,0.31,AC,62100,0,62100,218400,0,280500,59700,0,59700,201900,0,261600,B1,BUS/GEN,,,
9560,37-1-0-4-0,6706-19-6879,COMM & IND,5.5,AC,73900,0,73900,0,0,73900,71900,0,71900,0,0,71900,M2,INDUS/G,,,
9561,55-1-0-67-0,6786-63-5432,SNGL FAM SUB,1.56,AC,79300,0,79300,148100,200,227600,70800,0,70800,120500,200,191500,A2,AG/LTD,,,
9562,3-1-0-7-0,5892-97-7796,AG 20-100 AC,25.231,AC,91300,0,91300,0,0,91300,90800,0,90800,0,0,90800,A1,AG/GEN,,,
9563,29-1-0-15-0,6749-23-5034,SNGL FAM SUB,1.99,AC,55900,54900,1000,0,0,55900,52400,51500,900,0,0,52400,A1,AG/GEN,,,
9564,29-1-0-9-0,6749-23-6282,SNGL FAM SUB,2,AC,67800,66800,1000,0,0,67800,63700,62800,900,0,0,63700,A1,AG/GEN,,,
9565,29-1-0-14-0,6749-24-1253,AG 20-100 AC,52.58,AC,407300,334300,73000,200100,6200,613600,402100,328500,73600,171000,6200,579300,A1,AG/GEN,,,
9567,64-12-C-4-0,7724-60-0138,SNGL FAM SUB,0,AC,134800,0,134800,368700,9800,513300,117300,0,117300,319000,8600,444900,R1,RES/LTD,,,
9568,26-1-0-35-C,6718-03-3732,SNGL FAM SUB,4.83,AC,60200,0,60200,135500,1300,197000,59100,0,59100,117600,1300,178000,A1,AG/GEN,,,
9569,46-27-B-3-0,7707-86-3941,SNGL FAM SUB,2,AC,165000,0,165000,300200,1500,466700,150000,0,150000,254600,1500,406100,RR,RES/RUR,,,
9571,46-27-A-1-0,7707-87-8339,SNGL FAM SUB,2.006,AC,165000,0,165000,297400,31000,493400,150000,0,150000,248700,0,398700,RR,RES/RUR,,,
9572,46-27-A-2-0,7707-87-8141,SNGL FAM SUB,2.109,AC,165000,0,165000,352400,37300,554700,150000,0,150000,296000,30400,476400,RR,RES/RUR,,,
9573,46-27-A-3-0,7707-86-8827,SNGL FAM SUB,2,AC,165000,0,165000,339900,29500,534400,150000,0,150000,286200,24200,460400,RR,RES/RUR,,,
9574,46-27-A-4-0,7707-86-8607,SNGL FAM SUB,2.24,AC,165000,0,165000,295400,1400,461800,150000,0,150000,249400,1400,400800,RR,RES/RUR,,,
9575,46-27-A-5-0,7707-86-7487,SNGL FAM SUB,2.525,AC,165000,0,165000,374400,28100,567500,150000,0,150000,315300,24200,489500,RR,RES/RUR,,,
9576,46-27-A-7-0,7707-86-7049,SNGL FAM SUB,2.802,AC,165000,0,165000,326800,46200,538000,150000,0,150000,273600,44300,467900,RR,RES/RUR,,,
9577,46-27-A-9-0,7707-85-6711,SNGL FAM SUB,2.271,AC,165000,0,165000,314000,5000,484000,150000,0,150000,264900,5400,420300,RR,RES/RUR,,,
9578,46-27-A-10-0,7707-85-5540,SNGL FAM SUB,2.541,AC,165000,0,165000,279600,1600,446200,150000,0,150000,234200,1600,385800,RR,RES/RUR,,,
9579,46-27-A-11-0,7707-85-4330,SNGL FAM SUB,2.252,AC,165000,0,165000,307200,400,472600,150000,0,150000,258100,400,408500,RR,RES/RUR,,,
9580,46-27-A-13-0,7707-84-2987,SNGL FAM SUB,2,AC,165000,0,165000,411900,5000,581900,150000,0,150000,332100,5000,487100,RR,RES/RUR,,,
9581,46-27-A-14-0,7707-84-2719,SNGL FAM SUB,2.352,AC,165000,0,165000,287600,3800,456400,150000,0,150000,241400,3300,394700,RR,RES/RUR,,,
9582,46-27-A-16-0,7707-74-8382,SNGL FAM SUB,4.776,AC,173300,0,173300,0,0,173300,157500,0,157500,0,0,157500,RR,RES/RUR,,,
9583,46-27-A-17-0,7707-74-5199,SNGL FAM SUB,6.743,AC,173300,0,173300,484900,0,658200,157500,0,157500,413900,0,571400,RR,RES/RUR,,,
9584,46-27-A-18-0,7707-74-3550,SNGL FAM SUB,3.383,AC,165000,0,165000,261200,2200,428400,150000,0,150000,218400,2200,370600,RR,RES/RUR,,,
9585,46-27-A-19-0,7707-74-2726,SNGL FAM SUB,3.41,AC,165000,0,165000,288600,200,453800,150000,0,150000,249900,200,400100,RR,RES/RUR,,,
9586,46-27-B-1-0,7707-87-4344,SNGL FAM SUB,2,AC,165000,0,165000,369500,25000,559500,150000,0,150000,309400,22800,482200,RR,RES/RUR,,,
9587,46-27-B-2-0,7707-87-3192,SNGL FAM SUB,2,AC,165000,0,165000,395100,500,560600,150000,0,150000,334000,500,484500,RR,RES/RUR,,,
9588,46-27-B-4-0,7707-86-3609,SNGL FAM SUB,2,AC,165000,0,165000,315200,1000,481200,150000,0,150000,264800,1000,415800,RR,RES/RUR,,,
9589,46-27-B-6-0,7707-86-2205,SNGL FAM SUB,2,AC,165000,0,165000,351200,10700,526900,150000,0,150000,297100,10700,457800,RR,RES/RUR,,,
9590,46-27-B-7-0,7707-86-1063,SNGL FAM SUB,2.032,AC,165000,0,165000,411700,34900,611600,150000,0,150000,345200,32900,528100,RR,RES/RUR,,,
9591,46-27-B-8-0,7707-85-1802,SNGL FAM SUB,2.003,AC,165000,0,165000,398800,4000,567800,150000,0,150000,339100,4000,493100,RR,RES/RUR,,,
9743,16-1-0-36-A,5890-71-9437,SNGL FAM SUB,7.021,AC,60500,0,60500,0,0,60500,59100,0,59100,0,0,59100,A1,AG/GEN,,,
9744,26-1-0-22-0,6719-00-9568,SNGL FAM SUB,15.58,AC,120400,0,120400,261600,0,382000,118200,0,118200,236000,0,354200,A1,AG/GEN,,,
9745,26-1-0-23-0,6719-11-0145,SNGL FAM SUB,3,AC,51000,0,51000,0,0,51000,50000,0,50000,0,0,50000,A1,AG/GEN,,,
9746,16-1-0-59-0,6800-07-8969,AG 20-100 AC,70.92,AC,145500,112800,32700,0,0,145500,141800,111700,30100,0,0,141800,A1,AG/GEN,,,
9748,16-1-0-55-0,5891-80-6453,AG 20-100 AC,46.5,AC,95400,66000,29400,0,0,95400,93000,65400,27600,0,0,93000,A1,AG/GEN,,,
9750,16-1-0-58-0,6800-18-9647,AG 20-100 AC,71.886,AC,183300,107500,75800,300800,36200,520300,179800,103800,76000,261200,33000,474000,A1,AG/GEN,,,
9752,16-4-0-16-0,5890-35-7745,SNGL FAM SUB,3.6,AC,48200,0,48200,0,0,48200,47100,0,47100,0,0,47100,A1,AG/GEN,,,
9753,7-3-0-3-0,6843-20-6100,SNGL FAM SUB,2.54,AC,52900,0,52900,181200,24300,258400,51300,0,51300,162500,24300,238100,A1,AG/GEN,,,
9754,16-4-0-12-0,5890-46-9500,SNGL FAM SUB,1.45,AC,40400,0,40400,133600,3200,177200,39600,0,39600,116600,3200,159400,A1,AG/GEN,,,
9755,16-4-0-15-0,5890-35-5864,SNGL FAM SUB,3.18,AC,46600,0,46600,175900,4500,227000,45600,0,45600,152100,4000,201700,A1,AG/GEN,,,
10105,20-11-0-17-0,6851-00-0953,SNGL FAM SUB,2,AC,55600,0,55600,151400,1700,208700,52500,0,52500,139600,1900,194000,A1,AG/GEN,,,
10106,55-18-0-5-0,6786-05-4168,SNGL FAM SUB,12,AC,235500,0,235500,504100,15900,755500,210800,0,210800,418600,13500,642900,A2,AG/LTD,,,
10110,29-1-0-110-A,6749-91-8377,AG 20-100 AC,68.62,AC,431400,340300,91100,356200,58900,846500,409400,325400,84000,328700,54700,792800,A1,AG/GEN,,,
10112,33-6-0-5-0,6798-33-5804,SNGL FAM SUB,2.011,AC,90700,0,90700,311500,0,402200,80900,0,80900,258300,0,339200,RR,RES/RUR,,,
10113,33-6-0-6-0,6798-33-5530,SNGL FAM SUB,2.01,AC,90600,0,90600,257500,0,348100,80900,0,80900,210900,0,291800,RR,RES/RUR,,,
10114,33-6-0-7-0,6798-33-6225,SNGL FAM SUB,2.621,AC,99100,0,99100,306500,2500,408100,88400,0,88400,251700,2500,342600,RR,RES/RUR,,,
10115,33-6-0-8-0,6798-33-7381,SNGL FAM SUB,2.158,AC,92700,0,92700,300000,0,392700,82700,0,82700,245100,0,327800,RR,RES/RUR,,,
10116,33-6-0-9-0,6798-33-9554,SNGL FAM SUB,2.01,AC,90600,0,90600,244400,300,335300,80900,0,80900,207400,300,288600,RR,RES/RUR,,,
10117,33-6-0-10-0,6798-33-8971,SNGL FAM SUB,2.023,AC,90800,0,90800,224400,35200,350400,81100,0,81100,184100,30100,295300,RR,RES/RUR,,,
10118,33-6-0-11-0,6798-34-7261,SNGL FAM SUB,2.055,AC,91300,0,91300,284000,76200,451500,81500,0,81500,222900,65300,369700,RR,RES/RUR,,,
10119,33-6-0-12-0,6798-34-9418,SNGL FAM SUB,2.002,AC,90500,0,90500,337300,0,427800,80800,0,80800,282200,0,363000,RR,RES/RUR,,,
10121,34-1-0-1-B,7708-03-9829,AG 20-100 AC,40.03,AC,528400,509400,19000,0,0,528400,472400,455400,17000,0,0,472400,A2,AG/LTD,,,
10122,38-1-0-5-D,6718-00-1327,SNGL FAM SUB,2,AC,44400,0,44400,0,9200,53600,43500,0,43500,0,8000,51500,A1,AG/GEN,,,
10123,38-1-0-84-B,6707-77-5110,SNGL FAM SUB,2.85,AC,49200,0,49200,223200,2200,274600,48200,0,48200,195000,2500,245700,A1,AG/GEN,,,
10124,38-1-0-84-C,6707-76-4771,SNGL FAM SUB,2.58,AC,47600,0,47600,100600,500,148700,46700,0,46700,85900,500,133100,A1,AG/GEN,,,
9592,46-27-B-9-0,7707-85-0641,SNGL FAM SUB,2.244,AC,165000,0,165000,369000,0,534000,150000,0,150000,309500,0,459500,RR,RES/RUR,,,
9593,46-27-B-10-0,7707-75-9442,SNGL FAM SUB,2.043,AC,165000,0,165000,310300,2100,477400,150000,0,150000,262100,2200,414300,RR,RES/RUR,,,
9594,46-27-B-11-0,7707-75-8261,SNGL FAM SUB,2,AC,165000,0,165000,379200,0,544200,150000,0,150000,317000,0,467000,RR,RES/RUR,,,
9595,46-27-B-12-0,7707-74-7944,SNGL FAM SUB,2.113,AC,165000,0,165000,299400,2000,466400,150000,0,150000,252700,2000,404700,RR,RES/RUR,,,
9597,62-13-A-14-0,7714-05-9445,SNGL FAM SUB,0,AC,115000,0,115000,301000,1000,417000,100000,0,100000,276000,1000,377000,R1,RES/LTD,,,
9598,45-12-0-H-2,6798-51-9756,SNGL FAM SUB,2,AC,86700,0,86700,119900,6300,212900,77400,0,77400,98700,6100,182200,A2,AG/LTD,,,
9599,64-1-0-26-0,7723-47-2276,SNGL FAM SUB,3.728,AC,251300,0,251300,823300,26400,1101000,218600,0,218600,764600,25200,1008400,R1,RES/LTD,,,
9600,64-1-0-29-A,7723-47-7245,SNGL FAM SUB,3.876,AC,246000,0,246000,0,0,246000,213900,0,213900,0,0,213900,R1A2,RES LTD,,,
9601,57-1-0-43-A,7715-13-6275,SNGL FAM SUB,4.6,AC,261700,0,261700,172800,21600,456100,227500,0,227500,146100,21600,395200,A2,AG/LTD,,,
9603,63-14-0-A-1,7714-74-2303,SNGL FAM SUB,2.617,AC,165100,0,165100,241200,0,406300,150600,0,150600,234300,0,384900,A2,AG/LTD,,,
9604,48-2-F-3-0,7726-58-9301,SNGL FAM SUB,0,AC,130000,0,130000,163400,700,294100,117000,0,117000,137700,700,255400,R1,RES/LTD,,,
9605,47-26-0-6-0,7727-09-1193,SNGL FAM SUB,8.472,AC,216100,0,216100,266100,76800,559000,193200,0,193200,226900,75200,495300,A2,AG/LTD,,,
9606,67-2-C-9-0,7723-54-3961,SNGL FAM SUB,0,AC,184000,0,184000,270600,4200,458800,160000,0,160000,233000,3800,396800,R1,RES/LTD,,,
9607,31-1-0-9-A,6769-45-5303,SNGL FAM SUB,10.81,AC,160800,95300,65500,255100,5700,421600,147300,88000,59300,213800,3900,365000,A2,AG/LTD,,,
9608,31-12-0-2-0,6769-55-4256,SNGL FAM SUB,14.833,AC,210800,203600,7200,0,0,210800,192000,185600,6400,0,0,192000,A2,AG/LTD,,,
9609,31-1-0-5-0,6769-64-2982,SNGL FAM SUB,1.878,AC,71900,10500,61400,92600,900,165400,64700,9200,55500,77300,900,142900,A2,AG/LTD,,,
9610,31-1-0-4-0,6769-64-2890,SNGL FAM SUB,0.453,AC,5600,5300,300,0,0,5600,4900,4700,200,0,0,4900,A2,AG/LTD,,,
9611,31-1-0-8-0,6769-54-7861,SNGL FAM SUB,3.859,AC,95400,93500,1900,0,0,95400,86300,84600,1700,0,0,86300,A2,AG/LTD,,,
9612,31-1-0-9-0,6769-54-4313,AG 20-100 AC,22.1,AC,286500,215400,71100,155900,13000,455400,264000,199900,64100,127900,13000,404900,A2,AG/LTD,,,
9613,27-8-0-B-0,6729-16-4669,SNGL FAM SUB,5,AC,63500,0,63500,327600,14000,405100,62000,0,62000,268500,10300,340800,A1,AG/GEN,,,
9614,16-1-0-64-0,6800-15-0552,SNGL FAM SUB,16.17,AC,83300,0,83300,13100,7500,103900,81200,0,81200,14800,7000,103000,A1,AG/GEN,,,
9615,41-2-0-8-0,6748-31-9708,SNGL FAM SUB,2.21,AC,66000,0,66000,159900,38600,264500,61300,0,61300,132300,32400,226000,A1,AG/GEN,,,
9616,67-2-D-2-0,7723-55-7910,SNGL FAM SUB,0,AC,184000,0,184000,258500,1000,443500,160000,0,160000,216700,1000,377700,R1,RES/LTD,,,
9617,47-1-0-89-0,7726-37-2421,SNGL FAM SUB,0.86,AC,374500,0,374500,24500,10200,409200,340500,0,340500,19300,8900,368700,R3,RES/GEN,,,
9619,21-1-0-1-0,6851-21-6310,AG 20-100 AC,53.365,AC,461600,337500,124100,391100,13500,866200,455600,335700,119900,342000,12300,809900,A1,AG/GEN,,,
9620,46-14-0-4-0,7708-91-5112,SNGL FAM SUB,3.64,AC,140400,0,140400,283400,1200,425000,127600,0,127600,239000,1200,367800,A2,AG/LTD,,,
9621,43-15-0-9-0,6768-91-2148,SNGL FAM SUB,3.16,AC,92000,0,92000,0,0,92000,83600,0,83600,0,0,83600,A2,AG/LTD,,,
9622,20-1-0-51-0,6841-51-4075,AG > 100 AC,196.22,AC,1191000,0,1191000,0,46000,1237000,1181100,0,1181100,0,41500,1222600,A1,AG/GEN,,,
9623,20-12-0-1-0,6841-80-6373,SNGL FAM SUB,1.77,AC,53700,0,53700,170800,0,224500,50200,0,50200,147600,0,197800,A1,AG/GEN,,,
9624,20-12-0-2-0,6840-99-1926,SNGL FAM SUB,10.68,AC,108000,0,108000,221600,1000,330600,104100,0,104100,193900,1000,299000,A1,AG/GEN,,,
9625,20-12-0-3-0,6840-99-2622,SNGL FAM SUB,2.12,AC,56600,0,56600,235900,39500,332000,53000,0,53000,203400,39200,295600,A1,AG/GEN,,,
9626,20-12-0-4-0,6840-89-7490,SNGL FAM SUB,12.34,AC,108600,0,108600,205600,2000,316200,106400,0,106400,178000,2000,286400,A1,AG/GEN,,,
9627,20-12-0-7-0,6840-99-7001,SNGL FAM SUB,8.88,AC,102100,0,102100,283000,1000,386100,96300,0,96300,265000,1000,362300,A1,AG/GEN,,,
9628,15-5-0-27-0,5789-77-4869,SNGL FAM SUB,8.1,AC,64400,0,64400,0,0,64400,62900,0,62900,0,0,62900,A1,AG/GEN,,,
9629,20-1-0-83-0,6840-51-1054,SNGL FAM SUB,1.19,AC,55900,0,55900,0,24700,80600,51900,0,51900,0,20400,72300,A1,AG/GEN,,,
9630,20-1-0-83-A,6840-51-3062,SNGL FAM SUB,1.17,AC,55700,0,55700,183200,2200,241100,51700,0,51700,149100,1600,202400,A1,AG/GEN,,,
9631,12-20-0-B-0,6831-09-8064,SNGL FAM SUB,4.7,AC,70100,0,70100,55200,1000,126300,68400,0,68400,45700,1000,115100,A1,AG/GEN,,,
9633,6-1-0-54-0,6832-09-2843,AG 20-100 AC,22.19,AC,197600,0,197600,0,0,197600,194900,0,194900,0,0,194900,A1,AG/GEN,,,
9635,6-2-0-1-0,6833-10-1365,SNGL FAM SUB,12.44,AC,253100,0,253100,0,0,253100,246500,0,246500,0,0,246500,B1A1,BS & AG,,,
9636,66-1-0-6-0,7713-86-9895,SNGL FAM SUB,6.14,AC,518300,0,518300,499900,59400,1077600,450800,0,450800,420300,55800,926900,A2,AG/LTD,,,
9637,39-1-0-26-0,6727-05-2112,SNGL FAM SUB,9.75,AC,83400,0,83400,27100,300,110800,81800,0,81800,22800,300,104900,A1,AG/GEN,,,
9638,39-1-0-36-0,6727-03-4721,SNGL FAM SUB,4.796,AC,60100,0,60100,228900,7900,296900,58900,0,58900,207700,7000,273600,A1,AG/GEN,,,
9639,64-12-G-8-0,7723-59-7553,SNGL FAM SUB,0,AC,77000,0,77000,166100,0,243100,67000,0,67000,146000,0,213000,R1,RES/LTD,,,
9640,28-7-0-B-0,6729-94-7877,SNGL FAM SUB,2.17,AC,55800,0,55800,155100,1300,212200,53200,0,53200,128400,1300,182900,A1,AG/GEN,,,
9641,50-5-0-11-0,6726-42-4273,SNGL FAM SUB,9,AC,73700,0,73700,0,0,73700,70200,0,70200,0,0,70200,A1,AG/GEN,,,
9642,62-4-E-2-0,7714-04-6638,SNGL FAM SUB,0,AC,115000,0,115000,226300,12600,353900,100000,0,100000,212500,11000,323500,R1,RES/LTD,,,
9643,5-1-0-80-0,6823-65-2396,SNGL FAM SUB,2.25,AC,46100,45100,1000,0,0,46100,45300,44300,1000,0,0,45300,A1,AG/GEN,,,
9644,6-1-0-51-0,6832-18-1805,SNGL FAM SUB,4.53,AC,69100,0,69100,105800,2800,177700,63900,0,63900,106700,2200,172800,A1,AG/GEN,,,
9645,5-1-0-41-A,6823-18-1645,SNGL FAM SUB,2.268,AC,46200,0,46200,140300,1200,187700,45300,0,45300,0,0,45300,A1,AG/GEN,,,
9646,45-1-0-61-0,6797-47-6817,SNGL FAM SUB,2,AC,84500,0,84500,176600,3200,264300,75500,0,75500,147200,3200,225900,A2,AG/LTD,,,
9647,45-1-0-106-0,6798-61-0603,SNGL FAM SUB,0.6,AC,42100,0,42100,122500,600,165200,37600,0,37600,100200,600,138400,A2,AG/LTD,,,
9648,64-19-E-11-0,7733-47-2930,SNGL FAM SUB,0,AC,265000,0,265000,571900,0,836900,220000,0,220000,452700,0,672700,R1,RES/LTD,,,
9649,13-13-0-10-0,6841-92-4812,SNGL FAM SUB,2,AC,58600,0,58600,142400,2700,203700,57500,0,57500,131300,1900,190700,A1,AG/GEN,,,
9650,20-11-0-6-0,6841-92-2020,SNGL FAM SUB,2.02,AC,55800,0,55800,155000,16300,227100,52700,0,52700,143600,16800,213100,A1,AG/GEN,,,
9652,45-1-0-14-0,6797-19-5467,COMM & IND,2,AC,200800,0,200800,181000,1600,383400,186000,0,186000,176900,1600,364500,B1,BUS/GEN,,,
9653,45-1-0-113-E,6798-60-0217,SNGL FAM SUB,2,AC,74000,0,74000,144700,23000,241700,66100,0,66100,118800,19900,204800,A2,AG/LTD,,,
9654,10-1-0-33-0,6812-56-1201,AG > 100 AC,127.69,AC,389800,326200,63600,0,0,389800,382100,327400,54700,0,0,382100,A1,AG/GEN,,,
9655,11-1-0-1-0,6812-76-0329,AG 20-100 AC,64.04,AC,263600,192800,70800,275700,41300,580600,254600,192500,62100,275800,32600,563000,A1,AG/GEN,,,
9656,5-1-0-61-0,6823-35-5620,AG 20-100 AC,22.173,AC,187300,91700,95600,580400,112100,879800,183800,91200,92600,550700,100800,835300,A1,AG/GEN,,,
9657,16-1-0-53-0,6800-07-0216,AG 20-100 AC,70.92,AC,130900,98200,32700,0,0,130900,127700,97600,30100,0,0,127700,A1,AG/GEN,,,
9658,31-1-0-89-0,6778-54-7648,SNGL FAM SUB,9.88,AC,170700,0,170700,273400,2000,446100,152200,0,152200,228300,2000,382500,A2,AG/LTD,,,
9659,46-21-B-6-0,7708-90-4590,SNGL FAM SUB,2.48,AC,128900,0,128900,227000,15700,371600,117200,0,117200,189500,13200,319900,A2,AG/LTD,,,
9660,43-20-0-2-0,6768-71-5825,SNGL FAM SUB,3.04,AC,96800,0,96800,147500,34100,278400,88000,0,88000,129300,29000,246300,A2,AG/LTD,,,
9661,5-1-0-60-0,6823-61-7780,AG 20-100 AC,25.195,AC,171600,0,171600,0,0,171600,170400,0,170400,0,0,170400,A1,AG/GEN,,,
9662,6-1-0-19-0,6823-71-6949,SNGL FAM SUB,10.74,AC,110800,0,110800,218500,36000,365300,109000,0,109000,189900,34100,333000,A1,AG/GEN,,,
9663,42-11-0-1-0,6757-49-0112,SNGL FAM SUB,0.5,AC,43200,0,43200,130100,400,173700,39900,0,39900,108100,400,148400,A2,AG/LTD,,,
9664,15-5-0-13-0,5789-58-5430,SNGL FAM SUB,8.3,AC,65100,0,65100,186700,800,252600,63600,0,63600,163700,800,228100,A1,AG/GEN,,,
9665,42-19-0-8-0,6766-18-8520,SNGL FAM SUB,1.5,AC,69900,0,69900,205100,900,275900,61100,0,61100,175000,900,237000,R3A2,RES GEN,,,
9666,45-1-0-45-0,6796-17-9355,SNGL FAM SUB,1.85,AC,96700,0,96700,291600,1200,389500,86300,0,86300,241800,1200,329300,A2,AG/LTD,,,
9667,45-1-0-46-0,6796-27-3835,SNGL FAM SUB,10.94,AC,246700,0,246700,203200,500,450400,219900,0,219900,167200,500,387600,A2,AG/LTD,,,
9668,45-1-0-47-0,6796-27-6735,SNGL FAM SUB,1.32,AC,20900,0,20900,0,0,20900,18600,0,18600,0,0,18600,A2,AG/LTD,,,
9669,15-5-0-10-0,5789-57-7681,SNGL FAM SUB,8.1,AC,64400,0,64400,0,0,64400,62900,0,62900,0,0,62900,A1,AG/GEN,,,
9670,58-1-0-80-A,7716-83-0531,SNGL FAM SUB,10.886,AC,375100,206300,168800,0,10200,385300,326500,179800,146700,0,10200,336700,A2,AG/LTD,,,
9671,2-3-0-21-0,6824-23-5262,SNGL FAM SUB,3.49,AC,50800,0,50800,201100,1500,253400,49700,0,49700,169700,1500,220900,A1,AG/GEN,,,
9672,46-1-0-61-0,7716-29-1257,AG 20-100 AC,65.109,AC,1393300,1362900,30400,0,0,1393300,1243600,1215900,27700,0,0,1243600,A2,AG/LTD,,,
9673,47-1-0-30-0,7716-68-5695,AG 20-100 AC,20.854,AC,704500,634000,70500,0,6600,711100,628400,504700,123700,18600,7100,654100,A2,AG/LTD,,,
9674,47-1-0-14-B,7717-30-0547,SNGL FAM SUB,3.99,AC,167200,0,167200,0,0,167200,149400,0,149400,0,0,149400,A2,AG/LTD,,,
9675,47-1-0-14-A,7717-20-7616,SNGL FAM SUB,7.086,AC,234100,0,234100,394900,34800,663800,208900,0,208900,327800,28500,565200,A2,AG/LTD,,,
9676,46-1-0-60-0,7717-20-1654,SNGL FAM SUB,7.096,AC,234300,0,234300,201400,25900,461600,209100,0,209100,172400,22300,403800,A2,AG/LTD,,,
9677,13-13-0-25-0,6841-92-8406,SNGL FAM SUB,2.76,AC,65200,0,65200,151600,1500,218300,64000,0,64000,131100,1500,196600,A1,AG/GEN,,,
9678,20-11-0-11-0,6841-92-6179,SNGL FAM SUB,2,AC,55600,0,55600,152200,12300,220100,52500,0,52500,139900,12700,205100,A1,AG/GEN,,,
9680,13-4-0-9-0,6852-05-2031,SNGL FAM SUB,6.76,AC,85300,0,85300,156400,2300,244000,83700,0,83700,136800,2300,222800,A1,AG/GEN,,,
9681,12-1-0-65-0,6831-86-2462,AG 20-100 AC,40,AC,121500,103100,18400,0,0,121500,115200,98200,17000,0,0,115200,A1,AG/GEN,,,
9682,12-1-0-66-0,6831-66-8326,AG > 100 AC,121.157,AC,347800,291900,55900,0,0,347800,337300,285800,51500,0,0,337300,A1,AG/GEN,,,
9683,12-1-0-73-0,6831-63-2968,AG 20-100 AC,61.515,AC,301800,273400,28400,0,0,301800,289100,263000,26100,0,0,289100,A1,AG/GEN,,,
9684,12-1-0-75-B,6831-84-0395,AG 20-100 AC,94.662,AC,338900,292700,46200,0,1024800,1363700,313500,273000,40500,0,960200,1273700,A1,AG/GEN,,,
9685,62-17-A-1-0,7714-05-1615,SNGL FAM SUB,0,AC,115000,0,115000,192400,3000,310400,100000,0,100000,177900,3000,280900,R1,RES/LTD,,,
9687,42-1-0-20-0,6766-07-6205,General Gov,0.373,AC,1300,0,1300,0,0,1300,1100,0,1100,0,0,1100,M2A2,INDUSTR,,,
9688,67-4-0-1-A,7733-02-3426,SNGL FAM SUB,5.035,AC,327000,0,327000,373400,2300,702700,284200,0,284200,317700,2300,604200,A2,AG/LTD,,,
9689,67-4-0-1-B,7733-02-0465,SNGL FAM SUB,5.331,AC,338100,0,338100,0,0,338100,293900,0,293900,0,0,293900,A2,AG/LTD,,,
9690,67-4-0-1-C,7733-03-1361,SNGL FAM SUB,0.634,AC,23700,0,23700,0,0,23700,20600,0,20600,0,0,20600,A2,AG/LTD,,,
9691,67-4-0-4-0,7733-06-0293,SNGL FAM SUB,2.274,AC,223700,0,223700,646100,72300,942100,194500,0,194500,579000,67100,840600,A2,AG/LTD,,,
9692,67-4-0-5-0,7723-96-8949,Roads,1.04,AC,0,0,0,0,0,0,0,0,0,0,0,0,A2R1,AG LTD/,,,
9693,64-15-D-3-0,7733-27-7852,SNGL FAM SUB,0,AC,251800,0,251800,494400,0,746200,209000,0,209000,433400,0,642400,R1,RES/LTD,,,
9694,33-1-0-17-A,6798-75-4269,SNGL FAM SUB,11.36,AC,213100,0,213100,143600,8200,364900,190000,0,190000,121700,8200,319900,A2,AG/LTD,,,
9695,33-1-0-17-B,6798-85-1217,SNGL FAM SUB,15,AC,263300,0,263300,0,0,263300,234800,0,234800,0,0,234800,A2,AG/LTD,,,
9696,9-1-0-76-A,5892-85-4950,SNGL FAM SUB,1.717,AC,41400,0,41400,176400,23900,241700,40500,0,40500,157700,23900,222100,A1,AG/GEN,,,
9697,55-2-0-9-0,6785-35-5884,SNGL FAM SUB,3.53,AC,111800,0,111800,86500,500,198800,99800,0,99800,71300,500,171600,R1,RES/LTD,,,
9698,55-2-0-3-0,6785-45-0428,SNGL FAM SUB,1.51,AC,91100,0,91100,151500,0,242600,81300,0,81300,128200,0,209500,R1,RES/LTD,,,
9699,55-2-0-8-0,6785-35-4211,SNGL FAM SUB,11.047,AC,221300,0,221300,371800,39600,632700,197400,0,197400,305400,33700,536500,R1,RES/LTD,,,
9700,55-1-0-1-H,6776-83-0894,SNGL FAM SUB,3.503,AC,107900,0,107900,313800,34100,455800,96400,0,96400,218900,30800,346100,A2,AG/LTD,,,
9701,55-16-0-14-0,6776-73-2210,SNGL FAM SUB,7.368,AC,173300,0,173300,367000,28400,568700,148600,0,148600,284200,27700,460500,A2,AG/LTD,,,
9702,55-16-0-16-0,6776-72-3798,SNGL FAM SUB,3.143,AC,10700,0,10700,0,0,10700,9400,0,9400,0,0,9400,A2,AG/LTD,,,
9703,57-20-B-7-0,7706-90-6818,SNGL FAM SUB,3.066,AC,315000,0,315000,512300,18000,845300,288800,0,288800,455100,18700,762600,A2,AG/LTD,,,
9705,67-4-0-1-D,7733-03-1069,SNGL FAM SUB,5,AC,325700,0,325700,235300,46800,607800,283100,0,283100,200100,38700,521900,A2,AG/LTD,,,
9706,30-1-0-42-0,6758-36-4351,SNGL FAM SUB,5,AC,91600,0,91600,40200,500,132300,87500,0,87500,32700,500,120700,A2,AG/LTD,,,
9707,43-1-0-57-E,6768-71-9550,SNGL FAM SUB,2,AC,84500,0,84500,268700,1400,354600,75500,0,75500,220100,1400,297000,A2,AG/LTD,,,
9708,56-1-0-15-H,6785-95-2502,SNGL FAM SUB,3.63,AC,106400,0,106400,128000,1000,235400,94900,0,94900,104700,1000,200600,A2,AG/LTD,,,
9709,56-1-0-15-J,6795-05-0614,SNGL FAM SUB,3.11,AC,64200,0,64200,0,0,64200,57300,0,57300,0,0,57300,A2,AG/LTD,,,
9710,56-1-0-15-K,6785-95-3356,SNGL FAM SUB,4,AC,94000,0,94000,0,0,94000,83900,0,83900,0,0,83900,A2,AG/LTD,,,
9711,56-1-0-15-A,6785-85-1175,SNGL FAM SUB,0.4,AC,61700,0,61700,86700,2100,150500,55100,0,55100,71900,2100,129100,A2,AG/LTD,,,
9712,18-1-0-10-A,6810-57-5089,SNGL FAM SUB,3.89,AC,57000,0,57000,116100,4000,177100,55300,0,55300,95800,4000,155100,A1,AG/GEN,,,
9713,67-10-0-23-0,7733-16-2043,SNGL FAM SUB,3.5,AC,340000,0,340000,1047900,13400,1401300,285000,0,285000,677600,14000,976600,R1,RES/LTD,,,
9714,16-4-0-18-0,5890-45-1953,SNGL FAM SUB,3.28,AC,47000,0,47000,120700,500,168200,46000,0,46000,98800,500,145300,A1,AG/GEN,,,
9715,16-5-0-4-0,5890-45-2421,SNGL FAM SUB,3.147,AC,36800,0,36800,120100,0,156900,34900,0,34900,97400,0,132300,A1,AG/GEN,,,
9716,16-1-0-44-0,5890-55-6879,SNGL FAM SUB,9,AC,60800,0,60800,154900,1200,216900,58000,0,58000,139300,1200,198500,A1,AG/GEN,,,
9717,30-2-0-4-0,6758-35-9360,SNGL FAM SUB,7.6,AC,95800,0,95800,197400,500,293700,88200,0,88200,169300,500,258000,A2,AG/LTD,,,
9718,67-2-B-11-0,7723-45-9363,SNGL FAM SUB,0,AC,184000,0,184000,236900,18600,439500,160000,0,160000,202800,15700,378500,R1,RES/LTD,,,
9719,5-14-0-4-0,6823-69-1242,SNGL FAM SUB,8.43,AC,73700,0,73700,258100,0,331800,72400,0,72400,232900,0,305300,A1,AG/GEN,,,
9720,57-1-0-34-B,7705-39-3805,SNGL FAM SUB,14.53,AC,495400,0,495400,603400,4600,1103400,431300,0,431300,520000,4700,956000,A2,AG/LTD,,,
9721,15-5-0-34-0,5880-60-6235,SNGL FAM SUB,8.67,AC,66400,0,66400,156500,18400,241300,64800,0,64800,135800,15600,216200,A1,AG/GEN,,,
9722,67-1-0-2-0,7723-43-6611,SNGL FAM SUB,4.979,AC,775000,0,775000,1080600,10600,1866200,675000,0,675000,1009900,10400,1695300,R1,RES/LTD,,,
9723,67-2-B-15-0,7723-54-0735,SNGL FAM SUB,0,AC,184000,0,184000,340400,0,524400,160000,0,160000,288000,0,448000,R1,RES/LTD,,,
9724,67-2-B-16-0,7723-44-9693,SNGL FAM SUB,0,AC,184000,0,184000,440100,0,624100,160000,0,160000,369100,0,529100,R1,RES/LTD,,,
9725,67-3-B-17-0,7723-44-9459,SNGL FAM SUB,0,AC,184000,0,184000,437600,0,621600,160000,0,160000,366700,0,526700,R1,RES/LTD,,,
9726,67-3-B-18-0,7723-44-9325,SNGL FAM SUB,0,AC,184000,0,184000,704600,0,888600,160000,0,160000,603800,0,763800,R1,RES/LTD,,,
9727,67-3-B-19-0,7723-44-8199,SNGL FAM SUB,0,AC,49700,0,49700,0,0,49700,43200,0,43200,0,0,43200,R1,RES/LTD,,,
9728,67-3-B-20-0,7723-44-8052,SNGL FAM SUB,0,AC,49700,0,49700,0,0,49700,43200,0,43200,0,0,43200,R1,RES/LTD,,,
9729,67-3-B-21-0,7723-43-8855,SNGL FAM SUB,0.553,AC,49700,0,49700,0,0,49700,43200,0,43200,0,0,43200,R1,RES/LTD,,,
9730,62-16-0-B-1,7704-55-8072,SNGL FAM SUB,15.4,AC,499700,0,499700,379600,14500,893800,435700,0,435700,344800,12900,793400,A2,AG/LTD,,,
9731,62-16-0-B-2,7704-55-8411,SNGL FAM SUB,10.1,AC,313700,0,313700,976000,78400,1368100,282900,0,282900,898600,70500,1252000,A2,AG/LTD,,,
9732,42-1-0-68-A,6757-89-3599,SNGL FAM SUB,2.49,AC,72300,0,72300,72400,500,145200,65400,0,65400,58700,500,124600,A2,AG/LTD,,,
9733,63-32-0-A-0,7723-09-4238,SNGL FAM SUB,5.019,AC,279200,0,279200,402600,0,681800,242700,0,242700,338200,0,580900,R1,RES/LTD,,,
9734,57-10-0-9-0,7705-66-3461,SNGL FAM SUB,3.5,AC,230000,0,230000,437900,14900,682800,210000,0,210000,403500,12600,626100,A2,AG/LTD,,,
9735,44-1-0-37-A,6787-09-6784,SNGL FAM SUB,8.257,AC,170200,0,170200,383000,54900,608100,151900,0,151900,316300,47100,515300,RR,RES/RUR,,,
9737,16-1-0-36-0,5890-81-0749,SNGL FAM SUB,4.5,AC,51400,0,51400,0,0,51400,50300,0,50300,0,0,50300,A1,AG/GEN,,,
9738,16-1-0-50-0,5890-76-2537,AG 20-100 AC,51.34,AC,142100,78200,63900,164400,18800,325300,138700,79200,59500,145300,16700,300700,A1,AG/GEN,,,
9739,17-1-0-15-0,6709-87-1190,SNGL FAM SUB,8.206,AC,79200,0,79200,0,0,79200,77600,0,77600,0,0,77600,A1,AG/GEN,,,
9740,26-1-0-6-0,6709-76-6613,SNGL FAM SUB,4.261,AC,57100,0,57100,23700,81600,162400,55900,0,55900,20300,73000,149200,A1,AG/GEN,,,
9741,26-1-0-65-0,6719-04-6656,SNGL FAM SUB,7.464,AC,76300,0,76300,338900,2300,417500,76800,0,76800,288900,2300,368000,A1,AG/GEN,,,
9742,26-1-0-66-0,6719-05-9019,SNGL FAM SUB,4.325,AC,59600,0,59600,0,0,59600,58000,0,58000,0,0,58000,A1,AG/GEN,,,
9756,17-1-0-19-0,6709-78-0548,SNGL FAM SUB,6,AC,66800,0,66800,0,0,66800,65500,0,65500,0,0,65500,A1,AG/GEN,,,
9757,17-1-0-16-0,6709-77-7255,SNGL FAM SUB,6.86,AC,71600,0,71600,133100,800,205500,70200,0,70200,117300,800,188300,A1,AG/GEN,,,
9758,16-1-0-59-A,5890-99-0137,AG 20-100 AC,70.92,AC,182300,111300,71000,0,13700,196000,177800,110100,67700,0,11500,189300,A1,AG/GEN,,,
9759,54-2-0-4-0,6776-13-4583,SNGL FAM SUB,6.604,AC,115300,0,115300,227900,6000,349200,102800,0,102800,182700,6000,291500,A2,AG/LTD,,,
9760,44-1-0-58-0,6786-37-6526,SNGL FAM SUB,5.12,AC,132300,0,132300,247200,6000,385500,118200,0,118200,205600,6000,329800,A2,AG/LTD,,,
9761,29-1-0-120-0,6758-18-0473,SNGL FAM SUB,3.5,AC,32900,31300,1600,0,0,32900,32000,30500,1500,0,0,32000,A1,AG/GEN,,,
9774,66-4-0-1-0,7723-25-7915,SNGL FAM SUB,4.844,AC,517500,0,517500,0,0,517500,450000,0,450000,0,0,450000,A2,AG/LTD,,,
9776,66-4-0-2-0,7723-25-3410,SNGL FAM SUB,3.404,AC,517500,0,517500,0,0,517500,450000,0,450000,0,0,450000,A2,AG/LTD,,,
9777,66-4-0-3-0,7723-25-5723,SNGL FAM SUB,3.219,AC,517500,0,517500,417200,0,934700,450000,0,450000,397700,0,847700,A2,AG/LTD,,,
9778,66-4-0-4-0,7723-25-9349,SNGL FAM SUB,3.654,AC,517500,0,517500,1590100,112300,2219900,450000,0,450000,1504100,105500,2059600,A2,AG/LTD,,,
9779,66-4-0-5-0,7723-35-6100,SNGL FAM SUB,3.347,AC,310500,0,310500,0,0,310500,270000,0,270000,0,0,270000,A2,AG/LTD,,,
9780,66-4-0-6-0,7723-34-7338,SNGL FAM SUB,3.753,AC,292600,0,292600,1044300,0,1336900,254500,0,254500,1007000,0,1261500,A2,AG/LTD,,,
9781,66-4-0-10-0,7723-25-8031,SNGL FAM SUB,3.254,AC,672800,0,672800,883200,0,1556000,585000,0,585000,829300,0,1414300,A2,AG/LTD,,,
9782,66-4-0-11-0,7723-25-6124,SNGL FAM SUB,3.341,AC,672800,0,672800,2627900,51300,3352000,585000,0,585000,2418800,49300,3053100,A2,AG/LTD,,,
9783,66-4-0-13-0,7723-24-0868,SNGL FAM SUB,4.094,AC,862500,0,862500,1285200,71200,2218900,750000,0,750000,1242500,65800,2058300,A2,AG/LTD,,,
9784,66-4-0-14-0,7723-24-4614,SNGL FAM SUB,3.677,AC,862500,0,862500,968800,0,1831300,750000,0,750000,925800,0,1675800,A2,AG/LTD,,,
9785,66-4-0-15-0,7723-24-7427,SNGL FAM SUB,3.297,AC,733100,0,733100,606800,0,1339900,637500,0,637500,598200,0,1235700,A2,AG/LTD,,,
9786,38-2-0-3-0,6718-00-6601,SNGL FAM SUB,1.19,AC,39900,0,39900,128300,2000,170200,39000,0,39000,107900,2000,148900,A1,AG/GEN,,,
9787,38-2-0-4-0,6718-00-5581,SNGL FAM SUB,1.19,AC,39900,0,39900,0,0,39900,39000,0,39000,0,0,39000,A1,AG/GEN,,,
9788,29-1-0-121-0,6758-08-9990,SNGL FAM SUB,10.021,AC,77000,72400,4600,0,0,77000,78400,74100,4300,0,0,78400,A1,AG/GEN,,,
9789,31-1-0-30-0,6778-05-0911,SNGL FAM SUB,4.488,AC,116800,0,116800,490700,24700,632200,104300,0,104300,403900,16700,524900,A2,AG/LTD,,,
9790,13-4-0-2-0,6842-85-5605,SNGL FAM SUB,10.6,AC,83800,0,83800,0,0,83800,82200,0,82200,0,0,82200,A1,AG/GEN,,,
9791,62-14-C-11-0,7704-95-9291,SNGL FAM SUB,0,AC,115000,0,115000,377300,0,492300,100000,0,100000,345200,0,445200,R1,RES/LTD,,,
9792,5-3-0-32-0,6824-20-3810,SNGL FAM SUB,5.41,AC,78000,0,78000,384500,1000,463500,76500,0,76500,326700,1000,404200,A1,AG/GEN,,,
9793,47-1-0-102-0,7727-46-0328,SNGL FAM SUB,1.16,AC,103500,0,103500,159200,22500,285200,92400,0,92400,132400,18700,243500,A2,AG/LTD,,,
9794,31-10-2-5-0,6779-50-3131,SNGL FAM SUB,1.48,AC,74200,0,74200,224600,31800,330600,66300,0,66300,184000,25700,276000,A2,AG/LTD,,,
9795,26-1-0-37-0,6718-32-8365,AG 20-100 AC,56.46,AC,144000,118000,26000,0,0,144000,141200,117200,24000,0,0,141200,A1,AG/GEN,,,
9796,42-1-0-70-0,6758-90-0180,SNGL FAM SUB,2,AC,66400,0,66400,74000,600,141000,61900,0,61900,58900,600,121400,A2,AG/LTD,,,
9797,38-6-0-1-0,6717-18-0998,SNGL FAM SUB,1.96,AC,44200,0,44200,103900,29800,177900,43300,0,43300,89200,27600,160100,A1,AG/GEN,,,
9798,44-6-0-2-0,6787-51-1324,AG 20-100 AC,30,AC,425100,334100,91000,459900,36900,921900,379200,297900,81300,377800,35800,792800,A2,AG/LTD,,,
9799,44-6-0-1-T,6787-52-7315-9999,AG 20-100 AC,24.86,AC,415000,303200,111800,0,0,415000,381500,271200,110300,0,0,381500,A2,AG/LTD,,,
9800,6-6-0-37-0,6833-81-9859,SNGL FAM SUB,3.45,AC,50500,0,50500,121400,500,172400,47700,0,47700,97200,500,145400,A1,AG/GEN,,,
9801,28-1-0-27-0,6738-18-1519,SNGL FAM SUB,1,AC,40000,0,40000,0,0,40000,39500,0,39500,0,3000,42500,A1,AG/GEN,,,
9802,28-1-0-96-A,6738-36-3489,SNGL FAM SUB,3.95,AC,71700,0,71700,87700,4800,164200,70400,0,70400,77100,4800,152300,A1,AG/GEN,,,
9803,11-9-0-A-0,6822-43-6599,SNGL FAM SUB,5.7,AC,63700,0,63700,102700,26900,193300,62500,0,62500,99000,23700,185200,A1,AG/GEN,,,
9805,42-19-0-2-0,6766-19-6228,SNGL FAM SUB,2.72,AC,86900,0,86900,199600,11600,298100,75700,0,75700,163500,8700,247900,A2,AG/LTD,,,
9806,51-1-0-31-0,6736-30-4700,SNGL FAM SUB,3.94,AC,51400,0,51400,0,0,51400,50400,0,50400,0,0,50400,A1,AG/GEN,,,
9807,20-1-0-70-A,6840-74-5194,AG > 100 AC,168.91,AC,975500,835500,140000,226200,11200,1212900,933100,815700,117400,186600,11200,1130900,A1,AG/GEN,,,
9808,20-1-0-70-B,6840-71-4322,SNGL FAM SUB,1.52,AC,11100,10400,700,0,0,11100,11300,10700,600,0,0,11300,A1,AG/GEN,,,
9809,63-1-0-114-0,7715-52-8860,SNGL FAM SUB,2.77,AC,132500,0,132500,0,500,133000,115200,0,115200,0,500,115700,A2,AG/LTD,,,
9810,67-2-C-5-0,7723-55-2449,SNGL FAM SUB,0,AC,184000,0,184000,484700,2000,670700,160000,0,160000,416600,2000,578600,R1,RES/LTD,,,
9811,67-2-C-6-0,7723-55-2334,SNGL FAM SUB,0,AC,184000,0,184000,433700,3500,621200,160000,0,160000,370600,3500,534100,R1,RES/LTD,,,
9812,67-2-C-10-0,7723-54-3776,SNGL FAM SUB,0,AC,184000,0,184000,378300,0,562300,160000,0,160000,325000,0,485000,R1,RES/LTD,,,
9813,67-2-C-11-0,7723-54-3506,SNGL FAM SUB,0,AC,184000,0,184000,429300,0,613300,160000,0,160000,386900,0,546900,R1,RES/LTD,,,
9814,67-2-C-12-0,7723-54-4485,SNGL FAM SUB,0,AC,184000,0,184000,456400,0,640400,160000,0,160000,399000,0,559000,R1,RES/LTD,,,
9815,67-2-D-13-0,7723-54-8293,SNGL FAM SUB,0,AC,184000,0,184000,605200,12700,801900,160000,0,160000,500300,10800,671100,R1,RES/LTD,,,
9816,67-2-D-18-0,7723-64-0993,SNGL FAM SUB,0,AC,184000,0,184000,450800,800,635600,160000,0,160000,395500,800,556300,R1,RES/LTD,,,
9817,67-2-D-19-0,7723-65-0068,SNGL FAM SUB,0,AC,184000,0,184000,488000,0,672000,160000,0,160000,425300,0,585300,R1,RES/LTD,,,
9818,67-2-D-20-0,7723-65-0223,SNGL FAM SUB,0,AC,184000,0,184000,484400,0,668400,160000,0,160000,420100,0,580100,R1,RES/LTD,,,
9819,67-2-E-5-0,7723-65-2490,SNGL FAM SUB,0,AC,184000,0,184000,498200,0,682200,160000,0,160000,411200,0,571200,R1,RES/LTD,,,
9821,67-2-E-7-0,7723-65-3127,SNGL FAM SUB,0,AC,184000,0,184000,474100,0,658100,160000,0,160000,392800,0,552800,R1,RES/LTD,,,
9822,67-2-E-8-0,7723-64-3719,SNGL FAM SUB,0,AC,184000,0,184000,620400,0,804400,160000,0,160000,515000,0,675000,R1,RES/LTD,,,
9824,67-3-G-1-0,7723-54-6137,SNGL FAM SUB,0,AC,184000,0,184000,386300,0,570300,160000,0,160000,335400,0,495400,R1,RES/LTD,,,
9825,67-2-B-3-0,7723-56-0713,SNGL FAM SUB,0,AC,149000,0,149000,597100,0,746100,129600,0,129600,508200,0,637800,R1,RES/LTD,,,
9826,67-2-A-6-A,7723-56-9381,SNGL FAM SUB,0.179,AC,4900,0,4900,0,0,4900,4200,0,4200,0,0,4200,R1,RES/LTD,,,
9827,67-15-0-A-0,7723-42-8707,SNGL FAM SUB,4.76,AC,575000,0,575000,0,0,575000,525000,0,525000,0,0,525000,A2R1,AG LTD/,,,
9828,67-15-0-B-0,7723-53-2139,SNGL FAM SUB,3.73,AC,546300,0,546300,0,0,546300,498800,0,498800,0,0,498800,A2,AG/LTD,,,
9829,67-15-0-C-0,7723-43-9077,SNGL FAM SUB,2.678,AC,575000,0,575000,0,0,575000,525000,0,525000,0,0,525000,R1A2,RES LTD,,,
9830,67-1-0-11-0,7723-66-4002,SNGL FAM SUB,2.408,AC,228800,0,228800,0,0,228800,198900,0,198900,0,0,198900,A2,AG/LTD,,,
9831,67-1-0-11-B,7723-52-8862,SNGL FAM SUB,14.47,AC,1162300,0,1162300,1715600,92300,2970200,1010300,0,1010300,1564400,86700,2661400,A2R1,AG LTD/,,,
9832,67-17-0-A-0,7733-03-7313,SNGL FAM SUB,5.2,AC,333200,0,333200,1011000,16100,1360300,289600,0,289600,849800,16000,1155400,A2,AG/LTD,,,
9833,58-3-A-2-0,7726-06-8798,SNGL FAM SUB,0,AC,105600,0,105600,302000,600,408200,96000,0,96000,256400,600,353000,RN,RESIDEN,,,
9835,64-1-0-50-0,7734-02-1557,COMM & IND,0.278,AC,60600,0,60600,55000,0,115600,59200,0,59200,52800,0,112000,B1,BUS/GEN,,,
9836,64-7-0-B-1T,7734-01-3999-9999,COMM & IND,3.6474,AC,262400,0,262400,378400,184800,825600,240900,0,240900,380200,139600,760700,B1A2,BS AND,,,
9837,64-1-0-50-A,7724-92-7610,COMM & IND,2.0607,AC,686200,0,686200,0,5000,691200,635300,0,635300,0,5000,640300,B1,BUS/GEN,,,
9838,64-17-0-C-0,7733-58-8475,SNGL FAM SUB,1.583,AC,197900,0,197900,577100,57600,832600,172000,0,172000,531900,0,703900,R1,RES/LTD,,,
9839,31-1-0-52-0,6769-96-1201,SNGL FAM SUB,6,AC,118700,0,118700,42800,16500,178000,107100,0,107100,36500,1800,145400,A2,AG/LTD,,,
9840,43-1-0-57-A,6768-81-2714,SNGL FAM SUB,4.39,AC,118900,0,118900,8800,600,128300,106300,0,106300,8700,600,115600,A2,AG/LTD,,,
9843,43-1-0-45-0,6767-75-7714,SNGL FAM SUB,2.56,AC,92600,0,92600,301600,37900,432100,82700,0,82700,274000,38500,395200,A2,AG/LTD,,,
9844,45-1-0-89-0,6797-76-8467,COMM & IND,2.001,AC,200900,0,200900,26500,8600,236000,186100,0,186100,21600,7200,214900,B1,BUS/GEN,,,
9845,45-1-0-90-0,6797-86-0299,SNGL FAM SUB,1.389,AC,82800,0,82800,0,0,82800,74000,0,74000,0,0,74000,A2,AG/LTD,,,
9846,31-1-0-21-0,6768-66-0597,AG 20-100 AC,28.68,AC,291600,271100,20500,0,0,291600,269600,250600,19000,0,0,269600,A2,AG/LTD,,,
9847,57-1-0-14-B,7706-24-7099,SNGL FAM SUB,3,AC,161000,0,161000,53400,600,215000,140100,0,140100,45800,600,186500,A2,AG/LTD,,,
9852,20-8-A-4-0,6840-32-8140,SNGL FAM SUB,1.294,AC,53900,0,53900,182000,15900,251800,51800,0,51800,162400,14100,228300,A1,AG/GEN,,,
9853,20-8-A-5-0,6840-31-9837,SNGL FAM SUB,2.67,AC,67400,0,67400,144000,4000,215400,64800,0,64800,128100,4200,197100,A1,AG/GEN,,,
9879,57-1-0-15-0,7706-24-5258,SNGL FAM SUB,1,AC,81300,0,81300,0,0,81300,70700,0,70700,0,0,70700,A2,AG/LTD,,,
9880,30-1-0-107-A,6759-91-2285,AG 20-100 AC,20,AC,260000,186600,73400,318800,41800,620600,238000,170500,67500,272200,36500,546700,A2,AG/LTD,,,
9881,29-6-0-C-0,6749-73-6488,SNGL FAM SUB,2.02,AC,64200,0,64200,0,0,64200,60000,0,60000,0,0,60000,A1,AG/GEN,,,
9882,67-2-D-21-0,7723-55-9377,SNGL FAM SUB,0,AC,184000,0,184000,324400,300,508700,160000,0,160000,276300,300,436600,R1,RES/LTD,,,
9883,12-1-0-14-0,6822-93-9232,AG 20-100 AC,55.6,AC,316900,205300,111600,453800,25100,795800,315200,202500,112700,427600,25800,768600,A1,AG/GEN,,,
9884,43-1-0-8-A,6767-67-3804,SNGL FAM SUB,3.374,AC,104300,0,104300,268200,8900,381400,93200,0,93200,224500,8900,326600,A2,AG/LTD,,,
9885,43-1-0-8-C,6767-67-5519,SNGL FAM SUB,1,AC,12000,0,12000,0,0,12000,10700,0,10700,0,0,10700,A2,AG/LTD,,,
9886,30-1-0-58-C,6759-51-4815,SNGL FAM SUB,3.32,AC,68500,0,68500,239400,400,308300,64200,0,64200,198200,400,262800,A2,AG/LTD,,,
9887,5-15-0-14-0,6823-21-9937,SNGL FAM SUB,3.37,AC,42700,0,42700,237800,19400,299900,41800,0,41800,204700,17200,263700,A1,AG/GEN,,,
9888,33-4-0-25-0,6798-52-1930,SNGL FAM SUB,3.21,AC,107200,0,107200,171400,1200,279800,95700,0,95700,140500,1200,237400,A2,AG/LTD,,,
9889,15-5-0-31-0,5789-79-6687,SNGL FAM SUB,8.13,AC,64500,0,64500,143600,28300,236400,63000,0,63000,132600,23900,219500,A1,AG/GEN,,,
9891,45-15-0-4-0,6797-63-8240,SNGL FAM SUB,4.57,AC,130600,0,130600,298000,2100,430700,116700,0,116700,238900,2200,357800,A2,AG/LTD,,,
9892,5-1-0-58-0,6823-62-2946,SNGL FAM SUB,0.951,AC,38300,0,38300,500,0,38800,37100,0,37100,500,0,37600,A1,AG/GEN,,,
9893,5-1-0-73-0,6823-38-6050,SNGL FAM SUB,2.88,AC,39400,38100,1300,0,0,39400,38700,37500,1200,0,0,38700,A1,AG/GEN,,,
9894,1-1-0-17-0,6814-08-1633,SNGL FAM SUB,7.301,AC,71800,0,71800,104900,5500,182200,70500,0,70500,93200,5500,169200,A1,AG/GEN,,,
9896,12-1-0-4-0,6822-75-8931,SNGL FAM SUB,4.193,AC,66400,0,66400,23400,0,89800,64500,0,64500,21200,0,85700,A1,AG/GEN,,,
9898,45-1-0-71-A,6797-64-9024,SNGL FAM SUB,1,AC,76700,0,76700,112900,0,189600,68500,0,68500,92100,0,160600,A2,AG/LTD,,,
9899,41-2-0-13-0,6748-31-6037,SNGL FAM SUB,1.79,AC,61900,0,61900,0,0,61900,57300,0,57300,0,0,57300,A1,AG/GEN,,,
9900,5-1-0-83-0,6823-53-8296,SNGL FAM SUB,1.5,AC,44400,0,44400,31900,1000,77300,42800,0,42800,27300,1000,71100,A1,AG/GEN,,,
9901,4-1-0-61-0,6812-59-6378,AG > 100 AC,101.179,AC,451000,362200,88800,271800,78600,801400,439700,357800,81900,231700,72600,744000,A1,AG/GEN,,,
9902,45-1-0-70-0,6797-63-8740,SNGL FAM SUB,5.787,AC,152300,0,152300,91200,200,243700,136000,0,136000,71200,200,207400,A2,AG/LTD,,,
9903,4-1-0-59-0,6812-37-0628,AG 20-100 AC,81.699,AC,374100,294700,79400,34600,400,409100,372800,299200,73600,29700,400,402900,A1,AG/GEN,,,
9904,45-1-0-114-0,6797-79-3492,SNGL FAM SUB,17.76,AC,300900,0,300900,120500,500,421900,269400,0,269400,98300,500,368200,A2,AG/LTD,,,
9905,55-1-0-82-C,6785-86-2609,SNGL FAM SUB,2.533,AC,92200,0,92200,193000,600,285800,82400,0,82400,156900,600,239900,A2,AG/LTD,,,
9906,47-1-0-98-A,7727-21-7384,COMM & IND,0,AC,0,0,0,364400,121700,486100,0,0,0,365200,87100,452300,B1,BUS/GEN,,,
9907,47-13-0-D-1,7727-22-2022,SNGL FAM SUB,7.11,AC,275000,0,275000,308000,39000,622000,245400,0,245400,260000,35000,540400,A2,AG/LTD,,,
9908,64-1-0-39-0,7724-71-8898,COMM & IND,66.73,AC,3222700,0,3222700,1028200,129400,4380300,2984900,0,2984900,1083400,24400,4092700,A2,AG/LTD,,,
9909,58-2-0-21-0,7726-36-0683,SNGL FAM SUB,0,AC,105600,0,105600,162100,59200,326900,96000,0,96000,134800,51900,282700,RN,RESIDEN,,,
9911,58-2-0-23-0,7726-26-9796,SNGL FAM SUB,0,AC,88000,0,88000,0,0,88000,80000,0,80000,0,0,80000,RN,RESIDEN,,,
9912,58-2-0-24-0,7726-36-2716,SNGL FAM SUB,0,AC,65900,0,65900,0,0,65900,59900,0,59900,0,0,59900,RN,RESIDEN,,,
9913,58-2-0-25-0,7726-36-2687,SNGL FAM SUB,0,AC,42600,0,42600,0,0,42600,38800,0,38800,0,0,38800,RN,RESIDEN,,,
9914,46-24-0-2-0,7707-45-1782,SNGL FAM SUB,8.48,AC,195400,0,195400,451900,1200,648500,174600,0,174600,380200,1200,556000,A2,AG/LTD,,,
9915,47-1-0-45-0,7727-01-9196,SNGL FAM SUB,4.083,AC,193000,0,193000,429700,10100,632800,172300,0,172300,362000,9900,544200,A2,AG/LTD,,,
9916,26-1-0-65-C,6719-14-2852,SNGL FAM SUB,2,AC,46000,0,46000,0,0,46000,44000,0,44000,0,0,44000,A1,AG/GEN,,,
9917,32-1-0-49-A,6778-84-5409,SNGL FAM SUB,3,AC,89100,0,89100,290500,41000,420600,79600,0,79600,239800,36700,356100,A2,AG/LTD,,,
9918,44-1-0-22-0,6777-92-5064,SNGL FAM SUB,2.87,AC,99600,0,99600,252000,22600,374200,89000,0,89000,206900,22600,318500,A2,AG/LTD,,,
9919,60-8-0-B-1,6784-29-7029,SNGL FAM SUB,5.53,AC,247900,0,247900,0,0,247900,221100,0,221100,0,0,221100,A2,AG/LTD,,,
9920,57-20-C-10-0,7716-00-6294,SNGL FAM SUB,1.746,AC,315000,0,315000,318500,0,633500,288800,0,288800,294600,0,583400,A2,AG/LTD,,,
9921,41-1-0-7-0,6748-50-2492,SNGL FAM SUB,3.579,AC,79000,0,79000,132800,4000,215800,72600,0,72600,108000,4000,184600,A1,AG/GEN,,,
9922,46-22-0-E-0,7706-87-7427,SNGL FAM SUB,5.006,AC,270500,0,270500,704900,70300,1045700,241400,0,241400,617700,64300,923400,A2,AG/LTD,,,
9923,31-1-0-87-0,6778-25-2019,AG 20-100 AC,21.75,AC,300700,227000,73700,119700,4400,424800,268900,202900,66000,94500,4400,367800,A2,AG/LTD,,,
9924,12-7-0-5-0,6821-86-7375,SNGL FAM SUB,19.67,AC,130700,0,130700,0,1000,131700,127200,0,127200,0,1000,128200,A1,AG/GEN,,,
9925,63-1-0-121-0,7715-60-0011,SNGL FAM SUB,0.3,AC,65000,0,65000,53600,0,118600,56600,0,56600,45700,0,102300,A2,AG/LTD,,,
9926,63-30-0-A-0,7715-60-1105,SNGL FAM SUB,1.88,AC,126400,0,126400,221300,500,348200,109900,0,109900,185800,500,296200,A2,AG/LTD,,,
9927,57-20-C-2-0,7716-00-2400,SNGL FAM SUB,2.334,AC,315000,0,315000,666200,19200,1000400,288800,0,288800,608600,17300,914700,A2,AG/LTD,,,
9928,32-1-0-13-0,6779-63-7959,SNGL FAM SUB,12.03,AC,153200,0,153200,14200,0,167400,136600,0,136600,13200,0,149800,A2,AG/LTD,,,
9929,63-1-0-134-0,7715-72-2129,SNGL FAM SUB,0.95,AC,109300,0,109300,203300,0,312600,95100,0,95100,170200,0,265300,A2,AG/LTD,,,
9930,62-22-0-1-0,7704-50-2119,SNGL FAM SUB,8.7,AC,82700,0,82700,0,0,82700,72200,0,72200,0,0,72200,A2,AG/LTD,,,
9931,62-22-0-2-0,7703-59-7915,SNGL FAM SUB,8.7,AC,82700,0,82700,0,0,82700,72200,0,72200,0,0,72200,A2,AG/LTD,,,
9933,62-22-0-4-0,7703-69-6642,SNGL FAM SUB,8.5,AC,80800,0,80800,0,0,80800,70600,0,70600,0,0,70600,A2,AG/LTD,,,
9934,62-22-0-5-0,7703-79-0543,SNGL FAM SUB,8.5,AC,80800,76500,4300,0,0,80800,70600,66900,3700,0,0,70600,A2,AG/LTD,,,
9935,62-22-0-6-0,7703-79-4444,SNGL FAM SUB,8.5,AC,80800,0,80800,0,0,80800,70600,0,70600,0,0,70600,A2,AG/LTD,,,
9936,62-22-0-7-0,7703-79-8359,SNGL FAM SUB,8.5,AC,80800,76500,4300,0,0,80800,70600,67000,3600,0,0,70600,A2,AG/LTD,,,
9937,62-22-0-8-0,7703-89-2360,SNGL FAM SUB,8,AC,76000,0,76000,0,0,76000,66400,0,66400,0,0,66400,A2,AG/LTD,,,
9938,62-22-0-9-0,7703-89-5552,SNGL FAM SUB,8.1,AC,77000,72900,4100,0,0,77000,67200,63700,3500,0,0,67200,A2,AG/LTD,,,
9939,62-23-0-1-0,7704-51-3196,SNGL FAM SUB,11.6,AC,110200,104300,5900,0,0,110200,96300,91300,5000,0,0,96300,A2,AG/LTD,,,
9940,62-23-0-2-0,7704-51-7084,SNGL FAM SUB,9.7,AC,92200,87300,4900,0,0,92200,80500,76300,4200,0,0,80500,A2,AG/LTD,,,
9941,62-23-0-3-0,7704-60-1902,SNGL FAM SUB,9.9,AC,94100,89100,5000,0,0,94100,82200,77900,4300,0,0,82200,A2,AG/LTD,,,
9942,62-23-0-4-0,7704-60-4842,SNGL FAM SUB,9.8,AC,93100,88100,5000,0,0,93100,81300,77100,4200,0,0,81300,A2,AG/LTD,,,
9943,67-13-A-4-0,7733-37-4149,SNGL FAM SUB,0,AC,265000,0,265000,544900,14100,824000,220000,0,220000,431400,14600,666000,R1,RES/LTD,,,
9944,21-1-0-53-A,6850-73-8600,SNGL FAM SUB,2,AC,66400,0,66400,0,0,66400,60300,0,60300,0,0,60300,A2,AG/LTD,,,
9945,46-1-0-25-0,7707-14-4655,SNGL FAM SUB,2.15,AC,135100,0,135100,87400,8500,231000,111900,0,111900,68100,5900,185900,A2,AG/LTD,,,
9946,26-1-0-52-0,6719-51-0599,Cemetery,1,AC,100,0,100,0,0,100,100,0,100,0,0,100,A1,AG/GEN,,,
9947,21-1-0-32-0,6759-37-3857,COMM & IND,9.16,AC,170400,0,170400,175700,54200,400300,165500,0,165500,166300,53900,385700,B1A2,BS AND,,,
9948,57-25-B-13-0,7706-94-9239,SNGL FAM SUB,3.24,AC,313900,0,313900,373400,22700,710000,288100,0,288100,368200,23600,679900,A2,AG/LTD,,,
9949,51-1-0-15-0,6735-27-0790,SNGL FAM SUB,12.23,AC,101700,0,101700,0,0,101700,99800,0,99800,0,0,99800,A1,AG/GEN,,,
9950,51-1-0-17-0,6735-27-9359,SNGL FAM SUB,6.13,AC,67500,0,67500,177500,200,245200,66200,0,66200,161000,200,227400,A1,AG/GEN,,,
9951,63-1-0-131-0,7715-62-9315,SNGL FAM SUB,3.71,AC,151700,0,151700,370300,1000,523000,131900,0,131900,312000,1000,444900,A2,AG/LTD,,,
9952,46-1-0-64-0,7716-08-9831,SNGL FAM SUB,2.506,AC,133300,0,133300,158200,0,291500,119100,0,119100,140200,0,259300,A2,AG/LTD,,,
9953,25-1-0-3-A,5799-71-5540,SNGL FAM SUB,1,AC,38800,0,38800,114800,800,154400,38000,0,38000,98100,800,136900,A1,AG/GEN,,,
9954,28-9-0-1-0,6729-83-6545,SNGL FAM SUB,2.945,AC,60500,0,60500,120600,1000,182100,58900,0,58900,100100,1000,160000,A1,AG/GEN,,,
9955,2-1-0-5-0,6814-66-8568,COMM & IND,26.18,AC,635800,0,635800,0,0,635800,616900,0,616900,0,0,616900,A1B1,AG GEN/,,,
9956,17-1-0-40-0,6801-91-3620,AG 20-100 AC,95.68,AC,296000,251900,44100,0,0,296000,294200,253500,40700,0,0,294200,A1,AG/GEN,,,
9957,55-14-0-18-0,6786-40-1722,SNGL FAM SUB,12.8,AC,255700,0,255700,468600,54400,778700,228600,0,228600,387100,45400,661100,A2,AG/LTD,,,
9958,21-1-0-58-0,6850-92-9355,SNGL FAM SUB,1,AC,54000,0,54000,115900,0,169900,49900,0,49900,95700,0,145600,A2,AG/LTD,,,
9959,57-10-0-35-0,7705-68-2024,SNGL FAM SUB,4.923,AC,230000,0,230000,551400,0,781400,210000,0,210000,496800,0,706800,A2,AG/LTD,,,
9960,57-10-0-36-0,7705-68-3307,SNGL FAM SUB,3.85,AC,230000,0,230000,0,0,230000,210000,0,210000,0,0,210000,A2,AG/LTD,,,
9961,64-15-B-2-0,7733-27-9474,SNGL FAM SUB,0,AC,265000,0,265000,473300,0,738300,220000,0,220000,404200,0,624200,R1,RES/LTD,,,
9962,12-1-0-31-A,6831-04-2018,SNGL FAM SUB,1.57,AC,44300,0,44300,111500,1500,157300,43900,0,43900,92300,1500,137700,A1,AG/GEN,,,
9963,6-1-0-27-0,6823-81-3761,SNGL FAM SUB,8.236,AC,76600,0,76600,237500,35000,349100,75200,0,75200,207600,30500,313300,A1,AG/GEN,,,
9964,31-1-0-75-A,6779-52-6791,SNGL FAM SUB,8.68,AC,130000,0,130000,53100,4700,187800,116000,0,116000,44500,2900,163400,A2,AG/LTD,,,
9965,43-19-0-2-0,6767-73-0620,SNGL FAM SUB,3.65,AC,92700,0,92700,0,0,92700,82600,0,82600,0,0,82600,A2,AG/LTD,,,
9966,43-19-0-3-0,6767-73-4276,SNGL FAM SUB,3.96,AC,72100,0,72100,0,0,72100,64200,0,64200,0,0,64200,A2,AG/LTD,,,
9967,43-1-0-37-A,6767-64-3107,SNGL FAM SUB,1.25,AC,67700,0,67700,129200,1000,197900,60400,0,60400,108700,1000,170100,A2,AG/LTD,,,
9968,43-1-0-53-0,6777-08-0355,SNGL FAM SUB,3.76,AC,103800,0,103800,73600,7000,184400,92800,0,92800,65200,7000,165000,A2,AG/LTD,,,
9969,43-19-0-1-0,6767-63-9267,SNGL FAM SUB,4.359,AC,100400,0,100400,162400,0,262800,89400,0,89400,127000,0,216400,A2,AG/LTD,,,
9971,29-1-0-94-0,6759-06-1590,SNGL FAM SUB,3.354,AC,76900,0,76900,98800,800,176500,73200,0,73200,81800,800,155800,A1,AG/GEN,,,
9972,43-1-0-37-D,6767-63-4976,SNGL FAM SUB,3.68,AC,94700,0,94700,89900,2000,186600,84500,0,84500,75800,2000,162300,A2,AG/LTD,,,
9973,43-12-0-3-0,6767-99-4357,SNGL FAM SUB,5.25,AC,107000,0,107000,146600,28100,281700,95500,0,95500,119300,24000,238800,A2,AG/LTD,,,
9974,29-5-0-2-C,6749-74-7515,SNGL FAM SUB,1.264,AC,56600,0,56600,198400,500,255500,52500,0,52500,156100,500,209100,A1,AG/GEN,,,
9975,29-5-0-2-B,6749-74-6306,SNGL FAM SUB,1.823,AC,62200,0,62200,201100,39500,302800,58000,0,58000,165900,35100,259000,A1,AG/GEN,,,
9976,13-2-0-1-0,6841-97-1900,SNGL FAM SUB,4.877,AC,77600,0,77600,125800,4500,207900,76100,0,76100,110400,4500,191000,A1,AG/GEN,,,
9977,43-19-0-4-0,6767-72-3974,SNGL FAM SUB,3.582,AC,69000,0,69000,261800,0,330800,61500,0,61500,0,0,61500,A2,AG/LTD,,,
9978,45-1-0-112-0,6798-70-3779,SNGL FAM SUB,2.32,AC,77800,0,77800,246000,0,323800,69400,0,69400,200300,0,269700,A2,AG/LTD,,,
9979,46-1-0-97-E,7718-00-3099,SNGL FAM SUB,1.08,AC,98500,0,98500,241500,35800,375800,89600,0,89600,200800,33100,323500,A2,AG/LTD,,,
9980,56-1-0-46-0,6796-51-4169,AG 20-100 AC,23,AC,776800,0,776800,1478600,296500,2551900,675000,0,675000,1359100,282900,2317000,A2,AG/LTD,,,
9981,46-1-0-9-D,7707-07-5725,SNGL FAM SUB,6.83,AC,228400,0,228400,0,0,228400,203800,0,203800,0,0,203800,A2,AG/LTD,,,
9982,39-1-0-15-0,6727-15-6131,SNGL FAM SUB,2,AC,44400,5100,39300,42900,0,87300,43500,5100,38400,37200,0,80700,A1,AG/GEN,,,
9983,46-9-0-B-1A,7707-58-3189,SNGL FAM SUB,3.93,AC,135400,0,135400,231900,11500,378800,123200,0,123200,194200,9800,327200,A2,AG/LTD,,,
9984,39-1-0-52-A,6717-82-5723,SNGL FAM SUB,6.215,AC,68000,0,68000,90400,33200,191600,66700,0,66700,77600,27400,171700,A1,AG/GEN,,,
9985,39-1-0-52-B,6717-72-9097,SNGL FAM SUB,5.18,AC,62200,0,62200,87400,6300,155900,61000,0,61000,72600,6600,140200,A1,AG/GEN,,,
9988,57-1-0-30-0,7706-12-1134,SNGL FAM SUB,1.5,AC,60700,0,60700,0,0,60700,52800,0,52800,0,0,52800,A2,AG/LTD,,,
9989,57-1-0-30-A,7706-02-9118,SNGL FAM SUB,0.5,AC,47500,0,47500,19200,100,66800,41300,0,41300,16800,100,58200,A2,AG/LTD,,,
9990,64-12-B-11-0,7724-60-3057,SNGL FAM SUB,0,AC,77000,0,77000,261100,3000,341100,67000,0,67000,224300,3000,294300,R1,RES/LTD,,,
9991,67-2-E-1-0,7723-65-1929,SNGL FAM SUB,0,AC,184000,0,184000,260800,300,445100,160000,0,160000,224100,300,384400,R1,RES/LTD,,,
9992,58-2-0-18-0,7726-36-2362,SNGL FAM SUB,0,AC,88000,0,88000,143400,25100,256500,80000,0,80000,121700,21300,223000,RN,RESIDEN,,,
9993,58-2-0-28-0,7726-36-4421,SNGL FAM SUB,0,AC,42600,0,42600,0,0,42600,38800,0,38800,0,0,38800,RN,RESIDEN,,,
9995,18-1-0-27-0,6719-87-4327,AG 20-100 AC,23.71,AC,104600,0,104600,0,5000,109600,113400,0,113400,0,500,113900,A1,AG/GEN,,,
9996,27-1-0-1-0,6719-66-5414,AG 20-100 AC,57.77,AC,190300,0,190300,0,0,190300,223600,0,223600,0,0,223600,A1,AG/GEN,,,
9997,27-1-0-4-A,6719-76-6084,AG 20-100 AC,46.6,AC,265900,0,265900,147000,30400,443300,266000,0,266000,119100,40600,425700,A1,AG/GEN,,,
9998,47-23-0-7-0,7717-21-7901,SNGL FAM SUB,2.147,AC,112600,0,112600,225300,1300,339200,100500,0,100500,187900,1300,289700,A2,AG/LTD,,,
9999,62-2-B-15-0,7704-94-8756,SNGL FAM SUB,0,AC,115000,0,115000,267000,0,382000,100000,0,100000,245600,0,345600,R1,RES/LTD,,,
10000,67-10-0-11-0,7733-05-5441,SNGL FAM SUB,2.5,AC,323000,0,323000,664900,2400,990300,270800,0,270800,584600,2500,857900,R1,RES/LTD,,,
10001,67-10-0-11-A,7733-05-4220,SNGL FAM SUB,0.25,AC,12000,0,12000,0,18200,30200,10000,0,10000,0,16800,26800,R1,RES/LTD,,,
10002,58-21-B-7-0,7716-23-2625,SNGL FAM SUB,1.556,AC,310000,0,310000,686100,12300,1008400,285000,0,285000,652200,10500,947700,A2,AG/LTD,,,
10003,5-1-0-36-B,6823-07-2132,SNGL FAM SUB,3.01,AC,50000,0,50000,384500,500,435000,49100,0,49100,341100,500,390700,A1,AG/GEN,,,
10004,6-8-0-D-0,6833-82-4807,SNGL FAM SUB,3.11,AC,50800,0,50800,149900,6600,207300,49800,0,49800,126200,6200,182200,A1,AG/GEN,,,
10005,42-1-0-67-0,6757-89-8380,SNGL FAM SUB,16.7,AC,261900,200100,61800,102600,2000,366500,238300,181700,56600,85200,2000,325500,A2,AG/LTD,,,
10006,29-1-0-138-0,6748-95-2619,SNGL FAM SUB,7.5,AC,60400,56900,3500,0,0,60400,60000,56800,3200,0,0,60000,A1,AG/GEN,,,
10007,29-1-0-139-0,6758-06-7785,SNGL FAM SUB,10,AC,105600,100600,5000,0,0,105600,103100,98800,4300,0,0,103100,A1,AG/GEN,,,
10008,29-1-0-140-0,6758-06-2467,SNGL FAM SUB,5.12,AC,45800,43400,2400,0,0,45800,44600,42400,2200,0,0,44600,A1,AG/GEN,,,
10009,29-1-0-141-0,6758-05-2600,SNGL FAM SUB,4.94,AC,47400,45100,2300,0,0,47400,43200,41100,2100,0,0,43200,A1,AG/GEN,,,
10010,29-1-0-142-0,6758-05-8554,SNGL FAM SUB,5,AC,47300,44700,2600,0,0,47300,43700,41500,2200,0,0,43700,A1,AG/GEN,,,
10011,30-1-0-28-A,6758-27-2417,AG 20-100 AC,89.59,AC,650100,606100,44000,0,0,650100,639700,601300,38400,0,0,639700,A1A2,AG GEN/,,,
10012,30-1-0-31-0,6758-25-7732,SNGL FAM SUB,2.16,AC,59000,57900,1100,0,0,59000,55800,54900,900,0,0,55800,A2,AG/LTD,,,
10013,30-1-0-32-0,6758-15-5598,AG 20-100 AC,49.51,AC,408800,331500,77300,289700,38700,737200,404000,333400,70600,241000,36000,681000,A1A2,AG GEN/,,,
10014,30-1-0-33-0,6758-16-4143,SNGL FAM SUB,13.02,AC,117600,111200,6400,0,0,117600,113400,107900,5500,0,0,113400,A1A2,AG GEN/,,,
10015,30-1-0-28-0,6758-27-9958,SNGL FAM SUB,4.512,AC,87400,0,87400,774700,31100,893200,82900,0,82900,628100,42000,753000,A2,AG/LTD,,,
10016,21-1-0-34-A,6759-38-8305,SNGL FAM SUB,4.459,AC,91100,0,91100,208300,12800,312200,82400,0,82400,177300,12300,272000,A2,AG/LTD,,,
10017,43-20-0-27-0,6768-51-2574,SNGL FAM SUB,3.66,AC,96800,0,96800,163900,10800,271500,88000,0,88000,143400,10100,241500,A2,AG/LTD,,,
10018,47-22-0-E-0,7718-80-6573,SNGL FAM SUB,10,AC,252000,0,252000,191800,29400,473200,225200,0,225200,159400,25100,409700,A2,AG/LTD,,,
10020,38-2-0-6-0,6718-00-5350,SNGL FAM SUB,1.33,AC,40600,0,40600,144000,1200,185800,39800,0,39800,119700,1300,160800,A1,AG/GEN,,,
10021,38-2-0-2-0,6718-00-6639,SNGL FAM SUB,1.182,AC,39800,0,39800,0,0,39800,39000,0,39000,0,0,39000,A1,AG/GEN,,,
10022,4-3-0-4-0,6813-14-2453,SNGL FAM SUB,1.27,AC,44300,0,44300,205200,7100,256600,43300,0,43300,173700,6500,223500,A1,AG/GEN,,,
10023,58-3-A-18-0,7726-26-6209,SNGL FAM SUB,0,AC,88000,0,88000,127200,1300,216500,80000,0,80000,105900,1300,187200,RN,RESIDEN,,,
10026,58-2-0-6-0,7726-26-9357,SNGL FAM SUB,0,AC,88000,0,88000,140600,32700,261300,80000,0,80000,120800,28000,228800,RN,RESIDEN,,,
10027,25-1-0-6-A,5798-69-7114,AG 20-100 AC,35.05,AC,105200,87300,17900,0,0,105200,105200,90100,15100,0,0,105200,A1,AG/GEN,,,
10028,25-1-0-7-0,5798-95-3874,AG > 100 AC,243,AC,486000,362100,123900,0,0,486000,486000,381500,104500,0,0,486000,A1,AG/GEN,,,
10029,25-2-0-1-0,5798-77-7532,AG 20-100 AC,41.3,AC,123900,102800,21100,0,0,123900,123900,106100,17800,0,0,123900,A1,AG/GEN,,,
10030,26-2-0-1-0,6708-38-9023,AG > 100 AC,340.7,AC,202200,0,202200,41300,8900,252400,182600,0,182600,36700,8900,228200,A1,AG/GEN,,,
10031,26-2-0-1-A,6708-69-8841,SNGL FAM SUB,2,AC,1000,0,1000,0,0,1000,900,0,900,0,0,900,A1,AG/GEN,,,
10032,26-2-0-2-0,6708-78-5558,AG 20-100 AC,21.004,AC,150800,0,150800,247200,5500,403500,148000,0,148000,213300,5900,367200,RR,RES/RUR,,,
10033,26-2-0-2-C,6708-79-0092,SNGL FAM SUB,2.22,AC,46200,0,46200,399800,600,446600,45300,0,45300,341900,600,387800,A1,AG/GEN,,,
10034,26-2-0-2-E,6708-99-4869,SNGL FAM SUB,8.05,AC,81800,0,81800,177000,200,259000,80300,0,80300,150000,200,230500,A1,AG/GEN,,,
10035,26-2-0-2-F,6708-99-2773,SNGL FAM SUB,8.05,AC,81800,0,81800,250600,0,332400,80300,0,80300,235500,0,315800,A1,AG/GEN,,,
10036,26-2-0-3-0,6708-39-2560,AG 20-100 AC,55.15,AC,25400,0,25400,0,0,25400,23400,0,23400,0,0,23400,A1,AG/GEN,,,
10037,26-2-0-3-D,6709-91-1784,SNGL FAM SUB,6,AC,66800,0,66800,251200,0,318000,65500,0,65500,221100,0,286600,A1,AG/GEN,,,
10038,20-1-0-25-A,6840-21-4517,SNGL FAM SUB,4,AC,82200,80400,1800,0,0,82200,74800,73100,1700,0,0,74800,A1,AG/GEN,,,
10039,18-4-0-1-0,6810-91-2148,AG 20-100 AC,30,AC,151800,91700,60100,201700,800,354300,149400,92200,57200,162900,800,313100,A1,AG/GEN,,,
10040,21-4-0-4-0,6759-47-7906,SNGL FAM SUB,3.61,AC,85500,0,85500,162300,900,248700,77000,0,77000,133900,900,211800,A2,AG/LTD,,,
10041,4-2-0-6-0,6814-10-9466,SNGL FAM SUB,4.39,AC,62400,0,62400,0,0,62400,61100,0,61100,0,0,61100,A1,AG/GEN,,,
10042,4-2-0-7-0,6814-10-7301,SNGL FAM SUB,2.514,AC,51500,0,51500,453800,0,505300,50400,0,50400,405900,0,456300,A1,AG/GEN,,,
10043,67-2-C-16-0,7723-55-5093,SNGL FAM SUB,0,AC,184000,0,184000,354500,0,538500,160000,0,160000,304300,0,464300,R1,RES/LTD,,,
10044,57-26-0-4-0,7706-51-3268,SNGL FAM SUB,5.09,AC,267600,0,267600,450300,0,717900,232700,0,232700,385900,0,618600,A2,AG/LTD,,,
10045,12-1-0-3-0,6822-76-8232,SNGL FAM SUB,2.462,AC,52200,0,52200,137900,4100,194200,50700,0,50700,120600,4100,175400,A1,AG/GEN,,,
10047,44-1-0-11-0,6777-82-9523,AG 20-100 AC,86.552,AC,1023400,879200,144200,548100,2500,1574000,914200,784400,129800,447500,2500,1364200,A2,AG/LTD,,,
10048,55-1-0-78-A,6785-69-3775,SNGL FAM SUB,3.36,AC,105700,0,105700,288100,2300,396100,94500,0,94500,242900,2300,339700,A2,AG/LTD,,,
10049,13-1-0-20-A,6841-65-4986,SNGL FAM SUB,3.55,AC,72000,0,72000,228700,9200,309900,70700,0,70700,203300,8900,282900,A1,AG/GEN,,,
10050,13-1-0-20-0,6841-56-8430,SNGL FAM SUB,11.5,AC,137300,0,137300,19300,300,156900,134700,0,134700,15000,300,150000,A1,AG/GEN,,,
10052,27-1-0-27-0,6728-32-3736,SNGL FAM SUB,2.68,AC,49000,0,49000,49100,12300,110400,48100,0,48100,42500,10300,100900,A1,AG/GEN,,,
10053,28-1-0-60-0,6739-10-2161,SNGL FAM SUB,1.02,AC,40200,0,40200,21700,800,62700,39600,0,39600,18800,800,59200,A1,AG/GEN,,,
10054,29-1-0-54-0,6749-50-7754,SNGL FAM SUB,19.35,AC,202300,0,202300,0,0,202300,193000,0,193000,0,0,193000,A1,AG/GEN,,,
10055,29-1-0-81-0,6749-87-0137,SNGL FAM SUB,17,AC,195100,0,195100,82800,3100,281000,190700,0,190700,68100,3100,261900,A1,AG/GEN,,,
10056,29-1-0-89-0,6749-97-0521,SNGL FAM SUB,18.07,AC,201700,0,201700,6000,1000,208700,200100,0,200100,5700,1000,206800,A1,AG/GEN,,,
10057,29-4-0-2-0,6759-16-3925,SNGL FAM SUB,2.5,AC,68900,0,68900,0,0,68900,64800,0,64800,0,0,64800,A1,AG/GEN,,,
10058,27-1-0-30-0,6728-33-4531,SNGL FAM SUB,5.005,AC,63200,0,63200,126400,100,189700,62000,0,62000,107300,100,169400,A1,AG/GEN,,,
10059,67-2-D-10-0,7723-54-8665,SNGL FAM SUB,0,AC,184000,0,184000,289500,0,473500,160000,0,160000,241500,0,401500,R1,RES/LTD,,,
10060,27-1-0-11-0,6719-60-1704,SNGL FAM SUB,0.896,AC,34800,0,34800,169100,4200,208100,34000,0,34000,113100,3000,150100,A1,AG/GEN,,,
10061,17-1-0-61-0,6810-46-2312,SNGL FAM SUB,3.126,AC,52700,0,52700,166200,2500,221400,51800,0,51800,134800,2500,189100,A1,AG/GEN,,,
10062,12-1-0-34-0,6831-13-2711,AG 20-100 AC,38.68,AC,225200,0,225200,0,0,225200,216600,0,216600,0,0,216600,A1,AG/GEN,,,
10063,47-25-0-14-0,7727-00-1214,SNGL FAM SUB,1.1,AC,129200,0,129200,307800,2900,439900,115300,0,115300,256500,3200,375000,A2,AG/LTD,,,
10064,27-1-0-32-0,6728-44-0395,SNGL FAM SUB,3.5,AC,54100,0,54100,0,0,54100,53000,0,53000,0,0,53000,A1,AG/GEN,,,
10066,40-1-0-41-0,6738-71-0754,SNGL FAM SUB,17.507,AC,41600,33500,8100,0,0,41600,40300,32900,7400,0,0,40300,A1,AG/GEN,,,
10067,56-1-0-54-0,6796-06-4233,AG 20-100 AC,36.34,AC,578900,414200,164700,796900,62200,1438000,516800,369200,147600,644000,56900,1217700,A2,AG/LTD,,,
10068,12-1-0-34-C,6831-03-4750,SNGL FAM SUB,1,AC,40000,0,40000,98800,0,138800,39500,0,39500,81400,0,120900,A1,AG/GEN,,,
10069,5-1-0-45-0,6823-17-8669,SNGL FAM SUB,3.504,AC,57700,0,57700,318500,4600,380800,56700,0,56700,288900,3300,348900,A1,AG/GEN,,,
10071,27-1-0-70-B,6729-61-3130,AG 20-100 AC,22.699,AC,81700,0,81700,0,0,81700,79400,0,79400,0,0,79400,A1,AG/GEN,,,
10072,10-1-0-1-0,6802-66-4910,AG 20-100 AC,69.468,AC,227200,195200,32000,0,0,227200,222300,192800,29500,0,0,222300,A1,AG/GEN,,,
10074,5-3-0-30-0,6824-10-7839,SNGL FAM SUB,4.11,AC,70500,0,70500,0,0,70500,69100,0,69100,0,0,69100,A1,AG/GEN,,,
10075,27-4-0-2-0,6728-48-5924,AG 20-100 AC,30.311,AC,202900,0,202900,880600,34500,1118000,199200,111600,87600,794600,32300,1026100,A1,AG/GEN,,,
10076,27-1-0-14-B,6718-59-8857,SNGL FAM SUB,2.76,AC,49500,0,49500,51400,300,101200,48600,0,48600,45700,300,94600,A1,AG/GEN,,,
10078,38-1-0-108-0,6717-09-5918,SNGL FAM SUB,5,AC,61200,0,61200,0,0,61200,60000,0,60000,0,0,60000,A1,AG/GEN,,,
10080,4-2-0-5-0,6814-20-0695,SNGL FAM SUB,2.45,AC,51100,0,51100,176700,800,228600,50100,0,50100,149700,800,200600,A1,AG/GEN,,,
10081,60-1-0-3-G,6775-90-6192,SNGL FAM SUB,0.31,AC,1800,0,1800,0,0,1800,1600,0,1600,0,0,1600,A2,AG/LTD,,,
10082,60-1-0-13-0,6784-15-5289,SNGL FAM SUB,1,AC,3400,0,3400,0,0,3400,3000,0,3000,0,0,3000,A2,AG/LTD,,,
10083,27-1-0-14-A,6719-50-8117,SNGL FAM SUB,2.77,AC,49600,0,49600,163000,0,212600,48600,0,48600,138100,0,186700,A1,AG/GEN,,,
10084,27-1-0-14-0,6718-59-2314,AG 20-100 AC,26.98,AC,151100,0,151100,0,0,151100,148400,0,148400,0,0,148400,A1,AG/GEN,,,
10085,27-1-0-16-0,6718-56-8647,SNGL FAM SUB,7.8,AC,58500,0,58500,0,0,58500,57500,0,57500,0,0,57500,A1,AG/GEN,,,
10086,12-1-0-34-A,6831-14-1364,SNGL FAM SUB,1,AC,42000,0,42000,77500,2200,121700,39500,0,39500,64700,2200,106400,A1,AG/GEN,,,
10087,26-1-0-25-0,6718-07-9693,AG 20-100 AC,47.5,AC,252700,190400,62300,234600,22000,509300,247300,189300,58000,198800,22000,468100,A1,AG/GEN,,,
10088,38-1-0-9-0,6707-99-9639,SNGL FAM SUB,1.82,AC,43400,0,43400,132000,600,176000,42500,0,42500,111900,600,155000,A1,AG/GEN,,,
10089,38-1-0-12-0,6707-99-0037,SNGL FAM SUB,1,AC,38800,0,38800,151800,0,190600,38000,0,38000,147600,0,185600,A1,AG/GEN,,,
10090,64-4-2-11-0,7724-94-4017,SNGL FAM SUB,0,AC,70000,0,70000,111200,3200,184400,60000,0,60000,96600,2800,159400,RN,RESIDEN,,,
10091,27-1-0-19-0,6718-66-6362,SNGL FAM SUB,5.775,AC,65500,0,65500,147300,1200,214000,64300,0,64300,124700,1300,190300,A1,AG/GEN,,,
10092,38-1-0-52-0,6707-60-8456,SNGL FAM SUB,5,AC,61200,0,61200,0,0,61200,60000,0,60000,0,0,60000,A1,AG/GEN,,,
10093,27-1-0-4-0,6719-83-1225,AG 20-100 AC,20,AC,126700,117500,9200,0,0,126700,120200,111700,8500,0,0,120200,A1,AG/GEN,,,
10094,27-9-0-A-0,6719-83-2818,AG 20-100 AC,40,AC,217000,119300,97700,368800,9400,595200,215500,119700,95800,301000,9400,525900,A1,AG/GEN,,,
10095,27-9-0-C-0,6719-84-2552,AG 20-100 AC,20.04,AC,117600,108400,9200,0,0,117600,108700,100200,8500,0,0,108700,A1,AG/GEN,,,
10096,67-2-E-10-0,7723-64-2487,SNGL FAM SUB,0,AC,184000,0,184000,469900,47400,701300,160000,0,160000,397500,40600,598100,R1,RES/LTD,,,
10097,58-21-D-3-0,7716-32-7606,SNGL FAM SUB,4.04,AC,365000,0,365000,1037500,0,1402500,335000,0,335000,959400,0,1294400,R3,RES/GEN,,,
10098,46-23-0-41-0,7717-06-6036,SNGL FAM SUB,3.023,AC,165000,0,165000,238300,51800,455100,150000,0,150000,197800,46300,394100,A2,AG/LTD,,,
10099,46-13-0-2-0,7717-07-5194,SNGL FAM SUB,1,AC,17000,0,17000,0,0,17000,15200,0,15200,0,0,15200,A2,AG/LTD,,,
10100,46-13-0-3-0,7717-07-6091,SNGL FAM SUB,1.03,AC,92900,0,92900,369800,7800,470500,83000,0,83000,309900,8000,400900,A2,AG/LTD,,,
10101,2-1-0-26-0,6814-72-3839,SNGL FAM SUB,1.01,AC,39800,0,39800,0,0,39800,39100,0,39100,0,0,39100,A1,AG/GEN,,,
10102,2-1-0-27-0,6814-73-2030,SNGL FAM SUB,0.94,AC,37300,0,37300,53100,1500,91900,36700,0,36700,47200,1500,85400,A1,AG/GEN,,,
10103,28-1-0-45-A,6738-73-3333,SNGL FAM SUB,2.496,AC,59600,0,59600,0,0,59600,58300,0,58300,0,0,58300,A1,AG/GEN,,,
10104,31-17-0-2-0,6779-33-9116,SNGL FAM SUB,1.5,AC,71300,0,71300,172700,2000,246000,63700,0,63700,137800,2000,203500,A2,AG/LTD,,,
10125,38-1-0-89-A,6717-05-0907,SNGL FAM SUB,13.56,AC,102900,0,102900,271600,38200,412700,100800,0,100800,230900,32100,363800,A1,AG/GEN,,,
10126,40-1-0-26-B,6737-20-5647,SNGL FAM SUB,10.03,AC,114500,0,114500,817000,60800,992300,112500,0,112500,799100,62300,973900,A1,AG/GEN,,,
10127,42-1-0-14-A,6757-73-9407,SNGL FAM SUB,9.21,AC,158400,0,158400,383900,26000,568300,141600,0,141600,321800,21900,485300,A2,AG/LTD,,,
10128,42-26-0-1-0,6767-37-4587,SNGL FAM SUB,1.51,AC,71400,0,71400,168100,0,239500,63800,0,63800,137700,0,201500,A2,AG/LTD,,,
10129,42-26-0-2-0,6767-37-7507,SNGL FAM SUB,1.51,AC,71400,0,71400,232700,11500,315600,63800,0,63800,191000,11500,266300,A2,AG/LTD,,,
10287,31-23-0-28-0,6768-94-3984,SNGL FAM SUB,1.5,AC,79200,0,79200,277000,3000,359200,72000,0,72000,232800,2200,307000,RR,RES/RUR,,,
10288,31-23-0-29-0,6768-84-7547,SNGL FAM SUB,3.64,AC,83200,0,83200,218500,1700,303400,75600,0,75600,188600,1600,265800,RR,RES/RUR,,,
10290,41-1-0-16-A,6747-69-4404,SNGL FAM SUB,4.29,AC,81200,0,81200,208400,1500,291100,78900,0,78900,185300,1500,265700,A1,AG/GEN,,,
10291,42-26-0-3-0,6767-37-9573,SNGL FAM SUB,1.51,AC,71400,0,71400,168700,20400,260500,63800,0,63800,137800,17600,219200,A2,AG/LTD,,,
10292,44-1-0-26-A,6777-92-4964,SNGL FAM SUB,2.005,AC,84000,0,84000,257400,1500,342900,75000,0,75000,210500,1500,287000,A2,AG/LTD,,,
10449,44-1-0-29-A,6787-02-4838,Cemetery,0,AC,100,0,100,0,0,100,100,0,100,0,0,100,A2,AG/LTD,,,
10450,44-7-0-A-1,6777-82-2713,Cemetery,0,AC,100,0,100,0,0,100,100,0,100,0,0,100,A2,AG/LTD,,,
10451,46-26-0-14-0,7707-56-7301,Cemetery,0.06,AC,100,0,100,0,0,100,100,0,100,0,0,100,RR,RES/RUR,,,
10452,48-13-0-E-0,7726-68-6976,Cemetery,0.16,AC,100,0,100,0,0,100,100,0,100,0,0,100,A2,AG/LTD,,,
10453,63-30-0-C-0,7714-69-3847,Cemetery,0.45,AC,100,0,100,0,0,100,100,0,100,0,0,100,A2,AG/LTD,,,
10454,44-7-0-A-2,6777-82-6399,Cemetery,0,AC,100,0,100,0,0,100,100,0,100,0,0,100,A2,AG/LTD,,,
10455,63-1-0-4-0,7715-21-8472,Cemetery,2,AC,100,0,100,0,0,100,100,0,100,0,0,100,A2,AG/LTD,,,
10456,45-1-0-31-0,6787-84-4290,Place of Worship,1.91,AC,84500,0,84500,717800,0,802300,75400,0,75400,671700,0,747100,A2,AG/LTD,,,
10457,63-1-0-21-0,7714-36-7353,Place of Worship,0,AC,170000,0,170000,570400,95000,835400,147800,0,147800,563300,44700,755800,R3,RES/GEN,,,
10458,63-1-0-22-0,7714-36-9268,Other Religious,2.224,AC,148000,0,148000,1142300,44100,1334400,128700,0,128700,1140700,30400,1299800,R3,RES/GEN,,,
10459,63-1-0-116-0,7715-50-4805,Place of Worship,4.13,AC,172300,0,172300,200000,0,372300,149700,0,149700,195300,0,345000,A2,AG/LTD,,,
10460,63-1-0-41-0,7714-33-7811,Place of Worship,1.41,AC,159200,0,159200,409400,1500,570100,138500,0,138500,402200,1500,542200,R3,RES/GEN,,,
10461,55-1-0-69-0,6786-62-4964,Place of Worship,2.9,AC,239800,0,239800,1191900,9600,1441300,214000,0,214000,1112100,0,1326100,A2,AG/LTD,,,
10462,55-1-0-48-0,6786-63-0073,Vacant Land,2.5,AC,94900,0,94900,0,0,94900,84700,0,84700,0,0,84700,A2,AG/LTD,,,
10463,46-1-0-103-0,7717-08-2292,Place of Worship,10.67,AC,440200,0,440200,2347200,30200,2817600,392700,0,392700,2220000,27000,2639700,A2,AG/LTD,,,
10464,46-1-0-107-0,7717-07-8622,Vacant Land,1.276,AC,84800,0,84800,0,0,84800,75700,0,75700,0,0,75700,A2,AG/LTD,,,
10465,46-5-0-A-0T,7717-07-7800,Vacant Land,2.452,AC,105500,0,105500,0,0,105500,94200,0,94200,0,0,94200,A2,AG/LTD,,,
10466,56-1-0-82-0,6795-88-3366,Place of Worship,1,AC,246100,0,246100,1409500,200,1655800,214000,0,214000,1339200,200,1553400,A2,AG/LTD,,,
10467,56-1-0-83-0,6795-88-4225,Place of Worship,0.29,AC,8800,0,8800,0,0,8800,7600,0,7600,0,0,7600,A2,AG/LTD,,,
10468,56-1-0-83-A,6795-88-4102,Place of Worship,2.08,AC,65100,0,65100,0,0,65100,56600,0,56600,0,0,56600,A2,AG/LTD,,,
10469,45-1-0-96-0,7707-08-1012,Place of Worship,5.85,AC,209600,0,209600,1161300,0,1370900,187300,0,187300,1108000,0,1295300,A2,AG/LTD,,,
10470,46-1-0-7-0,7707-26-2462,Cemetery,2.08,AC,100,0,100,0,0,100,100,0,100,0,0,100,A2,AG/LTD,,,
10472,59-1-0-6-0,7726-67-1167,COMM & IND,4.5,AC,2777500,0,2777500,350900,24200,3152600,2370000,0,2370000,304700,18000,2692700,R3,RES/GEN,,,
10473,47-3-0-C-2,7717-95-1748,SNGL FAM SUB,0.74,AC,73300,0,73300,145300,1000,219600,65400,0,65400,122500,1000,188900,A2,AG/LTD,,,
10474,57-1-0-64-0,7716-17-2349,Place of Worship,4.411,AC,255200,0,255200,374000,6300,635500,227800,0,227800,355300,4500,587600,A2,AG/LTD,,,
10659,44-24-0-2-0,6777-83-8231,SNGL FAM SUB,2.01,AC,84000,0,84000,0,0,84000,75000,0,75000,0,0,75000,A2,AG/LTD,,,
10660,44-24-0-3-0,6777-83-5480,SNGL FAM SUB,2.01,AC,84000,0,84000,0,0,84000,75000,0,75000,0,0,75000,A2,AG/LTD,,,
10661,44-24-0-4-0,6777-83-4240,SNGL FAM SUB,5.857,AC,119500,0,119500,0,0,119500,106700,0,106700,0,0,106700,A2,AG/LTD,,,
10662,56-1-0-15-M,6785-85-3562,SNGL FAM SUB,1.5,AC,77700,0,77700,126400,800,204900,69400,0,69400,100400,900,170700,A2,AG/LTD,,,
10666,45-1-0-130-B,6797-48-8524,SNGL FAM SUB,0.28,AC,3800,0,3800,0,0,3800,3800,0,3800,0,0,3800,A2,AG/LTD,,,
10130,42-26-0-4-0,6767-37-7353,SNGL FAM SUB,2.01,AC,78000,0,78000,179900,7900,265800,69600,0,69600,147400,6700,223700,A2,AG/LTD,,,
10131,42-26-0-5-0,6767-37-2246,SNGL FAM SUB,10.1,AC,95000,0,95000,0,0,95000,84500,0,84500,0,0,84500,A2,AG/LTD,,,
10132,43-1-0-57-F,6768-81-3446,SNGL FAM SUB,2,AC,87100,0,87100,187400,600,275100,79200,0,79200,168500,600,248300,A2,AG/LTD,,,
10133,43-24-0-1-0,6777-08-3751,SNGL FAM SUB,1.5,AC,79200,0,79200,218800,2500,300500,72000,0,72000,191100,2500,265600,RR,RES/RUR,,,
10135,43-24-0-2-0,6777-09-4034,SNGL FAM SUB,2,AC,79200,0,79200,231100,29900,340200,72000,0,72000,204700,25200,301900,RR,RES/RUR,,,
10136,43-24-0-3-0,6777-09-5410,SNGL FAM SUB,2,AC,79200,0,79200,186100,18700,284000,72000,0,72000,162400,15300,249700,RR,RES/RUR,,,
10137,43-24-0-4-0,6777-09-6706,SNGL FAM SUB,2,AC,79200,0,79200,213800,1000,294000,72000,0,72000,186200,1000,259200,RR,RES/RUR,,,
10138,43-24-0-5-0,6778-00-6163,SNGL FAM SUB,2.01,AC,79200,0,79200,187800,17400,284400,72000,0,72000,164600,14900,251500,RR,RES/RUR,,,
10139,43-24-0-6-0,6778-00-9327,SNGL FAM SUB,2.27,AC,79200,0,79200,199900,0,279100,72000,0,72000,177000,0,249000,RR,RES/RUR,,,
10140,43-24-0-7-0,6778-10-0113,SNGL FAM SUB,2.01,AC,79200,0,79200,227400,5500,312100,72000,0,72000,202300,3800,278100,RR,RES/RUR,,,
10141,43-24-0-8-0,6777-09-8799,SNGL FAM SUB,2,AC,79200,0,79200,220300,3000,302500,72000,0,72000,190900,3000,265900,RR,RES/RUR,,,
10142,43-24-0-9-0,6777-09-8416,SNGL FAM SUB,2,AC,79200,0,79200,192500,2300,274000,72000,0,72000,168600,2300,242900,RR,RES/RUR,,,
10143,43-24-0-10-0,6777-09-7029,SNGL FAM SUB,2,AC,79200,0,79200,185000,2500,266700,72000,0,72000,161100,2500,235600,RR,RES/RUR,,,
10144,43-24-0-11-0,6777-08-6745,SNGL FAM SUB,1.55,AC,79200,0,79200,191200,5500,275900,72000,0,72000,166900,5500,244400,A2,AG/LTD,,,
10145,43-25-0-1-0,6767-47-4522,SNGL FAM SUB,1.88,AC,71300,0,71300,351000,0,422300,64800,0,64800,308500,0,373300,A2,AG/LTD,,,
10146,43-25-0-2-0,6767-47-6524,SNGL FAM SUB,1.51,AC,67300,0,67300,244100,32300,343700,61200,0,61200,213500,32300,307000,A2,AG/LTD,,,
10147,43-25-0-3-0,6767-47-6223,SNGL FAM SUB,2.47,AC,79200,0,79200,267400,15600,362200,72000,0,72000,232600,15600,320200,A2,AG/LTD,,,
10148,44-15-1-20-A,6776-99-3006,SNGL FAM SUB,14.15,AC,241600,0,241600,0,0,241600,215200,0,215200,0,0,215200,A2,AG/LTD,,,
10149,44-19-0-16-A,6778-82-8158,Roads,0.59,AC,0,0,0,0,0,0,0,0,0,0,0,0,A2,AG/LTD,,,
10151,44-22-0-2-0,6786-78-8475,SNGL FAM SUB,7.64,AC,206200,0,206200,803800,0,1010000,183900,0,183900,663600,0,847500,A2,AG/LTD,,,
10152,44-22-0-3-0,6786-77-4953,SNGL FAM SUB,5.03,AC,160200,0,160200,0,0,160200,143000,0,143000,0,0,143000,A2,AG/LTD,,,
10153,44-22-0-4-0,6786-87-1813,SNGL FAM SUB,8.01,AC,212700,0,212700,702400,28300,943400,189800,0,189800,576700,26800,793300,A2,AG/LTD,,,
10154,44-22-0-5-0,6786-77-5544,SNGL FAM SUB,6.48,AC,185700,0,185700,670800,0,856500,165700,0,165700,563100,0,728800,A2,AG/LTD,,,
10155,44-22-0-6-0,6786-67-9441,SNGL FAM SUB,5.72,AC,163900,0,163900,420400,1000,585300,146300,0,146300,349000,1000,496300,A2,AG/LTD,,,
10156,44-22-0-7-0,6786-78-4619,SNGL FAM SUB,11.25,AC,251300,0,251300,368400,98800,718500,224200,0,224200,289300,85200,598700,A2,AG/LTD,,,
10157,44-23-0-1-0,6787-09-3180,SNGL FAM SUB,2.89,AC,96200,0,96200,231400,7300,334900,85800,0,85800,190000,6200,282000,A2,AG/LTD,,,
10158,44-23-0-2-0,6787-09-6105,SNGL FAM SUB,2.51,AC,90900,0,90900,275600,1000,367500,81200,0,81200,227600,1000,309800,A2,AG/LTD,,,
10159,44-23-0-3-0,6787-09-8210,SNGL FAM SUB,2.25,AC,87400,0,87400,260700,0,348100,78000,0,78000,211100,0,289100,A2,AG/LTD,,,
10160,44-23-0-4-0,6787-19-0238,SNGL FAM SUB,2.08,AC,85000,0,85000,242500,34200,361700,75900,0,75900,195500,29500,300900,A2,AG/LTD,,,
10161,44-23-0-5-0,6787-19-3319,SNGL FAM SUB,1.82,AC,81400,0,81400,156600,2000,240000,72700,0,72700,127400,2000,202100,A2,AG/LTD,,,
10162,45-1-0-81-A,6797-82-4847,SNGL FAM SUB,3.15,AC,109200,107600,1600,0,30400,139600,97500,96100,1400,0,26200,123700,A2,AG/LTD,,,
10166,46-1-0-25-A,7707-14-1377,SNGL FAM SUB,2.029,AC,120400,0,120400,0,0,120400,107500,0,107500,0,0,107500,A2,AG/LTD,,,
10167,46-29-0-1-0,7707-80-1698,SNGL FAM SUB,1.83,AC,117900,0,117900,255600,0,373500,105300,0,105300,213800,0,319100,A2,AG/LTD,,,
10169,46-29-0-2-0,7707-80-3682,SNGL FAM SUB,1.9,AC,119500,0,119500,244600,500,364600,106800,0,106800,212100,500,319400,A2,AG/LTD,,,
10170,46-29-0-3-0,7707-80-5576,SNGL FAM SUB,2.05,AC,122900,0,122900,383400,11600,517900,109800,0,109800,318600,11600,440000,A2,AG/LTD,,,
10171,46-29-0-4-0,7707-80-7459,SNGL FAM SUB,2.24,AC,127300,0,127300,377600,0,504900,113700,0,113700,314600,0,428300,A2,AG/LTD,,,
10172,46-29-0-5-0,7707-80-9431,SNGL FAM SUB,2.19,AC,126100,0,126100,421100,16500,563700,112700,0,112700,352300,14900,479900,A2,AG/LTD,,,
10173,47-1-0-41-C,7716-88-7992,COMM & IND,0.629,AC,431700,0,431700,0,0,431700,392500,0,392500,0,0,392500,MPUD,MIXPUD,,,
10174,47-2-0-C-1,7717-87-3199,SNGL FAM SUB,5,AC,167000,0,167000,158100,2600,327700,149200,0,149200,133800,2400,285400,A2,AG/LTD,,,
10175,56-1-0-42-A,6795-47-5332,Cemetery,0.6,AC,100,0,100,0,0,100,100,0,100,0,0,100,A2,AG/LTD,,,
10176,56-1-0-45-E,6796-20-3679,SNGL FAM SUB,7,AC,113400,110000,3400,0,0,113400,98600,95600,3000,0,0,98600,A2,AG/LTD,,,
10177,56-1-0-47-0,6795-77-9582,SNGL FAM SUB,17.45,AC,602700,0,602700,0,0,602700,524500,0,524500,0,0,524500,A2,AG/LTD,,,
10178,57-1-0-33-A,7706-21-2039,SNGL FAM SUB,17.592,AC,388600,0,388600,457000,0,845600,338000,0,338000,389200,0,727200,A2,AG/LTD,,,
10179,57-1-0-33-B,7706-21-5400,SNGL FAM SUB,3,AC,147500,0,147500,241500,21700,410700,128300,0,128300,203800,17800,349900,A2,AG/LTD,,,
10182,57-7-0-1-0,7705-95-5511,SNGL FAM SUB,2.247,AC,230000,0,230000,350500,2000,582500,210000,0,210000,324100,2100,536200,RR,RES/RUR,,,
10183,57-7-0-2-0,7705-95-5638,SNGL FAM SUB,2.182,AC,230000,0,230000,336600,500,567100,210000,0,210000,313300,500,523800,RR,RES/RUR,,,
10184,57-7-0-3-0,7705-96-6022,SNGL FAM SUB,3.09,AC,230000,0,230000,285100,0,515100,210000,0,210000,265400,0,475400,RR,RES/RUR,,,
10185,57-7-0-4-0,7705-96-3065,SNGL FAM SUB,3.121,AC,230000,0,230000,277600,2600,510200,210000,0,210000,263300,1900,475200,RR,RES/RUR,,,
10186,57-7-0-5-0,7705-96-6651,SNGL FAM SUB,3.061,AC,230000,0,230000,303600,0,533600,210000,0,210000,289100,0,499100,RR,RES/RUR,,,
10187,57-7-0-6-0,7705-96-4614,SNGL FAM SUB,3.128,AC,230000,0,230000,251500,5200,486700,210000,0,210000,236600,3800,450400,RR,RES/RUR,,,
10189,58-1-0-51-A,7715-98-6681,SNGL FAM SUB,4.8,AC,185900,0,185900,199000,25200,410100,161600,0,161600,168600,21600,351800,A2,AG/LTD,,,
10190,62-20-B-8-0,7714-16-6064,SNGL FAM SUB,0.574,AC,115000,0,115000,245100,800,360900,100000,0,100000,226800,800,327600,R1,RES/LTD,,,
10191,62-20-B-9-0,7714-16-7116,SNGL FAM SUB,0.574,AC,115000,0,115000,319200,17500,451700,100000,0,100000,287300,14800,402100,R1,RES/LTD,,,
10192,62-20-B-10-0,7714-16-7268,SNGL FAM SUB,0.574,AC,115000,0,115000,253700,500,369200,100000,0,100000,229300,500,329800,R1,RES/LTD,,,
10193,62-20-B-11-0,7714-16-8319,SNGL FAM SUB,0.574,AC,115000,0,115000,295600,39700,450300,100000,0,100000,267700,34100,401800,R1,RES/LTD,,,
10194,62-20-D-5-0,7714-16-0515,SNGL FAM SUB,0.626,AC,115000,0,115000,274500,1500,391000,100000,0,100000,248500,1000,349500,R1,RES/LTD,,,
10195,62-20-D-6-0,7714-16-1508,SNGL FAM SUB,0.635,AC,115000,0,115000,258100,1000,374100,100000,0,100000,236900,1000,337900,R1,RES/LTD,,,
10196,62-20-D-7-0,7714-16-2604,SNGL FAM SUB,0.635,AC,115000,0,115000,282900,0,397900,100000,0,100000,257600,0,357600,R1,RES/LTD,,,
10197,62-20-D-8-0,7714-16-3700,SNGL FAM SUB,0.65,AC,115000,0,115000,279900,0,394900,100000,0,100000,254900,0,354900,R1,RES/LTD,,,
10198,62-20-D-9-0,7714-16-4708,SNGL FAM SUB,0.701,AC,115000,0,115000,325400,3700,444100,100000,0,100000,296900,2600,399500,R1,RES/LTD,,,
10199,62-20-D-11-0,7714-16-7811,SNGL FAM SUB,1.34,AC,115000,0,115000,263300,500,378800,100000,0,100000,243800,500,344300,R1,RES/LTD,,,
10200,62-20-E-7-0,7714-16-3485,SNGL FAM SUB,0.935,AC,115000,0,115000,399600,17100,531700,100000,0,100000,363200,17500,480700,R1,RES/LTD,,,
10202,62-20-E-8-0,7714-16-6506,SNGL FAM SUB,0.568,AC,115000,0,115000,368700,0,483700,100000,0,100000,337800,0,437800,R1,RES/LTD,,,
10203,62-20-E-9-0,7714-16-5465,SNGL FAM SUB,0.551,AC,115000,0,115000,271300,0,386300,100000,0,100000,246500,0,346500,R1,RES/LTD,,,
10204,62-20-E-10-0,7714-16-5314,SNGL FAM SUB,0.551,AC,115000,0,115000,308900,0,423900,100000,0,100000,282100,0,382100,R1,RES/LTD,,,
10205,62-20-E-11-0,7714-16-4273,SNGL FAM SUB,0.551,AC,115000,0,115000,315400,0,430400,100000,0,100000,286900,0,386900,R1,RES/LTD,,,
10206,62-20-E-12-0,7714-16-4131,SNGL FAM SUB,0.551,AC,115000,0,115000,244900,0,359900,100000,0,100000,226400,0,326400,R1,RES/LTD,,,
10207,50-2-0-A-1,6726-14-2518,AG 20-100 AC,31.17,AC,112200,97800,14400,0,0,112200,109100,95900,13200,0,0,109100,A1,AG/GEN,,,
10208,51-1-0-45-A,6726-96-6215,SNGL FAM SUB,4.85,AC,60400,0,60400,151700,76900,289000,59200,0,59200,136800,60200,256200,A1,AG/GEN,,,
10209,55-1-0-13-0,6776-93-4282,SNGL FAM SUB,5.016,AC,127900,0,127900,226500,2000,356400,114400,0,114400,185700,2000,302100,A2,AG/LTD,,,
10210,58-1-0-29-0,7715-35-7520,SNGL FAM SUB,2.32,AC,401500,0,401500,831600,0,1233100,368500,0,368500,804300,0,1172800,A2,AG/LTD,,,
10211,62-20-B-12-0,7714-16-8561,SNGL FAM SUB,0.574,AC,115000,0,115000,291400,900,407300,100000,0,100000,265100,900,366000,R1,RES/LTD,,,
10212,62-20-B-13-0,7714-16-9603,SNGL FAM SUB,0.574,AC,115000,0,115000,289400,0,404400,100000,0,100000,264400,0,364400,R1,RES/LTD,,,
10213,62-20-B-14-0,7714-16-9755,SNGL FAM SUB,0.574,AC,115000,0,115000,534200,700,649900,100000,0,100000,481200,700,581900,R1,RES/LTD,,,
10214,62-20-D-10-0,7714-16-5821,SNGL FAM SUB,0.708,AC,115000,0,115000,262700,1500,379200,100000,0,100000,241900,1500,343400,R1,RES/LTD,,,
10215,62-20-E-6-0,7714-16-2372,SNGL FAM SUB,0.715,AC,115000,0,115000,312800,3200,431000,100000,0,100000,284200,3400,387600,R1,RES/LTD,,,
10216,63-1-0-14-A,7715-20-7177,Cemetery,0,AC,100,0,100,0,0,100,100,0,100,0,0,100,A2,AG/LTD,,,
10217,64-1-0-44-A,7724-93-9200,SNGL FAM SUB,7,AC,755200,0,755200,0,0,755200,694700,0,694700,0,0,694700,A2,AG/LTD,,,
10218,64-1-0-50-E,7734-02-2390,COMM & IND,0.3,AC,72600,0,72600,152700,28800,254100,67300,0,67300,151500,29700,248500,B1,BUS/GEN,,,
10220,64-1-0-83-A,7733-37-6536,SNGL FAM SUB,0.689,AC,265000,0,265000,573500,2000,840500,220000,0,220000,499000,2000,721000,R1,RES/LTD,,,
10221,64-4-2-16-B,7724-94-4870,Cemetery,0,AC,100,0,100,0,0,100,100,0,100,0,0,100,RN,RESIDEN,,,
10227,1-5-0-6-0,6804-97-8869,AG 20-100 AC,24.79,AC,148900,0,148900,155400,10500,314800,146100,0,146100,136000,10500,292600,A1,AG/GEN,,,
10228,1-5-0-7-0,6804-87-5438,SNGL FAM SUB,7.45,AC,72600,0,72600,152800,2400,227800,71300,0,71300,133100,1900,206300,A1,AG/GEN,,,
10229,5-10-0-1-A,6814-70-8920,SNGL FAM SUB,4,AC,55000,0,55000,0,3700,58700,54000,0,54000,0,3400,57400,A1,AG/GEN,,,
10230,18-10-0-1-0,6719-88-2798,SNGL FAM SUB,12.6,AC,102600,0,102600,0,0,102600,101800,0,101800,0,0,101800,A1,AG/GEN,,,
10231,18-10-0-1-A,6719-89-0853,SNGL FAM SUB,2.8,AC,50800,0,50800,0,0,50800,48800,0,48800,0,0,48800,A1,AG/GEN,,,
10232,18-10-0-2-0,6719-88-7871,SNGL FAM SUB,15.28,AC,116000,0,116000,0,0,116000,116500,0,116500,0,0,116500,A1,AG/GEN,,,
10233,18-10-0-3-0,6719-98-1862,SNGL FAM SUB,10.61,AC,84100,0,84100,0,0,84100,90900,0,90900,0,0,90900,A1,AG/GEN,,,
10234,18-10-0-3-A,6719-99-1319,Cemetery,0,AC,100,0,100,0,0,100,100,0,100,0,0,100,A1,AG/GEN,,,
10235,18-10-0-4-0,6810-90-3075,SNGL FAM SUB,3,AC,52000,0,52000,163700,21000,236700,50000,0,50000,134200,5700,189900,A1,AG/GEN,,,
10236,18-10-0-5-0,6719-99-8118,SNGL FAM SUB,16.57,AC,121700,0,121700,0,0,121700,123600,0,123600,0,0,123600,A1,AG/GEN,,,
10237,18-10-0-6-0,6729-09-3081,AG 20-100 AC,20.2,AC,129600,0,129600,6900,4600,141100,129200,0,129200,8000,4400,141600,A1,AG/GEN,,,
10238,27-10-0-1-0,6728-38-9404,SNGL FAM SUB,2.56,AC,49100,0,49100,227500,2700,279300,48100,0,48100,192400,1900,242400,A1,AG/GEN,,,
10239,27-10-0-2-0,6728-38-9941,SNGL FAM SUB,2.69,AC,50000,0,50000,217500,4100,271600,49000,0,49000,186900,4600,240500,A1,AG/GEN,,,
10240,27-10-0-3-0,6728-39-9392,SNGL FAM SUB,2.433,AC,48300,0,48300,307500,800,356600,51100,0,51100,295600,800,347500,A1,AG/GEN,,,
10241,27-10-0-4-0,6728-38-6527,SNGL FAM SUB,2.81,AC,50700,0,50700,0,0,50700,49800,0,49800,0,0,49800,A1,AG/GEN,,,
10242,27-10-0-5-0,6728-39-5014,SNGL FAM SUB,3.39,AC,54600,0,54600,243000,16800,314400,53500,0,53500,209400,1500,264400,A1,AG/GEN,,,
10243,27-10-0-6-0,6728-39-5376,SNGL FAM SUB,2.82,AC,50800,0,50800,210800,900,262500,49800,0,49800,179600,1000,230400,A1,AG/GEN,,,
10244,27-10-0-7-0,6728-39-0262,SNGL FAM SUB,4.36,AC,61000,0,61000,215000,20000,296000,59800,0,59800,182900,18600,261300,A1,AG/GEN,,,
10245,27-10-0-8-0,6728-28-9749,SNGL FAM SUB,2.68,AC,49900,0,49900,109700,300,159900,48900,0,48900,95100,300,144300,A1,AG/GEN,,,
10246,27-10-0-9-0,6728-38-1742,SNGL FAM SUB,2.75,AC,50400,0,50400,136700,0,187100,49400,0,49400,117000,0,166400,A1,AG/GEN,,,
10247,27-10-0-10-0,6728-39-5224,Roads,2.21,AC,0,0,0,0,0,0,0,0,0,0,0,0,A1,AG/GEN,,,
10248,28-1-0-71-D,6739-06-2294,Cemetery,0.26,AC,100,0,100,0,0,100,100,0,100,0,0,100,A1,AG/GEN,,,
10249,30-1-0-6-A,6759-44-1895,SNGL FAM SUB,14.57,AC,208400,201700,6700,0,0,208400,191000,184800,6200,0,0,191000,A1A2,AG GEN/,,,
10251,30-15-0-1-0,6759-90-1582,SNGL FAM SUB,2,AC,66400,0,66400,295400,6600,368400,57800,0,57800,244500,6000,308300,A2,AG/LTD,,,
10252,30-15-0-2-0,6759-90-5645,SNGL FAM SUB,4.56,AC,92100,0,92100,274300,0,366400,79400,0,79400,224800,0,304200,A2,AG/LTD,,,
10253,30-15-0-3-0,6759-90-9716,SNGL FAM SUB,3.61,AC,85500,0,85500,171700,1000,258200,77000,0,77000,142300,1000,220300,A2,AG/LTD,,,
10254,30-15-0-4-0,6769-00-2604,SNGL FAM SUB,3.3,AC,81900,0,81900,272100,1000,355000,73800,0,73800,224500,1000,299300,A2,AG/LTD,,,
10255,30-15-0-5-0,6759-90-7384,SNGL FAM SUB,3,AC,78300,0,78300,171700,2000,252000,70700,0,70700,141700,2000,214400,A2,AG/LTD,,,
10256,30-15-0-6-0,6759-90-2271,SNGL FAM SUB,2,AC,66400,0,66400,204100,2000,272500,57800,0,57800,157000,2000,216800,A2,AG/LTD,,,
10257,31-1-0-19-D,6768-37-8171,SNGL FAM SUB,3,AC,90200,0,90200,0,0,90200,79100,0,79100,0,0,79100,RP,"RURAL,P",,,
10258,31-1-0-90-B,6778-43-3621,SNGL FAM SUB,2,AC,78500,0,78500,260400,29300,368200,70100,0,70100,212400,25500,308000,A2,AG/LTD,,,
10259,31-23-0-1-0,6778-05-0588,SNGL FAM SUB,1.81,AC,75200,0,75200,171800,2000,249000,68400,0,68400,150800,2100,221300,RR,RES/RUR,,,
10260,31-23-0-2-0,6768-95-9417,SNGL FAM SUB,1.52,AC,79200,0,79200,270500,21400,371100,72000,0,72000,185500,29200,286700,RR,RES/RUR,,,
10261,31-23-0-3-0,6768-95-7312,SNGL FAM SUB,1.6,AC,79200,0,79200,277500,1600,358300,72000,0,72000,244600,1700,318300,RR,RES/RUR,,,
10262,31-23-0-4-0,6768-95-4477,SNGL FAM SUB,2.05,AC,79200,0,79200,292500,7600,379300,72000,0,72000,252600,7900,332500,RR,RES/RUR,,,
10263,31-23-0-5-0,6768-95-6677,SNGL FAM SUB,2.1,AC,79200,0,79200,225500,11900,316600,72000,0,72000,197300,10800,280100,RR,RES/RUR,,,
10264,31-23-0-6-0,6768-95-5823,SNGL FAM SUB,2.03,AC,79200,0,79200,204100,1600,284900,72000,0,72000,179800,1700,253500,RR,RES/RUR,,,
10265,31-23-0-7-0,6768-95-2847,SNGL FAM SUB,2.07,AC,79200,0,79200,241600,25900,346700,72000,0,72000,211700,24200,307900,RR,RES/RUR,,,
10266,31-23-0-8-0,6768-95-1611,SNGL FAM SUB,2.03,AC,79200,0,79200,288100,1600,368900,72000,0,72000,251100,1700,324800,RR,RES/RUR,,,
10267,31-23-0-9-0,6768-85-8731,SNGL FAM SUB,2,AC,79200,0,79200,289600,21400,390200,72000,0,72000,239200,20600,331800,RR,RES/RUR,,,
10268,31-23-0-10-0,6768-95-0928,SNGL FAM SUB,2.22,AC,79200,0,79200,232700,500,312400,72000,0,72000,204200,2500,278700,RR,RES/RUR,,,
10269,31-23-0-11-A,6768-86-8324,SNGL FAM SUB,1.19,AC,13400,0,13400,0,0,13400,12300,0,12300,0,0,12300,RR,RES/RUR,,,
10270,31-23-0-11-B,6768-86-9261,SNGL FAM SUB,1.45,AC,16400,0,16400,0,0,16400,14900,0,14900,0,0,14900,RR,RES/RUR,,,
10271,31-23-0-12-0,6768-86-6341,SNGL FAM SUB,2.86,AC,83200,0,83200,295000,25500,403700,75600,0,75600,246200,22600,344400,RR,RES/RUR,,,
10272,31-23-0-13-0,6768-86-5047,SNGL FAM SUB,2.26,AC,79200,0,79200,247400,9800,336400,72000,0,72000,209200,7800,289000,RR,RES/RUR,,,
10273,31-23-0-14-0,6768-85-4902,SNGL FAM SUB,2.44,AC,79200,0,79200,219100,2000,300300,72000,0,72000,192700,2100,266800,RR,RES/RUR,,,
10274,31-23-0-15-0,6768-85-2767,SNGL FAM SUB,2.51,AC,79200,0,79200,251400,29300,359900,72000,0,72000,219900,25700,317600,RR,RES/RUR,,,
10275,31-23-0-16-0,6768-85-0675,SNGL FAM SUB,2.62,AC,79200,0,79200,277100,2000,358300,72000,0,72000,237600,2100,311700,RR,RES/RUR,,,
10276,31-23-0-17-0,6768-75-8474,SNGL FAM SUB,4.03,AC,83200,0,83200,346700,44300,474200,75600,0,75600,275700,42700,394000,RR,RES/RUR,,,
10277,31-23-0-18-0,6768-75-8232,SNGL FAM SUB,3.75,AC,83200,0,83200,201400,5600,290200,75600,0,75600,178400,7900,261900,RR,RES/RUR,,,
10278,31-23-0-19-0,6768-85-0053,SNGL FAM SUB,2.48,AC,79200,0,79200,281700,37100,398000,72000,0,72000,238300,32300,342600,RR,RES/RUR,,,
10279,31-23-0-20-0,6768-84-2844,SNGL FAM SUB,2.05,AC,79200,0,79200,225000,6200,310400,72000,0,72000,195300,4900,272200,RR,RES/RUR,,,
10280,31-23-0-21-0,6768-84-6963,SNGL FAM SUB,2.01,AC,79200,0,79200,283900,2700,365800,72000,0,72000,248800,1900,322700,RR,RES/RUR,,,
10281,31-23-0-22-0,6768-85-5213,SNGL FAM SUB,2.27,AC,79200,0,79200,235300,17400,331900,72000,0,72000,214700,17900,304600,RR,RES/RUR,,,
10282,31-23-0-23-0,6768-85-6404,SNGL FAM SUB,2,AC,79200,0,79200,271300,28700,379200,72000,0,72000,231100,27700,330800,RR,RES/RUR,,,
10283,31-23-0-24-0,6768-85-8218,SNGL FAM SUB,2,AC,79200,0,79200,242400,0,321600,72000,0,72000,213700,0,285700,RR,RES/RUR,,,
10284,31-23-0-25-0,6768-95-0201,SNGL FAM SUB,2.01,AC,79200,0,79200,215000,27200,321400,72000,0,72000,185400,27500,284900,RR,RES/RUR,,,
10285,31-23-0-26-0,6768-95-1193,SNGL FAM SUB,2.09,AC,79200,0,79200,235200,23200,337600,72000,0,72000,208200,19800,300000,RR,RES/RUR,,,
10286,31-23-0-27-0,6768-95-4173,SNGL FAM SUB,1.5,AC,79200,0,79200,208500,0,287700,72000,0,72000,185500,0,257500,RR,RES/RUR,,,
10294,46-5-0-B-1,7717-07-0107,SNGL FAM SUB,3.982,AC,134600,0,134600,283800,600,419000,120200,0,120200,238200,600,359000,A2,AG/LTD,,,
10295,43-1-0-33-0,6766-59-0696,Non-Profit,160.7,AC,2044600,0,2044600,229200,643700,2917500,1823300,0,1823300,203400,602000,2628700,A2,AG/LTD,,,
10296,43-1-0-34-0,6767-60-8870,Non-Profit,189.075,AC,2358900,0,2358900,1535800,683600,4578300,2103100,0,2103100,1580900,502900,4186900,A2,AG/LTD,,,
10297,43-1-0-34-A,6766-88-6473,Non-Profit,1.15,AC,13100,0,13100,0,0,13100,11700,0,11700,0,0,11700,A2,AG/LTD,,,
10298,43-1-0-34-B,6766-89-7052,Non-Profit,35.64,AC,360000,0,360000,0,0,360000,320800,0,320800,0,0,320800,A2,AG/LTD,,,
10299,43-1-0-35-0,6767-81-8626,Non-Profit,106.8,AC,1335000,0,1335000,0,0,1335000,1196200,0,1196200,0,0,1196200,A2,AG/LTD,,,
10300,43-1-0-35-A,6767-71-8928,Non-Profit,30,AC,342000,0,342000,0,0,342000,306000,0,306000,0,0,306000,A2,AG/LTD,,,
10301,43-1-0-36-0,6767-72-0501,Non-Profit,19.5,AC,222300,0,222300,0,0,222300,198900,0,198900,0,0,198900,A2,AG/LTD,,,
10302,43-16-0-I-2,6766-78-6595,Non-Profit,18.5,AC,186900,0,186900,0,0,186900,166500,0,166500,0,0,166500,A2,AG/LTD,,,
10303,43-16-0-J-1,6766-98-6732,Non-Profit,39.62,AC,400200,0,400200,0,0,400200,356600,0,356600,0,0,356600,A2,AG/LTD,,,
10304,43-1-0-39-0,6767-63-1414,Non-Profit,4,AC,113300,0,113300,0,0,113300,101300,0,101300,0,0,101300,A2,AG/LTD,,,
10305,13-1-0-1-E,6842-31-4634,Cemetery,0,AC,100,0,100,0,0,100,100,0,100,0,0,100,A1,AG/GEN,,,
10306,20-11-0-18-A,6841-90-8799,Cemetery,0,AC,100,0,100,0,0,100,100,0,100,0,0,100,A1,AG/GEN,,,
10308,28-1-0-13-A,6728-98-0601,Cemetery,0.2,AC,100,0,100,0,0,100,100,0,100,0,0,100,A1,AG/GEN,,,
10309,28-1-0-33-0,6738-06-6747,Cemetery,0,AC,100,0,100,0,0,100,100,0,100,0,0,100,A1,AG/GEN,,,
10310,29-1-0-44-0,6748-69-6277,Cemetery,0.03,AC,100,0,100,0,0,100,100,0,100,0,0,100,A1,AG/GEN,,,
10311,31-1-0-19-C,6768-37-8537,Cemetery,0,AC,100,0,100,0,0,100,100,0,100,0,0,100,RP,"RURAL,P",,,
10312,31-1-0-78-B,6779-40-7734,Cemetery,0,AC,100,0,100,0,0,100,100,0,100,0,0,100,A2,AG/LTD,,,
10313,32-1-0-62-B,6789-22-3437,Cemetery,0,AC,100,0,100,0,0,100,100,0,100,0,0,100,A2,AG/LTD,,,
10314,51-6-0-E-0,6735-94-1297,Cemetery,0,AC,100,0,100,0,0,100,100,0,100,0,0,100,A1,AG/GEN,,,
10315,27-1-0-40-A,6728-35-9900,Cemetery,0.3,AC,100,0,100,0,0,100,100,0,100,0,0,100,A1,AG/GEN,,,
10316,29-1-0-36-A,6748-53-1904,Cemetery,0.27,AC,100,0,100,0,0,100,100,0,100,0,0,100,A1,AG/GEN,,,
10317,43-1-0-2-B,6768-50-8648,Cemetery,0.1,AC,100,0,100,0,0,100,100,0,100,0,0,100,A2,AG/LTD,,,
10318,43-1-0-16-0,6767-37-9866,Cemetery,0,AC,100,0,100,0,0,100,100,0,100,0,0,100,A2,AG/LTD,,,
10319,43-1-0-60-0,6778-21-1519,Cemetery,0.15,AC,100,0,100,0,0,100,100,0,100,0,0,100,A2,AG/LTD,,,
10320,30-1-0-99-0,6758-98-7473,Cemetery,0,AC,100,0,100,0,0,100,100,0,100,0,0,100,A2,AG/LTD,,,
10321,27-1-0-67-A,6728-48-8109,Place of Worship,5.676,AC,69700,0,69700,722300,76700,868700,68400,0,68400,707400,54600,830400,A1,AG/GEN,,,
10322,27-1-0-40-0,6728-46-1185,Vacant Land,0.28,AC,1700,0,1700,0,0,1700,1700,0,1700,0,0,1700,A1,AG/GEN,,,
10323,29-1-0-36-0,6748-54-0290,Place of Worship,3.09,AC,74400,0,74400,846800,7000,928200,69500,0,69500,806900,4800,881200,A1,AG/GEN,,,
10324,40-1-0-20-0,6726-97-1969,Place of Worship,2.5,AC,58900,0,58900,687900,1200,748000,57800,0,57800,677300,1200,736300,A1,AG/GEN,,,
10326,31-1-0-68-0,6779-44-0234,Place of Worship,4.279,AC,253300,0,253300,638500,25000,916800,226200,0,226200,592500,24000,842700,A2,AG/LTD,,,
10327,30-1-0-86-0,6758-92-5595,Place of Worship,5.1,AC,190600,0,190600,819500,85500,1095600,176200,0,176200,799600,57500,1033300,A2,AG/LTD,,,
10328,30-1-0-89-0,6758-92-9403,Vacant Land,1.14,AC,55700,0,55700,0,0,55700,51400,0,51400,0,0,51400,A2,AG/LTD,,,
10329,42-1-0-4-A,6757-38-7960,Place of Worship,5,AC,207000,0,207000,632800,0,839800,199100,0,199100,561400,0,760500,A2,AG/LTD,,,
10330,29-1-0-113-0,6748-79-2273,Place of Worship,1.5,AC,64400,0,64400,927000,34600,1026000,59300,0,59300,881600,23500,964400,A1,AG/GEN,,,
10331,29-12-0-1-0,6748-79-3090,Vacant Land,2.593,AC,69700,0,69700,0,48200,117900,63900,0,63900,0,34100,98000,A1,AG/GEN,,,
10332,42-1-0-45-0,6767-02-0966,Place of Worship,19.345,AC,849100,0,849100,1968500,4000,2821600,817200,0,817200,1760500,4000,2581700,B1A2,BS AND,,,
10335,30-1-0-4-0,6759-36-1874,Place of Worship,5.566,AC,241000,0,241000,2029000,42900,2312900,216600,0,216600,1892700,40900,2150200,A2,AG/LTD,,,
10336,40-1-0-21-0,6726-98-5024,Place of Worship,4.01,AC,68900,0,68900,433600,27800,530300,67600,0,67600,426000,24100,517700,A1,AG/GEN,,,
10338,51-1-0-1-A,6726-96-2623,Parsonage,1.02,AC,38900,0,38900,218900,900,258700,38100,0,38100,207200,900,246200,A1,AG/GEN,,,
10339,29-1-0-113-A,6748-79-5252,Vacant Land,1.483,AC,58300,0,58300,0,14700,73000,53900,0,53900,0,10000,63900,A1,AG/GEN,,,
10340,43-1-0-65-A,6778-40-9048,Non-Profit,1.95,AC,101900,0,101900,247700,0,349600,90900,0,90900,232700,0,323600,A2,AG/LTD,,,
10341,42-22-0-2-0,6767-24-2333,General Gov,9.59,AC,155200,0,155200,0,0,155200,149400,0,149400,0,0,149400,A2,AG/LTD,,,
10342,42-22-0-3-0,6767-23-3839,General Gov,10,AC,156400,0,156400,0,0,156400,150600,0,150600,0,0,150600,A2,AG/LTD,,,
10343,42-22-0-4-0,6767-23-2349,General Gov,8.24,AC,142700,0,142700,0,0,142700,137400,0,137400,0,0,137400,A2,AG/LTD,,,
10344,42-22-0-5-0,6767-13-9163,General Gov,8.67,AC,914800,0,914800,2055200,0,2970000,879900,0,879900,1903700,0,2783600,B1,BUS/GEN,,,
10345,42-22-0-6-0,6767-13-5601,General Gov,4.97,AC,118900,0,118900,0,0,118900,114500,0,114500,0,0,114500,R3A2,RES GEN,,,
10346,42-22-0-7-0,6767-13-4894,General Gov,3.27,AC,94700,0,94700,0,0,94700,91200,0,91200,0,0,91200,R3A2,RES GEN,,,
10347,42-1-0-43-A,6767-02-6443,General Gov,1.01,AC,126100,0,126100,0,13500,139600,121300,0,121300,0,9100,130400,B1,BUS/GEN,,,
10348,42-1-0-41-0,6767-02-6366,General Gov,0.163,AC,31800,0,31800,0,0,31800,30600,0,30600,0,0,30600,B1,BUS/GEN,,,
10349,42-1-0-40-0,6767-02-7460,General Gov,0.15,AC,63600,0,63600,450400,0,514000,61200,0,61200,420800,0,482000,B1,BUS/GEN,,,
10350,42-1-0-79-0,6767-08-1502,General Gov,3.082,AC,623200,0,623200,0,0,623200,599100,0,599100,0,0,599100,B1,BUS/GEN,,,
10351,42-1-0-95-A,6767-13-4032,General Gov,1.179,AC,147300,0,147300,0,32000,179300,141600,0,141600,0,30300,171900,B1,BUS/GEN,,,
10352,42-1-0-98-A,6767-12-2959,General Gov,0.23,AC,28700,0,28700,0,0,28700,27600,0,27600,0,0,27600,B1,BUS/GEN,,,
10353,42-1-0-102-0,6767-12-2822,General Gov,0.117,AC,63600,0,63600,224500,0,288100,61200,0,61200,208700,0,269900,B1,BUS/GEN,,,
10354,42-1-0-103-0,6767-12-2741,General Gov,0.125,AC,15600,0,15600,0,0,15600,15000,0,15000,0,0,15000,B1,BUS/GEN,,,
10355,42-1-0-103-A,6767-12-7723,General Gov,9.883,AC,1086100,0,1086100,5080900,0,6167000,1044600,0,1044600,4699200,0,5743800,B1,BUS/GEN,,,
10356,42-1-0-104-0,6767-12-0681,General Gov,2.3,AC,287300,0,287300,3697400,402900,4387600,276200,0,276200,3423000,415100,4114300,B1,BUS/GEN,,,
10357,42-1-0-121-T,6767-31-4448-9999,General Gov,17.902,AC,304500,0,304500,152000,309300,765800,296100,0,296100,149000,286100,731200,A2,AG/LTD,,,
10358,29-1-0-99-0,6749-84-3999,COMM & IND,8.49,AC,268700,0,268700,4018100,81900,4368700,260700,0,260700,3919600,64500,4244800,A1,AG/GEN,,,
10359,42-4-0-1-A,6767-12-2572,General Gov,0.05,AC,6200,0,6200,0,0,6200,6000,0,6000,0,0,6000,B1,BUS/GEN,,,
10360,42-14-0-A-1,6767-02-9469,General Gov,0.028,AC,5600,0,5600,0,0,5600,5500,0,5500,0,0,5500,B1,BUS/GEN,,,
10361,43-1-0-2-A,6767-39-8994,Parks & Rec,55.8,AC,697500,0,697500,174300,62900,934700,625000,0,625000,186900,54300,866200,A2,AG/LTD,,,
10362,43-2-0-2-0,6767-48-6700,General Gov,47.94,AC,632800,0,632800,1404500,310000,2347300,565700,0,565700,1358200,308000,2231900,A2,AG/LTD,,,
10363,42-1-0-101-A,6767-02-9870,General Gov,0.686,AC,84100,0,84100,328600,10000,422700,84100,0,84100,295600,10100,389800,B1,BUS/GEN,,,
10364,42-1-0-98-0,6767-12-1943,General Gov,0.84,AC,104900,0,104900,0,21000,125900,100900,0,100900,0,20200,121100,B1,BUS/GEN,,,
10365,42-1-0-50-0,6767-03-4917,Charitable/Benevolent,3.865,AC,482700,0,482700,2534100,166400,3183200,464200,0,464200,2461500,115600,3041300,BN,BUS/NHD,,,
10366,42-1-0-64-0,6757-97-8457,General Gov,12.198,AC,1371200,0,1371200,8432800,0,9804000,1318500,0,1318500,7953700,0,9272200,R3,RES/GEN,,,
10367,29-1-0-87-C,6749-86-3882,General Gov,2.954,AC,73200,0,73200,0,0,73200,69200,0,69200,0,0,69200,A1,AG/GEN,,,
10368,42-1-0-64-A,6757-97-2705,Public Schools,18.907,AC,2125300,0,2125300,7069800,1700,9196800,2043700,0,2043700,6454000,1300,8499000,R3,RES/GEN,,,
10369,29-1-0-86-0T,6749-86-2147,Parks & Rec,19.326,AC,491700,0,491700,4448100,136400,5076200,416700,0,416700,4348600,132400,4897700,A1,AG/GEN,,,
10370,42-1-0-83-0,6767-07-1926,General Gov,4.403,AC,1066500,0,1066500,0,0,1066500,1025300,0,1025300,0,0,1025300,B1,BUS/GEN,,,
10371,51-1-0-7-0,6726-92-0378,Public Schools,2.8,AC,49800,0,49800,0,0,49800,48800,0,48800,0,0,48800,A1,AG/GEN,,,
10372,42-1-0-78-T,6767-08-6540-9999,General Gov,3.306,AC,471000,0,471000,792900,10300,1274200,452900,0,452900,726500,6600,1186000,A2,AG/LTD,,,
10373,30-1-0-105-0,6758-99-8866,Non-Profit,23.3,AC,385500,0,385500,228200,26200,639900,357300,0,357300,220500,35800,613600,A2,AG/LTD,,,
10374,43-1-0-75-A,6777-63-0359,Academic-Private,36.15,AC,16700,0,16700,0,0,16700,15400,0,15400,0,0,15400,A2,AG/LTD,,,
10375,43-1-0-76-A,6777-51-9822,Academic-Private,33.52,AC,15500,0,15500,0,0,15500,14200,0,14200,0,0,14200,A2,AG/LTD,,,
10376,21-1-0-36-0,6759-38-0945,State Exmm,2.4,AC,168500,0,168500,192500,10000,371000,155700,0,155700,190600,10000,356300,A1,AG/GEN,,,
10377,42-1-0-72-0,6758-90-2490,SNGL FAM SUB,1,AC,54000,0,54000,218800,0,272800,49900,0,49900,179900,0,229800,A2,AG/LTD,,,
10378,42-1-0-90-A,6767-26-1900,Academic-Private,90.603,AC,2494800,0,2494800,10138300,0,12633100,2340800,0,2340800,9260600,0,11601400,A2,AG/LTD,,,
10379,50-1-0-18-0,6725-48-7179,State Exmm,3,AC,9000,0,9000,0,0,9000,9000,0,9000,0,0,9000,A1,AG/GEN,,,
10380,43-1-0-93-0,6777-40-9139,Academic-Private,30.19,AC,13900,0,13900,0,0,13900,12800,0,12800,0,0,12800,A2,AG/LTD,,,
10381,50-1-0-21-0,6725-79-6661,Other Religious,230.58,AC,923700,0,923700,981000,753900,2658600,898700,0,898700,995800,701200,2595700,A1,AG/GEN,,,
10382,55-1-0-14-0T,6775-67-4277,Prisons,1122.993,AC,7903600,0,7903600,8563900,5948100,22415600,7046800,0,7046800,8056300,6005300,21108400,A2,AG/LTD,,,
10383,42-1-0-19-0T,6757-90-0726,Prisons,266.5,AC,4661900,0,4661900,11958400,655900,17276200,4240200,0,4240200,11813700,717500,16771400,R3A2,RES GEN,,,
10384,11-1-0-35-F,6821-24-2797,Cemetery,0,AC,100,0,100,0,0,100,100,0,100,0,0,100,A1,AG/GEN,,,
10385,12-1-0-31-B,6831-03-0613,Cemetery,0.001,AC,100,0,100,0,0,100,100,0,100,0,0,100,A1,AG/GEN,,,
10386,12-6-0-21-A,6832-45-6761,Cemetery,0,AC,100,0,100,0,0,100,100,0,100,0,0,100,A1,AG/GEN,,,
10387,12-20-0-C-0,6831-19-0492,Cemetery,0.6,AC,100,0,100,0,0,100,100,0,100,0,0,100,A1,AG/GEN,,,
10388,15-4-0-7-0,5880-30-3190,Cemetery,0.3,AC,100,0,100,0,0,100,100,0,100,0,0,100,A1,AG/GEN,,,
10389,26-2-0-2-A,6708-78-2814,Cemetery,0,AC,100,0,100,0,0,100,100,0,100,0,0,100,A1,AG/GEN,,,
10390,26-9-0-B-2,6719-24-0384,Cemetery,0.027,AC,100,0,100,0,0,100,100,0,100,0,0,100,A1,AG/GEN,,,
10391,38-3-0-3-A,6717-18-6361,Cemetery,0.4,AC,100,0,100,0,0,100,100,0,100,0,0,100,A1,AG/GEN,,,
10392,12-7-0-3-B,6821-86-5823,Cemetery,0.51,AC,100,0,100,0,0,100,100,0,100,0,0,100,A1,AG/GEN,,,
10393,12-7-0-3-A,6821-86-2789,Cemetery,0.3,AC,100,0,100,0,0,100,100,0,100,0,0,100,A1,AG/GEN,,,
10394,17-1-0-68-B,6800-84-2343,Cemetery,0,AC,100,0,100,0,0,100,100,0,100,0,0,100,A1,AG/GEN,,,
10395,16-1-0-40-0,5890-44-6160,Cemetery,0.14,AC,100,0,100,0,0,100,100,0,100,0,0,100,A1,AG/GEN,,,
10396,38-1-0-118-0,6717-58-3451,Cemetery,0.25,AC,100,0,100,0,0,100,100,0,100,0,0,100,A1,AG/GEN,,,
10397,4-4-0-1-A,6804-50-4414,Cemetery,0.6,AC,100,0,100,0,0,100,100,0,100,0,0,100,A1,AG/GEN,,,
10398,17-1-0-31-A,6800-47-1917,Cemetery,0.5,AC,100,0,100,0,0,100,100,0,100,0,0,100,A1,AG/GEN,,,
10399,5-1-0-4-A,6813-99-3553,Place of Worship,0,AC,35000,0,35000,9000,0,44000,35000,0,35000,9000,0,44000,A1,AG/GEN,,,
10400,39-1-0-21-0,6717-64-5567,Place of Worship,4.295,AC,57300,0,57300,607300,52000,716600,56100,0,56100,593600,45000,694700,A1,AG/GEN,,,
10401,2-1-0-30-0,6814-62-8974,Place of Worship,5.75,AC,228300,0,228300,733900,12900,975100,224300,0,224300,672700,11500,908500,A1B1,AG GEN/,,,
10402,2-1-0-30-A,6814-63-7241,Vacant Land,1.88,AC,85900,0,85900,0,0,85900,83300,0,83300,0,0,83300,B1A1,BS & AG,,,
10403,39-1-0-20-0,6717-64-2799,Place of Worship,4.465,AC,58200,0,58200,253700,500,312400,57100,0,57100,250000,500,307600,A1,AG/GEN,,,
10404,11-2-0-2-B,6822-42-5490,Place of Worship,4.15,AC,55800,0,55800,627600,9800,693200,54800,0,54800,583400,9800,648000,A1,AG/GEN,,,
10405,11-3-0-2-0,6822-42-4823,Vacant Land,2.1,AC,45300,0,45300,0,0,45300,44500,0,44500,0,0,44500,A1,AG/GEN,,,
10406,11-2-0-2-A,6822-42-8616,Parsonage,1.446,AC,42000,0,42000,220300,500,262800,41200,0,41200,210100,500,251800,A1,AG/GEN,,,
10407,11-1-0-50-A,6822-42-5066,Vacant Land,5,AC,60100,0,60100,0,0,60100,59000,0,59000,0,0,59000,A1,AG/GEN,,,
10408,26-6-0-3-A,6718-02-1080,Place of Worship,1.345,AC,40900,0,40900,313000,500,354400,40100,0,40100,304900,500,345500,A1,AG/GEN,,,
10409,39-1-0-20-A,6717-65-2225,Vacant Land,1.13,AC,39500,0,39500,0,0,39500,38700,0,38700,0,0,38700,A1,AG/GEN,,,
10410,17-1-0-17-0,6709-87-8079,Place of Worship,4.248,AC,57000,0,57000,736000,5800,798800,55900,0,55900,723400,5800,785100,A1,AG/GEN,,,
10411,4-1-0-36-0,6803-98-5000,SNGL FAM SUB,1.95,AC,44500,0,44500,179800,1000,225300,43800,0,43800,158300,1000,203100,A1,AG/GEN,,,
10412,4-1-0-2-0,6804-30-7528,Vacant Land,4.32,AC,56600,0,56600,0,200,56800,55600,0,55600,0,200,55800,A1,AG/GEN,,,
10413,4-1-0-33-0,6803-87-3459,Place of Worship,2,AC,91300,0,91300,1008500,2000,1101800,89700,0,89700,948100,2000,1039800,A1,AG/GEN,,,
10414,18-1-0-12-0,6810-77-1085,Place of Worship,2.36,AC,82200,0,82200,609300,79800,771300,77800,0,77800,570600,63800,712200,A1,AG/GEN,,,
10415,18-1-0-13-A,6810-67-8375,Vacant Land,1,AC,6000,0,6000,0,0,6000,5500,0,5500,0,0,5500,A1,AG/GEN,,,
10416,18-1-0-13-0,6810-77-1246,Vacant Land,2.03,AC,46200,0,46200,0,0,46200,43700,0,43700,0,0,43700,A1,AG/GEN,,,
10417,18-1-0-48-0,6810-87-0320,Parsonage,0.73,AC,38000,0,38000,150600,6500,195100,36100,0,36100,135200,6500,177800,A1,AG/GEN,,,
10418,9-1-0-66-0,5892-51-4621,Place of Worship,3.531,AC,47900,0,47900,335600,1500,385000,46900,0,46900,272200,1500,320600,A1,AG/GEN,,,
10419,16-1-0-21-0,5890-34-2042,Place of Worship,1.55,AC,40800,0,40800,205000,300,246100,39900,0,39900,191600,300,231800,A1,AG/GEN,,,
10422,17-1-0-94-0,6810-21-8867,Place of Worship,32.56,AC,180700,0,180700,622500,22500,825700,180000,0,180000,584800,18400,783200,A1,AG/GEN,,,
10423,26-1-0-28-A,6708-44-3415,Academic-Private,174.42,AC,776100,0,776100,2378800,1147600,4302500,758800,0,758800,2389400,1146400,4294600,A1,AG/GEN,,,
10424,6-1-0-54-A,6823-90-3371,COMM & IND,1.25,AC,36800,0,36800,0,0,36800,35800,0,35800,0,0,35800,B1,BUS/GEN,,,
10425,6-1-0-25-T,6823-90-0217-9999,COMM & IND,0.55,AC,28900,0,28900,248600,70600,348100,28100,0,28100,225500,67500,321100,B1,BUS/GEN,,,
10426,26-1-0-60-T,6719-13-2303-9999,Non-Profit,5,AC,159600,0,159600,569500,181100,910200,97800,0,97800,551300,172200,821300,A1,AG/GEN,,,
10427,17-1-0-82-0,6719-09-7643,Public Schools,9.98,AC,170600,0,170600,6529000,217800,6917400,167400,0,167400,6318600,173000,6659000,A1,AG/GEN,,,
10428,18-1-0-1-A,6811-50-5473,Parks & Rec,35.89,AC,150700,0,150700,0,13700,164400,143600,0,143600,0,12000,155600,A1,AG/GEN,,,
10429,4-1-0-6-A,6803-77-9237,Cemetery,0.85,AC,100,0,100,0,0,100,100,0,100,0,0,100,A1,AG/GEN,,,
10430,17-1-0-81-0,6719-19-0984,Non-Profit,1,AC,40000,0,40000,70800,1400,112200,38000,0,38000,76200,1000,115200,A1,AG/GEN,,,
10431,7-1-0-3-A,6833-90-8872,State Exmm,5.025,AC,149600,0,149600,0,186200,335800,148200,0,148200,0,135800,284000,A1,AG/GEN,,,
10432,44-1-0-45-0,6787-65-8154,AG 20-100 AC,55.331,AC,825600,622100,203500,141400,75300,1042300,875900,617400,258500,133900,73700,1083500,A2,AG/LTD,,,
10433,58-21-A-1-B,7716-53-3605,Cemetery,0,AC,100,0,100,0,0,100,100,0,100,0,0,100,A2,AG/LTD,,,
10434,46-2-0-3-0,7707-61-9514,Place of Worship,17,AC,364400,0,364400,1679500,85000,2128900,325700,0,325700,1609100,63400,1998200,A2,AG/LTD,,,
10435,44-1-0-16-A,6787-00-3526,Cemetery,0.001,AC,100,0,100,0,0,100,100,0,100,0,0,100,A2,AG/LTD,,,
10436,44-1-0-16-B,6787-00-6638,Cemetery,0.008,AC,100,0,100,0,0,100,100,0,100,0,0,100,A2,AG/LTD,,,
10437,44-1-0-75-A,6786-69-8843,Cemetery,0,AC,100,0,100,0,0,100,100,0,100,0,0,100,A2,AG/LTD,,,
10438,45-1-0-43-0,6786-88-9022,Cemetery,0.08,AC,100,0,100,0,0,100,100,0,100,0,0,100,A2,AG/LTD,,,
10439,45-1-0-113-F,6798-60-1014,Cemetery,0,AC,100,0,100,0,0,100,100,0,100,0,0,100,A2,AG/LTD,,,
10440,47-15-0-1-A,7718-60-0914,Cemetery,0.22,AC,100,0,100,0,0,100,100,0,100,0,0,100,A2,AG/LTD,,,
10441,55-1-0-58-A,6786-66-8364,Cemetery,0.8,AC,100,0,100,0,0,100,100,0,100,0,0,100,A2,AG/LTD,,,
10442,56-1-0-1-F,6786-84-8670,Cemetery,0,AC,100,0,100,0,0,100,100,0,100,0,0,100,A2,AG/LTD,,,
10443,57-1-0-34-G,7706-31-2393,Cemetery,0.086,AC,100,0,100,0,0,100,100,0,100,0,0,100,A2,AG/LTD,,,
10444,60-7-0-A-1,6784-19-2837,Cemetery,0,AC,100,0,100,0,0,100,100,0,100,0,0,100,A2,AG/LTD,,,
10445,63-23-0-1-B,7713-69-3921,Cemetery,0,AC,100,0,100,0,0,100,100,0,100,0,0,100,A2,AG/LTD,,,
10446,64-1-0-27-0,7723-49-4470,Cemetery,0,AC,100,0,100,0,0,100,100,0,100,0,0,100,A2,AG/LTD,,,
10447,48-1-0-58-C,7738-21-9279,Cemetery,0.4,AC,100,0,100,0,0,100,100,0,100,0,0,100,A2,AG/LTD,,,
10448,45-1-0-49-0,6796-38-8085,Cemetery,0.065,AC,100,0,100,0,0,100,100,0,100,0,0,100,A2,AG/LTD,,,
10475,47-3-0-C-4,7717-95-1857,SNGL FAM SUB,0.07,AC,1600,0,1600,0,0,1600,1400,0,1400,0,0,1400,A2,AG/LTD,,,
10476,44-1-0-69-0,6786-68-9282,Place of Worship,4.15,AC,199400,0,199400,2003300,104900,2307600,177900,0,177900,1860200,74500,2112600,A2,AG/LTD,,,
10477,44-1-0-68-B,6786-58-6101,SNGL FAM SUB,3.549,AC,108600,0,108600,287500,19800,415900,97000,0,97000,235100,16200,348300,A2,AG/LTD,,,
10478,64-1-0-63-0,7723-99-5960,Place of Worship,0,AC,170000,0,170000,453300,27000,650300,147800,0,147800,408300,18000,574100,A2,AG/LTD,,,
10479,64-1-0-82-0,7733-58-1029,Place of Worship,6.775,AC,892100,0,892100,6929400,415900,8237400,775500,0,775500,6711600,352600,7839700,R1,RES/LTD,,,
10480,47-1-0-44-0,7727-00-7644,Place of Worship,9.475,AC,497700,0,497700,1415900,0,1913600,444600,0,444600,1350100,0,1794700,A2,AG/LTD,,,
10481,47-1-0-44-B,7727-00-4231,Parsonage,3.001,AC,160000,0,160000,308100,1200,469300,142800,0,142800,275800,1200,419800,A2,AG/LTD,,,
10482,46-8-0-B-3,7707-52-7525,Cemetery,1,AC,100,0,100,0,0,100,100,0,100,0,0,100,RR,RES/RUR,,,
10483,63-1-0-34-0,7714-43-3841,General Gov,1.356,AC,144100,0,144100,0,0,144100,125300,0,125300,0,0,125300,R3,RES/GEN,,,
10484,47-1-0-43-AT,7716-98-3730,Non-Profit,0.887,AC,605600,0,605600,921800,0,1527400,550500,0,550500,808900,0,1359400,A2,AG/LTD,,,
10485,47-1-0-43-B,7716-98-3961,Non-Profit,0.977,AC,494400,0,494400,0,5400,499800,449400,0,449400,0,5100,454500,R3,RES/GEN,,,
10486,55-1-0-92-0T,6785-66-4053,Non-Profit,0.86,AC,92200,0,92200,401600,21300,515100,82300,0,82300,389200,21400,492900,B1,BUS/GEN,,,
10489,67-1-0-14-E,7733-45-4989,General Gov,0.401,AC,42600,0,42600,0,9100,51700,37100,0,37100,0,6400,43500,A2,AG/LTD,,,
10490,58-1-0-65-0,7716-91-0834,General Gov,87.102,AC,4344200,0,4344200,0,2000,4346200,3778000,0,3778000,0,2000,3780000,A2,AG/LTD,,,
10491,66-1-0-2-0,7723-26-0038,Academic-Private,49.839,AC,1514900,0,1514900,21899200,5638100,29052200,1316200,0,1316200,21631800,5669800,28617800,A2R1,AG LTD/,,,
10492,44-1-0-46-0,6787-64-5163,Public Schools,31.535,AC,1029900,0,1029900,6300700,169800,7500400,918300,0,918300,6154400,164400,7237100,A2,AG/LTD,,,
10493,20-1-0-56-0,6851-11-1852,Place of Worship,2,AC,63600,0,63600,131300,0,194900,62400,0,62400,127100,0,189500,A1,AG/GEN,,,
10494,47-1-0-34-A,7716-79-1688,Cemetery,0,AC,100,0,100,0,0,100,100,0,100,0,0,100,B1,BUS/GEN,,,
10496,51-1-0-11-0,6735-29-1036,Vacant Land,11.67,AC,98600,0,98600,0,6200,104800,96700,0,96700,0,6400,103100,A1,AG/GEN,,,
10497,51-1-0-12-0,6735-28-1927,Vacant Land,4,AC,55600,0,55600,0,0,55600,54500,0,54500,0,0,54500,A1,AG/GEN,,,
10498,51-1-0-13-0,6735-09-5054,Vacant Land,151.35,AC,453900,0,453900,0,0,453900,445000,0,445000,0,0,445000,A1,AG/GEN,,,
10499,51-1-0-14-0,6725-96-6769,Vacant Land,268.35,AC,794800,0,794800,0,0,794800,780100,0,780100,0,0,780100,A1,AG/GEN,,,
10500,51-5-0-D-0,6725-93-6363,Vacant Land,1,AC,3000,0,3000,0,0,3000,3000,0,3000,0,0,3000,A1,AG/GEN,,,
10501,50-1-0-18-A,6725-47-7415,Vacant Land,3,AC,9000,0,9000,0,0,9000,9000,0,9000,0,0,9000,A1,AG/GEN,,,
10502,50-1-0-20-0,6725-69-3635,Other Religious,1.43,AC,41200,0,41200,206100,105300,352600,40400,0,40400,189800,98000,328200,A1,AG/GEN,,,
10503,51-1-0-8-A,6726-90-4009,Vacant Land,20,AC,107000,0,107000,0,0,107000,104500,0,104500,0,0,104500,A1,AG/GEN,,,
10505,26-1-0-70-A,6719-37-7074,SNGL FAM SUB,4.759,AC,62100,0,62100,530200,59100,651400,60600,0,60600,436100,55700,552400,A1,AG/GEN,,,
10506,29-8-0-1-B,6749-96-8926,Cemetery,0.32,AC,100,0,100,0,0,100,100,0,100,0,0,100,A1,AG/GEN,,,
10511,56-7-0-2-A,6785-94-6922,SNGL FAM SUB,1.5,AC,78000,0,78000,96600,41500,216100,69700,0,69700,78200,34000,181900,A2,AG/LTD,,,
10513,61-1-0-1-0,6785-81-5855,AG > 100 AC,360.806,AC,4792100,4317100,475000,1590100,169700,6551900,4173800,3758400,415400,1466900,157800,5798500,A2,AG/LTD,,,
10514,18-1-0-35-C,6820-60-3103,SNGL FAM SUB,3.42,AC,53000,0,53000,303400,33800,390200,49800,0,49800,261700,38000,349500,A1,AG/GEN,,,
10515,18-4-0-4-M,6820-11-3588,SNGL FAM SUB,3.68,AC,55900,0,55900,16400,9500,81800,52700,0,52700,19100,9500,81300,A1,AG/GEN,,,
10516,21-1-0-41-C,6850-41-6054,SNGL FAM SUB,2,AC,66400,0,66400,204900,4500,275800,60300,0,60300,175800,4500,240600,A2,AG/LTD,,,
10517,31-1-0-75-C,6779-53-4042,SNGL FAM SUB,2.47,AC,77600,0,77600,103500,0,181100,69200,0,69200,79700,0,148900,A2,AG/LTD,,,
10518,31-1-0-75-D,6779-52-1801,SNGL FAM SUB,2.17,AC,74800,0,74800,99600,0,174400,66700,0,66700,77600,0,144300,A2,AG/LTD,,,
10519,32-14-0-1-0,6779-56-9877,SNGL FAM SUB,3.53,AC,100500,0,100500,156400,1000,257900,89800,0,89800,128400,1000,219200,A2,AG/LTD,,,
10520,32-14-0-2-0,6779-66-2805,SNGL FAM SUB,3.2,AC,95800,0,95800,296300,5400,397500,85600,0,85600,243800,4200,333600,A2,AG/LTD,,,
10521,32-14-0-3-0,6779-66-4810,SNGL FAM SUB,3.37,AC,98200,0,98200,170700,48500,317400,87800,0,87800,139200,40900,267900,A2,AG/LTD,,,
10522,32-14-0-4-0,6779-66-6725,SNGL FAM SUB,3.5,AC,100100,0,100100,0,24200,124300,89500,0,89500,0,22400,111900,A2,AG/LTD,,,
10523,32-14-0-5-0,6779-66-8741,SNGL FAM SUB,3.48,AC,99800,0,99800,279100,37200,416100,89200,0,89200,230000,31700,350900,A2,AG/LTD,,,
10524,32-14-0-6-0,6779-76-1838,SNGL FAM SUB,2.694,AC,88500,0,88500,0,0,88500,79100,0,79100,0,0,79100,A2,AG/LTD,,,
10525,32-14-0-6-A,6779-76-0856,Cemetery,0.08,AC,100,0,100,0,0,100,100,0,100,0,0,100,A2,AG/LTD,,,
10526,43-1-0-13-B,6767-66-8523,SNGL FAM SUB,2.13,AC,78200,0,78200,0,0,78200,69900,0,69900,0,0,69900,A2,AG/LTD,,,
10527,43-1-0-13-C,6767-66-6646,SNGL FAM SUB,2.14,AC,78400,0,78400,0,0,78400,70000,0,70000,0,0,70000,A2,AG/LTD,,,
10528,43-1-0-13-D,6767-66-4862,SNGL FAM SUB,2.11,AC,62000,0,62000,0,0,62000,55300,0,55300,0,0,55300,A2,AG/LTD,,,
10531,57-1-0-45-B,7715-14-0402,SNGL FAM SUB,8.01,AC,353500,0,353500,0,0,353500,307300,0,307300,0,0,307300,A2,AG/LTD,,,
10532,57-1-0-49-B,7705-98-9230,SNGL FAM SUB,0.314,AC,9800,0,9800,0,0,9800,8500,0,8500,0,0,8500,A2,AG/LTD,,,
10533,63-1-0-126-A,7715-61-7105,SNGL FAM SUB,1.5,AC,118600,0,118600,0,0,118600,103200,0,103200,0,0,103200,A2,AG/LTD,,,
10534,67-1-0-14-F,7733-45-4740,Cmn Area/Open Spc,1.7,AC,0,0,0,0,0,0,0,0,0,0,0,0,A2,AG/LTD,,,
10535,67-21-E-19-0,7733-46-2802,SNGL FAM SUB,0.838,AC,265000,0,265000,559800,0,824800,220000,0,220000,452100,0,672100,R1,RES/LTD,,,
10536,67-21-E-20-0,7733-46-3889,SNGL FAM SUB,0.71,AC,265000,0,265000,721500,0,986500,220000,0,220000,605300,0,825300,R1,RES/LTD,,,
10537,67-21-E-21-0,7733-46-5822,SNGL FAM SUB,1.04,AC,265000,0,265000,892100,1000,1158100,220000,0,220000,755000,1000,976000,R1,RES/LTD,,,
10538,67-21-E-22-0,7733-46-4662,SNGL FAM SUB,0,AC,265000,0,265000,792700,13800,1071500,220000,0,220000,624700,14300,859000,R1,RES/LTD,,,
10539,67-21-E-23-0,7733-46-2589,SNGL FAM SUB,0.74,AC,265000,0,265000,604000,11100,880100,220000,0,220000,520700,10100,750800,R1,RES/LTD,,,
10540,67-21-E-24-0,7733-46-4425,SNGL FAM SUB,1.16,AC,265000,0,265000,894900,51900,1211800,220000,0,220000,570700,33900,824600,R1,RES/LTD,,,
10541,67-21-E-25-0,7733-46-4341,SNGL FAM SUB,0.919,AC,265000,0,265000,820400,2000,1087400,220000,0,220000,656200,2000,878200,R1,RES/LTD,,,
10542,67-21-E-26-0,7733-46-4165,SNGL FAM SUB,0.928,AC,265000,0,265000,1111800,0,1376800,220000,0,220000,906100,0,1126100,R1,RES/LTD,,,
10547,17-1-0-18-A,6709-97-4096,SNGL FAM SUB,5.6,AC,64600,0,64600,70200,2500,137300,63300,0,63300,61400,2500,127200,A1,AG/GEN,,,
10548,40-5-0-1-0,6736-09-5605,SNGL FAM SUB,1.98,AC,53100,0,53100,381300,0,434400,52100,0,52100,336200,0,388300,A1,AG/GEN,,,
10549,40-5-0-2-0,6736-09-6992,SNGL FAM SUB,2.7,AC,58200,0,58200,221000,1500,280700,57100,0,57100,209900,1500,268500,A1,AG/GEN,,,
10550,40-5-0-3-0,6736-09-9982,SNGL FAM SUB,2.54,AC,57000,0,57000,202100,1500,260600,56000,0,56000,176800,1500,234300,A1,AG/GEN,,,
10551,40-5-0-4-0,6736-19-2905,SNGL FAM SUB,2.54,AC,57000,0,57000,247400,0,304400,56000,0,56000,216400,0,272400,A1,AG/GEN,,,
10552,40-5-0-5-0,6736-19-4947,SNGL FAM SUB,3.03,AC,60500,0,60500,249500,1000,311000,59400,0,59400,216400,1000,276800,A1,AG/GEN,,,
10553,40-5-0-6-0,6737-10-1310,SNGL FAM SUB,3.49,AC,62500,0,62500,119800,1600,183900,61400,0,61400,100600,1800,163800,A1,AG/GEN,,,
10554,46-1-0-63-0,7716-18-0501,SNGL FAM SUB,2.429,AC,131600,0,131600,131500,100,263200,117600,0,117600,111000,100,228700,A2,AG/LTD,,,
10555,46-1-0-68-A,7707-81-3165,SNGL FAM SUB,2.724,AC,138300,0,138300,0,0,138300,123600,0,123600,0,0,123600,A2,AG/LTD,,,
10556,46-1-0-68-B,7707-81-5057,SNGL FAM SUB,2.552,AC,134400,0,134400,0,0,134400,120100,0,120100,0,0,120100,A2,AG/LTD,,,
10557,57-1-0-61-0,7716-16-0302,SNGL FAM SUB,2,AC,121800,0,121800,152400,38500,312700,108800,0,108800,128300,35200,272300,A2,AG/LTD,,,
10558,28-1-0-58-F,6739-20-0048,SNGL FAM SUB,5.49,AC,70200,0,70200,17800,800,88800,65100,0,65100,20100,800,86000,A1,AG/GEN,,,
10559,55-18-0-1-A,6776-93-3807,SNGL FAM SUB,3.167,AC,107000,0,107000,302700,36900,446600,95600,0,95600,254300,31200,381100,A2,AG/LTD,,,
10569,17-1-0-55-A,6810-27-8487,SNGL FAM SUB,0.2,AC,1100,0,1100,0,0,1100,1000,0,1000,0,0,1000,A1,AG/GEN,,,
10571,30-17-0-1-0,6759-54-0524,SNGL FAM SUB,1.83,AC,62300,0,62300,242000,0,304300,58500,0,58500,202300,0,260800,A2,AG/LTD,,,
10572,30-17-0-2-0,6759-44-8629,SNGL FAM SUB,1.83,AC,62300,0,62300,2800,17400,82500,58500,0,58500,2600,17400,78500,A2,AG/LTD,,,
10573,30-17-0-3-0,6759-44-6862,SNGL FAM SUB,1.63,AC,61800,0,61800,179400,0,241200,56500,0,56500,148600,0,205100,A2,AG/LTD,,,
10574,30-17-0-4-0,6759-44-5419,SNGL FAM SUB,2.24,AC,66300,0,66300,177200,1000,244500,62800,0,62800,151800,1000,215600,A2,AG/LTD,,,
10575,30-17-0-5-0,6759-44-4258,SNGL FAM SUB,2.27,AC,66600,0,66600,0,0,66600,63100,0,63100,0,0,63100,A2,AG/LTD,,,
10576,30-17-0-6-0,6759-44-7296,SNGL FAM SUB,2.2,AC,66000,0,66000,165800,0,231800,62400,0,62400,137400,0,199800,A2,AG/LTD,,,
10577,43-27-0-1-0,6767-98-8038,SNGL FAM SUB,3.83,AC,96800,0,96800,253500,1500,351800,88000,0,88000,227500,1500,317000,A2,AG/LTD,,,
10578,43-27-0-2-0,6767-97-5785,SNGL FAM SUB,4.64,AC,110700,0,110700,259600,38300,408600,100700,0,100700,227500,32600,360800,A2,AG/LTD,,,
10579,43-27-0-3-0,6767-97-2825,SNGL FAM SUB,3.36,AC,96800,0,96800,247800,0,344600,88000,0,88000,213100,0,301100,A2,AG/LTD,,,
10580,43-27-0-4-0,6767-88-8055,SNGL FAM SUB,3.75,AC,96800,0,96800,216700,1000,314500,88000,0,88000,189000,1000,278000,A2,AG/LTD,,,
10581,43-27-0-5-0,6767-98-0381,SNGL FAM SUB,3.48,AC,96800,0,96800,234800,1400,333000,88000,0,88000,204400,1400,293800,A2,AG/LTD,,,
10582,43-27-0-6-0,6767-98-4298,SNGL FAM SUB,3.35,AC,92000,0,92000,152600,2400,247000,83600,0,83600,133700,2600,219900,A2,AG/LTD,,,
10583,31-24-0-1-0,6779-42-2194,SNGL FAM SUB,1.5,AC,71300,0,71300,260100,4900,336300,63700,0,63700,222900,3500,290100,A2,AG/LTD,,,
10584,31-24-0-2-0,6779-41-4857,SNGL FAM SUB,1.66,AC,73600,0,73600,0,0,73600,65700,0,65700,0,0,65700,A2,AG/LTD,,,
10585,31-24-0-3-0,6779-41-5696,SNGL FAM SUB,1.68,AC,73900,0,73900,168100,51100,293100,66000,0,66000,136200,40300,242500,A2,AG/LTD,,,
10586,31-24-0-4-0,6779-41-6476,SNGL FAM SUB,1.5,AC,71300,0,71300,0,0,71300,63700,0,63700,0,0,63700,A2,AG/LTD,,,
10587,31-24-0-5-0,6779-41-9730,SNGL FAM SUB,2,AC,75300,0,75300,305700,2000,383000,67200,0,67200,256700,2000,325900,A2,AG/LTD,,,
10588,31-24-0-6-0,6779-41-7916,SNGL FAM SUB,2.25,AC,78900,0,78900,0,0,78900,70400,0,70400,0,0,70400,A2,AG/LTD,,,
10589,31-24-0-6-A,6779-41-8948,Cemetery,0,AC,100,0,100,0,0,100,100,0,100,0,0,100,A2,AG/LTD,,,
10590,56-7-0-4-A,6785-84-6715,SNGL FAM SUB,1.86,AC,83700,0,83700,0,0,83700,74700,0,74700,0,0,74700,A2,AG/LTD,,,
10591,22-1-0-8-C,6769-68-8655,SNGL FAM SUB,1.5,AC,67200,0,67200,0,0,67200,61100,0,61100,0,0,61100,A2,AG/LTD,,,
10592,22-1-0-8-D,6769-78-2199,SNGL FAM SUB,0.43,AC,5300,5100,200,0,0,5300,4300,4100,200,0,0,4300,A2,AG/LTD,,,
10593,14-1-0-9-0,6851-16-4099,SNGL FAM SUB,3.063,AC,62800,0,62800,0,0,62800,61500,0,61500,0,0,61500,A1,AG/GEN,,,
10594,14-1-0-9-A,6851-16-6081,SNGL FAM SUB,2.549,AC,58300,0,58300,247100,1000,306400,57200,0,57200,215400,1000,273600,A1,AG/GEN,,,
10595,14-1-0-9-B,6851-15-8924,SNGL FAM SUB,2.425,AC,57300,0,57300,130100,1700,189100,56100,0,56100,113200,2000,171300,A1,AG/GEN,,,
10596,14-1-0-9-C,6851-15-8793,SNGL FAM SUB,2.006,AC,53600,0,53600,152700,1000,207300,52600,0,52600,131600,1000,185200,A1,AG/GEN,,,
10597,11-1-0-53-E,6822-23-7710,SNGL FAM SUB,5,AC,60100,0,60100,230700,11400,302200,59000,0,59000,206100,10800,275900,A1,AG/GEN,,,
10598,31-4-0-A-1,6779-05-1944,SNGL FAM SUB,2.01,AC,73500,0,73500,252800,2000,328300,67200,0,67200,216900,2000,286100,A2,AG/LTD,,,
10599,31-4-0-A-2,6779-05-4823,SNGL FAM SUB,2.1,AC,74600,0,74600,254800,2500,331900,68300,0,68300,210500,2500,281300,A2,AG/LTD,,,
10600,31-4-0-A-3,6779-05-5569,SNGL FAM SUB,2.08,AC,79700,0,79700,332000,9000,420700,71100,0,71100,269300,6800,347200,A2,AG/LTD,,,
10601,31-4-0-A-4,6779-05-8721,SNGL FAM SUB,2.13,AC,80400,0,80400,377800,28300,486500,71800,0,71800,317300,26800,415900,A2,AG/LTD,,,
10602,27-1-0-14-D,6719-50-8445,SNGL FAM SUB,2.03,AC,45100,0,45100,0,0,45100,44200,0,44200,0,0,44200,A1,AG/GEN,,,
10603,10-1-0-35-C,6812-23-7453,SNGL FAM SUB,2.567,AC,46000,0,46000,212500,3600,262100,45100,0,45100,189600,3600,238300,A1,AG/GEN,,,
10604,27-1-0-5-D,6719-51-7777,SNGL FAM SUB,6.16,AC,69400,0,69400,203000,0,272400,66400,0,66400,168900,0,235300,A1,AG/GEN,,,
10605,57-1-0-42-A,7705-94-6752,SNGL FAM SUB,1.5,AC,167000,0,167000,104300,2000,273300,145200,0,145200,86500,2000,233700,A2,AG/LTD,,,
10606,20-1-0-92-G,6759-07-6636,SNGL FAM SUB,1.34,AC,6700,0,6700,0,0,6700,5600,0,5600,0,0,5600,A1,AG/GEN,,,
10607,29-1-0-29-B,6748-43-3064,SNGL FAM SUB,4,AC,82800,0,82800,272100,15600,370500,78100,0,78100,228200,15100,321400,A1,AG/GEN,,,
10608,29-1-0-29-C,6748-43-5144,SNGL FAM SUB,2,AC,64000,0,64000,0,0,64000,59800,0,59800,0,0,59800,A1,AG/GEN,,,
10610,47-1-0-91-C,7726-18-4762,COMM & IND,23.25,AC,9562300,9550400,11900,0,0,9562300,8768100,8758100,10000,0,0,8768100,B1A2,BS AND,,,
10611,47-1-0-91-D,7726-17-5563,COMM & IND,28.74,AC,8824900,8810600,14300,0,0,8824900,8158100,8145800,12300,0,0,8158100,B1A2,BS AND,,,
10612,47-1-0-98-B,7727-21-6367,COMM & IND,1.13,AC,497200,0,497200,0,0,497200,452000,0,452000,0,0,452000,B1,BUS/GEN,,,
10613,47-1-0-98-C,7727-20-2807,SNGL FAM SUB,1.44,AC,139900,0,139900,0,0,139900,125000,0,125000,0,0,125000,A2,AG/LTD,,,
10614,58-1-0-94-0,7726-37-7147,SNGL FAM SUB,10.53,AC,1999800,0,1999800,0,0,1999800,1818100,0,1818100,0,0,1818100,R3,RES/GEN,,,
10633,56-13-0-2-0,6795-68-3155,AG 20-100 AC,23.74,AC,581100,407900,173200,393800,27100,1002000,504800,353600,151200,324700,23500,853000,A2,AG/LTD,,,
10639,19-1-0-61-A,6830-82-7549,SNGL FAM SUB,0.33,AC,2600,0,2600,0,0,2600,2400,0,2400,0,0,2400,A1,AG/GEN,,,
10640,30-16-0-1-0,6768-08-9805,SNGL FAM SUB,8,AC,132100,0,132100,0,0,132100,122700,0,122700,0,0,122700,A2,AG/LTD,,,
10641,30-16-0-2-0,6768-09-7427,SNGL FAM SUB,8.87,AC,141000,0,141000,300500,3700,445200,131700,0,131700,246100,3200,381000,A2,AG/LTD,,,
10642,30-16-0-3-0,6769-00-5285,SNGL FAM SUB,9.03,AC,142600,0,142600,0,10800,153400,133400,0,133400,0,10500,143900,A2,AG/LTD,,,
10643,30-16-0-4-0,6769-00-8485,SNGL FAM SUB,7.85,AC,130600,0,130600,482000,29800,642400,121100,0,121100,398200,22100,541400,A2,AG/LTD,,,
10644,30-16-0-5-0,6769-10-3291,SNGL FAM SUB,8.19,AC,112300,0,112300,312000,100,424400,102000,0,102000,276000,100,378100,A2,AG/LTD,,,
10645,30-16-0-6-0,6768-19-3517,SNGL FAM SUB,8.91,AC,141400,0,141400,345900,1100,488400,132200,0,132200,284000,1000,417200,A2,AG/LTD,,,
10646,32-15-0-1-0,6789-03-5729,SNGL FAM SUB,2.5,AC,85700,0,85700,222800,37000,345500,76600,0,76600,181900,33400,291900,A2,AG/LTD,,,
10647,32-15-0-1-A,6789-03-6879,Cemetery,0.04,AC,100,0,100,0,0,100,100,0,100,0,0,100,A2,AG/LTD,,,
10648,32-15-0-2-0,6789-03-3975,SNGL FAM SUB,2.52,AC,86000,0,86000,259100,3600,348700,76800,0,76800,213600,2700,293100,A2,AG/LTD,,,
10649,32-15-0-3-0,6789-03-1594,SNGL FAM SUB,3.5,AC,100100,0,100100,236000,2500,338600,89500,0,89500,192600,2500,284600,A2,AG/LTD,,,
10650,32-15-0-4-0,6779-93-9107,SNGL FAM SUB,5.99,AC,136000,0,136000,228800,0,364800,121600,0,121600,192900,0,314500,A2,AG/LTD,,,
10651,43-26-0-1-0,6767-46-5450,SNGL FAM SUB,3.024,AC,91100,0,91100,0,0,91100,82800,0,82800,0,0,82800,A2,AG/LTD,,,
10652,43-26-0-2-0,6767-46-3053,SNGL FAM SUB,6.41,AC,116500,0,116500,0,0,116500,106000,0,106000,0,0,106000,A2,AG/LTD,,,
10653,43-26-0-3-0,6767-45-1512,SNGL FAM SUB,7.82,AC,132100,0,132100,0,0,132100,120200,0,120200,0,0,120200,A2,AG/LTD,,,
10654,43-26-0-3-A,6767-45-2657,Cemetery,0.338,AC,100,0,100,0,0,100,100,0,100,0,0,100,A2,AG/LTD,,,
10655,43-26-0-4-0,6767-34-7973,SNGL FAM SUB,11.35,AC,157800,0,157800,0,0,157800,140200,0,140200,0,0,140200,A2,AG/LTD,,,
10656,43-26-0-5-0,6767-35-5449,SNGL FAM SUB,14.55,AC,185200,0,185200,0,0,185200,164000,0,164000,0,0,164000,A2,AG/LTD,,,
10657,43-26-0-6-0,6767-36-6297,SNGL FAM SUB,12.26,AC,165600,0,165600,0,0,165600,147000,0,147000,0,0,147000,A2,AG/LTD,,,
10658,44-24-0-1-0,6777-93-1046,SNGL FAM SUB,2.01,AC,84000,0,84000,0,0,84000,75000,0,75000,0,0,75000,A2,AG/LTD,,,
10667,45-19-0-1-0,6797-68-1958,COMM & IND,2.893,AC,230300,0,230300,311500,81900,623700,219300,0,219300,294100,85500,598900,M1,INDUS/L,,,
10668,45-19-0-2-0,6797-59-9335,COMM & IND,2.268,AC,180500,0,180500,264900,15500,460900,171900,0,171900,258400,16400,446700,M2,INDUS/G,,,
10669,45-19-0-3-0,6797-59-7670,COMM & IND,2.787,AC,221800,0,221800,502600,87300,811700,211300,0,211300,485100,77700,774100,M2,INDUS/G,,,
10670,45-19-0-4-0,6797-59-6801,COMM & IND,2.312,AC,184000,0,184000,0,0,184000,175300,0,175300,0,0,175300,M2,INDUS/G,,,
10671,45-19-0-5-0,6798-50-5062,COMM & IND,2.204,AC,175400,0,175400,473200,48900,697500,167100,0,167100,449000,50500,666600,M2,INDUS/G,,,
10672,45-19-0-6-0,6798-50-6313,COMM & IND,4.303,AC,342500,0,342500,426100,180600,949200,326200,0,326200,414400,188900,929500,M2,INDUS/G,,,
10674,45-19-0-8-0,6798-50-4626,COMM & IND,3.38,AC,269000,0,269000,202200,52900,524100,256200,0,256200,194800,55400,506400,M2,INDUS/G,,,
10675,45-19-0-9-0,6798-50-0778,COMM & IND,2.947,AC,234600,0,234600,394100,53600,682300,223400,0,223400,379900,56000,659300,M2,INDUS/G,,,
10676,45-19-0-10-0,6798-40-7892,COMM & IND,4.132,AC,312500,0,312500,327900,61700,702100,297500,0,297500,302000,63600,663100,M2,INDUS/G,,,
10677,45-19-0-11-0,6798-40-5690,COMM & IND,5.027,AC,380100,0,380100,339700,70000,789800,362000,0,362000,314600,70700,747300,M2,INDUS/G,,,
10678,45-19-0-12-0,6798-40-5270,COMM & IND,2.383,AC,189700,0,189700,0,0,189700,180600,0,180600,0,0,180600,M2,INDUS/G,,,
10679,45-19-0-13-0,6797-49-5912,COMM & IND,3.33,AC,265100,0,265100,313500,145600,724200,252400,0,252400,293600,149700,695700,M2,INDUS/G,,,
10680,45-19-0-14-0,6797-49-4640,COMM & IND,2.678,AC,170500,0,170500,326200,112600,609300,162400,0,162400,310800,117700,590900,M1,INDUS/L,,,
10681,45-19-0-15-0,6797-49-4209,COMM & IND,3.55,AC,206300,0,206300,66300,84000,356600,196400,0,196400,62400,81000,339800,M1,INDUS/L,,,
10682,45-19-0-16-0,6797-49-5161,COMM & IND,2.664,AC,201500,0,201500,0,0,201500,191800,0,191800,0,0,191800,M1,INDUS/L,,,
10683,45-19-0-17-0,6797-49-8098,COMM & IND,2.234,AC,177800,0,177800,0,0,177800,169300,0,169300,0,0,169300,M2,INDUS/G,,,
10684,45-19-0-18-0,6797-59-2045,COMM & IND,2.411,AC,191900,0,191900,0,56600,248500,182800,0,182800,0,57800,240600,M2,INDUS/G,,,
10685,45-19-0-19-0,6797-59-5044,COMM & IND,2.05,AC,163200,0,163200,928000,57900,1149100,155400,0,155400,871900,60600,1087900,M2,INDUS/G,,,
10686,45-19-0-20-0,6797-59-8000,COMM & IND,2.162,AC,258100,0,258100,0,0,258100,147500,0,147500,0,0,147500,M2,INDUS/G,,,
10687,45-19-0-21-0,6797-59-4452,COMM & IND,2.409,AC,191800,0,191800,309400,54600,555800,182600,0,182600,250000,60200,492800,M2,INDUS/G,,,
10688,45-19-0-22-0,6797-59-2524,COMM & IND,3.258,AC,259300,0,259300,337600,100500,697400,247000,0,247000,328100,104500,679600,M2,INDUS/G,,,
10689,45-19-0-23-0,6797-49-9416,COMM & IND,2.717,AC,216300,0,216300,0,0,216300,205900,0,205900,0,0,205900,M2,INDUS/G,,,
10690,45-19-0-24-0,6797-49-9723,COMM & IND,2.17,AC,172700,0,172700,0,40900,213600,164500,0,164500,0,38100,202600,M2,INDUS/G,,,
10691,45-19-0-25-0,6798-50-0173,COMM & IND,6.196,AC,492000,0,492000,273300,91700,857000,468500,0,468500,262600,59200,790300,M2,INDUS/G,,,
10694,67-1-0-3-0,7723-44-6146,SNGL FAM SUB,3.435,AC,390000,0,390000,1406300,51900,1848200,340000,0,340000,1226700,46600,1613300,R1,RES/LTD,,,
10695,66-1-0-11-0,7723-44-1009,SNGL FAM SUB,6.053,AC,468000,0,468000,1258100,29100,1755200,408000,0,408000,1223000,29800,1660800,R1,RES/LTD,,,
10696,66-1-0-12-0,7723-43-0761,SNGL FAM SUB,3.468,AC,775000,0,775000,1094800,87200,1957000,675000,0,675000,985300,79100,1739400,R1,RES/LTD,,,
10697,66-1-0-13-0,7723-43-3655,SNGL FAM SUB,2.646,AC,751800,0,751800,0,0,751800,654800,0,654800,0,0,654800,R1,RES/LTD,,,
10698,58-26-0-1-0,7715-35-1940,SNGL FAM SUB,2,AC,376000,0,376000,0,0,376000,345100,0,345100,0,0,345100,A2,AG/LTD,,,
10699,58-26-0-2-0,7715-25-8999,SNGL FAM SUB,2,AC,376000,0,376000,806100,800,1182900,345100,0,345100,744000,800,1089900,A2,AG/LTD,,,
10700,58-26-0-3-0,7715-26-6194,SNGL FAM SUB,2.032,AC,376000,0,376000,403900,3100,783000,345100,0,345100,397100,2300,744500,A2,AG/LTD,,,
10701,58-26-0-4-0,7715-26-4255,SNGL FAM SUB,2.269,AC,376000,0,376000,986300,55800,1418100,345100,0,345100,909500,60400,1315000,A2,AG/LTD,,,
10702,58-26-0-5-0,7715-26-2312,SNGL FAM SUB,2.86,AC,376000,0,376000,456800,800,833600,345100,0,345100,409000,800,754900,A2,AG/LTD,,,
10703,58-26-0-6-0,7715-25-4837,SNGL FAM SUB,2.038,AC,346800,0,346800,615900,0,962700,318300,0,318300,570200,0,888500,A2,AG/LTD,,,
10705,20-1-0-68-B,6840-96-1828,AG 20-100 AC,39.951,AC,225100,205200,19900,0,0,225100,220700,203600,17100,0,0,220700,A1,AG/GEN,,,
10710,42-2-0-2-A,6757-95-5175,SNGL FAM SUB,4.826,AC,106200,0,106200,362800,4800,473800,94900,0,94900,302300,4300,401500,R3,RES/GEN,,,
10711,46-30-0-1-0,7707-91-9234,SNGL FAM SUB,2.42,AC,131400,0,131400,23300,2800,157500,117400,0,117400,20200,2800,140400,A2,AG/LTD,,,
10712,46-30-0-2-0,7717-01-0516,SNGL FAM SUB,3.1,AC,146900,0,146900,506900,200,654000,131200,0,131200,443300,200,574700,A2,AG/LTD,,,
10713,46-30-0-3-0,7717-02-2051,SNGL FAM SUB,3.79,AC,162600,0,162600,246500,31900,441000,145300,0,145300,208500,30000,383800,A2,AG/LTD,,,
10714,46-30-0-4-0,7707-92-9093,SNGL FAM SUB,3.16,AC,158100,0,158100,368900,300,527300,141300,0,141300,311300,300,452900,A2,AG/LTD,,,
10715,46-30-0-5-0,7707-92-6092,SNGL FAM SUB,2.65,AC,136600,0,136600,0,0,136600,122100,0,122100,0,0,122100,A2,AG/LTD,,,
10716,46-30-0-6-0,7707-92-4056,SNGL FAM SUB,3.24,AC,150100,0,150100,0,0,150100,134100,0,134100,0,0,134100,A2,AG/LTD,,,
10741,31-1-0-56-A,6769-98-3040,SNGL FAM SUB,19.12,AC,210100,0,210100,0,3100,213200,187400,0,187400,0,2700,190100,A2,AG/LTD,,,
10744,55-1-0-71-B,6786-62-5603,SNGL FAM SUB,2.01,AC,86800,0,86800,0,0,86800,77400,0,77400,0,0,77400,A2,AG/LTD,,,
10745,55-1-0-71-C,6786-62-4334,SNGL FAM SUB,3,AC,103100,0,103100,0,0,103100,92000,0,92000,0,0,92000,A2,AG/LTD,,,
10746,55-1-0-71-D,6786-62-8587,SNGL FAM SUB,2.15,AC,89100,0,89100,335800,1900,426800,79500,0,79500,275700,2000,357200,A2,AG/LTD,,,
10752,57-1-0-70-A,7706-95-0791,AG 20-100 AC,21.401,AC,841900,831600,10300,0,0,841900,731700,722500,9200,0,0,731700,A2,AG/LTD,,,
10757,1-1-0-22-G,6804-67-0339,SNGL FAM SUB,1.527,AC,5600,4900,700,0,0,5600,5500,4900,600,0,0,5500,A1,AG/GEN,,,
10784,13-1-0-3-F,6842-75-7660,SNGL FAM SUB,2.203,AC,45200,0,45200,145200,3000,193400,45000,0,45000,131200,3000,179200,A1,AG/GEN,,,
10793,43-1-0-64-A,6778-51-3390,SNGL FAM SUB,6.67,AC,121400,49600,71800,183800,800,306000,131000,66000,65000,150900,800,282700,A2,AG/LTD,,,
10828,46-1-0-5-A,7707-35-2675,SNGL FAM SUB,2.271,AC,128000,0,128000,212800,0,340800,114300,0,114300,183500,0,297800,A2,AG/LTD,,,
10829,26-1-0-62-B,6719-24-7311,SNGL FAM SUB,3,AC,52000,0,52000,156000,1200,209200,49000,0,49000,128100,1200,178300,A1,AG/GEN,,,
10830,31-1-0-31-A,6768-97-5140,SNGL FAM SUB,4,AC,101600,0,101600,212900,1500,316000,90800,0,90800,173300,1500,265600,A2,AG/LTD,,,
10832,55-23-0-1-0,6776-65-4131,SNGL FAM SUB,10.05,AC,209000,0,209000,395900,0,604900,186400,0,186400,284400,0,470800,A2,AG/LTD,,,
10833,55-23-0-2-0,6776-65-1558,SNGL FAM SUB,8.55,AC,184100,0,184100,0,0,184100,164500,0,164500,0,0,164500,A2,AG/LTD,,,
10834,55-23-0-3-0,6776-56-9018,SNGL FAM SUB,6.61,AC,154800,0,154800,0,0,154800,138300,0,138300,0,0,138300,A2,AG/LTD,,,
10835,54-6-0-4-0,6776-56-2299,AG 20-100 AC,43.73,AC,407300,317500,89800,690700,6000,1104000,362800,282000,80800,568400,6000,937200,A2,AG/LTD,,,
10836,54-6-0-5-0,6776-54-5905,AG 20-100 AC,20,AC,262000,0,262000,468600,1500,732100,233600,0,233600,387500,1500,622600,A2,AG/LTD,,,
10838,4-1-0-3-0,6804-42-1321,AG 20-100 AC,60,AC,66500,0,66500,371100,21000,458600,64300,0,64300,316900,21000,402200,A1,AG/GEN,,,
10839,1-1-0-20-0,6804-88-2700,AG 20-100 AC,65.11,AC,299600,216600,83000,200200,11200,511000,293800,214200,79600,175600,10300,479700,A1,AG/GEN,,,
10840,58-21-C-11-0,7716-22-4558,Cmn Area/Open Spc,0.06,AC,0,0,0,0,0,0,0,0,0,0,0,0,R3,RES/GEN,,,
10841,54-7-0-1-0,6766-74-8886,SNGL FAM SUB,11.683,AC,198300,0,198300,0,0,198300,163400,0,163400,0,0,163400,A2,AG/LTD,,,
10842,54-7-0-2-0,6766-85-3615,SNGL FAM SUB,11.792,AC,199600,0,199600,0,0,199600,163400,0,163400,0,0,163400,A2,AG/LTD,,,
10843,54-7-0-3-0,6766-86-6265,SNGL FAM SUB,14.095,AC,234200,0,234200,0,0,234200,194700,0,194700,0,0,194700,A2,AG/LTD,,,
10844,54-7-0-4-0,6766-97-0110,SNGL FAM SUB,7.269,AC,155500,0,155500,0,0,155500,187500,0,187500,0,0,187500,A2,AG/LTD,,,
10862,30-18-0-1-A,6759-21-8185,Cemetery,0.32,AC,100,0,100,0,0,100,100,0,100,0,0,100,A2,AG/LTD,,,
10863,31-1-0-21-C,6768-66-0823,Cemetery,0.11,AC,100,0,100,0,0,100,100,0,100,0,0,100,A2,AG/LTD,,,
10864,31-1-0-21-D,6768-56-9590,Cemetery,0.84,AC,100,0,100,0,0,100,100,0,100,0,0,100,A2,AG/LTD,,,
10865,47-18-0-12-A,7727-18-0505,Cemetery,0.082,AC,100,0,100,0,0,100,100,0,100,0,0,100,RR,RES/RUR,,,
10866,50-1-0-1-C,6716-95-0614,Cemetery,0,AC,100,0,100,0,0,100,100,0,100,0,0,100,A1,AG/GEN,,,
10867,50-2-0-A-2,6726-13-8816,Cemetery,0,AC,100,0,100,0,0,100,100,0,100,0,0,100,A1,AG/GEN,,,
10869,17-1-0-17-A,6709-87-6239,Vacant Land,0.7,AC,3900,0,3900,0,0,3900,3900,0,3900,0,0,3900,A1,AG/GEN,,,
10870,64-1-0-82-A,7733-58-1399,Place of Worship,8.51,AC,676500,0,676500,2188000,1000,2865500,588200,0,588200,2114900,1000,2704100,R1,RES/LTD,,,
10877,38-1-0-81-B,6707-75-3557,SNGL FAM SUB,2.04,AC,44600,0,44600,102200,500,147300,43700,0,43700,87000,500,131200,A1,AG/GEN,,,
10878,58-28-0-F-0,7715-27-3953,SNGL FAM SUB,0.702,AC,22400,0,22400,0,0,22400,20400,0,20400,0,0,20400,R3,RES/GEN,,,
10879,47-1-0-43-L,7726-09-6205,COMM & IND,0.706,AC,209700,0,209700,147400,3900,361000,190600,0,190600,142600,3600,336800,B1,BUS/GEN,,,
10881,58-28-0-K-0,7715-26-6816,SNGL FAM SUB,1.02,AC,32500,0,32500,0,0,32500,29600,0,29600,0,0,29600,A2,AG/LTD,,,
10882,44-13-0-D-1,6787-61-4985,SNGL FAM SUB,3,AC,97700,0,97700,0,0,97700,87200,0,87200,0,0,87200,A2,AG/LTD,,,
10884,30-1-0-94-A,6768-14-0237,SNGL FAM SUB,6.47,AC,104000,0,104000,218400,0,322400,95400,0,95400,186700,0,282100,A2,AG/LTD,,,
10885,31-15-0-1-A,6779-36-6334,SNGL FAM SUB,2.97,AC,88700,0,88700,264600,44600,397900,79300,0,79300,213300,38500,331100,A2,AG/LTD,,,
10887,57-7-0-7-0,7705-97-6965,SNGL FAM SUB,2.174,AC,230000,0,230000,570600,0,800600,210000,0,210000,516500,0,726500,RR,RES/RUR,,,
10888,57-7-0-8-0,7705-97-6770,SNGL FAM SUB,2.027,AC,230000,0,230000,466800,2100,698900,210000,0,210000,424100,2100,636200,RR,RES/RUR,,,
10889,57-7-0-9-0,7705-97-6496,SNGL FAM SUB,2.004,AC,230000,0,230000,599500,14800,844300,210000,0,210000,550400,12500,772900,RR,RES/RUR,,,
10890,57-7-0-10-0,7705-97-7116,SNGL FAM SUB,2.025,AC,230000,0,230000,752900,0,982900,210000,0,210000,674200,0,884200,RR,RES/RUR,,,
10891,57-7-0-11-0,7705-97-4087,SNGL FAM SUB,3,AC,230000,0,230000,644800,108100,982900,210000,0,210000,579900,99900,889800,RR,RES/RUR,,,
10892,57-7-0-12-0,7705-97-1273,SNGL FAM SUB,3.01,AC,230000,0,230000,568100,0,798100,210000,0,210000,518400,0,728400,RR,RES/RUR,,,
10893,57-7-0-13-0,7705-97-2543,SNGL FAM SUB,2.763,AC,230000,0,230000,676100,0,906100,210000,0,210000,618900,0,828900,RR,RES/RUR,,,
10894,57-7-0-14-0,7705-97-2865,SNGL FAM SUB,2.774,AC,230000,0,230000,539700,1800,771500,210000,0,210000,497300,1800,709100,RR,RES/RUR,,,
10895,57-7-0-15-0,7705-87-9548,SNGL FAM SUB,4.423,AC,265000,0,265000,505300,26500,796800,240000,0,240000,467300,23000,730300,RR,RES/RUR,,,
10896,57-7-0-16-0,7705-87-7633,SNGL FAM SUB,4.087,AC,230000,0,230000,470000,0,700000,210000,0,210000,431500,0,641500,RR,RES/RUR,,,
10897,57-7-0-17-0,7705-87-5603,SNGL FAM SUB,4.662,AC,265000,0,265000,891200,0,1156200,240000,0,240000,808900,0,1048900,RR,RES/RUR,,,
10898,57-7-0-18-0,7705-87-2606,SNGL FAM SUB,4.916,AC,265000,0,265000,597100,36100,898200,240000,0,240000,542500,31400,813900,RR,RES/RUR,,,
10899,57-7-0-19-0,7705-77-8773,SNGL FAM SUB,4.524,AC,265000,0,265000,519400,0,784400,240000,0,240000,478200,0,718200,RR,RES/RUR,,,
10900,57-7-0-20-0,7705-77-5747,SNGL FAM SUB,3.672,AC,230000,0,230000,0,0,230000,210000,0,210000,0,0,210000,RR,RES/RUR,,,
10902,57-7-0-21-0,7705-78-5222,SNGL FAM SUB,3.028,AC,230000,0,230000,593400,0,823400,210000,0,210000,560100,0,770100,RR,RES/RUR,,,
10903,57-7-0-22-0,7705-78-7442,SNGL FAM SUB,3.301,AC,230000,0,230000,713000,10200,953200,210000,0,210000,659200,8900,878100,RR,RES/RUR,,,
10904,57-7-0-23-0,7705-88-1351,SNGL FAM SUB,5.509,AC,230000,0,230000,395700,1000,626700,210000,0,210000,366100,1000,577100,RR,RES/RUR,,,
10905,57-7-0-24-0,7705-88-6300,SNGL FAM SUB,4.712,AC,265000,0,265000,796000,3700,1064700,240000,0,240000,731900,2700,974600,RR,RES/RUR,,,
10906,57-7-0-25-0,7705-88-9390,SNGL FAM SUB,2.705,AC,230000,0,230000,519000,0,749000,210000,0,210000,474800,0,684800,RR,RES/RUR,,,
10908,57-7-0-26-0,7705-98-2380,SNGL FAM SUB,2.204,AC,230000,0,230000,594500,33800,858300,210000,0,210000,546700,30000,786700,RR,RES/RUR,,,
10909,57-7-0-27-0,7705-98-6229,SNGL FAM SUB,2.247,AC,230000,0,230000,586000,1600,817600,210000,0,210000,537500,1600,749100,RR,RES/RUR,,,
10910,6-10-0-1-A1,6822-99-0136,SNGL FAM SUB,2.81,AC,55100,0,55100,218200,9000,282300,53500,0,53500,190200,9400,253100,A1,AG/GEN,,,
10912,47-1-0-43-K,7716-99-3195,COMM & IND,1.098,AC,325700,0,325700,492700,82800,901200,296100,0,296100,469600,73900,839600,R3,RES/GEN,,,
10913,47-1-0-43-M,7716-99-9734,COMM & IND,1.261,AC,299000,0,299000,0,0,299000,271800,0,271800,0,0,271800,M1,INDUS/L,,,
10914,47-1-0-43-N,7716-99-8323,COMM & IND,3.096,AC,863000,0,863000,0,0,863000,784500,0,784500,0,0,784500,M1,INDUS/L,,,
10915,38-1-0-103-0,6707-88-1284,SNGL FAM SUB,2.75,AC,48600,0,48600,104600,0,153200,47600,0,47600,89800,0,137400,A1,AG/GEN,,,
10917,39-1-0-92-B,6727-14-8108,SNGL FAM SUB,2.27,AC,46500,0,46500,0,0,46500,45600,0,45600,0,0,45600,A1,AG/GEN,,,
10918,11-12-0-1-0,6821-26-0836,SNGL FAM SUB,3.22,AC,53300,51700,1600,0,0,53300,52400,51000,1400,0,0,52400,A1,AG/GEN,,,
10919,11-12-0-2-0,6821-27-0143,SNGL FAM SUB,3.77,AC,56400,54500,1900,0,0,56400,56000,54400,1600,0,0,56000,A1,AG/GEN,,,
10922,11-12-0-3-0,6821-26-5620,SNGL FAM SUB,7.65,AC,77100,33700,43400,9100,0,86200,77900,37000,40900,8500,0,86400,A1,AG/GEN,,,
10923,11-12-0-4-0,6821-36-0423,SNGL FAM SUB,8.34,AC,80500,0,80500,0,0,80500,82000,0,82000,0,0,82000,A1,AG/GEN,,,
10924,33-7-0-1-0,6798-24-3939,COMM & IND,3.45,AC,241200,0,241200,693900,0,935100,229800,0,229800,693900,0,923700,M1,INDUS/L,,,
10925,33-7-0-1-A,6798-24-1913,Cemetery,0,AC,100,0,100,0,0,100,100,0,100,0,0,100,M1,INDUS/L,,,
10929,33-7-0-2-0,6798-25-3293,COMM & IND,2.39,AC,167100,0,167100,464900,36100,668100,159200,0,159200,435800,40300,635300,M1,INDUS/L,,,
10930,33-7-0-3-0,6798-25-4445,COMM & IND,2.24,AC,156600,0,156600,250500,14100,421200,149200,0,149200,234800,17300,401300,M1,INDUS/L,,,
10931,33-7-0-4-0,6798-25-5638,COMM & IND,2.11,AC,147500,0,147500,377100,66500,591100,140500,0,140500,350600,67100,558200,M1,INDUS/L,,,
10932,33-7-0-5-0,6798-25-6930,COMM & IND,2.05,AC,143300,0,143300,153700,53000,350000,136500,0,136500,144300,53500,334300,M1,INDUS/L,,,
10933,33-7-0-6-0,6798-26-7028,COMM & IND,2.14,AC,149600,0,149600,224300,63700,437600,142500,0,142500,208600,66500,417600,M1,INDUS/L,,,
10941,33-7-0-11-0,6798-36-3022,COMM & IND,3.097,AC,216500,0,216500,1045200,57800,1319500,206300,0,206300,987800,60900,1255000,M1,INDUS/L,,,
10942,33-7-0-12-0,6798-35-1880,COMM & IND,2.563,AC,179200,0,179200,1092400,64700,1336300,170700,0,170700,1019800,68800,1259300,M1,INDUS/L,,,
10943,33-7-0-13-0,6798-35-0671,Non-Profit,2.61,AC,182400,0,182400,498600,109100,790100,173800,0,173800,461700,110200,745700,M1,INDUS/L,,,
10944,33-7-0-14-0,6798-25-9485,COMM & IND,2.18,AC,152400,0,152400,265700,54000,472100,145200,0,145200,243900,56900,446000,M1,INDUS/L,,,
10945,33-7-0-15-0,6798-25-9229,COMM & IND,2.09,AC,146100,0,146100,545200,0,691300,139200,0,139200,545200,0,684400,M1,INDUS/L,,,
10946,33-7-0-16-0,6798-25-8098,COMM & IND,2.405,AC,151300,0,151300,0,0,151300,144200,0,144200,0,0,144200,M1,INDUS/L,,,
10947,58-27-0-1-0,7715-49-8217,SNGL FAM SUB,0.955,AC,339500,0,339500,473600,3800,816900,311600,0,311600,449000,3700,764300,R3,RES/GEN,,,
10948,58-27-0-2-0,7715-49-5494,SNGL FAM SUB,0.915,AC,354100,0,354100,446600,0,800700,325000,0,325000,424600,0,749600,R3,RES/GEN,,,
10949,58-27-0-3-0,7715-49-4366,SNGL FAM SUB,0.808,AC,354100,0,354100,860000,0,1214100,325000,0,325000,859500,0,1184500,R3,RES/GEN,,,
10950,58-27-0-4-0,7715-49-3188,SNGL FAM SUB,1.377,AC,365000,0,365000,698100,0,1063100,335000,0,335000,693300,0,1028300,R3,RES/GEN,,,
10951,58-27-0-6-0,7715-48-6906,SNGL FAM SUB,1.165,AC,365000,0,365000,725300,3900,1094200,335000,0,335000,715600,2700,1053300,R3,RES/GEN,,,
10952,58-27-0-7-0,7715-48-7970,SNGL FAM SUB,2.036,AC,365000,0,365000,651000,0,1016000,335000,0,335000,636900,0,971900,R3,RES/GEN,,,
10953,12-1-0-9-A,6832-27-1081,SNGL FAM SUB,4,AC,64800,0,64800,175800,0,240600,63000,0,63000,152200,0,215200,A1,AG/GEN,,,
10954,31-25-0-1-0,6768-94-3272,SNGL FAM SUB,3,AC,104500,0,104500,468600,0,573100,95000,0,95000,413900,0,508900,RR,RES/RUR,,,
10955,31-25-0-2-0,6768-94-6627,SNGL FAM SUB,3,AC,104500,0,104500,412600,0,517100,95000,0,95000,369100,0,464100,RR,RES/RUR,,,
10956,31-25-0-3-0,6768-94-6110,SNGL FAM SUB,3,AC,110000,0,110000,390200,0,500200,100000,0,100000,341700,0,441700,RR,RES/RUR,,,
10957,31-25-0-4-0,6768-94-8346,SNGL FAM SUB,3.05,AC,110000,0,110000,380500,1600,492100,100000,0,100000,336100,1700,437800,RR,RES/RUR,,,
10958,31-25-0-5-0,6778-04-0470,SNGL FAM SUB,3,AC,110000,0,110000,308600,18400,437000,100000,0,100000,270400,19200,389600,RR,RES/RUR,,,
10959,31-25-0-6-0,6778-04-4144,SNGL FAM SUB,3,AC,110000,0,110000,344300,1900,456200,100000,0,100000,301800,2000,403800,RR,RES/RUR,,,
10960,31-25-0-8-0,6778-13-1570,SNGL FAM SUB,3.42,AC,110000,0,110000,361300,24600,495900,100000,0,100000,322700,23400,446100,RR,RES/RUR,,,
10961,31-25-0-9-0,6778-13-4128,SNGL FAM SUB,3,AC,110000,0,110000,0,0,110000,100000,0,100000,0,0,100000,RR,RES/RUR,,,
10962,31-25-0-10-0,6778-12-2833,SNGL FAM SUB,3.72,AC,110000,0,110000,394800,0,504800,100000,0,100000,344800,0,444800,RR,RES/RUR,,,
10963,31-25-0-11-0,6778-03-9001,SNGL FAM SUB,3.84,AC,110000,0,110000,437300,2400,549700,100000,0,100000,380600,2500,483100,RR,RES/RUR,,,
10964,31-25-0-12-0,6778-03-6281,SNGL FAM SUB,4.53,AC,143000,0,143000,0,0,143000,130000,0,130000,0,0,130000,RR,RES/RUR,,,
10965,31-25-0-13-0,6778-03-5428,SNGL FAM SUB,5.18,AC,154000,0,154000,426700,0,580700,140000,0,140000,378000,0,518000,RR,RES/RUR,,,
10966,31-25-0-14-0,6778-03-1816,SNGL FAM SUB,3.29,AC,132000,0,132000,356300,1600,489900,120000,0,120000,315600,1700,437300,RR,RES/RUR,,,
10968,31-25-0-15-0,6778-03-1515,SNGL FAM SUB,3.22,AC,143000,0,143000,407100,1600,551700,130000,0,130000,358700,1700,490400,RR,RES/RUR,,,
10969,31-25-0-16-0,6778-03-1135,SNGL FAM SUB,4.82,AC,154000,0,154000,528200,42300,724500,140000,0,140000,458200,39000,637200,RR,RES/RUR,,,
10970,31-25-0-17-0,6768-93-7250,SNGL FAM SUB,3,AC,110000,0,110000,0,0,110000,100000,0,100000,0,0,100000,RR,RES/RUR,,,
10971,31-25-0-18-0,6768-93-4449,SNGL FAM SUB,3.91,AC,110000,0,110000,317200,0,427200,100000,0,100000,282900,0,382900,RR,RES/RUR,,,
10972,31-25-0-19-0,6768-93-6704,SNGL FAM SUB,3.49,AC,110000,0,110000,433900,1200,545100,100000,0,100000,383900,1300,485200,RR,RES/RUR,,,
10973,31-25-0-20-0,6768-93-1707,SNGL FAM SUB,3,AC,104500,0,104500,385700,2400,492600,95000,0,95000,336000,1800,432800,RR,RES/RUR,,,
10974,19-1-0-54-D,6830-55-1435,SNGL FAM SUB,16.934,AC,175400,113900,61500,600700,70800,846900,166200,109500,56700,495000,56500,717700,A1,AG/GEN,,,
10976,40-1-0-22-B,6726-86-8746,SNGL FAM SUB,6.1,AC,77600,0,77600,244000,30300,351900,76200,0,76200,212000,36700,324900,A1,AG/GEN,,,
10978,20-17-0-C-1,6830-99-4816,SNGL FAM SUB,4.43,AC,86000,0,86000,214500,38800,339300,78400,0,78400,175500,32800,286700,A1,AG/GEN,,,
10979,20-17-0-C-2,6830-99-8615,SNGL FAM SUB,5.59,AC,95800,0,95800,196500,15400,307700,88000,0,88000,161900,13600,263500,A1,AG/GEN,,,
10980,43-1-0-64-0,6778-50-9688,SNGL FAM SUB,8.98,AC,144700,76500,68200,172000,7600,324300,129000,68400,60600,141400,7600,278000,A2,AG/LTD,,,
10981,45-20-0-1-0,6797-79-9454,SNGL FAM SUB,2.01,AC,84000,0,84000,122500,200,206700,75000,0,75000,102600,200,177800,A2,AG/LTD,,,
10982,57-1-0-37-A,7715-27-1367,SNGL FAM SUB,0.127,AC,4100,0,4100,0,0,4100,3700,0,3700,0,0,3700,R3,RES/GEN,,,
10983,58-28-0-1-0,7716-20-9634,COMM & IND,360.368,AC,8760500,0,8760500,0,3643200,12403700,8126300,0,8126300,0,3449700,11576000,A2R3,AGRIC.R,,,
10984,58-28-0-A-0,7715-48-3973,SNGL FAM SUB,0.018,AC,600,0,600,0,0,600,500,0,500,0,0,500,A2,AG/LTD,,,
10985,58-28-0-J-0,7715-26-3988,SNGL FAM SUB,0.702,AC,22400,0,22400,0,0,22400,20400,0,20400,0,0,20400,R3,RES/GEN,,,
10988,58-28-0-N-0,7715-36-1486,SNGL FAM SUB,0.063,AC,2000,0,2000,0,0,2000,1800,0,1800,0,0,1800,A2,AG/LTD,,,
10990,58-28-0-S-0,7715-36-9283,SNGL FAM SUB,2.125,AC,67800,0,67800,0,0,67800,61600,0,61600,0,0,61600,A2,AG/LTD,,,
10991,40-1-0-24-A,6736-17-7102,SNGL FAM SUB,3.01,AC,50100,0,50100,92600,1500,144200,49100,0,49100,78000,1500,128600,A1,AG/GEN,,,
10993,21-1-0-37-A,6759-39-3213,SNGL FAM SUB,3.57,AC,80800,0,80800,445200,4800,530800,72800,0,72800,407500,4400,484700,A2,AG/LTD,,,
10994,29-3-0-4-B,6749-82-4795,SNGL FAM SUB,2.34,AC,67300,0,67300,0,0,67300,62500,0,62500,0,0,62500,A1,AG/GEN,,,
10995,51-1-0-53-A,6736-51-3538,SNGL FAM SUB,2,AC,40500,0,40500,109800,1500,151800,39700,0,39700,94000,1500,135200,A1,AG/GEN,,,
10996,17-1-0-47-E,6810-37-1402,SNGL FAM SUB,2,AC,44400,0,44400,165900,1100,211400,43500,0,43500,143700,1100,188300,A1,AG/GEN,,,
10997,13-18-0-1-0,6841-87-5011,SNGL FAM SUB,3.8,AC,74200,0,74200,0,0,74200,72800,0,72800,0,0,72800,A1,AG/GEN,,,
10999,13-18-0-2-0,6841-86-1832,SNGL FAM SUB,2.87,AC,63600,0,63600,0,0,63600,62500,0,62500,0,0,62500,A1,AG/GEN,,,
11000,13-18-0-3-0,6841-86-3690,SNGL FAM SUB,2.19,AC,60200,0,60200,233700,0,293900,59100,0,59100,205800,0,264900,A1,AG/GEN,,,
11001,13-18-0-4-0,6841-86-3315,SNGL FAM SUB,2.5,AC,62900,0,62900,223700,500,287100,61800,0,61800,195700,500,258000,A1,AG/GEN,,,
11002,47-27-0-8-0,7716-97-8819,COMM & IND,12.113,AC,5735400,1507600,4227800,0,0,5735400,5213900,1370500,3843400,0,0,5213900,B1,BUS/GEN,,,
11003,47-27-0-9-0,7726-08-1034,COMM & IND,1.919,AC,596000,0,596000,171500,0,767500,541700,0,541700,159700,0,701400,B1,BUS/GEN,,,
11004,47-27-0-10-0,7726-07-3045,COMM & IND,7.502,AC,1489500,0,1489500,0,0,1489500,1354300,0,1354300,0,0,1354300,A2,AG/LTD,,,
11005,17-1-0-32-A,6800-59-6049,SNGL FAM SUB,2.01,AC,43400,0,43400,0,0,43400,42500,0,42500,0,0,42500,A1,AG/GEN,,,
11007,21-1-0-27-A,6759-27-0588,SNGL FAM SUB,2.11,AC,65100,0,65100,175200,25000,265300,61400,0,61400,144700,21000,227100,A2,AG/LTD,,,
11009,21-1-0-27-B,6759-17-7414,SNGL FAM SUB,5.47,AC,95600,0,95600,176300,19700,291600,80300,0,80300,145300,13100,238700,A2,AG/LTD,,,
11010,39-8-0-D-1,6727-23-7611,SNGL FAM SUB,3.99,AC,55500,0,55500,210900,2500,268900,54400,0,54400,179800,2500,236700,A1,AG/GEN,,,
11011,26-2-0-3-P,6709-82-9773,SNGL FAM SUB,15.182,AC,115600,0,115600,0,6000,121600,116000,0,116000,0,6000,122000,A1,AG/GEN,,,
11012,20-17-0-C-3,6840-09-2582,SNGL FAM SUB,2.32,AC,66900,0,66900,119300,0,186200,63000,0,63000,99200,0,162200,A1,AG/GEN,,,
11014,45-17-0-G-1,6797-40-6127,SNGL FAM SUB,4.21,AC,133400,0,133400,324200,71400,529000,119100,0,119100,272400,60300,451800,A2,AG/LTD,,,
11015,28-1-0-56-A,6738-27-2905,SNGL FAM SUB,2.32,AC,34600,0,34600,0,0,34600,34000,0,34000,0,0,34000,A1,AG/GEN,,,
11016,4-1-0-26-B,6803-62-4904,SNGL FAM SUB,11.199,AC,96900,53100,43800,314200,3100,414200,94100,51800,42300,269800,3400,367300,A1,AG/GEN,,,
11017,19-1-0-26-B,6739-18-4527,SNGL FAM SUB,2.01,AC,61700,0,61700,136700,3500,201900,57300,0,57300,113000,3500,173800,A1,AG/GEN,,,
11018,29-1-0-112-D,6749-70-8137,SNGL FAM SUB,4.27,AC,82100,0,82100,413300,2100,497500,75400,0,75400,345500,2100,423000,A1,AG/GEN,,,
11019,47-1-0-43-G,7716-99-6722,COMM & IND,2.041,AC,542500,0,542500,1806300,76900,2425700,493100,0,493100,1737600,53700,2284400,M1,INDUS/L,,,
11020,47-1-0-43-H,7716-99-5543,COMM & IND,0.896,AC,266100,0,266100,773000,8100,1047200,241900,0,241900,736800,6300,985000,M1,INDUS/L,,,
11021,45-20-0-2-0,6797-89-0291,SNGL FAM SUB,2.4,AC,89400,0,89400,157100,14800,261300,79800,0,79800,128500,11500,219800,A2,AG/LTD,,,
11025,47-12-0-B-1,7717-26-2426,SNGL FAM SUB,10.943,AC,294800,181100,113700,353700,3000,651500,263400,161900,101500,299700,3000,566100,A2,AG/LTD,,,
11027,47-12-0-2-B,7717-15-7678,AG 20-100 AC,22.422,AC,597300,585900,11400,0,0,597300,532700,523100,9600,0,0,532700,A2,AG/LTD,,,
11028,47-1-0-8-0,7717-56-4654,SNGL FAM SUB,16.38,AC,290700,282900,7800,0,0,290700,259900,252900,7000,0,0,259900,A2,AG/LTD,,,
11029,47-12-0-3-0,7717-45-3323,AG > 100 AC,131,AC,3081100,3015200,65900,0,0,3081100,2751000,2694800,56200,0,0,2751000,A2,AG/LTD,,,
11031,47-12-0-1-A,7717-34-8017,AG 20-100 AC,22.6,AC,694200,538300,155900,147600,20900,862700,619300,480500,138800,125800,20900,766000,A2,AG/LTD,,,
11032,47-12-0-1-B,7717-33-1503,SNGL FAM SUB,14.994,AC,491600,484000,7600,0,17100,508700,438600,432200,6400,0,15800,454400,A2,AG/LTD,,,
11033,63-1-0-83-0,7723-07-3179,SNGL FAM SUB,2,AC,191600,0,191600,384500,6200,582300,166600,0,166600,327700,6700,501000,A2,AG/LTD,,,
11036,12-1-0-28-0,6821-82-5823,SNGL FAM SUB,8.528,AC,84300,0,84300,172200,11200,267700,78600,0,78600,146900,8400,233900,A1,AG/GEN,,,
11037,28-1-0-87-C,6739-24-7898,SNGL FAM SUB,4.1,AC,68200,0,68200,0,15700,83900,68900,0,68900,0,14300,83200,A1,AG/GEN,,,
11038,5-1-0-55-D,6823-50-2661,AG 20-100 AC,22.14,AC,145000,0,145000,0,0,145000,143200,0,143200,0,0,143200,A1,AG/GEN,,,
11039,5-1-0-55-C,6823-41-7350,AG 20-100 AC,26.23,AC,165700,116500,49200,219900,22800,408400,163800,117500,46300,197900,20900,382600,A1,AG/GEN,,,
11040,5-1-0-55-B,6823-51-7555,SNGL FAM SUB,5.13,AC,62600,0,62600,356400,27400,446400,60900,0,60900,310300,23200,394400,A1,AG/GEN,,,
11041,57-1-0-26-G,7706-10-3910,SNGL FAM SUB,3.89,AC,170900,0,170900,0,0,170900,148700,0,148700,0,0,148700,A2,AG/LTD,,,
11042,47-18-0-10-0,7717-98-8582,SNGL FAM SUB,3.1,AC,157300,0,157300,220000,600,377900,140500,0,140500,183800,600,324900,RR,RES/RUR,,,
11043,47-18-0-11-0,7727-08-3482,SNGL FAM SUB,3.1,AC,107000,0,107000,184600,400,292000,95500,0,95500,154100,400,250000,RR,RES/RUR,,,
11044,47-18-0-12-0,7727-08-8440,SNGL FAM SUB,3.145,AC,125600,0,125600,228800,15700,370100,112200,0,112200,193100,15700,321000,RR,RES/RUR,,,
11045,47-18-0-13-0,7727-08-7784,SNGL FAM SUB,3.227,AC,127000,0,127000,187000,0,314000,113500,0,113500,156000,0,269500,RR,RES/RUR,,,
11047,30-18-0-1-0,6759-21-4153,AG 20-100 AC,20.07,AC,145200,0,145200,189100,47800,382100,139500,0,139500,155100,42600,337200,A1,AG/GEN,,,
11048,30-18-0-2-0,6759-30-0954,SNGL FAM SUB,8,AC,101300,0,101300,371900,0,473200,93300,0,93300,307900,0,401200,A1,AG/GEN,,,
11049,30-18-0-3-0,6759-30-4968,SNGL FAM SUB,8.1,AC,101900,0,101900,244300,0,346200,93900,0,93900,200500,0,294400,A1A2,AG GEN/,,,
11050,30-18-0-4-0,6759-30-8919,SNGL FAM SUB,6.2,AC,97000,0,97000,183600,9500,290100,93100,0,93100,150900,8100,252100,A2,AG/LTD,,,
11051,30-18-0-5-0,6759-40-1802,SNGL FAM SUB,4.8,AC,86300,0,86300,242800,6000,335100,81400,0,81400,197500,6000,284900,A2,AG/LTD,,,
11052,30-18-0-B-0,6759-41-3086,Cmn Area/Open Spc,0.32,AC,0,0,0,0,0,0,0,0,0,0,0,0,A2,AG/LTD,,,
11054,31-1-0-56-B,6769-97-7586,AG 20-100 AC,20.15,AC,249600,239600,10000,0,4000,253600,235100,226400,8700,0,4000,239100,A2,AG/LTD,,,
11055,47-1-0-70-0,7727-07-7161,SNGL FAM SUB,5.922,AC,309000,0,309000,0,0,309000,294500,0,294500,0,0,294500,A2,AG/LTD,,,
11056,11-1-0-30-A,6811-53-6413,SNGL FAM SUB,4.5,AC,58400,56100,2300,9300,0,67700,57300,55400,1900,9200,0,66500,A1,AG/GEN,,,
11057,31-25-0-7-0,6778-03-8801,SNGL FAM SUB,3,AC,110000,0,110000,603200,4300,717500,100000,0,100000,540600,3800,644400,RR,RES/RUR,,,
11058,21-8-0-1-0,6769-18-9154,AG 20-100 AC,20.3,AC,178600,169200,9400,0,0,178600,169600,161000,8600,0,0,169600,A2,AG/LTD,,,
11059,30-19-0-2-0,6769-17-4595,AG 20-100 AC,21.07,AC,180200,170500,9700,0,0,180200,164300,155300,9000,0,0,164300,A2,AG/LTD,,,
11061,30-19-0-3-0,6769-27-5402,AG 20-100 AC,21.28,AC,154800,145000,9800,0,0,154800,140600,131600,9000,0,0,140600,A2,AG/LTD,,,
11062,30-19-0-4-0,6769-16-5772,AG 20-100 AC,20.93,AC,152700,143100,9600,0,0,152700,138600,129700,8900,0,0,138600,A2,AG/LTD,,,
11063,30-19-0-5-0,6769-26-5531,AG 20-100 AC,20.59,AC,150600,141100,9500,0,0,150600,136700,127900,8800,0,0,136700,A2,AG/LTD,,,
11064,30-19-0-6-0,6769-16-4093,AG 20-100 AC,20.17,AC,148000,138700,9300,0,0,148000,134300,125700,8600,0,0,134300,A2,AG/LTD,,,
11065,30-19-0-7-0,6769-05-8792,AG 20-100 AC,20.33,AC,149000,139600,9400,0,0,149000,135200,126600,8600,0,0,135200,A2,AG/LTD,,,
11066,30-19-0-8-0,6769-05-2475,AG 20-100 AC,20.3,AC,148800,139400,9400,0,0,148800,135000,126400,8600,0,0,135000,A2,AG/LTD,,,
11067,30-19-0-9-0,6759-95-5696,AG 20-100 AC,20.3,AC,148800,139400,9400,0,0,148800,135000,126400,8600,0,0,135000,A2,AG/LTD,,,
11068,30-19-0-10-0,6759-85-8893,AG 20-100 AC,20.03,AC,147100,137900,9200,0,0,147100,133500,125000,8500,0,0,133500,A2,AG/LTD,,,
11069,30-19-0-11-0,6759-96-1830,AG 20-100 AC,20.02,AC,147100,137900,9200,0,0,147100,133400,124900,8500,0,0,133400,A2,AG/LTD,,,
11070,30-19-0-12-0,6769-06-2739,AG 20-100 AC,21.23,AC,154500,144700,9800,0,0,154500,140300,131300,9000,0,0,140300,A2,AG/LTD,,,
11071,30-19-0-13-0,6759-97-6480,AG 20-100 AC,20.23,AC,174100,164800,9300,0,0,174100,159500,150900,8600,0,0,159500,A2,AG/LTD,,,
11072,21-8-0-14-0,6769-07-3884,AG 20-100 AC,20.56,AC,176500,167000,9500,0,0,176500,161400,152700,8700,0,0,161400,A2,AG/LTD,,,
11073,58-27-0-5-0,7715-49-4083,SNGL FAM SUB,0.973,AC,350400,0,350400,675500,0,1025900,321600,0,321600,649500,0,971100,R3,RES/GEN,,,
11074,29-1-0-112-C,6748-89-1850,SNGL FAM SUB,10,AC,125300,0,125300,0,0,125300,120100,0,120100,0,0,120100,A1,AG/GEN,,,
11076,39-7-0-F-2,6717-71-0003,SNGL FAM SUB,3.01,AC,50100,0,50100,0,0,50100,49100,0,49100,0,0,49100,A1,AG/GEN,,,
11077,39-7-0-F-1,6717-61-8256,SNGL FAM SUB,3.01,AC,49100,0,49100,0,0,49100,48100,0,48100,0,0,48100,A1,AG/GEN,,,
11078,32-1-0-55-A,6788-08-4388,AG 20-100 AC,30.44,AC,347000,332600,14400,0,0,347000,310500,297500,13000,0,0,310500,A2,AG/LTD,,,
11080,13-16-0-A-3,6842-83-3152,SNGL FAM SUB,0.398,AC,1500,0,1500,0,0,1500,1400,0,1400,0,0,1400,A1,AG/GEN,,,
11081,12-1-0-52-C,6832-22-7197,SNGL FAM SUB,2,AC,46100,0,46100,78100,1000,125200,45100,0,45100,65000,1000,111100,A1,AG/GEN,,,
11082,12-1-0-52-E,6832-32-0171,SNGL FAM SUB,2.945,AC,53400,0,53400,427500,4000,484900,50700,0,50700,380700,2800,434200,A1,AG/GEN,,,
11083,31-1-0-45-C,6769-95-1297,SNGL FAM SUB,2.3,AC,77000,0,77000,188200,8600,273800,70700,0,70700,156000,6600,233300,A2,AG/LTD,,,
11084,19-1-0-26-C,6739-18-6398,SNGL FAM SUB,2.01,AC,61700,0,61700,123700,0,185400,57300,0,57300,102400,0,159700,A1,AG/GEN,,,
11085,58-28-0-R-0,7715-28-2872,SNGL FAM SUB,0.438,AC,14000,0,14000,0,0,14000,12700,0,12700,0,0,12700,A2,AG/LTD,,,
11086,29-1-0-63-A,6749-44-7348,SNGL FAM SUB,2,AC,57000,0,57000,0,0,57000,52500,0,52500,0,0,52500,A1,AG/GEN,,,
11087,16-1-0-46-A,5890-65-0475,SNGL FAM SUB,5.445,AC,41100,38600,2500,0,0,41100,41800,0,41800,0,0,41800,A1,AG/GEN,,,
11090,46-1-0-76-D3,7707-22-9708,SNGL FAM SUB,4.2,AC,142200,0,142200,170400,16100,328700,131100,0,131100,147400,13400,291900,A2,AG/LTD,,,
11091,30-1-0-22-A,6759-41-1361,SNGL FAM SUB,1.62,AC,60200,0,60200,397400,0,457600,56300,0,56300,325900,0,382200,A2,AG/LTD,,,
11092,64-7-0-C-1,7724-91-9797,SNGL FAM SUB,10.24,AC,587800,0,587800,0,0,587800,395000,0,395000,0,0,395000,R3,RES/GEN,,,
11094,50-6-0-4-0,6726-15-2384,SNGL FAM SUB,2.17,AC,45400,0,45400,244200,23900,313500,44400,0,44400,207300,21000,272700,A1,AG/GEN,,,
11096,50-6-0-1-0,6726-16-0230,SNGL FAM SUB,2.17,AC,45400,0,45400,143600,1000,190000,44400,0,44400,121100,1000,166500,A1,AG/GEN,,,
11097,50-6-0-2-0,6726-15-0922,SNGL FAM SUB,2.17,AC,45400,0,45400,141600,0,187000,44400,0,44400,120900,0,165300,A1,AG/GEN,,,
11098,50-6-0-3-0,6726-15-0696,SNGL FAM SUB,2.17,AC,45400,0,45400,0,0,45400,44400,0,44400,0,0,44400,A1,AG/GEN,,,
11102,40-1-0-15-A,6736-08-9970,SNGL FAM SUB,10,AC,101000,0,101000,277300,12000,390300,99200,0,99200,240800,10000,350000,A1,AG/GEN,,,
11103,39-1-0-85-B,6726-77-3227,SNGL FAM SUB,11.33,AC,96600,0,96600,398600,2900,498100,94800,0,94800,342500,2900,440200,A1,AG/GEN,,,
11104,19-11-0-2-A1,6831-41-1922,SNGL FAM SUB,2.193,AC,58600,0,58600,101000,1100,160700,54600,0,54600,84400,1100,140100,A1,AG/GEN,,,
11105,17-1-0-19-A,6709-78-3148,SNGL FAM SUB,12.12,AC,101100,0,101100,162400,2800,266300,99200,0,99200,153100,1500,253800,A1,AG/GEN,,,
11106,17-1-0-19-B,6709-77-7954,SNGL FAM SUB,7.76,AC,76700,0,76700,262500,21300,360500,75200,0,75200,203300,21300,299800,A1,AG/GEN,,,
11107,20-17-0-D-0,6830-99-6962,SNGL FAM SUB,1.5,AC,58900,0,58900,164600,5200,228700,54900,0,54900,135900,5200,196000,A1,AG/GEN,,,
11110,4-1-0-59-A,6812-38-1791,SNGL FAM SUB,10.366,AC,87500,0,87500,152900,25100,265500,85800,0,85800,138000,23000,246800,A1,AG/GEN,,,
11111,6-1-0-54-B,6822-99-5907,COMM & IND,5,AC,262500,0,262500,0,0,262500,255000,0,255000,0,0,255000,B1,BUS/GEN,,,
11122,43-1-0-64-B,6778-51-8175,SNGL FAM SUB,7,AC,128900,125300,3600,0,500,129400,114800,111800,3000,0,500,115300,A2,AG/LTD,,,
11217,48-1-0-68-0,7737-17-2879,COMM & IND,0,AC,0,0,0,311500,40000,351500,0,0,0,304300,40300,344600,M2,INDUS/G,,,
11235,6-1-0-60-D,6833-60-8684,SNGL FAM SUB,2.81,AC,55100,0,55100,131600,2000,188700,53500,0,53500,113700,2000,169200,A1,AG/GEN,,,
11241,24-1-0-1-A,5789-26-0582,SNGL FAM SUB,1.15,AC,2900,0,2900,0,0,2900,2900,0,2900,0,0,2900,A1,AG/GEN,,,
11242,25-1-0-8-C,6708-24-6022,SNGL FAM SUB,0.13,AC,300,0,300,0,0,300,300,0,300,0,0,300,A1,AG/GEN,,,
11243,41-1-0-8-A,6747-96-9774,SNGL FAM SUB,2.57,AC,7200,0,7200,0,0,7200,7200,0,7200,0,0,7200,A1,AG/GEN,,,
11244,42-1-0-17-A,6756-79-6142,SNGL FAM SUB,0.6,AC,1700,0,1700,0,0,1700,1700,0,1700,0,0,1700,A2,AG/LTD,,,
11247,42-1-0-20-A,6766-07-6345,SNGL FAM SUB,0.517,AC,2700,0,2700,0,0,2700,2500,0,2500,0,0,2500,M2,INDUS/G,,,
11248,51-1-0-20-E,6735-31-8914,SNGL FAM SUB,2.22,AC,5700,0,5700,0,0,5700,5600,0,5600,0,0,5600,A1,AG/GEN,,,
11250,42-1-0-25-B,6766-07-8660,COMM & IND,0.13,AC,1500,0,1500,0,0,1500,1500,0,1500,0,0,1500,B1,BUS/GEN,,,
11251,60-1-0-1-0,6774-98-3897,SNGL FAM SUB,1.36,AC,7900,0,7900,0,0,7900,7100,0,7100,0,0,7100,A2,AG/LTD,,,
11252,60-1-0-1-A,6774-98-3012,SNGL FAM SUB,2.308,AC,13400,0,13400,0,0,13400,12000,0,12000,0,0,12000,A2,AG/LTD,,,
11254,67-1-0-11-C,7723-52-6209,SNGL FAM SUB,1.1,AC,10500,0,10500,0,0,10500,9100,0,9100,0,0,9100,A2,AG/LTD,,,
11281,46-1-0-38-B,7707-41-4750,SNGL FAM SUB,3.094,AC,145500,0,145500,267300,39900,452700,129900,0,129900,231300,37700,398900,A2,AG/LTD,,,
11350,26-9-0-B-3,6719-24-0077,SNGL FAM SUB,4.02,AC,57800,0,57800,156800,28400,243000,54600,0,54600,128600,28400,211600,A2,AG/LTD,,,
11356,28-1-0-77-C,6739-26-7742,SNGL FAM SUB,3.12,AC,60900,0,60900,0,7000,67900,60400,0,60400,0,6300,66700,A1,AG/GEN,,,
11359,63-23-0-1-E,7714-60-0348,SNGL FAM SUB,0.5,AC,93500,0,93500,131600,11300,236400,81300,0,81300,110700,9500,201500,A2,AG/LTD,,,
11370,31-1-0-3-E,6769-65-2113,SNGL FAM SUB,1.883,AC,71900,0,71900,251800,3300,327000,64700,0,64700,208000,2900,275600,A2,AG/LTD,,,
11371,44-10-0-6-A,6787-53-8536,SNGL FAM SUB,2.43,AC,92700,0,92700,35100,0,127800,82800,0,82800,29500,0,112300,A2,AG/LTD,,,
11372,4-1-0-26-C,6803-72-0804,Cemetery,0,AC,100,0,100,0,0,100,100,0,100,0,0,100,A1,AG/GEN,,,
11373,13-1-0-36-E,6851-08-1012,SNGL FAM SUB,14.978,AC,122700,115800,6900,0,0,122700,120400,114000,6400,0,0,120400,A1,AG/GEN,,,
11374,13-2-0-2-B,6841-96-8901,SNGL FAM SUB,0.01,AC,100,0,100,0,0,100,100,0,100,0,0,100,A1,AG/GEN,,,
11380,48-1-0-21-B,7727-44-6935,SNGL FAM SUB,3,AC,158200,0,158200,9400,1000,168600,141200,0,141200,9000,1000,151200,A2,AG/LTD,,,
11382,28-1-0-98-A,6738-46-2546,SNGL FAM SUB,5,AC,77400,0,77400,0,0,77400,76600,0,76600,0,0,76600,A1,AG/GEN,,,
11383,26-2-0-3-N1,6709-52-3935,SNGL FAM SUB,2.42,AC,48500,0,48500,240400,9200,298100,45800,0,45800,195900,8000,249700,A1,AG/GEN,,,
11385,28-1-0-96-B,6738-36-8157,Cemetery,0,AC,100,0,100,0,0,100,100,0,100,0,0,100,A1,AG/GEN,,,
11386,28-1-0-97-A,6738-36-9327,Cemetery,0,AC,100,0,100,0,0,100,100,0,100,0,0,100,A1,AG/GEN,,,
11387,39-1-0-97-B,6728-30-5843,Cemetery,0,AC,100,0,100,0,0,100,100,0,100,0,0,100,A1,AG/GEN,,,
11391,26-4-0-1-B2,6719-41-2855,SNGL FAM SUB,4,AC,55600,0,55600,0,0,55600,54500,0,54500,0,0,54500,A1,AG/GEN,,,
11395,31-2-0-2-C1,6769-51-0016,AG 20-100 AC,22.484,AC,278300,193300,85000,475400,28700,782400,257100,188300,68800,397700,26000,680800,A2,AG/LTD,,,
11400,62-22-0-3-0,7703-69-2705,SNGL FAM SUB,8.5,AC,80800,76500,4300,0,0,80800,70600,66900,3700,0,0,70600,A2,AG/LTD,,,
11411,63-23-0-1-0,7713-49-8125,AG > 100 AC,313.007,AC,150300,0,150300,0,34900,185200,133600,0,133600,0,34900,168500,A2,AG/LTD,,,
11415,13-1-0-57-0,6841-18-7938,COMM & IND,3.39,AC,72800,0,72800,92300,3800,168900,70700,0,70700,83500,3800,158000,A1,AG/GEN,,,
11416,27-1-0-31-B,6728-22-9987,SNGL FAM SUB,2.58,AC,47600,0,47600,0,0,47600,46700,0,46700,0,0,46700,A1,AG/GEN,,,
11418,13-4-0-9-B,6852-04-4616,SNGL FAM SUB,3.93,AC,75300,0,75300,151100,20700,247100,73900,0,73900,131200,18700,223800,A1,AG/GEN,,,
11420,29-1-0-126-A,6748-99-3254,SNGL FAM SUB,2.22,AC,64900,0,64900,0,0,64900,59400,0,59400,0,0,59400,A1,AG/GEN,,,
11425,5-1-0-54-C,6822-08-2484,SNGL FAM SUB,6.76,AC,69100,0,69100,241100,16500,326700,67800,0,67800,208300,14300,290400,A1,AG/GEN,,,
11426,64-1-0-75-A,7733-49-4151,SNGL FAM SUB,11.721,AC,570900,0,570900,0,0,570900,554700,0,554700,0,0,554700,R1A2,RES LTD,,,
11431,56-1-0-1-G,6786-84-8986,SNGL FAM SUB,2,AC,85900,0,85900,0,0,85900,76700,0,76700,0,0,76700,A2,AG/LTD,,,
11432,56-1-0-1-H,6786-94-4697,SNGL FAM SUB,11.61,AC,230300,0,230300,482700,37300,750300,205800,0,205800,410900,32500,649200,A2,AG/LTD,,,
11433,56-1-0-1-J,6786-94-7031,SNGL FAM SUB,2.74,AC,94600,0,94600,123400,4500,222500,84500,0,84500,101500,4500,190500,A2,AG/LTD,,,
11435,55-18-0-3-A,6786-04-0357,SNGL FAM SUB,10,AC,188900,0,188900,436500,1900,627300,168800,0,168800,365800,1900,536500,A2,AG/LTD,,,
11437,19-7-0-A-1,6830-86-4592,SNGL FAM SUB,5.31,AC,78600,0,78600,125300,24900,228800,71400,0,71400,95800,20800,188000,A1,AG/GEN,,,
11440,55-1-0-31-A,6785-56-9495,SNGL FAM SUB,0.101,AC,1700,0,1700,0,0,1700,1500,0,1500,0,0,1500,A2,AG/LTD,,,
11441,63-1-0-84-0,7723-07-0331,SNGL FAM SUB,3.23,AC,227300,0,227300,867600,3300,1098200,197600,0,197600,735300,3600,936500,A2,AG/LTD,,,
11442,20-3-0-3-A,6840-35-5647,SNGL FAM SUB,4.079,AC,75900,0,75900,247600,0,323500,73600,0,73600,205000,0,278600,A1,AG/GEN,,,
11443,4-1-0-45-A,6813-28-1698,AG 20-100 AC,24.5,AC,142200,91700,50500,67100,1400,210700,139500,90500,49000,57100,1400,198000,A1,AG/GEN,,,
11446,11-1-0-2-A,6812-64-5152,AG 20-100 AC,48,AC,23800,0,23800,0,0,23800,20500,0,20500,0,0,20500,A1,AG/GEN,,,
11447,5-1-0-64-C,6823-37-2915,SNGL FAM SUB,6.94,AC,64500,61300,3200,0,0,64500,63300,60300,3000,0,0,63300,A1,AG/GEN,,,
11449,5-1-0-64-D,6823-28-7185,SNGL FAM SUB,0.14,AC,900,0,900,0,0,900,800,0,800,0,0,800,A1,AG/GEN,,,
11455,31-1-0-11-B,6769-63-9245,SNGL FAM SUB,3.56,AC,88800,0,88800,203400,1500,293700,80400,0,80400,167500,1500,249400,A2,AG/LTD,,,
11457,63-1-0-176-0,7714-93-3182,COMM & IND,3.507,AC,324600,0,324600,0,0,324600,300500,0,300500,0,0,300500,B1R3,BUS/GEN,,,
11462,51-1-0-8-B,6736-01-0285,SNGL FAM SUB,4.91,AC,62700,0,62700,285100,500,348300,61500,0,61500,248200,500,310200,A1,AG/GEN,,,
11463,51-1-0-25-B,6735-58-4508,SNGL FAM SUB,4,AC,57100,0,57100,180900,18400,256400,56000,0,56000,158700,22400,237100,A1,AG/GEN,,,
12435,38-1-0-110-B,6717-19-4199,SNGL FAM SUB,2.07,AC,44800,0,44800,96300,400,141500,43900,0,43900,81800,400,126100,A1,AG/GEN,,,
12436,38-1-0-110-C,6717-19-7493,SNGL FAM SUB,8.13,AC,78700,0,78700,328900,12900,420500,77200,0,77200,261700,11000,349900,A1,AG/GEN,,,
12437,38-1-0-110-D,6717-19-8096,SNGL FAM SUB,2.08,AC,44800,0,44800,111000,400,156200,43900,0,43900,94400,400,138700,A1,AG/GEN,,,
12438,25-1-0-5-E,5799-91-0669,AG 20-100 AC,61.43,AC,147600,103600,44000,0,0,147600,145000,103500,41500,0,0,145000,A1,AG/GEN,,,
12439,25-1-0-5-F,5799-90-5516,SNGL FAM SUB,3.01,AC,48000,0,48000,170600,1800,220400,47000,0,47000,145400,1900,194300,A1,AG/GEN,,,
13834,19-11-0-1-A,6831-20-9201,AG 20-100 AC,27.2,AC,178900,0,178900,0,0,178900,167800,0,167800,0,0,167800,A1,AG/GEN,,,
13835,20-1-0-65-B,6840-77-2234,Cemetery,0,AC,100,0,100,0,0,100,100,0,100,0,0,100,A1,AG/GEN,,,
13836,20-1-0-92-C1,6759-08-4117,SNGL FAM SUB,3,AC,73600,0,73600,9900,2700,86200,69700,0,69700,9400,2700,81800,A1,AG/GEN,,,
13837,20-1-0-92-C2,6759-07-2882,SNGL FAM SUB,0.03,AC,300,0,300,0,0,300,200,0,200,0,0,200,A1,AG/GEN,,,
13838,21-9-0-A-0,6850-40-5597,Cmn Area/Open Spc,1.06,AC,0,0,0,0,0,0,0,0,0,0,0,0,RR,RES/RUR,,,
11466,39-1-0-48-B,6726-18-0986,SNGL FAM SUB,2.1,AC,9700,0,9700,0,0,9700,9500,0,9500,0,0,9500,A1,AG/GEN,,,
11468,57-1-0-69-A,7706-74-8068,SNGL FAM SUB,9.24,AC,434000,0,434000,0,0,434000,377200,0,377200,0,0,377200,A2,AG/LTD,,,
11469,47-9-0-3-B,7717-33-9084,SNGL FAM SUB,2.23,AC,152500,0,152500,66900,1500,220900,136200,0,136200,55800,1400,193400,A2,AG/LTD,,,
11479,29-1-0-37-D,6748-53-1339,SNGL FAM SUB,2.42,AC,68100,66900,1200,0,0,68100,63200,62200,1000,0,0,63200,A1,AG/GEN,,,
11480,29-1-0-37-E,6748-53-1188,SNGL FAM SUB,2.95,AC,73100,71600,1500,0,0,73100,68200,66900,1300,0,0,68200,A1,AG/GEN,,,
11481,26-1-0-14-A,6719-03-4721,SNGL FAM SUB,2.01,AC,46100,0,46100,110600,700,157400,44100,0,44100,90800,700,135600,A1,AG/GEN,,,
11490,31-1-0-3-D,6769-64-7944,SNGL FAM SUB,3.73,AC,90600,0,90600,145400,2000,238000,82100,0,82100,119600,2000,203700,A2,AG/LTD,,,
11499,38-1-0-39-E,6707-53-8682,SNGL FAM SUB,2.4,AC,46600,0,46600,182300,1200,230100,45700,0,45700,157200,1200,204100,A1,AG/GEN,,,
11509,32-1-0-61-D,6789-04-8159,SNGL FAM SUB,0.2,AC,2900,0,2900,0,0,2900,2600,0,2600,0,0,2600,A2,AG/LTD,,,
11510,32-1-0-61-C,6789-04-8222,SNGL FAM SUB,0.2,AC,2900,0,2900,0,0,2900,2600,0,2600,0,0,2600,A2,AG/LTD,,,
11551,28-1-0-98-B,6738-47-4075,SNGL FAM SUB,5.35,AC,79900,0,79900,0,0,79900,77000,0,77000,0,0,77000,A1,AG/GEN,,,
11639,63-1-0-146-0,7724-09-8882,AG > 100 AC,173,AC,3723500,3643700,79800,0,0,3723500,3242400,3168900,73500,0,0,3242400,A2,AG/LTD,,,
11652,19-1-0-62-B,6830-70-3595,AG 20-100 AC,48.28,AC,174300,149700,24600,0,0,174300,173800,153000,20800,0,0,173800,A1,AG/GEN,,,
11653,28-1-0-30-A,6738-07-6758,SNGL FAM SUB,2.82,AC,52800,51400,1400,0,0,52800,50800,49600,1200,0,0,50800,A1,AG/GEN,,,
11654,28-1-0-30-B,6738-08-8030,SNGL FAM SUB,2.81,AC,52800,51400,1400,0,0,52800,50700,49500,1200,0,0,50700,A1,AG/GEN,,,
11655,28-1-0-30-C,6738-08-9294,SNGL FAM SUB,3.32,AC,56000,0,56000,271300,57200,384500,53900,0,53900,226000,48000,327900,A1,AG/GEN,,,
11656,29-1-0-99-A,6749-85-3175,COMM & IND,0.23,AC,10900,0,10900,0,21700,32600,10600,0,10600,0,20300,30900,A1,AG/GEN,,,
11657,31-1-0-88-B,6778-44-5859,SNGL FAM SUB,4.09,AC,108600,0,108600,252100,2500,363200,97100,0,97100,206800,2500,306400,A2,AG/LTD,,,
11658,31-1-0-88-C,6778-45-7031,SNGL FAM SUB,4.74,AC,118000,115600,2400,0,3400,121400,105400,103400,2000,0,3500,108900,A2,AG/LTD,,,
11659,31-1-0-88-D,6778-45-9173,SNGL FAM SUB,4.95,AC,121000,54900,66100,331000,54100,506100,108200,49300,58900,272000,50600,430800,A2,AG/LTD,,,
11660,39-1-0-15-D,6727-15-3123,SNGL FAM SUB,17.98,AC,125400,116800,8600,0,0,125400,122900,115300,7600,0,0,122900,A1,AG/GEN,,,
11662,48-1-0-73-A,7727-92-6123,Cemetery,0,AC,100,0,100,0,0,100,100,0,100,0,0,100,A2,AG/LTD,,,
11663,48-1-0-73-B,7737-02-2494,SNGL FAM SUB,9.05,AC,212000,207700,4300,0,0,212000,189500,185600,3900,0,0,189500,A2,AG/LTD,,,
11664,48-1-0-73-C,7737-02-1152,SNGL FAM SUB,18.1,AC,366700,284200,82500,1147100,2100,1515900,327900,254300,73600,980200,2100,1310200,A2,AG/LTD,,,
11665,63-1-0-148-A,7714-79-5924,SNGL FAM SUB,2.64,AC,87700,0,87700,55400,6800,149900,76200,0,76200,53300,6900,136400,A2,AG/LTD,,,
11716,32-1-0-19-B,6779-61-2952,SNGL FAM SUB,6.11,AC,92600,0,92600,0,0,92600,82500,0,82500,0,0,82500,A2,AG/LTD,,,
11717,32-1-0-19-A,6779-52-7352,SNGL FAM SUB,13.1,AC,131900,0,131900,0,0,131900,117500,0,117500,0,0,117500,A2,AG/LTD,,,
11722,27-1-0-26-A,6728-21-7905,AG 20-100 AC,22.47,AC,159000,142900,16100,0,0,159000,156100,141400,14700,0,0,156100,A1,AG/GEN,,,
11757,5-18-0-1-0,6814-81-6171,SNGL FAM SUB,10,AC,85600,0,85600,328300,7300,421200,84000,0,84000,287700,6600,378300,RR,RES/RUR,,,
11758,5-18-0-2-0,6814-90-0700,SNGL FAM SUB,6.33,AC,66900,0,66900,245900,8200,321000,65700,0,65700,215100,7500,288300,RR,RES/RUR,,,
11760,5-18-0-3-0,6814-90-2460,SNGL FAM SUB,6.5,AC,67800,0,67800,144800,14800,227400,66500,0,66500,126500,11500,204500,RR,RES/RUR,,,
11762,5-18-0-4-0,6814-90-5019,SNGL FAM SUB,6.86,AC,69600,0,69600,0,0,69600,68300,0,68300,0,0,68300,RR,RES/RUR,,,
11763,5-18-0-5-0,6813-99-7779,SNGL FAM SUB,6.98,AC,70200,0,70200,0,0,70200,68900,0,68900,0,0,68900,RR,RES/RUR,,,
11764,5-18-0-6-0,6823-09-0439,SNGL FAM SUB,7.05,AC,70600,0,70600,462400,4400,537400,69300,0,69300,420100,3700,493100,RR,RES/RUR,,,
11765,5-18-0-7-0,6823-09-3146,SNGL FAM SUB,8.4,AC,77400,0,77400,315300,0,392700,76000,0,76000,273300,0,349300,RR,RES/RUR,,,
11766,5-18-0-8-0,6823-08-6850,SNGL FAM SUB,8.4,AC,77400,0,77400,207300,0,284700,76000,0,76000,176400,0,252400,RR,RES/RUR,,,
11767,64-18-0-1-0,7733-47-0255,SNGL FAM SUB,0.779,AC,265000,0,265000,786900,0,1051900,220000,0,220000,666300,0,886300,R1,RES/LTD,,,
11768,64-18-0-2-0,7733-47-1392,SNGL FAM SUB,0.794,AC,265000,0,265000,633600,0,898600,220000,0,220000,504000,0,724000,R1,RES/LTD,,,
11769,64-18-0-3-0,7733-47-3411,SNGL FAM SUB,0.83,AC,265000,0,265000,758800,0,1023800,220000,0,220000,613300,0,833300,R1,RES/LTD,,,
11770,64-18-0-4-0,7733-47-4595,SNGL FAM SUB,1.094,AC,265000,0,265000,676900,11500,953400,220000,0,220000,582800,12300,815100,R1,RES/LTD,,,
11771,64-18-0-5-0,7733-47-5451,SNGL FAM SUB,0.81,AC,265000,0,265000,796300,9700,1071000,220000,0,220000,676000,10100,906100,R1,RES/LTD,,,
11772,67-22-0-6-0,7733-47-5230,SNGL FAM SUB,0.809,AC,265000,0,265000,824000,0,1089000,220000,0,220000,718100,0,938100,R1,RES/LTD,,,
11773,67-22-0-7-0,7733-47-4059,SNGL FAM SUB,0.925,AC,265000,0,265000,720600,8000,993600,220000,0,220000,570800,8200,799000,R1,RES/LTD,,,
11774,67-22-0-8-0,7733-47-3005,SNGL FAM SUB,0.789,AC,265000,0,265000,616500,0,881500,220000,0,220000,535000,0,755000,R1,RES/LTD,,,
11775,67-22-0-9-0,7733-47-1042,SNGL FAM SUB,0.779,AC,265000,0,265000,794400,0,1059400,220000,0,220000,679400,0,899400,R1,RES/LTD,,,
11776,31-1-0-86-A,6778-15-5397,AG 20-100 AC,20.41,AC,309800,0,309800,623700,79100,1012600,264900,0,264900,374400,75200,714500,A2,AG/LTD,,,
11777,31-1-0-86-B,6778-36-6521,AG 20-100 AC,46.55,AC,459700,361200,98500,46600,127600,633900,409800,322100,87700,40800,115600,566200,A2,AG/LTD,,,
11778,31-1-0-86-C,6778-57-0591,AG 20-100 AC,20.01,AC,256100,0,256100,640700,63800,960600,228300,0,228300,529800,56400,814500,A2,AG/LTD,,,
11779,31-1-0-86-E,6778-34-2445,AG 20-100 AC,29.31,AC,386800,298700,88100,587800,0,974600,346000,267000,79000,490100,0,836100,A2,AG/LTD,,,
11780,31-1-0-86-F,6778-24-7821,AG 20-100 AC,21.78,AC,301000,0,301000,331700,3300,636000,269200,0,269200,270300,3300,542800,A2,AG/LTD,,,
11782,5-18-0-8-A,6823-08-7972,Cemetery,0,AC,100,0,100,0,0,100,100,0,100,0,0,100,RR,RES/RUR,,,
11784,31-1-0-86-D,6778-35-8539,AG 20-100 AC,21.34,AC,269500,196000,73500,488300,46000,803800,240300,174500,65800,399800,38800,678900,A2,AG/LTD,,,
11786,21-16-0-2-0,6851-30-6137,SNGL FAM SUB,2.144,AC,59800,0,59800,243600,3100,306500,58700,0,58700,225300,2700,286700,A1,AG/GEN,,,
11787,21-1-0-2-B,6851-31-6267,SNGL FAM SUB,3.92,AC,75200,0,75200,191500,24700,291400,73800,0,73800,171400,20500,265700,A1,AG/GEN,,,
11794,47-1-0-31-C,7716-79-0350,SNGL FAM SUB,0.692,AC,169300,0,169300,0,0,169300,151100,0,151100,0,0,151100,A2,AG/LTD,,,
11795,1-1-0-2-A,6805-91-3076,SNGL FAM SUB,16.907,AC,112700,104900,7800,0,0,112700,148400,137600,10800,0,0,148400,A1,AG/GEN,,,
11798,5-19-A-1-0,6813-78-2779,SNGL FAM SUB,12.858,AC,88500,0,88500,127400,0,215900,86900,0,86900,104500,0,191400,A1,AG/GEN,,,
11799,5-19-B-1-0,6813-68-5852,SNGL FAM SUB,17,AC,113100,0,113100,307200,9400,429700,111000,0,111000,267100,6500,384600,A1,AG/GEN,,,
11800,5-19-B-2-0,6813-59-7456,AG 20-100 AC,25,AC,138000,0,138000,0,2500,140500,135300,0,135300,0,2500,137800,A1,AG/GEN,,,
11801,5-19-B-3-0,6813-59-4825,AG 20-100 AC,20.375,AC,128600,0,128600,365500,6000,500100,126200,0,126200,322700,6000,454900,A1,AG/GEN,,,
11802,5-19-B-4-0,6814-50-6340,AG 20-100 AC,20.375,AC,128600,0,128600,378300,0,506900,126200,0,126200,339200,0,465400,A1,AG/GEN,,,
11803,5-19-B-5-0,6814-50-7799,AG 20-100 AC,20,AC,126900,0,126900,278100,72800,477800,124500,0,124500,241600,64400,430500,A1,AG/GEN,,,
11804,5-19-B-6-0,6814-61-0630,AG 20-100 AC,20,AC,126900,0,126900,251500,3200,381600,124500,0,124500,224100,1400,350000,A1,AG/GEN,,,
11805,5-19-C-1-0,6814-71-2997,SNGL FAM SUB,8.867,AC,79800,0,79800,0,0,79800,78300,0,78300,0,0,78300,RR,RES/RUR,,,
11806,5-19-C-2-0,6814-61-7959,SNGL FAM SUB,6,AC,65200,0,65200,572700,23900,661800,64000,0,64000,497900,20400,582300,RR,RES/RUR,,,
11807,5-19-C-3-0,6814-71-5469,SNGL FAM SUB,7.5,AC,72900,0,72900,223000,400,296300,71500,0,71500,193300,400,265200,RR,RES/RUR,,,
11809,20-1-0-53-C,6841-80-2085,SNGL FAM SUB,2.16,AC,60000,0,60000,122900,600,183500,58900,0,58900,109100,600,168600,A1,AG/GEN,,,
11811,19-1-0-55-A,6830-64-1780,SNGL FAM SUB,5.59,AC,95800,0,95800,561600,0,657400,88000,0,88000,328600,0,416600,A1,AG/GEN,,,
11989,30-1-0-76-E,6758-88-9572,SNGL FAM SUB,1,AC,48600,0,48600,0,0,48600,44900,0,44900,0,0,44900,A2,AG/LTD,,,
11993,20-1-0-20-A,6840-02-3709,SNGL FAM SUB,3.16,AC,74700,0,74700,122400,7000,204100,72400,0,72400,102700,5800,180900,A1,AG/GEN,,,
11994,20-1-0-20-B,6840-02-5669,SNGL FAM SUB,2.3,AC,66700,0,66700,156800,30400,253900,63400,0,63400,128900,26200,218500,A1,AG/GEN,,,
11995,20-1-0-20-C,6840-02-8876,SNGL FAM SUB,4.86,AC,87900,0,87900,242300,59000,389200,81900,0,81900,203100,49000,334000,A1,AG/GEN,,,
11999,25-1-0-11-A,5799-26-4269,AG 20-100 AC,58.5,AC,179100,0,179100,0,6500,185600,174800,0,174800,0,0,174800,A1,AG/GEN,,,
12002,5-1-0-14-B,6813-73-7538,SNGL FAM SUB,2.09,AC,45300,0,45300,104200,500,150000,44500,0,44500,91600,500,136600,A1,AG/GEN,,,
12004,18-1-0-35-D,6820-60-6998,SNGL FAM SUB,11.87,AC,93600,0,93600,0,0,93600,91200,0,91200,0,0,91200,A1,AG/GEN,,,
12007,16-1-0-72-C,6800-03-5075,SNGL FAM SUB,0.39,AC,1500,0,1500,0,0,1500,1400,0,1400,0,0,1400,A1,AG/GEN,,,
12009,63-9-0-1-B,7724-01-7144,SNGL FAM SUB,9.861,AC,413400,0,413400,0,0,413400,359400,0,359400,0,0,359400,R1A2,RES LTD,,,
12010,63-9-0-1-C,7724-01-5545,SNGL FAM SUB,9.844,AC,412900,0,412900,0,0,412900,359000,0,359000,0,0,359000,A2R1,AG LTD/,,,
12011,27-1-0-82-A,6728-31-8984,SNGL FAM SUB,11.54,AC,89000,0,89000,313900,1800,404700,87300,0,87300,280000,1800,369100,A1,AG/GEN,,,
12012,39-1-0-98-0,6728-31-9025,SNGL FAM SUB,11.52,AC,91800,0,91800,313900,14000,419700,90100,0,90100,272100,12500,374700,A1,AG/GEN,,,
12013,39-1-0-99-0,6728-31-9476,SNGL FAM SUB,11.53,AC,88900,0,88900,180800,0,269700,87200,0,87200,157100,0,244300,A1,AG/GEN,,,
12014,44-15-2-7-A,6776-67-2370,Cemetery,0,AC,100,0,100,0,0,100,100,0,100,0,0,100,A2,AG/LTD,,,
12015,44-15-2-7-B,6776-67-3123,Cemetery,0,AC,100,0,100,0,0,100,100,0,100,0,0,100,A2,AG/LTD,,,
12043,47-1-0-38-0,7717-60-1498,COMM & IND,50.765,AC,1272800,0,1272800,121900,467900,1862600,1156200,0,1156200,127300,450000,1733500,A2,AG/LTD,,,
12045,47-1-0-42-A,7717-90-0135,COMM & IND,77.015,AC,1845200,0,1845200,0,713200,2558400,1676200,0,1676200,0,707200,2383400,A2,AG/LTD,,,
12047,47-1-0-46-A,7717-92-2216,SNGL FAM SUB,16.7,AC,1653300,0,1653300,35000,600,1688900,1476300,0,1476300,29800,600,1506700,RPUD,RES/PUD,,,
12109,3-3-0-1-0,6803-00-2929,SNGL FAM SUB,8.622,AC,66700,0,66700,155900,31300,253900,64700,0,64700,134000,26400,225100,A1,AG/GEN,,,
12110,3-3-0-2-0,6803-01-7214,SNGL FAM SUB,11.141,AC,75100,0,75100,147500,0,222600,73500,0,73500,133100,0,206600,A1,AG/GEN,,,
12111,3-3-0-3-0,6803-11-1478,SNGL FAM SUB,11.16,AC,75200,0,75200,0,0,75200,73600,0,73600,0,0,73600,A1,AG/GEN,,,
12112,3-3-0-4-0,6803-11-6703,SNGL FAM SUB,12.121,AC,78000,0,78000,241700,37900,357600,76900,0,76900,200500,43500,320900,A1,AG/GEN,,,
12116,12-1-0-28-A,6821-82-8505,SNGL FAM SUB,2.39,AC,50200,0,50200,136100,900,187200,49000,0,49000,116600,900,166500,A1,AG/GEN,,,
12117,12-1-0-28-B,6821-82-9819,SNGL FAM SUB,4.69,AC,65000,0,65000,358300,5300,428600,64600,0,64600,294600,5300,364500,A1,AG/GEN,,,
12118,12-1-0-28-C,6821-93-0088,SNGL FAM SUB,3.15,AC,54800,0,54800,265800,3000,323600,54100,0,54100,219400,3000,276500,A1,AG/GEN,,,
12119,12-1-0-28-D,6821-93-2298,SNGL FAM SUB,3.41,AC,56600,0,56600,169300,8000,233900,55900,0,55900,139500,8000,203400,A1,AG/GEN,,,
12120,13-1-0-20-C,6841-65-4655,SNGL FAM SUB,2,AC,58600,0,58600,104100,3500,166200,47500,0,47500,99800,2800,150100,A1,AG/GEN,,,
12121,13-1-0-20-D,6841-65-1960,SNGL FAM SUB,2,AC,58600,0,58600,119800,5500,183900,47500,0,47500,115300,4000,166800,A1,AG/GEN,,,
12122,17-1-0-84-A,6719-09-7155,SNGL FAM SUB,2.4,AC,48400,0,48400,0,0,48400,45700,0,45700,0,0,45700,A1,AG/GEN,,,
12123,26-2-0-2-H,6708-67-9289,AG 20-100 AC,29.118,AC,200200,0,200200,477900,46900,725000,196400,0,196400,436000,47300,679700,RR,RES/RUR,,,
12124,32-1-0-7-A,6779-84-7333,SNGL FAM SUB,7.26,AC,154200,86900,67300,379500,21900,555600,138000,78100,59900,309200,17900,465100,A2,AG/LTD,,,
12125,34-2-0-5-0,7708-62-8496,SNGL FAM SUB,4.96,AC,170000,0,170000,322500,0,492500,156000,0,156000,271400,0,427400,RR,RES/RUR,,,
12126,34-2-0-6-0,7708-62-8816,SNGL FAM SUB,6.22,AC,175000,0,175000,368300,800,544100,161000,0,161000,308900,800,470700,RR,RES/RUR,,,
12127,34-2-0-7-0,7708-72-5722,SNGL FAM SUB,4.6,AC,170000,0,170000,402500,1800,574300,156000,0,156000,339500,1900,497400,RR,RES/RUR,,,
12128,43-1-0-5-F,6767-58-2524,SNGL FAM SUB,1.048,AC,6600,0,6600,0,0,6600,5900,0,5900,0,0,5900,A2,AG/LTD,,,
12129,46-31-0-1-0,7708-70-0621,SNGL FAM SUB,6.59,AC,175000,0,175000,350000,56100,581100,161000,0,161000,296900,51400,509300,RR,RES/RUR,,,
12130,46-31-0-1-A,7708-60-6697,SNGL FAM SUB,1.53,AC,15300,0,15300,0,0,15300,14000,0,14000,0,0,14000,RR,RES/RUR,,,
12131,46-31-0-2-0,7708-61-9490,SNGL FAM SUB,4.05,AC,170000,0,170000,464400,26100,660500,156000,0,156000,386900,23800,566700,RR,RES/RUR,,,
12133,46-31-0-4-0,7708-62-8172,SNGL FAM SUB,3.78,AC,170000,0,170000,298900,12400,481300,156000,0,156000,250900,12400,419300,RR,RES/RUR,,,
12134,46-31-0-8-0,7708-72-4383,SNGL FAM SUB,5.72,AC,175000,0,175000,412200,3000,590200,161000,0,161000,347900,2500,511400,RR,RES/RUR,,,
12141,67-23-B-12-0,7733-36-8565,SNGL FAM SUB,0.807,AC,265000,0,265000,614900,500,880400,220000,0,220000,547500,500,768000,R1,RES/LTD,,,
12142,67-23-B-13-0,7733-36-8742,SNGL FAM SUB,0.69,AC,265000,0,265000,765400,1600,1032000,220000,0,220000,640900,1700,862600,R1,RES/LTD,,,
12143,67-23-B-14-0,7733-36-9798,SNGL FAM SUB,0.898,AC,265000,0,265000,612400,0,877400,220000,0,220000,517800,0,737800,R1,RES/LTD,,,
12144,67-23-B-15-0,7733-46-0547,SNGL FAM SUB,0.733,AC,251800,0,251800,444700,0,696500,209000,0,209000,354800,0,563800,R1,RES/LTD,,,
12145,67-23-B-16-0,7733-46-0480,SNGL FAM SUB,0.982,AC,265000,0,265000,0,0,265000,220000,0,220000,0,0,220000,R1,RES/LTD,,,
12147,67-23-B-17-0,7733-46-1246,SNGL FAM SUB,0.926,AC,265000,0,265000,0,0,265000,220000,0,220000,0,0,220000,R1,RES/LTD,,,
12149,67-23-B-18-0,7733-36-7029,SNGL FAM SUB,1.22,AC,289000,0,289000,846300,0,1135300,242300,0,242300,749600,0,991900,R1,RES/LTD,,,
12152,67-23-B-20-0,7733-46-0110,SNGL FAM SUB,0.992,AC,265000,0,265000,777500,8000,1050500,220000,0,220000,660100,8800,888900,R1,RES/LTD,,,
12153,67-23-B-21-0,7733-46-2110,SNGL FAM SUB,0.727,AC,265000,0,265000,657400,0,922400,220000,0,220000,585500,0,805500,R1,RES/LTD,,,
12154,67-23-B-22-0,7733-45-2962,SNGL FAM SUB,0.92,AC,265000,0,265000,886800,25100,1176900,220000,0,220000,739700,24500,984200,R1,RES/LTD,,,
12155,67-23-B-23-0,7733-45-1759,SNGL FAM SUB,1.3,AC,408000,0,408000,656600,1000,1065600,342000,0,342000,585600,1000,928600,R1,RES/LTD,,,
12156,67-23-B-24-0,7733-35-8870,SNGL FAM SUB,1.8,AC,425000,0,425000,1040200,4500,1469700,356300,0,356300,911000,3900,1271200,R1,RES/LTD,,,
12158,67-23-B-26-0,7733-35-5881,SNGL FAM SUB,1.6,AC,391000,0,391000,0,0,391000,327800,0,327800,0,0,327800,R1,RES/LTD,,,
12312,40-1-0-16-A,6726-89-3022,SNGL FAM SUB,5.508,AC,69100,66600,2500,0,0,69100,67800,65500,2300,0,0,67800,A1,AG/GEN,,,
12409,43-28-0-1-0,6767-47-8004,SNGL FAM SUB,2.4,AC,79200,0,79200,287100,0,366300,72000,0,72000,256500,0,328500,R1,RES/LTD,,,
12410,43-28-0-2-0,6767-46-9834,SNGL FAM SUB,2.56,AC,79200,0,79200,272500,55900,407600,72000,0,72000,246700,46000,364700,R1,RES/LTD,,,
12411,43-28-0-3-0,6767-56-0686,SNGL FAM SUB,2.77,AC,79200,0,79200,280300,2500,362000,72000,0,72000,254300,2700,329000,R1,RES/LTD,,,
12412,43-28-0-4-0,6767-56-2574,SNGL FAM SUB,2.63,AC,79200,0,79200,452600,0,531800,72000,0,72000,403100,0,475100,R1,RES/LTD,,,
12413,43-28-0-5-0,6767-57-2046,SNGL FAM SUB,3.58,AC,91000,0,91000,281600,9200,381800,82700,0,82700,248800,8100,339600,R1,RES/LTD,,,
12415,43-28-0-6-0,6767-57-4274,SNGL FAM SUB,3.79,AC,91000,0,91000,319200,2500,412700,82700,0,82700,280500,2500,365700,R1,RES/LTD,,,
12416,43-28-0-7-0,6767-57-9338,SNGL FAM SUB,4.53,AC,96800,0,96800,311700,2900,411400,88000,0,88000,272500,3100,363600,R1,RES/LTD,,,
12418,43-28-0-9-0,6767-66-1739,SNGL FAM SUB,9.139,AC,148200,0,148200,355400,36700,540300,134800,0,134800,307000,29600,471400,R1,RES/LTD,,,
12419,43-28-0-10-0,6767-56-8825,SNGL FAM SUB,2.84,AC,85800,0,85800,306300,7300,399400,78000,0,78000,268000,7300,353300,R1,RES/LTD,,,
12420,43-28-0-11-0,6767-56-7529,SNGL FAM SUB,2.8,AC,85800,0,85800,290300,800,376900,78000,0,78000,253400,800,332200,R1,RES/LTD,,,
12421,43-28-0-12-0,6767-56-4387,SNGL FAM SUB,2.23,AC,79200,0,79200,359100,1000,439300,72000,0,72000,310700,1000,383700,R1,RES/LTD,,,
12422,43-28-0-13-0,6767-56-7214,SNGL FAM SUB,2.53,AC,79200,0,79200,421600,0,500800,72000,0,72000,369500,0,441500,R1,RES/LTD,,,
12423,43-28-0-14-0,6767-66-0032,SNGL FAM SUB,5.61,AC,110000,0,110000,301200,80700,491900,100000,0,100000,270300,70400,440700,R1,RES/LTD,,,
12426,43-28-0-16-0,6767-55-9642,SNGL FAM SUB,3.2,AC,79200,0,79200,318600,0,397800,72000,0,72000,281200,0,353200,R1,RES/LTD,,,
12427,43-28-0-17-0,6767-55-6715,SNGL FAM SUB,2.03,AC,75200,0,75200,221900,31500,328600,68400,0,68400,193800,29400,291600,R1,RES/LTD,,,
12430,43-28-0-18-0,6767-55-4809,SNGL FAM SUB,2.04,AC,79200,0,79200,307800,2300,389300,72000,0,72000,270800,2200,345000,R1,RES/LTD,,,
12432,43-28-0-19-0,6767-55-1998,SNGL FAM SUB,2.08,AC,79200,0,79200,255400,29200,363800,72000,0,72000,223000,0,295000,R1,RES/LTD,,,
12433,43-28-0-20-0,6767-46-9086,SNGL FAM SUB,2.19,AC,79200,0,79200,302900,800,382900,72000,0,72000,266400,800,339200,R1,RES/LTD,,,
12434,43-28-0-21-0,6767-46-7294,SNGL FAM SUB,4.006,AC,85800,0,85800,346400,37700,469900,78000,0,78000,302200,31400,411600,R1,RES/LTD,,,
12440,25-1-0-5-G,5799-90-2736,SNGL FAM SUB,3.01,AC,48000,0,48000,0,0,48000,47000,0,47000,0,0,47000,A1,AG/GEN,,,
12441,25-1-0-5-H,5799-80-9956,SNGL FAM SUB,3.01,AC,48000,0,48000,0,0,48000,47000,0,47000,0,0,47000,A1,AG/GEN,,,
12442,25-1-0-5-J,5799-81-6189,SNGL FAM SUB,3.01,AC,48000,0,48000,0,0,48000,47000,0,47000,0,0,47000,A1,AG/GEN,,,
12445,64-2-0-4-A,7733-08-1296,SNGL FAM SUB,2.26,AC,179000,0,179000,221700,5800,406500,155600,0,155600,187300,5800,348700,A2R1,AG LTD/,,,
12449,66-4-0-19-0,7723-23-6956,SNGL FAM SUB,8.145,AC,70900,0,70900,0,0,70900,61900,0,61900,0,0,61900,A2,AG/LTD,,,
12450,66-4-0-19-A,7723-33-5414,Cmn Area/Open Spc,1.095,AC,0,0,0,0,0,0,0,0,0,0,0,0,A2,AG/LTD,,,
12464,4-15-0-1-C,6803-77-3546,AG 20-100 AC,23.02,AC,140800,82600,58200,187700,19300,347800,138100,81500,56600,162200,17300,317600,A1,AG/GEN,,,
12467,45-1-0-78-G,6797-82-1657,SNGL FAM SUB,10.5,AC,213500,132100,81400,76200,1000,290700,191100,118500,72600,66400,1000,258500,A2,AG/LTD,,,
12490,31-1-0-65-0,6779-57-2224,AG 20-100 AC,30,AC,313100,235000,78100,191000,49000,553100,279100,209500,69600,156100,49000,484200,A2,AG/LTD,,,
12526,1-1-0-22-H,6804-86-2636,SNGL FAM SUB,6.77,AC,65100,0,65100,9500,500,75100,64000,0,64000,10000,500,74500,A1,AG/GEN,,,
12527,4-1-0-6-B,6803-57-3329,Cemetery,0,AC,100,0,100,0,0,100,100,0,100,0,0,100,A1,AG/GEN,,,
12528,5-1-0-73-B,6823-48-0188,SNGL FAM SUB,16.959,AC,87300,79500,7800,0,0,87300,85700,78500,7200,0,0,85700,A1,AG/GEN,,,
12529,5-1-0-76-D,6823-66-7807,SNGL FAM SUB,10.626,AC,77700,0,77700,0,0,77700,76300,0,76300,0,0,76300,A1,AG/GEN,,,
12531,7-1-0-8-A,6842-38-4944,AG 20-100 AC,50.782,AC,296200,176800,119400,660300,64000,1020500,289900,174300,115600,610100,68700,968700,A1,AG/GEN,,,
12537,10-1-0-13-A,6801-22-9227,AG 20-100 AC,28.163,AC,115000,0,115000,77900,1800,194700,111300,0,111300,68800,1800,181900,A1,AG/GEN,,,
12539,10-1-0-43-A,6811-34-5178,SNGL FAM SUB,10,AC,71300,0,71300,26000,0,97300,69500,0,69500,29200,0,98700,A1,AG/GEN,,,
12540,11-1-0-2-B,6812-64-8172,SNGL FAM SUB,2,AC,40200,0,40200,295200,2000,337400,39400,0,39400,261000,2000,302400,A1,AG/GEN,,,
12541,11-1-0-23-C,6821-17-5260,SNGL FAM SUB,2.01,AC,46100,0,46100,129500,1900,177500,44600,0,44600,105200,2000,151800,A1,AG/GEN,,,
12543,11-1-0-53-F,6822-23-8993,Cemetery,0,AC,100,0,100,0,0,100,100,0,100,0,0,100,A1,AG/GEN,,,
12546,11-1-0-53-G,6822-33-1623,SNGL FAM SUB,6.79,AC,75100,0,75100,0,24300,99400,73700,0,73700,0,21600,95300,A1,AG/GEN,,,
12547,11-1-0-53-H,6822-33-4375,SNGL FAM SUB,16.94,AC,123800,0,123800,0,0,123800,121800,0,121800,0,0,121800,A1,AG/GEN,,,
12551,12-2-0-1-E,6821-95-8307,SNGL FAM SUB,4.15,AC,61500,0,61500,141300,500,203300,60900,0,60900,116900,500,178300,A1,AG/GEN,,,
12552,12-2-0-1-F,6821-85-5355,SNGL FAM SUB,16.65,AC,85600,0,85600,0,0,85600,85900,0,85900,0,0,85900,A1,AG/GEN,,,
12553,12-2-0-1-G,6821-75-2439,SNGL FAM SUB,16.66,AC,81200,0,81200,0,0,81200,84100,0,84100,0,0,84100,A1,AG/GEN,,,
12554,4-1-0-6-D,6803-77-9530,Vacant Land,1,AC,45700,0,45700,0,0,45700,44000,0,44000,0,0,44000,A1,AG/GEN,,,
12556,4-1-0-33-A,6803-87-1336,Cemetery,2.2,AC,100,0,100,0,0,100,100,0,100,0,0,100,A1,AG/GEN,,,
12558,12-1-0-17-C,6822-91-6991,SNGL FAM SUB,3.07,AC,57200,0,57200,0,0,57200,55600,0,55600,0,0,55600,A1,AG/GEN,,,
12559,11-1-0-30-B,6811-62-3982,AG 20-100 AC,50.26,AC,177300,154100,23200,0,0,177300,175900,154500,21400,0,0,175900,A1,AG/GEN,,,
12567,17-1-0-86-F,6719-18-0659,SNGL FAM SUB,3,AC,52000,0,52000,217900,0,269900,49000,0,49000,184800,0,233800,A1,AG/GEN,,,
12568,17-1-0-88-A,6719-57-3105,SNGL FAM SUB,16.16,AC,119900,0,119900,88100,20700,228700,121400,0,121400,71000,17300,209700,A1,AG/GEN,,,
12569,18-1-0-6-E,6811-90-0341,AG 20-100 AC,21.53,AC,132100,82600,49500,267600,0,399700,130400,83700,46700,231300,0,361700,A1,AG/GEN,,,
12570,18-1-0-24-0,6719-57-6676,SNGL FAM SUB,10,AC,89100,0,89100,206900,70000,366000,87500,0,87500,180500,66900,334900,A1,AG/GEN,,,
12571,18-1-0-28-C,6729-27-4796,SNGL FAM SUB,4,AC,57600,0,57600,12300,0,69900,54500,0,54500,12300,0,66800,A1,AG/GEN,,,
12572,18-1-0-33-A,6729-69-3626,SNGL FAM SUB,2.24,AC,27200,0,27200,0,21200,48400,25600,0,25600,0,19500,45100,A1,AG/GEN,,,
12573,18-4-0-2-F,6729-09-6835,SNGL FAM SUB,2.37,AC,48200,0,48200,237200,1400,286800,46200,0,46200,213300,1400,260900,A1,AG/GEN,,,
12575,19-1-0-45-B,6831-61-7114,SNGL FAM SUB,2.5,AC,68600,0,68600,8700,500,77800,64800,0,64800,8700,500,74000,A1,AG/GEN,,,
12576,20-1-0-20-B1,6840-03-6032,SNGL FAM SUB,2.01,AC,63900,0,63900,168700,600,233200,60400,0,60400,139400,600,200400,A1,AG/GEN,,,
12577,20-1-0-84-B,6840-70-3247,SNGL FAM SUB,3.632,AC,79000,0,79000,246400,161200,486600,77300,0,77300,207900,144700,429900,A1,AG/GEN,,,
12586,26-1-0-28-C,6708-65-5205,Academic-Private,0.79,AC,4400,0,4400,0,0,4400,4300,0,4300,0,0,4300,A1,AG/GEN,,,
12589,26-2-0-3-Q,6709-70-7226,SNGL FAM SUB,4.696,AC,61300,0,61300,319700,36300,417300,60200,0,60200,282000,30100,372300,A1,AG/GEN,,,
12592,27-1-0-80-D,6728-54-5710,SNGL FAM SUB,9.59,AC,86900,0,86900,0,0,86900,85200,0,85200,0,0,85200,A1,AG/GEN,,,
12604,29-1-0-126-B,6748-98-0751,SNGL FAM SUB,2.99,AC,71600,0,71600,191100,0,262700,66400,0,66400,157000,0,223400,A1,AG/GEN,,,
12605,29-9-0-7-A,6748-89-8923,SNGL FAM SUB,2.51,AC,66800,0,66800,12600,300,79700,61700,0,61700,13400,300,75400,A1,AG/GEN,,,
12606,29-9-0-7-B,6749-90-0022,SNGL FAM SUB,2.51,AC,67500,0,67500,128500,1500,197500,61700,0,61700,106400,1500,169600,A1,AG/GEN,,,
12607,29-15-0-B-1,6749-71-5299,SNGL FAM SUB,2.65,AC,70300,0,70300,230600,700,301600,66200,0,66200,197100,800,264100,A1,AG/GEN,,,
12610,31-1-0-17-B,6768-47-9880,SNGL FAM SUB,2,AC,73400,0,73400,162900,5200,241500,67100,0,67100,134400,3400,204900,A2,AG/LTD,,,
12611,31-1-0-86-A1,6778-16-4484,AG 20-100 AC,21.34,AC,269500,189400,80100,529600,194700,993800,240300,169000,71300,430500,155500,826300,A2,AG/LTD,,,
12612,31-1-0-86-A2,6778-26-4421,AG 20-100 AC,20,AC,268800,0,268800,1189200,11300,1469300,228200,0,228200,1011800,11100,1251100,A2,AG/LTD,,,
12617,32-2-0-3-F,6778-86-3922,SNGL FAM SUB,2.28,AC,82500,0,82500,158700,4400,245600,73700,0,73700,128700,4400,206800,A2,AG/LTD,,,
12618,32-2-0-3-G,6778-87-3102,Cemetery,0,AC,100,0,100,0,0,100,100,0,100,0,0,100,A2,AG/LTD,,,
12619,34-1-0-2-A,7708-24-1368,SNGL FAM SUB,6.09,AC,147000,0,147000,0,0,147000,131300,0,131300,0,0,131300,A2,AG/LTD,,,
12620,34-1-0-2-B,7708-24-1702,SNGL FAM SUB,0.67,AC,10100,0,10100,0,0,10100,9000,0,9000,0,0,9000,A2,AG/LTD,,,
12622,34-1-0-5-0,7708-24-6156,SNGL FAM SUB,7.49,AC,168100,0,168100,0,0,168100,150200,0,150200,0,0,150200,A2,AG/LTD,,,
12623,39-1-0-5-A,6728-20-9615,SNGL FAM SUB,3.28,AC,51000,0,51000,218500,8900,278400,50000,0,50000,188700,9700,248400,A1,AG/GEN,,,
12624,39-1-0-63-C,6726-18-1807,SNGL FAM SUB,2,AC,44400,0,44400,139000,800,184200,43500,0,43500,117600,800,161900,A1,AG/GEN,,,
12625,39-1-0-94-B,6727-27-7604,SNGL FAM SUB,2,AC,44900,0,44900,137700,15500,198100,44000,0,44000,116400,13400,173800,A1,AG/GEN,,,
12626,40-1-0-31-B,6737-74-7283,SNGL FAM SUB,9.573,AC,109900,56600,53300,198300,6500,314700,108000,56300,51700,167100,6500,281600,A1,AG/GEN,,,
12627,40-1-0-40-0,6738-91-1189,Parks & Rec,176.523,AC,96000,0,96000,0,94400,190400,92800,0,92800,0,80300,173100,A1,AG/GEN,,,
12630,44-20-0-4-A,6787-41-2460,SNGL FAM SUB,4.5,AC,116300,0,116300,152000,2500,270800,103900,0,103900,124900,2500,231300,A2,AG/LTD,,,
12631,44-20-0-4-B,6787-40-0941,SNGL FAM SUB,4.5,AC,116300,0,116300,309900,800,427000,103900,0,103900,252800,800,357500,A2,AG/LTD,,,
12632,45-1-0-19-C,6797-09-1054,SNGL FAM SUB,2.37,AC,90800,0,90800,206900,1000,298700,81100,0,81100,168900,1000,251000,A2,AG/LTD,,,
12633,45-1-0-72-B,6797-41-4957,Cemetery,0.5,AC,100,0,100,0,0,100,100,0,100,0,0,100,A2,AG/LTD,,,
12634,45-1-0-50-A,6796-57-0895,SNGL FAM SUB,2.489,AC,107300,0,107300,0,0,107300,95700,0,95700,0,0,95700,A2,AG/LTD,,,
12635,45-1-0-78-H,6797-72-9896,Cemetery,0,AC,100,0,100,0,0,100,100,0,100,0,0,100,A2,AG/LTD,,,
12636,45-1-0-127-B2,6797-57-6846,SNGL FAM SUB,2.02,AC,182500,0,182500,0,0,182500,169100,0,169100,0,0,169100,A2,AG/LTD,,,
12637,45-1-0-129-0,6797-69-1471,COMM & IND,4.976,AC,269300,0,269300,374800,14400,658500,256500,0,256500,361600,16400,634500,M2,INDUS/G,,,
12647,46-1-0-76-H,7707-44-0658,Cemetery,0.09,AC,100,0,100,0,0,100,100,0,100,0,0,100,A2,AG/LTD,,,
12648,46-1-0-111-B,7707-96-6951,SNGL FAM SUB,2.14,AC,108500,0,108500,95400,1700,205600,96900,0,96900,78000,1700,176600,A2,AG/LTD,,,
12649,46-1-0-111-C,7707-97-5081,Cemetery,0.04,AC,100,0,100,0,0,100,100,0,100,0,0,100,A2,AG/LTD,,,
12655,46-27-A-21-0,7707-64-9965,SNGL FAM SUB,5.027,AC,173300,0,173300,429400,0,602700,157500,0,157500,359800,0,517300,RR,RES/RUR,,,
12656,46-27-A-22-0,7707-65-9256,SNGL FAM SUB,2.704,AC,165000,0,165000,303800,0,468800,150000,0,150000,257000,0,407000,RR,RES/RUR,,,
12657,46-27-A-23-0,7707-75-0468,SNGL FAM SUB,2.007,AC,165000,0,165000,344700,500,510200,150000,0,150000,290500,500,441000,RR,RES/RUR,,,
12658,46-27-A-24-0,7707-75-1647,SNGL FAM SUB,2.002,AC,165000,0,165000,352100,22800,539900,150000,0,150000,298800,22400,471200,RR,RES/RUR,,,
12659,46-27-A-25-0,7707-75-2817,SNGL FAM SUB,2.002,AC,165000,0,165000,304600,500,470100,150000,0,150000,255600,500,406100,RR,RES/RUR,,,
12660,46-27-A-26-0,7707-76-2089,SNGL FAM SUB,2.002,AC,165000,0,165000,370900,22400,558300,150000,0,150000,309900,19900,479800,RR,RES/RUR,,,
12661,46-27-A-27-0,7707-76-3259,SNGL FAM SUB,2.002,AC,165000,0,165000,462500,2000,629500,150000,0,150000,402400,2000,554400,RR,RES/RUR,,,
12662,46-27-A-28-0,7707-76-4429,SNGL FAM SUB,2.002,AC,165000,0,165000,453300,14500,632800,150000,0,150000,379000,14500,543500,RR,RES/RUR,,,
12663,46-27-A-29-0,7707-76-4790,SNGL FAM SUB,2.002,AC,165000,0,165000,299500,0,464500,150000,0,150000,251000,0,401000,RR,RES/RUR,,,
12665,46-27-A-30-0,7707-76-5991,SNGL FAM SUB,2.004,AC,165000,0,165000,459200,700,624900,150000,0,150000,383900,700,534600,RR,RES/RUR,,,
12666,46-27-A-31-0,7707-77-5196,SNGL FAM SUB,2.092,AC,165000,0,165000,443800,23300,632100,150000,0,150000,371600,23000,544600,RR,RES/RUR,,,
12667,46-27-B-13-0,7707-75-5161,SNGL FAM SUB,2.009,AC,165000,0,165000,325600,0,490600,150000,0,150000,275900,0,425900,RR,RES/RUR,,,
12668,46-27-B-14-0,7707-75-4353,SNGL FAM SUB,2.253,AC,165000,0,165000,380100,19100,564200,150000,0,150000,318600,17900,486500,RR,RES/RUR,,,
12669,46-27-B-15-0,7707-75-5577,SNGL FAM SUB,2.002,AC,165000,0,165000,324400,0,489400,150000,0,150000,273200,0,423200,RR,RES/RUR,,,
12670,46-27-B-16-0,7707-75-6757,SNGL FAM SUB,2.002,AC,165000,0,165000,374600,3000,542600,150000,0,150000,315600,2600,468200,RR,RES/RUR,,,
12671,46-27-B-17-0,7707-75-7917,SNGL FAM SUB,2.002,AC,165000,0,165000,547000,800,712800,150000,0,150000,474800,800,625600,RR,RES/RUR,,,
12672,46-27-B-18-0,7707-76-7188,SNGL FAM SUB,2,AC,165000,0,165000,383000,0,548000,150000,0,150000,320800,0,470800,RR,RES/RUR,,,
12673,46-27-B-19-0,7707-76-8441,SNGL FAM SUB,2,AC,165000,0,165000,374200,56800,596000,150000,0,150000,313900,48200,512100,RR,RES/RUR,,,
12674,46-27-B-20-0,7707-76-9614,SNGL FAM SUB,2,AC,165000,0,165000,453300,1000,619300,150000,0,150000,385200,1000,536200,RR,RES/RUR,,,
12677,47-27-0-8-A,7726-07-4702,COMM & IND,1,AC,440000,0,440000,266100,6500,712600,400000,0,400000,250100,4400,654500,B1,BUS/GEN,,,
12678,48-1-0-13-D,7727-58-6916,COMM & IND,2.02,AC,155900,0,155900,0,0,155900,148500,0,148500,0,0,148500,M2,INDUS/G,,,
12680,48-13-0-A-1,7726-69-6519,SNGL FAM SUB,2.73,AC,148700,0,148700,164400,34200,347300,132800,0,132800,139800,29000,301600,A2,AG/LTD,,,
12683,51-1-0-21-B,6735-51-1841,SNGL FAM SUB,1,AC,2600,0,2600,0,0,2600,2500,0,2500,0,0,2500,A1,AG/GEN,,,
12684,52-1-0-5-0,6746-05-0302,SNGL FAM SUB,1,AC,2100,0,2100,0,0,2100,2000,0,2000,0,0,2000,A1,AG/GEN,,,
12685,55-1-0-14-J,6776-90-2342,State Exmm,45.803,AC,1160200,0,1160200,12493700,11900,13665800,1034100,0,1034100,12493600,11900,13539600,A2,AG/LTD,,,
12686,55-1-0-14-K,6785-04-1557,State Exmm,2.638,AC,97100,0,97100,0,0,97100,86700,0,86700,0,0,86700,A2,AG/LTD,,,
12688,56-14-0-1-0,6785-99-2896,AG 20-100 AC,23.9,AC,386100,0,386100,674000,81200,1141300,344300,0,344300,559300,73000,976600,A2,AG/LTD,,,
12690,56-14-0-3-0,6785-99-7187,SNGL FAM SUB,17.64,AC,299700,291100,8600,0,0,299700,267300,259700,7600,0,0,267300,A2,AG/LTD,,,
12691,56-14-0-4-0,6785-98-0228,SNGL FAM SUB,15.89,AC,223900,216600,7300,0,0,223900,199600,192800,6800,0,0,199600,A2,AG/LTD,,,
12692,56-14-0-5-0,6785-89-6182,SNGL FAM SUB,19.98,AC,301000,0,301000,0,0,301000,268400,0,268400,0,0,268400,A2,AG/LTD,,,
12693,57-1-0-45-C,7715-15-2054,SNGL FAM SUB,6.46,AC,245900,0,245900,0,0,245900,213800,0,213800,0,0,213800,A2,AG/LTD,,,
12694,57-1-0-45-D,7715-14-9131,SNGL FAM SUB,3,AC,181100,0,181100,128900,16000,326000,157400,0,157400,107600,13500,278500,A2,AG/LTD,,,
12696,57-1-0-69-B,7706-94-3871,SNGL FAM SUB,7.44,AC,404900,0,404900,353800,23000,781700,352000,0,352000,322600,23000,697600,A2,AG/LTD,,,
12697,57-1-0-69-C,7706-84-3848,SNGL FAM SUB,9.19,AC,408800,0,408800,0,0,408800,355400,0,355400,0,0,355400,A2,AG/LTD,,,
12704,62-1-0-34-A,7715-00-7115,SNGL FAM SUB,19,AC,652400,440500,211900,1664200,60200,2376800,567400,382900,184500,1495900,81200,2144500,A2,AG/LTD,,,
12708,63-34-0-1-0,7724-37-9045,COMM & IND,9,AC,1568500,0,1568500,6076100,143400,7788000,1493800,0,1493800,5762600,84800,7341200,M1,INDUS/L,,,
12709,64-1-0-75-B,7733-38-9569,SNGL FAM SUB,4.146,AC,293800,0,293800,297900,0,591700,194800,0,194800,252100,0,446900,R1,RES/LTD,,,
12710,64-1-0-83-B,7733-37-6492,SNGL FAM SUB,0.635,AC,265000,0,265000,0,0,265000,220000,0,220000,0,0,220000,R1,RES/LTD,,,
12716,64-20-0-3-0,7724-97-2302,COMM & IND,20,AC,4016000,0,4016000,11419200,100,15435300,3824700,0,3824700,11419200,100,15244000,M1,INDUS/L,,,
12764,14-1-0-10-A,6851-48-9095,SNGL FAM SUB,15.03,AC,70900,64000,6900,0,0,70900,69300,62900,6400,0,0,69300,A1,AG/GEN,,,
12765,14-1-0-10-B,6851-55-3806,Cemetery,0,AC,100,0,100,0,0,100,100,0,100,0,0,100,A1,AG/GEN,,,
12769,4-1-0-46-C,6813-07-0225,AG 20-100 AC,25.83,AC,153700,141100,12600,0,6000,159700,150700,139700,11000,0,6000,156700,A1,AG/GEN,,,
12770,4-1-0-46-D,6813-06-9434,AG 20-100 AC,21.293,AC,143500,133400,10100,0,0,143500,140700,131600,9100,0,0,140700,A1,AG/GEN,,,
12772,19-7-0-B-1,6830-85-9757,Cemetery,0,AC,100,0,100,0,0,100,100,0,100,0,0,100,A1,AG/GEN,,,
12773,19-7-0-B-2,6830-96-3065,SNGL FAM SUB,2,AC,54800,0,54800,20900,1000,76700,50900,0,50900,32000,1000,83900,A1,AG/GEN,,,
12774,20-1-0-1-A,6831-90-5874,SNGL FAM SUB,8.8,AC,112400,0,112400,184000,16300,312700,109400,0,109400,154200,13800,277400,RR,RES/RUR,,,
12775,28-1-0-58-GT,6738-18-9354-9999,SNGL FAM SUB,4.61,AC,157900,0,157900,223400,125300,506600,155700,0,155700,189900,118600,464200,A1,AG/GEN,,,
12776,29-1-0-112-D1,6748-79-7756,SNGL FAM SUB,3,AC,71600,0,71600,0,0,71600,65500,0,65500,0,0,65500,A1,AG/GEN,,,
12777,29-1-0-112-D2,6748-79-6473,SNGL FAM SUB,3,AC,73600,0,73600,0,0,73600,66500,0,66500,0,0,66500,A1,AG/GEN,,,
12778,31-1-0-31-B,6768-97-3674,SNGL FAM SUB,14.11,AC,237200,0,237200,67400,2000,306600,211900,0,211900,55700,2000,269600,A2,AG/LTD,,,
12781,46-1-0-53-E,7706-98-9307,SNGL FAM SUB,6.76,AC,167200,0,167200,0,0,167200,149500,0,149500,0,0,149500,A2,AG/LTD,,,
12782,46-1-0-53-F,7706-97-7752,SNGL FAM SUB,6.76,AC,167200,0,167200,0,0,167200,149500,0,149500,0,0,149500,A2,AG/LTD,,,
12788,56-15-0-3-0,6795-97-0403,SNGL FAM SUB,19.72,AC,600800,0,600800,644100,60800,1305700,522700,0,522700,634900,53400,1211000,RR,RES/RUR,,,
12789,56-15-0-4-0,6795-86-9030,AG 20-100 AC,21.653,AC,642500,0,642500,788500,99100,1530100,559100,0,559100,836000,87400,1482500,RR,RES/RUR,,,
12790,56-15-0-5-0,6795-85-2728,AG 20-100 AC,22.232,AC,655000,0,655000,597000,17500,1269500,570000,0,570000,579000,17500,1166500,RR,RES/RUR,,,
12791,56-15-0-6-0,6795-86-1664,SNGL FAM SUB,17.668,AC,556400,0,556400,2226200,144200,2926800,484200,0,484200,2205900,132400,2822500,RR,RES/RUR,,,
12793,56-15-0-7-0,6795-76-2709,AG 20-100 AC,28.349,AC,787100,0,787100,117900,8700,913700,685000,0,685000,116600,8700,810300,RR,RES/RUR,,,
12794,56-15-0-8-0,6795-66-0241,SNGL FAM SUB,10.825,AC,439100,0,439100,678900,41000,1159000,382000,0,382000,714600,41000,1137600,RR,RES/RUR,,,
12795,56-15-0-9-0,6795-66-8093,AG 20-100 AC,21.746,AC,644500,0,644500,81600,39000,765100,560800,0,560800,81100,39000,680900,RR,RES/RUR,,,
12796,56-15-0-9-A,6795-66-8335,SNGL FAM SUB,0.23,AC,4200,0,4200,0,0,4200,3700,0,3700,0,0,3700,RR,RES/RUR,,,
12797,56-15-0-10-0,6795-75-1219,SNGL FAM SUB,18.312,AC,570300,0,570300,588700,57400,1216400,496300,0,496300,617000,52500,1165800,RR,RES/RUR,,,
12798,56-15-0-11-0,6795-84-3779,SNGL FAM SUB,19.858,AC,603700,0,603700,1795100,158200,2557000,525300,0,525300,1845400,139000,2509700,RR,RES/RUR,,,
12799,57-1-0-40-B,7705-23-5076,Cmn Area/Open Spc,145.49,AC,0,0,0,0,0,0,0,0,0,0,0,0,RR,RES/RUR,,,
12804,53-1-0-6-A,6766-25-9160,SNGL FAM SUB,0.8,AC,1400,0,1400,0,0,1400,1200,0,1200,0,0,1200,A2,AG/LTD,,,
12810,22-1-0-1-A1,6769-58-5206,SNGL FAM SUB,12.08,AC,184500,0,184500,406000,38400,628900,169700,0,169700,341900,32200,543800,A2,AG/LTD,,,
12812,29-1-0-56-B,6749-71-0894,SNGL FAM SUB,1.5,AC,59000,0,59000,99500,600,159100,54900,0,54900,82300,600,137800,A1,AG/GEN,,,
12813,32-1-0-2-A,6779-75-8886,SNGL FAM SUB,2,AC,78500,0,78500,142200,500,221200,70100,0,70100,116700,500,187300,A2,AG/LTD,,,
12818,47-1-0-43-M2,7716-99-7850,COMM & IND,1.268,AC,319500,0,319500,239700,8700,567900,290400,0,290400,221800,6700,518900,M1,INDUS/L,,,
12912,11-1-0-57-0,6822-63-5137,AG 20-100 AC,34.42,AC,209000,147900,61100,315800,62900,587700,208500,152500,56000,282000,59100,549600,A1,AG/GEN,,,
12913,12-1-0-16-A,6822-84-0025,SNGL FAM SUB,4.53,AC,69100,0,69100,165200,3000,237300,67200,0,67200,153200,3000,223400,A1,AG/GEN,,,
12914,12-1-0-16-B,6822-72-4875,SNGL FAM SUB,17.42,AC,134100,0,134100,201300,3800,339200,131000,0,131000,172100,2800,305900,A1,AG/GEN,,,
12918,13-1-0-31-A,6852-00-1257,Roads,2.56,AC,0,0,0,0,0,0,0,0,0,0,0,0,A1,AG/GEN,,,
12920,13-19-0-4-A,6852-10-5440,SNGL FAM SUB,18.88,AC,124600,0,124600,230500,6900,362000,122300,0,122300,202600,5300,330200,A1,AG/GEN,,,
12921,13-19-0-4-B,6852-10-9271,SNGL FAM SUB,15.6,AC,108600,0,108600,0,0,108600,106600,0,106600,0,0,106600,A1,AG/GEN,,,
12922,13-19-0-5-A,6851-08-4870,SNGL FAM SUB,6.5,AC,76000,0,76000,181700,6400,264100,74500,0,74500,157700,5900,238100,A1,AG/GEN,,,
12923,13-19-0-5-B,6851-08-9971,SNGL FAM SUB,12,AC,94600,0,94600,170100,1000,265700,92900,0,92900,147600,1000,241500,A1,AG/GEN,,,
12924,21-1-0-34-B,6759-28-9500,SNGL FAM SUB,2.11,AC,67700,0,67700,171100,17100,255900,61400,0,61400,148500,14600,224500,A2,AG/LTD,,,
12925,30-1-0-29-C,6758-16-9348,SNGL FAM SUB,3.59,AC,79100,0,79100,0,0,79100,74200,0,74200,0,0,74200,A1,AG/GEN,,,
12926,30-1-0-29-D,6758-16-6477,SNGL FAM SUB,3.18,AC,75300,0,75300,16700,500,92500,70400,0,70400,19000,500,89900,A1,AG/GEN,,,
12927,39-1-0-2-A,6728-00-2020,AG 20-100 AC,20.09,AC,107200,97900,9300,0,0,107200,104900,96400,8500,0,0,104900,A1,AG/GEN,,,
12928,43-1-0-24-A,6767-54-5291,Cemetery,0,AC,100,0,100,0,0,100,100,0,100,0,0,100,R1,RES/LTD,,,
12931,47-28-0-1-0,7716-69-6449,SNGL FAM SUB,1.504,AC,200000,0,200000,291600,2100,493700,170000,0,170000,284800,2400,457200,R1,RES/LTD,,,
12932,47-28-0-2-0,7716-69-6883,SNGL FAM SUB,1.517,AC,200000,0,200000,489700,46400,736100,170000,0,170000,483000,41000,694000,R1,RES/LTD,,,
12933,47-28-0-3-0,7717-60-6098,SNGL FAM SUB,1.724,AC,200000,0,200000,0,0,200000,170000,0,170000,0,0,170000,R1,RES/LTD,,,
12934,47-28-0-4-0,7717-60-8317,SNGL FAM SUB,3.097,AC,200000,0,200000,479800,0,679800,170000,0,170000,467000,0,637000,R1,RES/LTD,,,
12935,47-28-0-5-0,7717-60-5348,SNGL FAM SUB,2.079,AC,200000,0,200000,420900,79500,700400,170000,0,170000,416800,70500,657300,R1,RES/LTD,,,
12936,47-28-0-6-0,7717-60-3401,SNGL FAM SUB,1.857,AC,200000,0,200000,472800,0,672800,170000,0,170000,469500,0,639500,R1,RES/LTD,,,
12937,47-28-0-7-0,7717-60-0472,SNGL FAM SUB,1.815,AC,200000,0,200000,781300,0,981300,170000,0,170000,784900,0,954900,R1,RES/LTD,,,
12938,47-28-0-8-0,7717-50-8562,SNGL FAM SUB,1.503,AC,200000,0,200000,641400,0,841400,170000,0,170000,623900,0,793900,R1,RES/LTD,,,
12939,47-28-0-9-0,7717-50-7327,SNGL FAM SUB,1.502,AC,200000,0,200000,476200,0,676200,170000,0,170000,472900,0,642900,R1,RES/LTD,,,
12940,47-28-0-10-0,7717-50-6154,SNGL FAM SUB,1.501,AC,200000,0,200000,484600,500,685100,170000,0,170000,473000,500,643500,R1,RES/LTD,,,
12941,47-28-0-11-0,7717-50-8005,SNGL FAM SUB,1.527,AC,200000,0,200000,367700,12900,580600,170000,0,170000,361500,10900,542400,R1,RES/LTD,,,
12942,47-28-0-12-0,7717-60-0024,SNGL FAM SUB,1.626,AC,200000,0,200000,1283100,0,1483100,170000,0,170000,1209800,0,1379800,R1,RES/LTD,,,
12943,47-28-0-13-0,7716-69-1992,SNGL FAM SUB,2.53,AC,200000,0,200000,424000,28100,652100,170000,0,170000,409500,27200,606700,R1,RES/LTD,,,
12944,47-28-0-14-0,7716-69-3795,SNGL FAM SUB,2.187,AC,200000,0,200000,582500,0,782500,170000,0,170000,593800,0,763800,R1,RES/LTD,,,
12945,47-28-0-15-0,7717-50-3423,SNGL FAM SUB,2.247,AC,190000,0,190000,299300,0,489300,158100,0,158100,300300,0,458400,R1,RES/LTD,,,
12946,47-28-0-16-0,7717-51-3698,SNGL FAM SUB,2.184,AC,200000,0,200000,491800,0,691800,158100,0,158100,495700,0,653800,R1,RES/LTD,,,
12947,47-28-0-17-0,7717-51-5663,SNGL FAM SUB,2.042,AC,200000,0,200000,586200,0,786200,158100,0,158100,584700,0,742800,R1,RES/LTD,,,
12948,47-28-0-18-0,7717-51-7589,SNGL FAM SUB,2.234,AC,200000,0,200000,0,0,200000,158100,0,158100,0,0,158100,R1,RES/LTD,,,
12961,63-15-A-1-A,7714-91-7218,SNGL FAM SUB,9.74,AC,509100,0,509100,1257700,120900,1887700,442500,0,442500,1088900,106200,1637600,A2R1,AG LTD/,,,
13279,1-1-0-30-A,6814-34-5091,AG > 100 AC,114.12,AC,623300,395600,227700,0,51800,675100,611100,390100,221000,0,52900,664000,A1,AG/GEN,,,
13282,41-1-0-2-D,6747-25-1083,AG > 100 AC,205.19,AC,621100,520000,101100,0,0,621100,620500,532700,87800,0,0,620500,A1,AG/GEN,,,
13283,1-1-0-13-A,6814-37-1332,SNGL FAM SUB,2.01,AC,44900,0,44900,98500,0,143400,44100,0,44100,84700,0,128800,A1,AG/GEN,,,
13284,4-1-0-51-A,6803-83-7570,SNGL FAM SUB,15,AC,64400,0,64400,0,0,64400,63200,0,63200,0,0,63200,A1,AG/GEN,,,
13287,6-1-0-35-A,6822-78-7889,SNGL FAM SUB,3.67,AC,62100,0,62100,184300,26200,272600,60400,0,60400,162500,22000,244900,A1,AG/GEN,,,
13288,6-1-0-35-B,6822-78-7577,SNGL FAM SUB,2.63,AC,53600,0,53600,105900,1500,161000,52000,0,52000,90200,1500,143700,A1,AG/GEN,,,
13289,10-1-0-25-A,6801-85-9973,SNGL FAM SUB,6.4,AC,63600,60300,3300,0,35800,99400,62300,0,62300,0,35500,97800,A1,AG/GEN,,,
13290,10-1-0-25-B,6801-85-2145,SNGL FAM SUB,7.154,AC,67100,0,67100,173000,20100,260200,65700,0,65700,154400,17500,237600,A1,AG/GEN,,,
13291,10-1-0-25-C,6801-84-6997,SNGL FAM SUB,6.34,AC,63400,0,63400,115300,0,178700,62000,0,62000,97900,0,159900,A1,AG/GEN,,,
13292,10-1-0-25-D,6801-94-9818,AG 20-100 AC,23.178,AC,116600,0,116600,218300,7000,341900,104500,0,104500,182000,600,287100,A1,AG/GEN,,,
13294,11-10-0-3-A,6821-35-2901,SNGL FAM SUB,5,AC,63500,0,63500,501500,0,565000,62000,0,62000,400800,0,462800,A1,AG/GEN,,,
13295,12-1-0-16-B1,6822-73-3652,SNGL FAM SUB,17,AC,131700,0,131700,230500,100100,462300,128600,0,128600,199800,87100,415500,A1,AG/GEN,,,
13297,13-1-0-16-A,6841-47-1561,SNGL FAM SUB,2.18,AC,60100,0,60100,181500,0,241600,54000,0,54000,168400,0,222400,A1,AG/GEN,,,
13298,13-1-0-20-E,6841-55-3963,SNGL FAM SUB,4.97,AC,83300,0,83300,188700,0,272000,81800,0,81800,167500,0,249300,A1,AG/GEN,,,
13300,13-1-0-32-0,6852-03-7962,SNGL FAM SUB,2,AC,58600,0,58600,191700,10200,260500,57500,0,57500,168100,9300,234900,A1,AG/GEN,,,
13301,13-1-0-32-A,6852-03-6780,SNGL FAM SUB,2,AC,58600,0,58600,187200,500,246300,54000,0,54000,161200,500,215700,A1,AG/GEN,,,
13302,13-1-0-32-B,6852-03-9796,SNGL FAM SUB,2.51,AC,56700,0,56700,197000,2500,256200,56600,0,56600,122800,2500,181900,A1,AG/GEN,,,
13303,13-1-0-32-C,6852-13-3609,SNGL FAM SUB,5.77,AC,76000,0,76000,212200,28700,316900,72900,0,72900,181300,24800,279000,A1,AG/GEN,,,
13304,7-5-0-1-0,6843-00-4547,SNGL FAM SUB,7.424,AC,83800,0,83800,195600,4000,283400,81700,0,81700,170500,4000,256200,A1,AG/GEN,,,
13305,7-5-0-2-0,6843-00-9402,SNGL FAM SUB,11.147,AC,102400,0,102400,180100,61400,343900,99900,0,99900,155100,54000,309000,A1,AG/GEN,,,
13306,7-5-0-3-0,6843-10-4228,SNGL FAM SUB,14.974,AC,120100,0,120100,369400,47700,537200,117300,0,117300,331100,42400,490800,A1,AG/GEN,,,
13307,7-5-0-4-0,6843-10-9241,SNGL FAM SUB,14.263,AC,116100,0,116100,0,0,116100,113300,0,113300,0,0,113300,A1,AG/GEN,,,
13309,16-4-0-21-0,5890-46-4755,SNGL FAM SUB,4.29,AC,50600,0,50600,213600,2400,266600,49500,0,49500,184000,2400,235900,A1,AG/GEN,,,
13310,17-1-0-88-A1,6719-47-7410,SNGL FAM SUB,2.76,AC,50600,0,50600,217000,19500,287100,48600,0,48600,120400,15700,184700,A1,AG/GEN,,,
13311,17-1-0-88-A2,6719-47-5235,SNGL FAM SUB,2,AC,46000,0,46000,123600,200,169800,44000,0,44000,99100,200,143300,A1,AG/GEN,,,
13312,17-6-0-W-1,6810-34-0389,SNGL FAM SUB,3,AC,52000,0,52000,0,0,52000,49000,0,49000,0,0,49000,A1,AG/GEN,,,
13313,18-3-0-2-C,6810-83-0189,AG 20-100 AC,69.64,AC,214100,141000,73100,360500,129500,704100,209600,142300,67300,303100,123900,636600,A1,AG/GEN,,,
13314,19-1-0-8-A,6830-08-5227,SNGL FAM SUB,2.285,AC,57000,0,57000,0,0,57000,54700,0,54700,0,0,54700,A1,AG/GEN,,,
13315,19-1-0-8-B,6830-08-3486,SNGL FAM SUB,4.421,AC,71500,0,71500,14400,5500,91400,68000,0,68000,13900,5500,87400,A1,AG/GEN,,,
13316,19-1-0-8-C,6830-08-3761,SNGL FAM SUB,4.402,AC,71300,0,71300,165500,30200,267000,67800,0,67800,136200,26300,230300,A1,AG/GEN,,,
13319,19-1-0-40-B,6831-52-6256,SNGL FAM SUB,1.51,AC,52000,0,52000,129400,1200,182600,48700,0,48700,106900,1200,156800,A1,AG/GEN,,,
13320,21-1-0-39-A,6759-39-6285,SNGL FAM SUB,3.76,AC,87300,0,87300,281900,0,369200,77200,0,77200,234400,0,311600,A2,AG/LTD,,,
13321,25-1-0-10-A,5799-34-0613,SNGL FAM SUB,7.2,AC,67300,0,67300,0,0,67300,65900,0,65900,0,0,65900,A1,AG/GEN,,,
13323,26-1-0-57-C,6719-11-9916,COMM & IND,2,AC,85700,0,85700,139000,45900,270600,83200,0,83200,139000,34500,256700,B1,BUS/GEN,,,
13324,27-1-0-50-A,6719-95-7955,SNGL FAM SUB,4,AC,57600,0,57600,104500,9400,171500,56000,0,56000,81900,8600,146500,A1,AG/GEN,,,
13326,27-11-0-1-0,6728-45-7542,SNGL FAM SUB,4.57,AC,60600,0,60600,199500,17600,277700,59400,0,59400,176000,14900,250300,A1,AG/GEN,,,
13327,27-11-0-2-0,6728-55-4860,SNGL FAM SUB,10.02,AC,89300,0,89300,218500,0,307800,87600,0,87600,189100,0,276700,A1,AG/GEN,,,
13329,27-11-0-3-0,6728-65-3930,SNGL FAM SUB,10.02,AC,89300,0,89300,231000,8800,329100,87600,0,87600,203900,9400,300900,A1,AG/GEN,,,
13331,27-11-0-4-0,6728-75-0786,SNGL FAM SUB,12.14,AC,101200,0,101200,255800,24300,381300,99300,0,99300,217000,20700,337000,A1,AG/GEN,,,
13332,27-11-0-5-0,6728-65-5293,AG 20-100 AC,20.8,AC,149500,0,149500,304300,2100,455900,146500,0,146500,270500,1900,418900,A1,AG/GEN,,,
13333,27-11-0-6-0,6728-55-5305,SNGL FAM SUB,7.5,AC,78500,0,78500,207500,3000,289000,77000,0,77000,178300,3000,258300,A1,AG/GEN,,,
13334,27-11-0-7-0,6728-45-7273,SNGL FAM SUB,4.73,AC,61600,0,61600,236300,18400,316300,60400,0,60400,202600,16100,279100,A1,AG/GEN,,,
13335,28-1-0-76-A,6739-27-4253,SNGL FAM SUB,3,AC,60800,0,60800,0,0,60800,58300,0,58300,0,0,58300,A1,AG/GEN,,,
13336,28-1-0-87-D,6739-24-0206,SNGL FAM SUB,7.5,AC,90000,0,90000,0,0,90000,88900,0,88900,0,0,88900,A1,AG/GEN,,,
13337,28-1-0-87-E,6739-04-4571,SNGL FAM SUB,8.475,AC,91200,0,91200,10300,0,101500,88100,0,88100,9800,0,97900,A1,AG/GEN,,,
13338,28-1-0-87-F,6739-03-6949,SNGL FAM SUB,8.475,AC,91200,0,91200,0,0,91200,88100,0,88100,0,0,88100,A1,AG/GEN,,,
13339,28-1-0-87-G,6739-24-8130,SNGL FAM SUB,7.13,AC,87500,0,87500,0,0,87500,113100,0,113100,0,0,113100,A1,AG/GEN,,,
13340,29-1-0-129-A,6748-97-2969,SNGL FAM SUB,2,AC,63000,0,63000,145300,500,208800,57700,0,57700,119500,500,177700,A1,AG/GEN,,,
13342,29-5-0-1-E,6749-64-6682,SNGL FAM SUB,6.234,AC,102000,0,102000,197400,800,300200,99100,0,99100,161700,800,261600,RR,RES/RUR,,,
13343,30-1-0-21-A,6759-41-3531,SNGL FAM SUB,2.559,AC,69400,0,69400,142800,15300,227500,66100,0,66100,118000,13800,197900,A2,AG/LTD,,,
13345,30-1-0-111-B,6759-75-2619,AG 20-100 AC,97.6,AC,994700,0,994700,0,0,994700,858900,0,858900,0,0,858900,R1,RES/LTD,,,
13347,31-1-0-38-A,6768-99-0439,SNGL FAM SUB,3.3,AC,92000,0,92000,195300,10800,298100,82700,0,82700,162600,10300,255600,A2,AG/LTD,,,
13348,31-1-0-38-B,6768-89-7745,SNGL FAM SUB,3.5,AC,94300,0,94300,178600,23900,296800,85100,0,85100,148900,20800,254800,A2,AG/LTD,,,
13349,31-1-0-38-C,6768-89-5926,SNGL FAM SUB,2.87,AC,86900,0,86900,199900,25900,312700,77500,0,77500,165900,22100,265500,A2,AG/LTD,,,
13350,31-1-0-38-D,6769-80-3133,SNGL FAM SUB,3.23,AC,91100,0,91100,203700,27200,322000,81900,0,81900,167200,22700,271800,A2,AG/LTD,,,
13352,31-1-0-91-A,6778-43-3227,SNGL FAM SUB,3.99,AC,107200,0,107200,229400,2000,338600,95800,0,95800,189700,2000,287500,A2,AG/LTD,,,
13353,31-6-0-5-A,6778-51-4998,SNGL FAM SUB,3.381,AC,98400,0,98400,383200,26800,508400,87900,0,87900,322300,22800,433000,A2,AG/LTD,,,
13355,31-12-0-6-A,6769-76-1648,SNGL FAM SUB,1.891,AC,72000,0,72000,167900,26600,266500,64800,0,64800,138900,23100,226800,A2,AG/LTD,,,
13356,32-1-0-31-B1,6778-67-3843,SNGL FAM SUB,0.25,AC,3600,0,3600,0,0,3600,3200,0,3200,0,0,3200,A2,AG/LTD,,,
13359,32-1-0-65-A1,6789-41-4165,SNGL FAM SUB,2,AC,78500,0,78500,198400,3500,280400,70100,0,70100,167100,3500,240700,A2,AG/LTD,,,
13360,33-1-0-9-C,6798-46-4550,SNGL FAM SUB,2.01,AC,91000,0,91000,172000,2000,265000,81300,0,81300,139900,2000,223200,A2,AG/LTD,,,
13362,63-1-0-2-A,7715-31-2872,SNGL FAM SUB,3.06,AC,169300,0,169300,418800,61900,650000,147300,0,147300,354100,51600,553000,A2,AG/LTD,,,
13363,39-1-0-15-E,6727-15-4631,SNGL FAM SUB,3.62,AC,53500,51700,1800,0,0,53500,52400,50900,1500,0,0,52400,A1,AG/GEN,,,
13364,40-1-0-29-A,6737-51-0813,SNGL FAM SUB,13.342,AC,124300,0,124300,0,0,124300,122100,0,122100,0,0,122100,A1,AG/GEN,,,
13365,40-1-0-29-B,6737-51-5915,SNGL FAM SUB,18.274,AC,154400,145800,8600,0,0,154400,151600,143800,7800,0,0,151600,A1,AG/GEN,,,
13366,40-1-0-29-C,6737-52-9331,SNGL FAM SUB,8.2,AC,100100,95900,4200,0,50100,150200,98400,94900,3500,0,44100,142500,A1,AG/GEN,,,
13367,40-1-0-29-D,6737-52-9709,SNGL FAM SUB,14.3,AC,130100,58100,72000,460300,37300,627700,127800,57400,70400,400300,41600,569700,A1,AG/GEN,,,
13368,63-1-0-2-B,7715-21-7905,SNGL FAM SUB,3.569,AC,180900,0,180900,0,0,180900,157400,0,157400,0,0,157400,A2,AG/LTD,,,
13369,63-1-0-2-C,7715-31-0601,SNGL FAM SUB,5.92,AC,304000,0,304000,782700,0,1086700,209800,0,209800,693800,0,903600,R1,RES/LTD,,,
13371,43-1-0-82-F,6767-92-5990,SNGL FAM SUB,11.73,AC,192400,0,192400,201700,21500,415600,172000,0,172000,170100,17700,359800,A2,AG/LTD,,,
13372,43-1-0-82-G,6777-02-1773,Cemetery,0,AC,100,0,100,0,0,100,100,0,100,0,0,100,A2,AG/LTD,,,
13373,43-1-0-91-A,6776-47-7039,AG 20-100 AC,28.64,AC,180900,167700,13200,0,0,180900,160900,148700,12200,0,0,160900,A2,AG/LTD,,,
13375,43-29-0-1-0,6767-30-8284,SNGL FAM SUB,3.229,AC,103800,0,103800,246400,0,350200,92700,0,92700,203200,0,295900,A2,AG/LTD,,,
13376,43-29-0-2-0,6767-40-2165,SNGL FAM SUB,3.778,AC,112000,0,112000,285300,6000,403300,100100,0,100100,237800,6000,343900,A2,AG/LTD,,,
13377,43-29-0-3-0,6767-40-3458,SNGL FAM SUB,2.728,AC,96200,0,96200,265500,800,362500,85900,0,85900,223600,800,310300,A2,AG/LTD,,,
13378,43-29-0-4-0,6767-30-9690,SNGL FAM SUB,3.017,AC,100600,0,100600,483700,0,584300,89800,0,89800,398900,0,488700,A2,AG/LTD,,,
13379,44-4-0-3-C,6787-13-6776,SNGL FAM SUB,2.3,AC,88000,0,88000,0,0,88000,78600,0,78600,0,0,78600,A2,AG/LTD,,,
13380,44-4-0-3-D,6787-14-6355,SNGL FAM SUB,4.04,AC,110200,0,110200,191800,0,302000,98500,0,98500,155900,0,254400,A2,AG/LTD,,,
13381,44-4-0-3-E,6787-14-9203,SNGL FAM SUB,4.04,AC,110200,0,110200,170200,10500,290900,98500,0,98500,137900,10500,246900,A2,AG/LTD,,,
13382,60-1-0-12-B,6784-26-3842,SNGL FAM SUB,0.58,AC,3400,0,3400,0,0,3400,3000,0,3000,0,0,3000,A2,AG/LTD,,,
13383,60-1-0-12-C,6784-26-1850,SNGL FAM SUB,0.15,AC,900,0,900,0,0,900,800,0,800,0,0,800,A2,AG/LTD,,,
13384,60-1-0-12-D,6784-06-7598,SNGL FAM SUB,1.69,AC,9800,0,9800,0,0,9800,8800,0,8800,0,0,8800,A2,AG/LTD,,,
13385,60-1-0-12-E,6784-06-0526,SNGL FAM SUB,0.78,AC,4500,0,4500,0,0,4500,4100,0,4100,0,0,4100,A2,AG/LTD,,,
13386,60-1-0-12-F,6784-06-0754,SNGL FAM SUB,0.17,AC,1000,0,1000,0,0,1000,900,0,900,0,0,900,A2,AG/LTD,,,
13387,60-1-0-12-G,6784-06-0892,SNGL FAM SUB,0.04,AC,200,0,200,0,0,200,200,0,200,0,0,200,A2,AG/LTD,,,
13388,60-1-0-12-H,6774-96-7934,SNGL FAM SUB,0.27,AC,1600,0,1600,0,0,1600,1400,0,1400,0,0,1400,A2,AG/LTD,,,
13389,60-1-0-12-I,6774-96-8821,SNGL FAM SUB,0.08,AC,500,0,500,0,0,500,400,0,400,0,0,400,A2,AG/LTD,,,
13390,60-1-0-12-J,6774-96-7708,SNGL FAM SUB,0.01,AC,200,0,200,0,0,200,200,0,200,0,0,200,A2,AG/LTD,,,
13391,60-1-0-12-K,6774-96-7770,SNGL FAM SUB,0.01,AC,200,0,200,0,0,200,200,0,200,0,0,200,A2,AG/LTD,,,
13392,60-1-0-12-L,6774-96-5687,SNGL FAM SUB,0.06,AC,200,0,200,0,0,200,200,0,200,0,0,200,A2,AG/LTD,,,
13398,44-25-0-1-0,6787-23-9658,SNGL FAM SUB,3.054,AC,102600,0,102600,309200,0,411800,91600,0,91600,253700,0,345300,A2,AG/LTD,,,
13399,44-25-0-2-0,6787-33-6604,SNGL FAM SUB,8,AC,166700,0,166700,155500,0,322200,148700,0,148700,127200,0,275900,A2,AG/LTD,,,
13414,44-25-0-3-0,6787-43-0587,SNGL FAM SUB,7.257,AC,156400,0,156400,268100,2000,426500,139600,0,139600,218400,2000,360000,A2,AG/LTD,,,
13416,46-1-0-8-B,7707-16-3842,SNGL FAM SUB,2.91,AC,142500,0,142500,498200,0,640700,127400,0,127400,447500,0,574900,A2,AG/LTD,,,
13417,46-1-0-8-C,7707-17-6227,SNGL FAM SUB,3.71,AC,159200,0,159200,209200,25600,394000,142100,0,142100,175600,25600,343300,A2,AG/LTD,,,
13418,46-1-0-8-D,7707-17-8080,SNGL FAM SUB,4.27,AC,171600,0,171600,205100,2600,379300,153100,0,153100,170000,2600,325700,A2,AG/LTD,,,
13419,46-1-0-8-E,7707-17-7010,Cemetery,0,AC,100,0,100,0,0,100,100,0,100,0,0,100,A2,AG/LTD,,,
13421,46-1-0-118-E,7717-04-0524,SNGL FAM SUB,6.556,AC,193500,0,193500,398600,800,592900,172900,0,172900,336600,800,510300,A2,AG/LTD,,,
13422,46-1-0-118-F,7707-93-9962,SNGL FAM SUB,11.026,AC,269400,0,269400,679000,82600,1031000,240800,0,240800,564300,72500,877600,A2,AG/LTD,,,
13423,57-1-0-56-A1,7716-03-4315,SNGL FAM SUB,12.739,AC,468000,0,468000,0,68100,536100,429000,0,429000,0,61200,490200,A2,AG/LTD,,,
13424,57-1-0-56-A2,7716-03-0065,SNGL FAM SUB,8.123,AC,264000,0,264000,0,0,264000,242000,0,242000,0,0,242000,A2,AG/LTD,,,
13425,57-1-0-56-A3,7716-02-2541,SNGL FAM SUB,6.011,AC,228300,0,228300,0,0,228300,209000,0,209000,0,0,209000,A2,AG/LTD,,,
13427,57-1-0-56-A4,7716-02-1057,SNGL FAM SUB,6.661,AC,228300,0,228300,0,0,228300,209000,0,209000,0,0,209000,A2,AG/LTD,,,
13428,57-1-0-79-D,7706-53-8119,SNGL FAM SUB,2,AC,136700,0,136700,402700,5900,545300,118900,0,118900,343900,5400,468200,A2,AG/LTD,,,
13430,47-1-0-92-D,7727-20-0231,COMM & IND,1.81,AC,570500,0,570500,0,0,570500,518700,0,518700,0,0,518700,B1,BUS/GEN,,,
13432,57-13-0-41-0,7705-02-2675,AG 20-100 AC,23.741,AC,836700,0,836700,751100,40300,1628100,728000,0,728000,735100,35100,1498200,RR,RES/RUR,,,
13433,47-21-0-9-A,7726-29-0672,COMM & IND,0.176,AC,2200,0,2200,0,0,2200,2200,0,2200,0,0,2200,B1,BUS/GEN,,,
13443,60-1-0-12-P,6775-90-6605,SNGL FAM SUB,0.01,AC,300,0,300,0,0,300,300,0,300,0,0,300,A2,AG/LTD,,,
13444,60-1-0-12-Q,6775-90-6712,SNGL FAM SUB,0.04,AC,200,0,200,0,0,200,200,0,200,0,0,200,A2,AG/LTD,,,
13445,60-1-0-12-R,6775-90-6717,SNGL FAM SUB,0.01,AC,200,0,200,0,0,200,200,0,200,0,0,200,A2,AG/LTD,,,
13446,60-1-0-12-S,6775-91-5083,SNGL FAM SUB,0.72,AC,4200,0,4200,0,0,4200,3700,0,3700,0,0,3700,A2,AG/LTD,,,
13447,60-1-0-12-U,6775-91-5439,SNGL FAM SUB,0.13,AC,800,0,800,0,0,800,700,0,700,0,0,700,A2,AG/LTD,,,
13448,60-1-0-12-O,6775-90-7991,SNGL FAM SUB,5.16,AC,17500,0,17500,0,0,17500,15500,0,15500,0,0,15500,A2,AG/LTD,,,
13452,48-1-0-13-E,7727-59-2418,Roads,1.1,AC,0,0,0,0,0,0,0,0,0,0,0,0,M2,INDUS/G,,,
13455,48-1-0-13-F,7727-59-9213,Roads,1.19,AC,0,0,0,0,0,0,0,0,0,0,0,0,M2,INDUS/G,,,
13457,62-25-0-1-0,7704-88-3852,SNGL FAM SUB,4.5,AC,315700,0,315700,323700,20800,660200,274700,0,274700,273500,20800,569000,A2,AG/LTD,,,
13458,62-25-0-2-0,7704-89-6108,SNGL FAM SUB,5,AC,277700,0,277700,330600,0,608300,241700,0,241700,280900,0,522600,A2,AG/LTD,,,
13459,62-25-0-3-0,7704-99-0427,SNGL FAM SUB,9.2,AC,296700,0,296700,314600,29800,641100,258400,0,258400,266900,25300,550600,A2,AG/LTD,,,
13460,51-1-0-26-D,6735-38-2112,SNGL FAM SUB,5.91,AC,68800,0,68800,111400,1000,181200,67500,0,67500,95200,1000,163700,A1,AG/GEN,,,
13462,56-12-0-B-1,6796-24-9103,SNGL FAM SUB,19.13,AC,452900,443800,9100,0,0,452900,393400,385200,8200,0,0,393400,A2,AG/LTD,,,
13464,55-1-0-10-B,6776-92-4797,SNGL FAM SUB,3.268,AC,88200,0,88200,139200,20600,248000,78700,0,78700,109000,17500,205200,A2,AG/LTD,,,
13465,55-1-0-10-C,6786-02-9219,AG > 100 AC,137.406,AC,69400,0,69400,0,79100,148500,59000,0,59000,0,70900,129900,A2,AG/LTD,,,
13467,57-3-0-3-A,7706-41-2398,AG 20-100 AC,22.36,AC,636000,409200,226800,844800,177100,1657900,552500,355600,196900,705000,150700,1408200,A2,AG/LTD,,,
13468,57-3-0-2-B,7706-23-6191,SNGL FAM SUB,3.48,AC,173600,0,173600,0,0,173600,151100,0,151100,0,0,151100,A2,AG/LTD,,,
13474,17-3-0-2-C,6709-39-8840,SNGL FAM SUB,2.65,AC,46400,0,46400,169700,0,216100,47100,0,47100,139800,0,186900,A1,AG/GEN,,,
13475,17-3-0-2-D,6800-40-0219,SNGL FAM SUB,2.59,AC,47700,0,47700,111300,700,159700,46700,0,46700,93600,700,141000,A1,AG/GEN,,,
13481,29-5-0-1-D,6749-74-0345,SNGL FAM SUB,5,AC,91600,0,91600,231600,5100,328300,89500,0,89500,190900,5700,286100,A1,AG/GEN,,,
13485,31-1-0-9-B,6769-44-5793,SNGL FAM SUB,8.22,AC,137400,0,137400,314800,42100,494300,123000,0,123000,262100,35400,420500,A2,AG/LTD,,,
13486,31-1-0-24-A,6768-76-4177,SNGL FAM SUB,2,AC,60600,0,60600,12400,1500,74500,54500,0,54500,12300,1500,68300,A2,AG/LTD,,,
13489,40-4-0-E-1,6737-63-6205,SNGL FAM SUB,2.179,AC,56800,0,56800,93900,800,151500,55700,0,55700,77600,800,134100,A1,AG/GEN,,,
13491,57-25-B-13-B,7716-03-8833,SNGL FAM SUB,0.31,AC,8900,0,8900,0,0,8900,8100,0,8100,0,0,8100,A2,AG/LTD,,,
13492,57-25-B-13-C,7716-04-3114,SNGL FAM SUB,3.09,AC,365000,0,365000,419200,0,784200,335000,0,335000,382400,0,717400,A2,AG/LTD,,,
13493,57-25-B-13-D,7716-03-8959,SNGL FAM SUB,3.09,AC,346800,0,346800,734600,0,1081400,318300,0,318300,666600,0,984900,A2,AG/LTD,,,
13495,45-1-0-84-A,6797-84-0906,SNGL FAM SUB,4.29,AC,126400,0,126400,108100,2500,237000,112900,0,112900,85800,2700,201400,A2,AG/LTD,,,
13496,45-1-0-84-A1,6797-85-0272,SNGL FAM SUB,3.23,AC,110400,0,110400,0,0,110400,98600,0,98600,0,0,98600,A2,AG/LTD,,,
13497,45-1-0-84-A2,6797-85-1467,SNGL FAM SUB,2.68,AC,102100,0,102100,104600,3500,210200,91200,0,91200,83100,3700,178000,A2,AG/LTD,,,
13498,45-21-0-1-0,6797-89-2719,SNGL FAM SUB,4.686,AC,110500,0,110500,240500,0,351000,98500,0,98500,202900,0,301400,A2,AG/LTD,,,
13499,45-21-0-2-0,6797-89-5554,SNGL FAM SUB,4.686,AC,110500,0,110500,115900,0,226400,98500,0,98500,92300,0,190800,A2,AG/LTD,,,
13501,45-21-0-4-0,6797-99-0127,SNGL FAM SUB,4.673,AC,112500,0,112500,0,0,112500,100600,0,100600,0,0,100600,A2,AG/LTD,,,
13502,45-21-0-5-0,6797-98-3937,SNGL FAM SUB,2.343,AC,82400,0,82400,129100,1700,213200,73600,0,73600,105400,1700,180700,A2,AG/LTD,,,
13503,45-21-0-6-0,6797-98-0639,SNGL FAM SUB,4.686,AC,109900,0,109900,127100,0,237000,98300,0,98300,104300,0,202600,A2,AG/LTD,,,
13504,45-21-0-7-0,6797-88-7896,SNGL FAM SUB,2.343,AC,88600,0,88600,175200,1500,265300,79100,0,79100,143300,1500,223900,A2,AG/LTD,,,
13507,51-10-0-A-1,6736-16-7597,SNGL FAM SUB,3,AC,46100,0,46100,244600,3000,293700,45200,0,45200,220400,3200,268800,A1,AG/GEN,,,
13508,58-1-0-30-D,7715-44-6704,AG 20-100 AC,26.124,AC,1162500,1150500,12000,0,0,1162500,582600,571500,11100,0,0,582600,A2,AG/LTD,,,
13519,60-1-0-12-A,6784-27-6114,SNGL FAM SUB,0.06,AC,300,0,300,0,0,300,300,0,300,0,0,300,A2,AG/LTD,,,
13520,60-1-0-12-T,6775-91-4286,SNGL FAM SUB,0.51,AC,3000,0,3000,0,0,3000,2700,0,2700,0,0,2700,A2,AG/LTD,,,
13530,12-1-0-46-A,6831-06-5787,SNGL FAM SUB,2,AC,47600,0,47600,167700,1500,216800,47800,0,47800,135200,1800,184800,A1,AG/GEN,,,
13531,12-1-0-46-B,6831-16-0678,SNGL FAM SUB,4.34,AC,60500,0,60500,11100,4500,76100,60200,0,60200,11000,4500,75700,A1,AG/GEN,,,
13532,58-24-0-3-A,7716-50-9576,SNGL FAM SUB,11.57,AC,399900,0,399900,616200,21900,1038000,348100,0,348100,573000,20900,942000,A2,AG/LTD,,,
13534,46-1-0-79-D,7708-70-4856,Cemetery,0,AC,100,0,100,0,0,100,100,0,100,0,0,100,A2,AG/LTD,,,
13537,57-1-0-11-B,7706-33-7355,SNGL FAM SUB,2.947,AC,177000,0,177000,339500,7400,523900,153900,0,153900,285000,6000,444900,A2,AG/LTD,,,
13538,57-1-0-11-C,7706-33-7168,SNGL FAM SUB,0.157,AC,4400,0,4400,0,0,4400,3900,0,3900,0,0,3900,A2,AG/LTD,,,
13539,54-3-0-K-2,6776-45-2041,AG 20-100 AC,50,AC,404500,380600,23900,0,0,404500,360000,338600,21400,0,0,360000,A2,AG/LTD,,,
13541,44-29-0-1-0,6777-61-3125,SNGL FAM SUB,8.785,AC,177500,0,177500,0,0,177500,158400,0,158400,0,0,158400,A2,AG/LTD,,,
13543,31-1-0-86-C1,6778-56-2684,AG 20-100 AC,53.46,AC,593900,503400,90500,606000,127100,1327000,529300,449600,79700,491300,119700,1140300,A2,AG/LTD,,,
13544,46-10-0-D-1,7707-15-7863,SNGL FAM SUB,5.38,AC,196200,0,196200,438200,0,634400,175100,0,175100,368900,0,544000,A2,AG/LTD,,,
13545,21-1-0-2-C,6851-30-6939,SNGL FAM SUB,5.71,AC,88900,0,88900,281800,10000,380700,87300,0,87300,252700,10000,350000,A1,AG/GEN,,,
13556,46-1-0-79-C,7708-70-4612,SNGL FAM SUB,2,AC,115200,0,115200,366500,18000,499700,102900,0,102900,308900,14700,426500,A2,AG/LTD,,,
13591,48-1-0-67-0,7737-26-3530,COMM & IND,98.31,AC,4409300,4363100,46200,0,0,4409300,4198000,4156100,41900,0,0,4198000,M1A2,INDUSTR,,,
13593,48-1-0-47-0,7727-87-0299,COMM & IND,124.044,AC,6407800,0,6407800,1152000,404400,7964200,6107400,0,6107400,1336400,120500,7564300,M2,INDUS/G,,,
13594,62-1-0-10-T,7704-91-8292-9999,COMM & IND,145.86,AC,2874400,0,2874400,1196900,629500,4700800,2668700,0,2668700,1285200,453100,4407000,M2,INDUS/G,,,
13597,57-1-0-45-E,7715-14-8568,SNGL FAM SUB,6.3,AC,271900,0,271900,312900,42200,627000,236400,0,236400,264400,36000,536800,A2,AG/LTD,,,
13602,17-1-0-10-A,6800-40-4347,SNGL FAM SUB,2.08,AC,44800,0,44800,98200,1300,144300,43900,0,43900,86500,1300,131700,A1,AG/GEN,,,
13603,29-1-0-45-A,6748-69-6124,SNGL FAM SUB,2,AC,64000,0,64000,292900,1500,358400,59300,0,59300,248100,1500,308900,A1,AG/GEN,,,
13608,55-1-0-45-D,6786-52-7886,SNGL FAM SUB,2,AC,86600,0,86600,103300,800,190700,77300,0,77300,84400,800,162500,A2,AG/LTD,,,
13611,61-6-0-34-0,6794-99-5510,AG 20-100 AC,21.884,AC,883900,0,883900,673700,154500,1712100,769100,0,769100,652300,134400,1555800,RR,RES/RUR,,,
13630,47-3-0-A-0,7727-03-9412,COMM & IND,227.92,AC,9068400,7304200,1764200,787600,262700,10118700,8472900,6801600,1671300,681400,282600,9436900,B1A2,BS AND,,,
13740,42-3-0-10-0,6767-04-8685,COMM & IND,0.684,AC,85400,0,85400,0,0,85400,82100,0,82100,0,0,82100,RO,RES/OF,,,
13741,1-1-0-1-A,6805-82-9944,SNGL FAM SUB,10.5,AC,88200,82900,5300,0,0,88200,86500,82000,4500,0,0,86500,A1,AG/GEN,,,
13742,12-1-0-46-C,6831-36-1851,AG 20-100 AC,48.66,AC,234000,209900,24100,0,0,234000,228700,207900,20800,0,0,228700,A1,AG/GEN,,,
13743,12-1-0-46-D,6831-38-0066,AG 20-100 AC,28.35,AC,135800,111300,24500,0,0,135800,133200,109900,23300,0,0,133200,A1,AG/GEN,,,
13744,17-1-0-10-B,6800-32-6021,AG 20-100 AC,25,AC,84000,72500,11500,0,0,84000,80000,69400,10600,0,0,80000,A1,AG/GEN,,,
13745,19-1-0-36-F,6830-08-9757,SNGL FAM SUB,2.08,AC,55600,0,55600,84300,2900,142800,53100,0,53100,66800,2900,122800,A1,AG/GEN,,,
13746,19-1-0-68-A,6739-49-6557,AG > 100 AC,168.97,AC,616400,530600,85800,0,800,617200,608300,535700,72600,0,800,609100,A1,AG/GEN,,,
13747,26-2-0-2-J,6708-89-3152,AG 20-100 AC,20.01,AC,145300,0,145300,125900,1000,272200,142600,0,142600,100900,1000,244500,A1,AG/GEN,,,
13748,26-2-0-2-K,6708-78-9827,AG 20-100 AC,30,AC,145400,0,145400,0,0,145400,142500,0,142500,0,0,142500,A1,AG/GEN,,,
13749,31-1-0-44-B,6769-83-4610,AG > 100 AC,117.99,AC,1123700,1063800,59900,0,58300,1182000,1000100,949400,50700,0,52400,1052500,A2,AG/LTD,,,
13751,47-1-0-43-P,7716-98-5696,COMM & IND,0.996,AC,678500,0,678500,498800,49500,1226800,616800,0,616800,0,0,616800,B1,BUS/GEN,,,
13753,47-1-0-43-Q,7726-09-3570,COMM & IND,4.44,AC,1152900,0,1152900,0,0,1152900,1048100,0,1048100,0,0,1048100,M1,INDUS/L,,,
13756,62-26-0-A-0,7704-95-6854,Cmn Area/Open Spc,1.46,AC,0,0,0,0,0,0,0,0,0,0,0,0,RPUD,RES/PUD,,,
13757,62-26-0-1-0,7704-95-5588,SNGL FAM URB,0,AC,115000,0,115000,275600,13500,404100,100000,0,100000,248300,13500,361800,RPUD,RES/PUD,,,
13758,62-26-0-2-0,7704-95-5762,SNGL FAM URB,0,AC,115000,0,115000,418300,1000,534300,100000,0,100000,342200,1000,443200,RPUD,RES/PUD,,,
13759,62-26-0-3-0,7704-95-5874,SNGL FAM URB,0,AC,115000,0,115000,303300,30700,449000,100000,0,100000,279200,25700,404900,RPUD,RES/PUD,,,
13760,62-26-0-4-0,7704-95-5906,SNGL FAM URB,0,AC,115000,0,115000,363700,0,478700,100000,0,100000,335300,0,435300,RPUD,RES/PUD,,,
13761,62-26-0-5-0,7704-96-4007,SNGL FAM URB,0,AC,115000,0,115000,414800,0,529800,100000,0,100000,378500,0,478500,RPUD,RES/PUD,,,
13762,62-26-0-6-0,7704-96-2182,SNGL FAM URB,0,AC,115000,0,115000,249400,0,364400,100000,0,100000,229000,0,329000,RPUD,RES/PUD,,,
13763,62-26-0-7-0,7704-96-1064,SNGL FAM URB,0,AC,115000,0,115000,329300,2800,447100,100000,0,100000,298800,3000,401800,RPUD,RES/PUD,,,
13764,62-26-0-8-0,7704-95-0981,SNGL FAM URB,0,AC,115000,0,115000,274300,2600,391900,100000,0,100000,247700,2600,350300,RPUD,RES/PUD,,,
13765,62-26-0-9-0,7704-95-0719,SNGL FAM URB,0,AC,115000,0,115000,395200,0,510200,100000,0,100000,360900,0,460900,RPUD,RES/PUD,,,
13766,62-26-0-11-0,7704-95-3632,SNGL FAM URB,0,AC,115000,0,115000,281800,0,396800,100000,0,100000,258500,0,358500,RPUD,RES/PUD,,,
13767,62-26-0-12-0,7704-95-7499,SNGL FAM URB,0,AC,115000,0,115000,282600,700,398300,100000,0,100000,259300,700,360000,RPUD,RES/PUD,,,
13769,62-26-0-10-0,7704-95-1761,SNGL FAM URB,0,AC,115000,0,115000,310200,0,425200,100000,0,100000,284000,0,384000,RPUD,RES/PUD,,,
13772,48-1-0-47-C,7727-87-0299-0001,MINERALS,0,AC,0,0,0,100,0,100,0,0,0,2522800,0,2522800,M2,INDUS/G,,,
13773,48-1-0-67-A,7737-26-2494-0001,MINERALS,0,AC,0,0,0,0,0,0,0,0,0,0,0,0,M2,INDUS/G,,,
13774,48-1-0-69-D,7727-98-8288-0001,MINERALS,0,AC,0,0,0,100,0,100,0,0,0,1206600,0,1206600,M2,INDUS/G,,,
13775,62-1-0-10-E,7704-91-8292-0001,MINERALS,0,AC,0,0,0,100,0,100,0,0,0,1962300,0,1962300,M2,INDUS/G,,,
13776,22-1-0-1-A2,6769-58-0305,SNGL FAM SUB,4.55,AC,115400,0,115400,407800,0,523200,104800,0,104800,343900,0,448700,A2,AG/LTD,,,
13777,1-1-0-1-C,6805-82-2383,Cemetery,0,AC,100,0,100,0,0,100,100,0,100,0,0,100,A1,AG/GEN,,,
13778,1-6-0-1-0,6815-01-2474,SNGL FAM SUB,7.037,AC,75000,0,75000,170500,51700,297200,73300,0,73300,147200,44300,264800,RR,RES/RUR,,,
13779,1-6-0-2-0,6815-01-8636,SNGL FAM SUB,7,AC,74800,0,74800,182400,2600,259800,73200,0,73200,152900,2400,228500,RR,RES/RUR,,,
13780,1-6-0-3-0,6805-91-5917,SNGL FAM SUB,7.48,AC,77400,0,77400,140700,1500,219600,75700,0,75700,120700,1500,197900,RR,RES/RUR,,,
13781,1-6-0-4-0,6805-92-8183,SNGL FAM SUB,7,AC,74800,0,74800,159300,0,234100,73200,0,73200,142700,0,215900,RR,RES/RUR,,,
13782,1-6-0-5-0,6815-02-1326,SNGL FAM SUB,7,AC,74800,0,74800,228600,27000,330400,73200,0,73200,201100,24200,298500,RR,RES/RUR,,,
13783,1-6-0-6-0,6815-02-3473,SNGL FAM SUB,7,AC,74800,0,74800,228300,10900,314000,73200,0,73200,194000,12000,279200,RR,RES/RUR,,,
13784,1-6-0-7-0,6815-02-7349,SNGL FAM SUB,7,AC,74800,0,74800,319600,58800,453200,73200,0,73200,274700,53200,401100,RR,RES/RUR,,,
13785,1-6-0-8-0,6815-02-8804,SNGL FAM SUB,7,AC,74800,0,74800,178400,22400,275600,73200,0,73200,159100,18400,250700,RR,RES/RUR,,,
13786,1-6-0-9-0,6815-12-3673,SNGL FAM SUB,7.01,AC,67300,0,67300,222500,500,290300,65900,0,65900,192900,500,259300,RR,RES/RUR,,,
13787,1-6-0-10-0,6815-12-5271,SNGL FAM SUB,7.126,AC,75500,0,75500,0,0,75500,73800,0,73800,0,0,73800,RR,RES/RUR,,,
13788,1-6-0-11-0,6815-11-7920,SNGL FAM SUB,8.739,AC,84100,0,84100,270200,9700,364000,82200,0,82200,236300,6700,325200,RR,RES/RUR,,,
13789,1-6-0-12-0,6805-92-3449,SNGL FAM SUB,7,AC,74800,0,74800,413000,19200,507000,73200,0,73200,349100,2500,424800,RR,RES/RUR,,,
13790,3-1-0-11-A,5892-79-6514,AG 20-100 AC,27.301,AC,103100,51700,51400,54800,5000,162900,98800,54600,44200,49000,3900,151700,A1,AG/GEN,,,
13791,3-1-0-11-B,5893-80-7039,SNGL FAM SUB,14.919,AC,81700,0,81700,193700,9000,284400,86700,0,86700,167700,9000,263400,A1,AG/GEN,,,
13792,4-1-0-69-A1,6813-40-0956,SNGL FAM SUB,0.248,AC,1100,0,1100,0,0,1100,1100,0,1100,0,0,1100,A1,AG/GEN,,,
13793,5-1-0-21-A1,6822-09-4287,SNGL FAM SUB,2.038,AC,45000,0,45000,0,0,45000,44200,0,44200,0,0,44200,A1,AG/GEN,,,
13795,5-1-0-24-A,6812-99-5188,SNGL FAM SUB,2.74,AC,48600,0,48600,421600,1000,471200,47700,0,47700,360700,1000,409400,A1,AG/GEN,,,
13796,9-1-0-35-E,5892-52-9612,SNGL FAM SUB,5.44,AC,54800,0,54800,0,0,54800,53500,0,53500,0,0,53500,A1,AG/GEN,,,
13797,5-1-0-37-A,6823-07-3625,SNGL FAM SUB,2.7,AC,48400,0,48400,0,0,48400,47500,0,47500,0,0,47500,A1,AG/GEN,,,
13798,9-1-0-35-F,5892-62-1800,SNGL FAM SUB,3.06,AC,46200,0,46200,9200,0,55400,45200,0,45200,9100,0,54300,A1,AG/GEN,,,
13799,5-1-0-79-C,6823-64-1544,SNGL FAM SUB,2.4,AC,46800,0,46800,6500,7500,60800,46000,0,46000,6500,6500,59000,A1,AG/GEN,,,
13800,12-1-0-71-C,6831-43-1278,SNGL FAM SUB,2.65,AC,58000,0,58000,142300,1500,201800,55800,0,55800,118900,1500,176200,A1,AG/GEN,,,
13801,9-1-0-63-A,5891-69-2098,Cemetery,0,AC,100,0,100,0,0,100,100,0,100,0,0,100,A1,AG/GEN,,,
13803,10-1-0-25-A2,6801-95-3406,SNGL FAM SUB,18.755,AC,96100,43000,53100,557200,27400,680700,93900,0,93900,489200,26300,609400,A1,AG/GEN,,,
13804,10-1-0-29-F,6812-25-9072,SNGL FAM SUB,3,AC,48000,0,48000,153900,400,202300,47000,0,47000,136100,400,183500,A1,AG/GEN,,,
13805,12-2-0-3-B,6821-94-6158,SNGL FAM SUB,2,AC,47600,0,47600,91000,1500,140100,47300,0,47300,75300,1500,124100,A1,AG/GEN,,,
13806,12-2-0-3-C,6821-94-6276,Cemetery,0,AC,100,0,100,0,0,100,100,0,100,0,0,100,A1,AG/GEN,,,
13807,12-3-0-1-A1,6832-11-4853,SNGL FAM SUB,2.5,AC,52500,0,52500,180000,2700,235200,51000,0,51000,170500,2900,224400,A1,AG/GEN,,,
13808,12-3-0-1-A2,6832-11-0867,SNGL FAM SUB,3.38,AC,59700,0,59700,352500,0,412200,58000,0,58000,305900,0,363900,A1,AG/GEN,,,
13809,13-1-0-20-E1,6841-55-7619,SNGL FAM SUB,3.27,AC,69600,0,69600,206900,1500,278000,68300,0,68300,187000,1500,256800,A1,AG/GEN,,,
13810,13-1-0-20-E2,6841-65-0592,SNGL FAM SUB,2.62,AC,63200,0,63200,89400,500,153100,57900,0,57900,76100,500,134500,A1,AG/GEN,,,
13811,13-1-0-20-E3,6841-65-5362,SNGL FAM URB,0.0042,AC,100,0,100,0,0,100,100,0,100,0,0,100,A1,AG/GEN,,,
13812,13-1-0-25-A1,6841-78-9418,SNGL FAM SUB,2,AC,53600,0,53600,119900,1700,175200,52500,0,52500,101200,1700,155400,A1,AG/GEN,,,
13813,13-1-0-52-A,6841-18-9639,SNGL FAM SUB,5.935,AC,85600,0,85600,222800,7400,315800,83900,0,83900,193400,7400,284700,A1,AG/GEN,,,
13814,13-1-0-52-B,6841-19-2032,SNGL FAM SUB,6.397,AC,89200,0,89200,0,0,89200,87400,0,87400,0,0,87400,A1,AG/GEN,,,
13815,13-1-0-52-C,6841-09-8147,SNGL FAM SUB,5.479,AC,84700,0,84700,315000,47900,447600,80600,0,80600,210100,34800,325500,A1,AG/GEN,,,
13816,13-1-0-52-D,6841-09-5320,SNGL FAM SUB,4.791,AC,79500,0,79500,275700,39200,394400,75500,0,75500,246500,42700,364700,A1,AG/GEN,,,
13817,17-1-0-19-C,6709-68-7887,SNGL FAM SUB,6.11,AC,67400,0,67400,227600,18200,313200,66100,0,66100,197500,16100,279700,A1,AG/GEN,,,
13818,17-1-0-27-A,6709-49-7736,SNGL FAM SUB,2,AC,44400,0,44400,0,0,44400,43500,0,43500,0,0,43500,A1,AG/GEN,,,
13819,17-1-0-27-B,6709-59-2812,SNGL FAM SUB,4.59,AC,58900,0,58900,0,0,58900,57700,0,57700,0,0,57700,A1,AG/GEN,,,
13820,17-1-0-27-C,6800-50-9342,AG 20-100 AC,29.26,AC,104500,0,104500,0,0,104500,102400,0,102400,0,0,102400,A1,AG/GEN,,,
13821,17-1-0-40-A,6801-81-4553,SNGL FAM SUB,7.32,AC,67900,0,67900,0,0,67900,69600,0,69600,0,0,69600,A1,AG/GEN,,,
13822,17-11-0-A-0,6810-14-8192,AG 20-100 AC,24.69,AC,113200,0,113200,318800,5400,437400,109100,0,109100,261500,5900,376500,A1,AG/GEN,,,
13823,17-11-0-1-0,6810-13-2760,SNGL FAM SUB,5.35,AC,65300,0,65300,306000,34400,405700,61900,0,61900,249500,28900,340300,A1,AG/GEN,,,
13824,17-11-0-2-0,6810-13-7551,SNGL FAM SUB,3.26,AC,53500,0,53500,260800,5500,319800,50400,0,50400,215300,5900,271600,A1,AG/GEN,,,
13825,17-11-0-3-0,6810-23-1456,SNGL FAM SUB,3.17,AC,53000,0,53000,311300,6700,371000,49900,0,49900,235900,1700,287500,A1,AG/GEN,,,
13826,17-11-0-4-0,6810-23-4682,SNGL FAM SUB,3.447,AC,54600,0,54600,258500,5000,318100,51500,0,51500,211500,4300,267300,A1,AG/GEN,,,
13827,17-11-0-5-0,6810-23-8659,SNGL FAM SUB,4.47,AC,60400,0,60400,295200,1100,356700,57100,0,57100,242500,1100,300700,A1,AG/GEN,,,
13828,17-11-0-6-0,6810-24-9074,SNGL FAM SUB,4.47,AC,60400,0,60400,345000,0,405400,57100,0,57100,282100,0,339200,A1,AG/GEN,,,
13830,19-1-0-6-A,6831-01-1269,SNGL FAM SUB,2.07,AC,48100,0,48100,116200,3000,167300,47800,0,47800,90600,3000,141400,A1,AG/GEN,,,
13831,19-1-0-8-D,6831-00-2233,SNGL FAM SUB,2.501,AC,50900,0,50900,143500,1800,196200,51200,0,51200,118100,1800,171100,A1,AG/GEN,,,
13832,19-1-0-36-G,6831-00-6352,SNGL FAM SUB,2.25,AC,49300,0,49300,66600,600,116500,49300,0,49300,53600,600,103500,A1,AG/GEN,,,
13833,19-4-0-C-4,6830-37-6442,SNGL FAM SUB,2.23,AC,66000,0,66000,294100,7100,367200,60100,0,60100,235400,6800,302300,A1,AG/GEN,,,
13839,21-9-0-B-0,6850-40-6400,Cmn Area/Open Spc,1.59,AC,0,0,0,0,0,0,0,0,0,0,0,0,RR,RES/RUR,,,
13840,21-9-0-C-0,6850-50-9486,Cmn Area/Open Spc,2.67,AC,0,0,0,0,0,0,0,0,0,0,0,0,RR,RES/RUR,,,
13841,21-9-0-D-0,6850-50-8074,Cmn Area/Open Spc,1.77,AC,0,0,0,0,0,0,0,0,0,0,0,0,RR,RES/RUR,,,
13842,21-9-0-E-0,6759-99-3177,Cmn Area/Open Spc,11.75,AC,0,0,0,0,0,0,0,0,0,0,0,0,RR,RES/RUR,,,
13843,21-9-0-F-0,6850-80-9071,Cmn Area/Open Spc,13.64,AC,0,0,0,0,0,0,0,0,0,0,0,0,RR,RES/RUR,,,
13988,45-21-0-5-A,6797-99-5242,SNGL FAM SUB,2.343,AC,78900,0,78900,197400,500,276800,70500,0,70500,161500,500,232500,A2,AG/LTD,,,
13989,45-21-0-7-A,6797-89-6053,SNGL FAM SUB,2.343,AC,88600,0,88600,257900,11500,358000,79100,0,79100,210500,10300,299900,A2,AG/LTD,,,
13991,55-24-0-1-0,6785-27-8307,SNGL FAM SUB,5.32,AC,133700,0,133700,0,0,133700,119500,0,119500,0,0,119500,A2,AG/LTD,,,
13992,55-24-0-2-0,6785-27-9782,SNGL FAM SUB,4.9,AC,128200,0,128200,336900,0,465100,114500,0,114500,276100,0,390600,A2,AG/LTD,,,
13993,55-24-0-3-0,6785-37-4578,SNGL FAM SUB,4.84,AC,127400,0,127400,574000,0,701400,113800,0,113800,488800,0,602600,A2,AG/LTD,,,
14161,58-30-0-4-0,7716-76-2530,AG 20-100 AC,20.001,AC,528700,344100,184600,636400,98600,1263700,459900,299600,160300,535800,101500,1097200,A2,AG/LTD,,,
14162,58-30-0-5-0,7716-75-3647,AG 20-100 AC,20.007,AC,528800,344200,184600,951600,44000,1524400,460000,299700,160300,802200,45100,1307300,A2,AG/LTD,,,
14163,58-30-0-6-0,7716-74-6669,SNGL FAM SUB,8.243,AC,225300,0,225300,0,800,226100,196100,0,196100,0,800,196900,A2,AG/LTD,,,
14164,58-30-0-7-0,7716-74-5168,SNGL FAM SUB,13.155,AC,350800,0,350800,387800,23400,762000,305300,0,305300,327300,23200,655800,A2,AG/LTD,,,
14165,58-30-0-8-0,7716-64-9334,AG 20-100 AC,23.278,AC,468800,0,468800,266300,800,735900,407900,0,407900,231400,800,640100,A2,AG/LTD,,,
14166,58-30-0-9-0,7716-65-6421,SNGL FAM SUB,10.44,AC,366300,0,366300,775100,3100,1144500,318600,0,318600,644300,12600,975500,A2,AG/LTD,,,
14167,58-30-0-10-0,7716-66-4124,SNGL FAM SUB,8.337,AC,319400,0,319400,610800,57100,987300,277800,0,277800,536700,50000,864500,A2,AG/LTD,,,
14168,58-30-0-11-0,7716-66-4876,SNGL FAM SUB,9.428,AC,343700,0,343700,1075200,0,1418900,299000,0,299000,920800,0,1219800,A2,AG/LTD,,,
14169,58-30-0-11-A,7716-67-6000,Cemetery,0,AC,100,0,100,0,0,100,100,0,100,0,0,100,A2,AG/LTD,,,
14171,63-1-0-108-A,7715-31-5958,SNGL FAM SUB,2,AC,141400,0,141400,254900,2000,398300,123000,0,123000,224800,2000,349800,A2,AG/LTD,,,
14319,46-20-0-A-1,7706-28-8060,SNGL FAM SUB,8.726,AC,4300,0,4300,0,0,4300,3800,0,3800,0,0,3800,A2,AG/LTD,,,
14320,47-1-0-43-P3,7726-08-3863,COMM & IND,0.442,AC,184800,0,184800,279500,4500,468800,168000,0,168000,265700,4500,438200,B1,BUS/GEN,,,
14321,54-1-0-1-A,6766-65-6643,SNGL FAM SUB,8.23,AC,156900,83100,73800,209700,9100,375700,140000,74300,65700,175500,9300,324800,A2,AG/LTD,,,
14322,1-1-0-37-0,6814-43-9494,SNGL FAM SUB,5.008,AC,60100,0,60100,104000,400,164500,59000,0,59000,85400,400,144800,A1,AG/GEN,,,
14323,2-1-0-4-D,6814-65-7048,COMM & IND,2.857,AC,134900,0,134900,0,0,134900,130900,0,130900,0,0,130900,B1,BUS/GEN,,,
14326,2-2-0-2-B,6814-54-2173,SNGL FAM SUB,0.79,AC,4000,0,4000,0,0,4000,4000,0,4000,0,0,4000,A1,AG/GEN,,,
14328,5-1-0-3-F,6814-60-7117,Cemetery,0,AC,100,0,100,0,0,100,100,0,100,0,0,100,A1,AG/GEN,,,
14329,5-1-0-36-F,6813-97-8395,Cemetery,0,AC,100,0,100,0,0,100,100,0,100,0,0,100,A1,AG/GEN,,,
14331,9-1-0-20-A,5892-63-4717,SNGL FAM SUB,1.939,AC,42200,0,42200,57300,2700,102200,41300,0,41300,50100,2900,94300,A1,AG/GEN,,,
14332,10-1-0-22-C,6801-82-3531,SNGL FAM SUB,10.72,AC,62500,57600,4900,0,0,62500,62500,57900,4600,0,0,62500,A1,AG/GEN,,,
14335,62-32-0-8-0,7704-66-0615,SNGL FAM SUB,3.48,AC,275000,0,275000,480800,46700,802500,250000,0,250000,477000,38700,765700,R1,RES/LTD,,,
14336,62-32-0-22-0,7704-89-0146,SNGL FAM SUB,3.83,AC,288800,0,288800,791200,0,1080000,262500,0,262500,794000,0,1056500,R1,RES/LTD,,,
14337,63-1-0-24-A,7714-45-2189,Cemetery,0,AC,100,0,100,0,0,100,100,0,100,0,0,100,R3,RES/GEN,,,
14338,64-20-0-4-T,7724-66-5442-9999,COMM & IND,227,AC,21062200,0,21062200,0,674900,21737100,20504000,0,20504000,0,526200,21030200,M1,INDUS/L,,,
14339,64-20-0-5-0,7724-74-0040,COMM & IND,3.625,AC,10300,0,10300,0,0,10300,10300,0,10300,0,0,10300,M1,INDUS/L,,,
14342,64-20-0-6-0,7724-63-3920,COMM & IND,53.19,AC,7649400,0,7649400,0,0,7649400,7285400,0,7285400,0,0,7285400,M1,INDUS/L,,,
14345,10-1-0-17-B,6801-43-5175,SNGL FAM SUB,4,AC,52600,0,52600,68900,300,121800,51500,0,51500,68800,300,120600,A1,AG/GEN,,,
14346,13-1-0-12-A,6842-50-7058,SNGL FAM SUB,2.32,AC,56300,0,56300,135500,1000,192800,55200,0,55200,118100,1000,174300,A1,AG/GEN,,,
14347,20-18-0-5-0,6840-22-9170,SNGL FAM SUB,3.6,AC,78700,0,78700,332500,18100,429300,76900,0,76900,273800,16100,366800,A1,AG/GEN,,,
14348,29-8-0-1-C,6749-97-3135,SNGL FAM SUB,2.96,AC,73200,0,73200,352600,2300,428100,69300,0,69300,306200,0,375500,A1,AG/GEN,,,
13844,21-9-0-1-0,6850-81-2674,SNGL FAM SUB,3.7,AC,100000,0,100000,258900,0,358900,90000,0,90000,236200,0,326200,RR,RES/RUR,,,
13845,21-9-0-2-0,6850-71-9661,SNGL FAM SUB,3.05,AC,100000,0,100000,255200,62600,417800,90000,0,90000,230100,55300,375400,RR,RES/RUR,,,
13846,21-9-0-3-0,6850-71-6775,SNGL FAM SUB,3.05,AC,100000,0,100000,206500,3200,309700,90000,0,90000,188500,2200,280700,RR,RES/RUR,,,
13847,21-9-0-4-0,6850-71-1626,SNGL FAM SUB,4.12,AC,100000,0,100000,247300,0,347300,90000,0,90000,224700,0,314700,RR,RES/RUR,,,
13848,21-9-0-5-0,6850-71-2482,SNGL FAM SUB,3.33,AC,100000,0,100000,247800,4100,351900,90000,0,90000,225500,4400,319900,RR,RES/RUR,,,
13849,21-9-0-6-0,6850-71-5244,SNGL FAM SUB,3.05,AC,100000,0,100000,283300,800,384100,90000,0,90000,255600,800,346400,RR,RES/RUR,,,
13850,21-9-0-7-0,6850-70-2942,SNGL FAM SUB,3.25,AC,100000,0,100000,271300,5000,376300,90000,0,90000,247900,3200,341100,RR,RES/RUR,,,
13851,21-9-0-8-0,6850-71-0112,SNGL FAM SUB,3.05,AC,100000,0,100000,325900,46600,472500,90000,0,90000,297000,39400,426400,RR,RES/RUR,,,
13852,21-9-0-9-0,6850-61-7382,SNGL FAM SUB,3.05,AC,100000,0,100000,295500,0,395500,90000,0,90000,267600,0,357600,RR,RES/RUR,,,
13853,21-9-0-10-0,6850-61-5520,SNGL FAM SUB,3.47,AC,100000,0,100000,310600,3300,413900,90000,0,90000,281200,3600,374800,RR,RES/RUR,,,
13854,21-9-0-11-0,6850-61-1489,SNGL FAM SUB,3.4,AC,100000,0,100000,335000,14100,449100,90000,0,90000,301500,14100,405600,RR,RES/RUR,,,
13855,21-9-0-12-0,6850-51-9325,SNGL FAM SUB,3.07,AC,100000,0,100000,247100,1200,348300,90000,0,90000,221800,1300,313100,RR,RES/RUR,,,
13856,21-9-0-13-0,6850-50-8957,SNGL FAM SUB,3.44,AC,100000,0,100000,281000,6500,387500,90000,0,90000,254400,6100,350500,RR,RES/RUR,,,
13857,21-9-0-14-0,6850-50-9700,SNGL FAM SUB,4.12,AC,115000,0,115000,289300,0,404300,103500,0,103500,264800,0,368300,RR,RES/RUR,,,
13858,21-9-0-15-0,6850-60-3966,SNGL FAM SUB,3.23,AC,107000,0,107000,300600,22700,430300,96300,0,96300,272000,22000,390300,RR,RES/RUR,,,
13859,21-9-0-16-0,6850-60-5748,SNGL FAM SUB,4.12,AC,105000,0,105000,270000,1600,376600,94500,0,94500,246700,1700,342900,RR,RES/RUR,,,
13860,21-9-0-17-0,6850-60-3431,SNGL FAM SUB,3.06,AC,107000,0,107000,256700,0,363700,96300,0,96300,231800,0,328100,RR,RES/RUR,,,
13861,21-9-0-18-0,6850-60-6494,SNGL FAM SUB,4.42,AC,100000,0,100000,243000,40500,383500,90000,0,90000,219300,40700,350000,RR,RES/RUR,,,
13862,21-9-0-19-0,6850-60-9421,SNGL FAM SUB,3.59,AC,100000,0,100000,204000,39400,343400,90000,0,90000,187300,38600,315900,RR,RES/RUR,,,
13863,21-9-0-20-0,6759-69-9912,SNGL FAM SUB,3.09,AC,100000,0,100000,243200,2500,345700,90000,0,90000,222200,2500,314700,RR,RES/RUR,,,
13864,21-9-0-21-0,6759-69-6900,SNGL FAM SUB,3.02,AC,100000,0,100000,284700,43100,427800,90000,0,90000,257600,40800,388400,RR,RES/RUR,,,
13865,21-9-0-22-0,6850-60-1160,SNGL FAM SUB,3.03,AC,107000,0,107000,263100,100,370200,96300,0,96300,241300,100,337700,RR,RES/RUR,,,
13866,21-9-0-23-0,6759-69-1830,SNGL FAM SUB,3.19,AC,100000,0,100000,286400,1500,387900,90000,0,90000,257800,1500,349300,RR,RES/RUR,,,
13867,21-9-0-24-0,6850-50-5260,SNGL FAM SUB,3.55,AC,102000,0,102000,308800,1200,412000,91800,0,91800,283500,1300,376600,RR,RES/RUR,,,
13868,21-9-0-25-0,6850-50-1105,SNGL FAM SUB,3.99,AC,100000,0,100000,370600,0,470600,90000,0,90000,336400,0,426400,RR,RES/RUR,,,
13869,21-9-0-26-0,6759-59-4739,SNGL FAM SUB,3.84,AC,100000,0,100000,329300,0,429300,90000,0,90000,298600,0,388600,RR,RES/RUR,,,
13870,21-9-0-27-0,6759-59-5470,SNGL FAM SUB,4.6,AC,100000,0,100000,389900,0,489900,90000,0,90000,356800,0,446800,RR,RES/RUR,,,
13871,21-9-0-28-0,6759-59-8396,SNGL FAM SUB,3.39,AC,100000,0,100000,233200,16100,349300,90000,0,90000,210800,14800,315600,RR,RES/RUR,,,
13872,21-9-0-29-0,6759-69-2410,SNGL FAM SUB,3.11,AC,100000,0,100000,353300,0,453300,90000,0,90000,320900,0,410900,RR,RES/RUR,,,
13873,21-9-0-30-0,6759-69-6452,SNGL FAM SUB,6.18,AC,105000,0,105000,297100,6100,408200,95000,0,95000,260000,6200,361200,RR,RES/RUR,,,
13874,21-9-0-31-0,6759-79-2426,SNGL FAM SUB,6.71,AC,105000,0,105000,458900,48200,612100,95000,0,95000,414500,45400,554900,RR,RES/RUR,,,
13875,21-9-0-32-0,6759-79-7420,SNGL FAM SUB,3.12,AC,100000,0,100000,352100,42700,494800,90000,0,90000,319800,40500,450300,RR,RES/RUR,,,
13876,21-9-0-33-0,6759-89-0200,SNGL FAM SUB,3.11,AC,100000,0,100000,349600,23800,473400,90000,0,90000,314100,23700,427800,RR,RES/RUR,,,
13877,21-9-0-34-0,6759-78-9971,SNGL FAM SUB,3.2,AC,100000,0,100000,268200,0,368200,90000,0,90000,243900,0,333900,RR,RES/RUR,,,
13878,21-9-0-35-0,6759-78-5988,SNGL FAM SUB,3.17,AC,100000,0,100000,300700,15800,416500,90000,0,90000,271300,12200,373500,RR,RES/RUR,,,
13879,21-9-0-36-0,6759-79-2054,SNGL FAM SUB,3.25,AC,100000,0,100000,255300,4800,360100,90000,0,90000,234200,1700,325900,RR,RES/RUR,,,
13880,21-9-0-37-0,6759-68-9950,SNGL FAM SUB,3.33,AC,100000,0,100000,271300,26300,397600,90000,0,90000,244500,21900,356400,RR,RES/RUR,,,
13881,21-9-0-38-0,6759-68-9573,SNGL FAM SUB,3.24,AC,100000,0,100000,252000,65600,417600,90000,0,90000,226900,35200,352100,RR,RES/RUR,,,
13882,21-9-0-39-0,6759-68-9292,SNGL FAM SUB,3.72,AC,100000,0,100000,213500,3500,317000,90000,0,90000,194000,3500,287500,RR,RES/RUR,,,
13883,21-9-0-40-0,6759-78-3238,SNGL FAM SUB,3.22,AC,100000,0,100000,285800,0,385800,90000,0,90000,259800,0,349800,RR,RES/RUR,,,
13884,21-9-0-41-0,6759-78-5377,SNGL FAM SUB,3.1,AC,100000,0,100000,245200,1000,346200,90000,0,90000,221300,1000,312300,RR,RES/RUR,,,
13885,21-9-0-42-0,6759-78-9548,SNGL FAM SUB,3.12,AC,100000,0,100000,270300,8500,378800,90000,0,90000,249500,8500,348000,RR,RES/RUR,,,
13886,21-9-0-43-0,6759-78-8279,SNGL FAM SUB,3.18,AC,100000,0,100000,271900,1700,373600,90000,0,90000,245600,1900,337500,RR,RES/RUR,,,
13887,21-9-0-44-0,6759-78-9034,SNGL FAM SUB,3.39,AC,100000,0,100000,273400,36000,409400,90000,0,90000,248600,34400,373000,RR,RES/RUR,,,
13888,21-9-0-45-0,6759-88-2070,SNGL FAM SUB,3.31,AC,100000,0,100000,211000,0,311000,90000,0,90000,194300,0,284300,RR,RES/RUR,,,
13889,21-9-0-46-0,6759-88-5122,SNGL FAM SUB,3.56,AC,100000,0,100000,331900,0,431900,90000,0,90000,301900,0,391900,RR,RES/RUR,,,
13890,21-9-0-47-0,6759-88-4541,SNGL FAM SUB,3.38,AC,100000,0,100000,272900,0,372900,90000,0,90000,247100,0,337100,RR,RES/RUR,,,
13891,21-9-0-48-0,6759-88-7086,SNGL FAM SUB,3.07,AC,100000,0,100000,350000,67000,517000,90000,0,90000,318400,35900,444300,RR,RES/RUR,,,
13892,21-9-0-49-0,6759-98-0092,SNGL FAM SUB,3.37,AC,100000,0,100000,434600,2700,537300,90000,0,90000,396600,2000,488600,RR,RES/RUR,,,
13893,21-9-0-50-0,6759-98-1370,SNGL FAM SUB,3.06,AC,100000,0,100000,215100,0,315100,90000,0,90000,196000,0,286000,RR,RES/RUR,,,
13894,21-9-0-51-0,6759-98-2534,SNGL FAM SUB,3.88,AC,100000,0,100000,0,0,100000,90000,0,90000,0,0,90000,RR,RES/RUR,,,
13895,21-9-0-52-0,6759-98-0755,SNGL FAM SUB,4.03,AC,100000,0,100000,331200,27600,458800,90000,0,90000,308600,25600,424200,RR,RES/RUR,,,
13896,21-9-0-53-0,6759-88-8986,SNGL FAM SUB,4.82,AC,100000,0,100000,284200,0,384200,90000,0,90000,259600,0,349600,RR,RES/RUR,,,
13897,21-9-0-54-0,6759-88-4950,SNGL FAM SUB,3.06,AC,100000,0,100000,289300,23300,412600,90000,0,90000,265200,23600,378800,RR,RES/RUR,,,
13898,21-9-0-55-0,6759-89-5137,SNGL FAM SUB,3.19,AC,100000,0,100000,352300,35600,487900,90000,0,90000,321400,30200,441600,RR,RES/RUR,,,
13899,21-9-0-56-0,6759-89-7408,SNGL FAM SUB,3.08,AC,130000,0,130000,321300,0,451300,117000,0,117000,293600,0,410600,RR,RES/RUR,,,
13900,21-9-0-57-0,6759-89-2575,SNGL FAM SUB,3.85,AC,115000,0,115000,310500,0,425500,103500,0,103500,289500,0,393000,RR,RES/RUR,,,
13901,21-9-0-58-0,6759-79-8851,SNGL FAM SUB,5.08,AC,105000,0,105000,246200,2100,353300,95000,0,95000,224700,2200,321900,RR,RES/RUR,,,
13902,21-9-0-59-0,6759-79-3944,SNGL FAM SUB,3.86,AC,100000,0,100000,314100,25900,440000,90000,0,90000,286300,21300,397600,RR,RES/RUR,,,
13903,21-9-0-60-0,6850-70-2352,SNGL FAM SUB,3,AC,100000,0,100000,280800,38200,419000,90000,0,90000,258600,34900,383500,RR,RES/RUR,,,
13904,21-9-0-61-0,6850-70-6231,SNGL FAM SUB,3,AC,100000,0,100000,270000,1600,371600,90000,0,90000,244200,1700,335900,RR,RES/RUR,,,
13905,21-9-0-62-0,6850-70-9196,SNGL FAM SUB,3,AC,100000,0,100000,212300,2500,314800,90000,0,90000,190100,2500,282600,RR,RES/RUR,,,
13906,21-9-0-63-0,6759-89-3909,SNGL FAM SUB,3.37,AC,115000,0,115000,296500,59900,471400,103500,0,103500,272900,50300,426700,RR,RES/RUR,,,
13907,21-9-0-64-0,6850-80-5156,SNGL FAM SUB,3.64,AC,120000,0,120000,275600,31500,427100,108000,0,108000,251800,27000,386800,RR,RES/RUR,,,
13908,21-9-0-65-0,6850-80-8303,SNGL FAM SUB,3.88,AC,140000,0,140000,548200,5500,693700,126000,0,126000,497300,3800,627100,RR,RES/RUR,,,
13909,21-9-0-66-0,6850-80-6671,SNGL FAM SUB,3.16,AC,118000,0,118000,283600,4200,405800,106200,0,106200,261100,4500,371800,RR,RES/RUR,,,
13910,21-9-0-67-0,6850-80-4744,SNGL FAM SUB,3.47,AC,102000,0,102000,268700,47100,417800,91800,0,91800,244600,45500,381900,RR,RES/RUR,,,
13911,21-9-0-68-0,6850-80-0674,SNGL FAM SUB,3.01,AC,100000,0,100000,252500,5700,358200,90000,0,90000,196100,1700,287800,RR,RES/RUR,,,
13912,21-9-0-69-0,6850-70-7684,SNGL FAM SUB,3.01,AC,100000,0,100000,230000,49000,379000,90000,0,90000,209900,46200,346100,RR,RES/RUR,,,
13913,21-9-0-70-0,6850-70-5710,SNGL FAM SUB,3,AC,100000,0,100000,280100,800,380900,90000,0,90000,264300,800,355100,RR,RES/RUR,,,
13914,21-9-0-71-0,6850-71-8048,SNGL FAM SUB,3.01,AC,100000,0,100000,359200,35900,495100,90000,0,90000,327700,30600,448300,RR,RES/RUR,,,
13915,21-9-0-72-0,6850-81-1143,SNGL FAM SUB,3.01,AC,100000,0,100000,0,0,100000,90000,0,90000,0,0,90000,RR,RES/RUR,,,
13916,21-9-0-73-0,6850-81-4039,SNGL FAM SUB,3.62,AC,100000,0,100000,341900,1600,443500,90000,0,90000,310700,1700,402400,RR,RES/RUR,,,
13917,21-9-0-74-0,6850-81-8280,SNGL FAM SUB,6.3,AC,115500,0,115500,342000,15000,472500,104500,0,104500,313700,15000,433200,RR,RES/RUR,,,
13918,21-9-0-75-0,6850-91-2077,SNGL FAM SUB,4.93,AC,117600,0,117600,323100,0,440700,106400,0,106400,293400,0,399800,RR,RES/RUR,,,
13919,21-9-0-76-0,6850-90-4714,SNGL FAM SUB,4.96,AC,123900,0,123900,302700,800,427400,112100,0,112100,277100,800,390000,RR,RES/RUR,,,
13920,21-9-0-77-0,6850-90-5402,SNGL FAM SUB,4.96,AC,123900,0,123900,382900,2300,509100,112100,0,112100,360300,2500,474900,RR,RES/RUR,,,
13921,21-9-0-78-0,6759-99-4955,SNGL FAM SUB,4.79,AC,131300,0,131300,271700,0,403000,118800,0,118800,247300,0,366100,RR,RES/RUR,,,
13922,21-9-0-79-0,6759-99-8321,SNGL FAM SUB,6.28,AC,105000,0,105000,519200,31200,655400,95000,0,95000,480400,29200,604600,RR,RES/RUR,,,
13923,21-9-0-80-0,6759-99-9753,SNGL FAM SUB,5.05,AC,105000,0,105000,292500,33500,431000,95000,0,95000,267400,31600,394000,RR,RES/RUR,,,
13924,21-9-0-81-0,6860-00-0061,SNGL FAM SUB,5.03,AC,105000,0,105000,389000,40300,534300,95000,0,95000,354100,34300,483400,RR,RES/RUR,,,
13925,21-9-0-82-0,6860-00-0452,SNGL FAM SUB,5.99,AC,105000,0,105000,468100,118400,691500,95000,0,95000,423400,102800,621200,RR,RES/RUR,,,
13926,21-9-0-83-0,6860-00-4352,SNGL FAM SUB,5.03,AC,105000,0,105000,336300,0,441300,95000,0,95000,303600,0,398600,RR,RES/RUR,,,
13927,21-9-0-84-0,6860-00-5639,SNGL FAM SUB,5.04,AC,105000,0,105000,284200,4300,393500,95000,0,95000,258800,4400,358200,RR,RES/RUR,,,
13928,21-9-0-85-0,6860-01-1010,SNGL FAM SUB,4.57,AC,100000,0,100000,259500,48000,407500,90000,0,90000,235700,40500,366200,RR,RES/RUR,,,
13929,21-9-0-86-0,6850-91-8352,SNGL FAM SUB,0.43,AC,4100,0,4100,0,0,4100,4100,0,4100,0,0,4100,RR,RES/RUR,,,
13930,21-9-0-87-0,6850-91-4666,SNGL FAM SUB,0.16,AC,1500,0,1500,0,0,1500,1500,0,1500,0,0,1500,RR,RES/RUR,,,
13931,21-9-0-89-0,6850-82-7009,SNGL FAM SUB,0.86,AC,8100,0,8100,0,0,8100,8100,0,8100,0,0,8100,RR,RES/RUR,,,
13932,21-9-0-90-0,6850-81-6646,SNGL FAM SUB,5.14,AC,105000,0,105000,387100,0,492100,95000,0,95000,350500,0,445500,RR,RES/RUR,,,
13934,26-1-0-57-D,6719-22-0246,SNGL FAM SUB,2.77,AC,50600,49200,1400,0,0,50600,47700,46500,1200,0,0,47700,A1,AG/GEN,,,
13935,26-2-0-1-B,6708-39-5291,SNGL FAM SUB,4.182,AC,2100,0,2100,0,0,2100,1800,0,1800,0,0,1800,A1,AG/GEN,,,
13936,26-9-0-C-1,6719-23-5852,SNGL FAM SUB,6.42,AC,70900,0,70900,0,0,70900,67800,0,67800,0,0,67800,A1,AG/GEN,,,
13937,28-1-0-87-H,6739-24-5322,SNGL FAM SUB,6,AC,80400,0,80400,199700,4700,284800,78700,0,78700,164700,4500,247900,A1,AG/GEN,,,
13938,29-1-0-75-B,6749-45-3187,SNGL FAM SUB,5,AC,77100,0,77100,0,0,77100,75900,0,75900,0,0,75900,A1,AG/GEN,,,
13939,29-1-0-75-C,6749-34-7948,SNGL FAM SUB,18.28,AC,151100,0,151100,0,0,151100,149300,0,149300,0,0,149300,A1,AG/GEN,,,
13940,30-1-0-77-A,6758-64-7544,AG > 100 AC,152.85,AC,1429500,1358400,71100,0,0,1429500,1326400,1261400,65000,0,0,1326400,A2,AG/LTD,,,
13942,31-1-0-22-A,6768-66-7909,SNGL FAM SUB,2.3,AC,64800,0,64800,59100,1000,124900,57600,0,57600,49200,1000,107800,A2,AG/LTD,,,
13943,31-1-0-22-B,6768-66-7641,SNGL FAM SUB,4.84,AC,94200,0,94200,273800,30000,398000,84000,0,84000,231000,27000,342000,A2,AG/LTD,,,
13944,31-1-0-22-C,6768-66-6086,SNGL FAM SUB,2.32,AC,65100,0,65100,293600,1200,359900,57800,0,57800,242500,1100,301400,A2,AG/LTD,,,
13945,31-1-0-22-C1,6768-66-7331,SNGL FAM SUB,2.52,AC,67500,0,67500,185600,21400,274500,59900,0,59900,153400,18100,231400,A2,AG/LTD,,,
13946,31-1-0-22-D,6768-65-6706,SNGL FAM SUB,4.84,AC,94200,0,94200,175800,500,270500,82100,0,82100,144400,500,227000,A2,AG/LTD,,,
13947,31-1-0-24-B,6768-77-7180,SNGL FAM SUB,5,AC,101100,0,101100,337400,4100,442600,92700,0,92700,269700,2900,365300,A2,AG/LTD,,,
13948,31-1-0-97-A,6778-32-9704,SNGL FAM SUB,2.36,AC,83700,0,83700,441400,0,525100,74700,0,74700,370900,0,445600,A2,AG/LTD,,,
13949,31-1-0-97-B,6778-42-1510,SNGL FAM SUB,2.37,AC,83800,0,83800,0,0,83800,74900,0,74900,0,0,74900,A2,AG/LTD,,,
13950,31-12-0-5-A,6769-66-9622,SNGL FAM SUB,1.926,AC,72500,0,72500,279600,0,352100,65200,0,65200,225200,0,290400,A2,AG/LTD,,,
13951,31-12-0-6-B,6769-77-0030,SNGL FAM SUB,2,AC,73400,0,73400,175200,22000,270600,66000,0,66000,144300,18300,228600,A2,AG/LTD,,,
13952,32-1-0-14-A,6779-63-8153,SNGL FAM SUB,12.09,AC,176100,0,176100,0,0,176100,157000,0,157000,0,0,157000,A2,AG/LTD,,,
13954,20-1-0-92-H,6759-07-8882,SNGL FAM SUB,9.68,AC,130700,0,130700,355700,196200,682600,131500,0,131500,295500,175500,602500,A1,AG/GEN,,,
13955,21-1-0-53-B,6850-73-9476,SNGL FAM SUB,2.46,AC,71900,0,71900,197700,2000,271600,65100,0,65100,163100,2000,230200,A2,AG/LTD,,,
13956,47-6-0-2-C,7717-48-5893,SNGL FAM SUB,5.67,AC,178400,0,178400,246800,600,425800,159400,0,159400,212100,600,372100,A2,AG/LTD,,,
13958,57-1-0-41-C,7715-13-2964,SNGL FAM SUB,3.86,AC,265600,0,265600,566100,74700,906400,230900,0,230900,511100,69000,811000,A2,AG/LTD,,,
13959,43-1-0-74-A,6777-59-0329,SNGL FAM SUB,2.17,AC,86900,0,86900,197600,1500,286000,77700,0,77700,161000,1500,240200,A2,AG/LTD,,,
13960,9-1-0-35-D,5892-63-0237,SNGL FAM SUB,5.44,AC,54800,0,54800,0,0,54800,53500,0,53500,0,0,53500,A1,AG/GEN,,,
13961,4-1-0-54-A,6802-99-3266,SNGL FAM SUB,16.85,AC,120800,113000,7800,0,0,120800,117300,110100,7200,0,0,117300,A1,AG/GEN,,,
13962,17-1-0-15-A,6709-66-8399,AG 20-100 AC,25.527,AC,113400,70600,42800,319400,10400,443200,111600,63100,48500,283500,9200,404300,A1,AG/GEN,,,
13963,31-26-0-A-0,6779-15-5033,AG 20-100 AC,25.87,AC,347600,270800,76800,229700,118000,695300,310900,243000,67900,192300,105900,609100,A2,AG/LTD,,,
13964,31-26-0-B-0,6779-24-2363,SNGL FAM SUB,6.99,AC,136000,0,136000,0,0,136000,121300,0,121300,0,0,121300,A2,AG/LTD,,,
13965,31-26-0-C-0,6779-13-8785,SNGL FAM SUB,11.43,AC,189300,0,189300,851300,102500,1143100,168800,0,168800,708400,95800,973000,A2,AG/LTD,,,
13966,31-26-0-D-0,6779-13-1982,SNGL FAM SUB,19.82,AC,294600,285000,9600,0,231100,525700,245100,237300,7800,0,222500,467600,A2,AG/LTD,,,
13967,31-26-0-E-0,6779-04-2139,SNGL FAM SUB,17.92,AC,267100,258200,8900,0,3200,270300,238200,230500,7700,0,3200,241400,A2,AG/LTD,,,
13968,31-26-0-F-0,6779-04-6757,SNGL FAM SUB,14.9,AC,230900,223400,7500,0,3200,234100,205900,199500,6400,0,3200,209100,A2,AG/LTD,,,
13969,47-6-0-2-A,7717-48-8937,AG 20-100 AC,38.07,AC,590100,571200,18900,0,0,590100,525400,509100,16300,0,0,525400,A2,AG/LTD,,,
13970,47-6-0-2-B,7717-58-4506,AG 20-100 AC,48.57,AC,895100,698700,196400,298100,37200,1230400,797400,622700,174700,245600,31500,1074500,A2,AG/LTD,,,
13971,43-30-0-1-0,6767-74-7962,SNGL FAM SUB,10.32,AC,171800,0,171800,515200,20000,707000,156200,0,156200,468700,20000,644900,A2,AG/LTD,,,
13972,43-30-0-2-0,6767-75-4479,SNGL FAM SUB,7.85,AC,153500,0,153500,288600,0,442100,139500,0,139500,252500,0,392000,A2,AG/LTD,,,
13973,43-30-0-3-0,6767-85-0467,SNGL FAM SUB,4.45,AC,110000,0,110000,312700,8100,430800,100000,0,100000,275900,8700,384600,A2,AG/LTD,,,
13974,43-30-0-4-0,6767-85-2263,SNGL FAM SUB,2.33,AC,85800,0,85800,209600,20600,316000,78000,0,78000,182500,17900,278400,A2,AG/LTD,,,
13975,43-30-0-5-0,6767-85-4074,SNGL FAM SUB,2.13,AC,85800,0,85800,238800,2000,326600,78000,0,78000,210900,2000,290900,A2,AG/LTD,,,
13976,44-1-0-42-B,6787-56-3209,SNGL FAM SUB,15,AC,7100,0,7100,0,0,7100,6400,0,6400,0,0,6400,A2,AG/LTD,,,
13977,44-13-0-C-1,6787-63-7363,SNGL FAM SUB,2.43,AC,92700,0,92700,238800,0,331500,82800,0,82800,194700,0,277500,A2,AG/LTD,,,
13978,44-13-0-C-2,6787-63-8091,SNGL FAM SUB,2.07,AC,84900,0,84900,0,0,84900,75800,0,75800,0,0,75800,A2,AG/LTD,,,
13979,44-13-0-C-3,6787-62-6894,SNGL FAM SUB,2.07,AC,84900,0,84900,120400,3900,209200,75800,0,75800,99900,4200,179900,A2,AG/LTD,,,
13980,44-13-0-C-4,6787-62-4860,SNGL FAM SUB,2,AC,83900,0,83900,216600,36300,336800,74900,0,74900,178500,30900,284300,A2,AG/LTD,,,
13981,46-1-0-25-C,7707-14-5317,SNGL FAM SUB,2.85,AC,140100,0,140100,336600,4100,480800,125000,0,125000,291000,4100,420100,A2,AG/LTD,,,
13982,46-9-0-B-1B,7707-48-8374,SNGL FAM SUB,2.93,AC,118900,0,118900,319400,1000,439300,108200,0,108200,267400,1000,376600,A2,AG/LTD,,,
13983,45-1-0-50-B,6796-47-9642,SNGL FAM SUB,2.489,AC,122300,0,122300,839800,0,962100,106300,0,106300,744400,0,850700,A2,AG/LTD,,,
13984,47-1-0-25-A,7716-57-3833,SNGL FAM SUB,2,AC,121200,0,121200,162300,0,283500,108200,0,108200,135100,0,243300,A2,AG/LTD,,,
13985,47-1-0-41-A1,7716-88-8992,COMM & IND,0.762,AC,521600,0,521600,0,0,521600,474200,0,474200,0,0,474200,MPUD,MIXPUD,,,
13986,47-1-0-43-J1,7716-99-4367,COMM & IND,0.926,AC,261200,0,261200,0,0,261200,237400,0,237400,0,0,237400,B1,BUS/GEN,,,
13987,47-6-0-2-D,7718-40-6002,Cemetery,0,AC,100,0,100,0,0,100,100,0,100,0,0,100,A2,AG/LTD,,,
13994,55-24-0-4-0,6785-37-4168,SNGL FAM SUB,7.35,AC,160500,0,160500,311000,0,471500,143400,0,143400,269000,0,412400,A2,AG/LTD,,,
13995,55-24-0-A-0,6785-26-9952,Roads,1.47,AC,0,0,0,0,0,0,0,0,0,0,0,0,A2,AG/LTD,,,
13996,55-24-0-B-0,6785-26-7539,Cmn Area/Open Spc,1.9,AC,0,0,0,0,0,0,0,0,0,0,0,0,A2,AG/LTD,,,
13997,55-24-0-C-0,6785-26-9700,Cmn Area/Open Spc,0.96,AC,0,0,0,0,0,0,0,0,0,0,0,0,A2,AG/LTD,,,
13999,56-1-0-73-0,6796-94-7746,SNGL FAM SUB,8,AC,287600,0,287600,916800,25000,1229400,250400,0,250400,770400,25000,1045800,A2,AG/LTD,,,
14000,56-12-0-A-1,6796-32-4669,AG 20-100 AC,45.19,AC,957900,912900,45000,0,32500,990400,831400,792600,38800,0,32500,863900,A2,AG/LTD,,,
14001,51-12-0-5-A,6735-29-8646,SNGL FAM SUB,2.67,AC,49000,0,49000,0,0,49000,48000,0,48000,0,0,48000,A1,AG/GEN,,,
14002,57-1-0-41-D,7715-03-8577,SNGL FAM SUB,10.66,AC,478500,0,478500,907600,62100,1448200,415900,0,415900,764700,60200,1240800,A2,AG/LTD,,,
14003,57-9-0-3-B,7706-53-5567,SNGL FAM SUB,0.44,AC,12500,0,12500,0,0,12500,10800,0,10800,0,0,10800,A2,AG/LTD,,,
14004,57-20-F-2-0,7715-08-9747,SNGL FAM SUB,2.657,AC,300000,0,300000,566400,58900,925300,275000,0,275000,515900,50300,841200,A2,AG/LTD,,,
14005,57-20-F-3-0,7715-18-3762,SNGL FAM SUB,5,AC,383300,0,383300,0,0,383300,351800,0,351800,0,0,351800,A2,AG/LTD,,,
14008,57-29-0-51-0,7705-36-5161,AG 20-100 AC,24.875,AC,1116100,0,1116100,943500,83900,2143500,970400,0,970400,945200,73200,1988800,RR,RES/RUR,,,
14009,57-29-0-52-0,7705-26-6563,SNGL FAM SUB,19.592,AC,609700,0,609700,1276300,8900,1894900,530600,0,530600,1254500,7500,1792600,RR,RES/RUR,,,
14010,57-29-0-63-0,7705-17-3959,AG 20-100 AC,20.712,AC,683300,0,683300,871100,18400,1572800,594600,0,594600,906600,18400,1519600,RR,RES/RUR,,,
14011,57-29-0-64-0,7705-27-0571,SNGL FAM SUB,19.793,AC,660600,0,660600,1199600,176700,2036900,574900,0,574900,1178500,158300,1911700,RR,RES/RUR,,,
14012,57-29-0-65-0,7705-27-8413,SNGL FAM SUB,11.392,AC,468700,0,468700,1116500,0,1585200,407700,0,407700,1175700,0,1583400,RR,RES/RUR,,,
14013,57-29-0-66-0,7705-36-6979,SNGL FAM SUB,17.953,AC,882800,0,882800,1627700,71500,2582000,767600,0,767600,1678300,64700,2510600,RR,RES/RUR,,,
14014,57-29-0-67-0,7705-37-9479,SNGL FAM SUB,15.39,AC,472800,0,472800,714500,1500,1188800,548500,0,548500,1049000,1500,1599000,RR,RES/RUR,,,
14015,57-29-0-68-0,7705-38-5025,SNGL FAM SUB,14.001,AC,517500,0,517500,1036500,0,1554000,450300,0,450300,1081600,0,1531900,RR,RES/RUR,,,
14017,62-27-0-36-0,7704-09-6258,SNGL FAM SUB,18.065,AC,617900,0,617900,442900,38400,1099200,537700,0,537700,446200,33200,1017100,RR,RES/RUR,,,
14018,62-27-0-36-A,7704-08-5512,SNGL FAM SUB,12.965,AC,491900,0,491900,779600,24600,1296100,428000,0,428000,773800,21500,1223300,A2,AG/LTD,,,
14021,62-28-0-Q-0,7704-59-0183,AG 20-100 AC,20.633,AC,748000,0,748000,1100700,33300,1882000,647800,0,647800,1041100,27700,1716600,RR,RES/RUR,,,
14023,62-30-0-1-0,7704-56-0158,SNGL FAM SUB,10.52,AC,394300,0,394300,907100,27700,1329100,345300,0,345300,822900,26800,1195000,A2,AG/LTD,,,
14024,62-30-0-2-0,7704-55-4836,SNGL FAM SUB,10.51,AC,394100,0,394100,0,0,394100,345100,0,345100,0,0,345100,A2,AG/LTD,,,
14025,62-30-0-3-0,7704-45-8386,SNGL FAM SUB,10.51,AC,388600,0,388600,509500,65300,963400,339300,0,339300,453100,55600,848000,A2,AG/LTD,,,
14026,62-30-0-4-0,7704-44-6721,SNGL FAM SUB,10.51,AC,388600,0,388600,509900,0,898500,339300,0,339300,457100,0,796400,A2,AG/LTD,,,
14027,63-1-0-72-A,7714-43-3372,Cemetery,0,AC,100,0,100,0,0,100,100,0,100,0,0,100,A2,AG/LTD,,,
14028,63-1-0-160-A,7724-05-0294,SNGL FAM SUB,8.66,AC,321800,0,321800,0,0,321800,292500,0,292500,0,0,292500,A2,AG/LTD,,,
14029,63-6-0-B-1,7724-00-1363,SNGL FAM SUB,2.89,AC,217400,0,217400,700500,2800,920700,189000,0,189000,648500,1900,839400,R1,RES/LTD,,,
14030,4-7-0-1-0,6813-08-7815,SNGL FAM SUB,8.62,AC,83500,0,83500,146200,7500,237200,81600,0,81600,125000,7500,214100,A1,AG/GEN,,,
14031,4-7-0-2-0,6813-08-9498,SNGL FAM SUB,9,AC,82400,0,82400,13600,1000,97000,80600,0,80600,14600,1000,96200,A1,AG/GEN,,,
14032,4-7-0-3-0,6813-18-6272,AG 20-100 AC,20.7,AC,101700,0,101700,113600,20900,236200,99400,0,99400,90900,19500,209800,A1,AG/GEN,,,
14033,4-7-0-4-0,6813-27-7607,AG 20-100 AC,22.3,AC,106700,0,106700,84000,2000,192700,104300,0,104300,67400,2000,173700,A1,AG/GEN,,,
14034,4-7-0-5-0,6813-36-1594,AG 20-100 AC,22.8,AC,108300,53900,54400,11200,23000,142500,105800,53000,52800,10800,21300,137900,A1,AG/GEN,,,
14035,63-14-0-A-4,7714-74-9630,SNGL FAM SUB,5.483,AC,234500,0,234500,164800,69000,468300,213600,0,213600,154300,56200,424100,A2,AG/LTD,,,
14036,4-7-0-6-0,6813-35-8509,AG 20-100 AC,23.06,AC,109100,0,109100,0,0,109100,106600,0,106600,0,0,106600,A1,AG/GEN,,,
14037,4-7-0-7-0,6813-35-1233,AG 20-100 AC,21.53,AC,104300,0,104300,108700,0,213000,101900,0,101900,87500,0,189400,A1,AG/GEN,,,
14038,4-7-0-8-0,6813-15-9196,AG 20-100 AC,20.37,AC,100600,0,100600,78700,3900,183200,98400,0,98400,63800,2300,164500,A1,AG/GEN,,,
14039,4-7-0-9-0,6813-15-1214,SNGL FAM SUB,5.71,AC,67900,0,67900,10900,1500,80300,66400,0,66400,11100,1500,79000,A1,AG/GEN,,,
14040,4-7-0-10-0,6813-15-0657,SNGL FAM SUB,5.46,AC,66600,0,66600,12200,2400,81200,65100,0,65100,12900,2700,80700,A1,AG/GEN,,,
14041,4-7-0-11-0,6813-15-4882,SNGL FAM SUB,5.29,AC,60300,0,60300,57900,500,118700,59000,0,59000,54600,500,114100,A1,AG/GEN,,,
14042,4-7-0-12-0,6813-15-8934,SNGL FAM SUB,5.57,AC,61600,0,61600,11300,0,72900,60300,0,60300,11400,0,71700,A1,AG/GEN,,,
14043,4-7-0-13-0,6813-26-4110,AG 20-100 AC,20.64,AC,101500,0,101500,227200,0,328700,99200,0,99200,193500,0,292700,A1,AG/GEN,,,
14044,4-7-0-14-0,6813-26-1946,AG 20-100 AC,20.75,AC,101800,0,101800,98200,4500,204500,99500,0,99500,80300,4500,184300,A1,AG/GEN,,,
14045,4-7-0-15-0,6813-17-4371,AG 20-100 AC,20.49,AC,101000,0,101000,0,0,101000,98700,0,98700,0,0,98700,A1,AG/GEN,,,
14046,4-7-0-16-0,6813-07-6754,AG 20-100 AC,20.56,AC,101200,0,101200,84500,500,186200,98900,0,98900,67900,500,167300,A1,AG/GEN,,,
14047,4-7-0-17-0,6803-98-8148,SNGL FAM SUB,6.81,AC,73800,0,73800,141600,1500,216900,72200,0,72200,119900,1500,193600,A1,AG/GEN,,,
14048,4-7-0-18-0,6813-08-1553,SNGL FAM SUB,7.17,AC,75700,0,75700,122300,2300,200300,74000,0,74000,73400,800,148200,A1,AG/GEN,,,
14049,10-1-0-28-B,6812-31-8967,SNGL FAM SUB,2.003,AC,43400,4100,39300,0,121900,165300,42500,4100,38400,0,115600,158100,A1,AG/GEN,,,
14050,10-1-0-28-C,6812-21-5745,AG 20-100 AC,34,AC,146000,0,146000,305100,150100,601200,142000,0,142000,275400,150000,567400,A1,AG/GEN,,,
14052,22-1-0-1-A3,6769-68-3413,SNGL FAM SUB,6.92,AC,127900,0,127900,0,0,127900,119600,0,119600,0,0,119600,A2,AG/LTD,,,
14054,25-1-0-13-A,5799-23-0990,SNGL FAM SUB,16.504,AC,141000,0,141000,279900,24600,445500,137800,0,137800,255700,19300,412800,A1,AG/GEN,,,
14055,26-1-0-65-D,6719-15-8550,SNGL FAM SUB,5,AC,63500,0,63500,128300,0,191800,62000,0,62000,104600,0,166600,A1,AG/GEN,,,
14056,45-1-0-75-A,6797-60-9551,SNGL FAM SUB,5.18,AC,151700,0,151700,0,0,151700,135200,0,135200,0,0,135200,A2,AG/LTD,,,
14057,48-1-0-31-C,7727-40-2137,Cemetery,0,AC,100,0,100,0,0,100,100,0,100,0,0,100,A2,AG/LTD,,,
14058,55-1-0-9-A1,6786-10-7979,SNGL FAM SUB,12.873,AC,241100,144400,96700,233300,4300,478700,221300,134700,86600,189100,32600,443000,A2,AG/LTD,,,
14059,55-1-0-96-A,6785-55-1604,SNGL FAM SUB,2.935,AC,102000,0,102000,289500,0,391500,91000,0,91000,238100,0,329100,A2,AG/LTD,,,
14060,48-1-0-31-B,7727-40-2048,SNGL FAM SUB,5,AC,210000,0,210000,378200,6800,595000,187500,0,187500,317000,6200,510700,A2,AG/LTD,,,
14065,19-1-0-63-A,6830-50-2792,AG 20-100 AC,31.17,AC,218800,118400,100400,686400,183200,1088400,204200,111800,92400,601600,159500,965300,A1,AG/GEN,,,
14066,2-1-0-4-B,6814-66-2083,COMM & IND,42.6,AC,1037800,1018200,19600,0,0,1037800,1007300,989200,18100,0,0,1007300,B1A1,BS & AG,,,
14068,4-1-0-25-A,6803-71-2980,AG 20-100 AC,36.93,AC,189500,171800,17700,0,0,189500,184700,169000,15700,0,0,184700,A1,AG/GEN,,,
14069,4-1-0-25-B,6803-62-5500,Cemetery,0,AC,100,0,100,0,0,100,100,0,100,0,0,100,A1,AG/GEN,,,
14070,4-1-0-52-A1,6813-14-8533,SNGL FAM SUB,2.58,AC,47800,0,47800,178900,0,226700,46900,0,46900,159300,0,206200,A1,AG/GEN,,,
14071,4-1-0-52-A2,6813-14-9367,SNGL FAM SUB,2.86,AC,49200,0,49200,157300,26000,232500,48300,0,48300,136500,22400,207200,A1,AG/GEN,,,
14072,11-9-0-A-1,6822-53-0879,SNGL FAM SUB,4.3,AC,56500,0,56500,218600,1300,276400,55500,0,55500,198000,1400,254900,A1,AG/GEN,,,
14073,12-1-0-44-A,6831-34-4244,Cemetery,0,AC,100,0,100,0,0,100,100,0,100,0,0,100,A1,AG/GEN,,,
14074,12-1-0-46-E,6831-25-6713,AG 20-100 AC,28.13,AC,149000,134900,14100,0,0,149000,146300,134200,12100,0,0,146300,A1,AG/GEN,,,
14075,12-13-0-C-1,6832-60-9917,SNGL FAM SUB,0.025,AC,200,0,200,0,0,200,200,0,200,0,0,200,A1,AG/GEN,,,
14076,12-24-0-1-0,6821-92-6809,SNGL FAM SUB,2.733,AC,52300,0,52300,130600,1500,184400,51300,0,51300,107600,1000,159900,A1,AG/GEN,,,
14077,12-24-0-2-0,6821-92-4641,SNGL FAM SUB,3.368,AC,56300,0,56300,201400,0,257700,55600,0,55600,166200,0,221800,A1,AG/GEN,,,
14078,12-24-0-3-0,6821-92-2268,SNGL FAM SUB,7.666,AC,79700,0,79700,0,0,79700,77500,0,77500,0,0,77500,A1,AG/GEN,,,
14079,12-24-0-4-0,6821-91-0883,SNGL FAM SUB,11.985,AC,107600,0,107600,0,0,107600,102100,0,102100,0,0,102100,A1,AG/GEN,,,
14080,13-1-0-40-A,6841-83-9980,SNGL FAM SUB,2.15,AC,59900,0,59900,168100,4500,232500,58800,0,58800,145900,4500,209200,A1,AG/GEN,,,
14081,13-1-0-40-B,6841-93-2834,SNGL FAM SUB,2.04,AC,58900,0,58900,151700,500,211100,57800,0,57800,130300,500,188600,A1,AG/GEN,,,
14082,5-1-0-16-0,6813-70-7394,AG 20-100 AC,91.198,AC,317100,273700,43400,0,0,317100,310900,272000,38900,0,0,310900,A1,AG/GEN,,,
14083,13-1-0-40-C,6841-93-0591,SNGL FAM SUB,4.04,AC,76200,0,76200,197600,12900,286700,74800,0,74800,175600,12900,263300,A1,AG/GEN,,,
14084,13-2-0-3-0,6841-85-5676,SNGL FAM SUB,2.6,AC,63800,0,63800,0,0,63800,62600,0,62600,0,0,62600,A1,AG/GEN,,,
14085,17-1-0-9-B,6800-35-5564,AG 20-100 AC,22.214,AC,70100,59500,10600,0,0,70100,66600,57100,9500,0,0,66600,A1,AG/GEN,,,
14086,16-1-0-43-0,6800-27-5284,AG 20-100 AC,21.27,AC,75300,64600,10700,0,0,75300,74400,65300,9100,0,0,74400,A1,AG/GEN,,,
14087,16-1-0-43-A,6800-36-1741,Cemetery,0,AC,100,0,100,0,0,100,100,0,100,0,0,100,A1,AG/GEN,,,
14088,17-1-0-75-A,6810-00-4282,Cemetery,0,AC,100,0,100,0,0,100,100,0,100,0,0,100,A1,AG/GEN,,,
14089,17-1-0-75-B,6810-00-6351,Cemetery,0.6,AC,100,0,100,0,0,100,100,0,100,0,0,100,A1,AG/GEN,,,
14090,17-1-0-79-A,6810-10-1487,SNGL FAM SUB,2.03,AC,46200,0,46200,122100,5700,174000,43700,0,43700,100200,5600,149500,A1,AG/GEN,,,
14091,18-1-0-28-D,6729-27-5269,SNGL FAM SUB,4.21,AC,56900,0,56900,0,0,56900,55700,0,55700,0,0,55700,A1,AG/GEN,,,
14092,18-4-0-2-D1,6729-29-3815,SNGL FAM SUB,4.93,AC,63100,0,63100,227100,0,290200,61600,0,61600,184800,0,246400,A1,AG/GEN,,,
14093,19-12-0-A-0,6821-90-6965,AG 20-100 AC,21.481,AC,136400,87000,49400,345500,500,482400,132900,84700,48200,289200,500,422600,A1,AG/GEN,,,
14094,19-12-0-B-0,6821-90-3602,AG 20-100 AC,24.029,AC,110800,0,110800,0,0,110800,109600,0,109600,0,0,109600,A1,AG/GEN,,,
14095,19-12-0-C-0,6820-99-6808,AG 20-100 AC,20.037,AC,141900,0,141900,344200,3000,489100,138500,0,138500,285400,3000,426900,A1,AG/GEN,,,
14098,21-1-0-47-A,6850-73-0934,SNGL FAM SUB,2.75,AC,75400,0,75400,204900,22500,302800,68100,0,68100,171100,19800,259000,A2,AG/LTD,,,
14099,20-1-0-65-C,6840-67-8581,SNGL FAM SUB,7.23,AC,100500,0,100500,306800,25900,433200,98700,0,98700,276300,18200,393200,A1,AG/GEN,,,
14101,24-1-0-5-A,5799-16-0609,SNGL FAM SUB,19.486,AC,105400,0,105400,0,0,105400,102700,0,102700,0,0,102700,A1,AG/GEN,,,
14102,24-1-0-5-B,5789-95-7998,SNGL FAM SUB,18.6,AC,111000,0,111000,392100,2100,505200,108400,0,108400,333000,0,441400,A1,AG/GEN,,,
14103,25-1-0-8-D,6708-24-6114,Academic-Private,3.37,AC,13800,0,13800,0,0,13800,13500,0,13500,0,0,13500,A1,AG/GEN,,,
14104,25-1-0-8-E,6708-14-9486,SNGL FAM SUB,7,AC,17500,13900,3600,0,0,17500,17500,14500,3000,0,0,17500,A1,AG/GEN,,,
14105,25-1-0-8-F,6707-19-5553,AG > 100 AC,263,AC,526000,393100,132900,0,0,526000,526000,413000,113000,0,0,526000,A1,AG/GEN,,,
14106,25-1-0-11-B,5799-15-9652,SNGL FAM SUB,16.158,AC,100900,0,100900,0,10000,110900,98600,0,98600,0,0,98600,A1,AG/GEN,,,
14107,26-1-0-28-D,6708-40-9226,AG > 100 AC,545.98,AC,1105500,853800,251700,0,0,1105500,1079500,847500,232000,0,0,1079500,A1,AG/GEN,,,
14109,21-1-0-1-A,6850-29-3953,SNGL FAM SUB,9.44,AC,113800,0,113800,332000,2000,447800,111600,0,111600,299600,2000,413200,A1,AG/GEN,,,
14110,28-1-0-87-J,6739-13-3989,SNGL FAM SUB,7.5,AC,90000,0,90000,0,0,90000,85000,0,85000,0,0,85000,A1,AG/GEN,,,
14111,28-1-0-87-K,6739-13-6713,SNGL FAM SUB,5,AC,74100,71800,2300,0,0,74100,71900,69800,2100,0,0,71900,A1,AG/GEN,,,
14112,28-1-0-87-L,6739-13-8273,SNGL FAM SUB,16.68,AC,146400,138700,7700,0,0,146400,141900,134800,7100,0,0,141900,A1,AG/GEN,,,
14113,29-1-0-126-C,6748-89-9359,SNGL FAM SUB,2,AC,63000,0,63000,125100,500,188600,57700,0,57700,99400,500,157600,A1,AG/GEN,,,
14114,27-1-0-27-A,6728-32-0446,SNGL FAM SUB,6,AC,69300,0,69300,144400,0,213700,68000,0,68000,122900,0,190900,A1,AG/GEN,,,
14116,31-1-0-69-A2,6779-36-1718,SNGL FAM SUB,2.73,AC,85700,0,85700,173300,1000,260000,76600,0,76600,141600,1000,219200,A2,AG/LTD,,,
14117,31-1-0-69-A3,6779-26-8817,SNGL FAM SUB,2.28,AC,80100,0,80100,162400,0,242500,71500,0,71500,128100,0,199600,A2,AG/LTD,,,
14118,30-1-0-42-A1,6758-36-9639,SNGL FAM SUB,4.44,AC,86700,0,86700,305100,9800,401600,82200,0,82200,251800,9000,343000,A2,AG/LTD,,,
14119,30-1-0-42-A2,6758-46-4609,SNGL FAM SUB,4.68,AC,88800,0,88800,216300,0,305100,84500,0,84500,183900,0,268400,A2,AG/LTD,,,
14120,30-1-0-42-A3,6758-56-0752,SNGL FAM SUB,7.61,AC,110800,0,110800,335200,26200,472200,104800,0,104800,279500,25600,409900,A2,AG/LTD,,,
14121,32-1-0-11-B,6779-75-6474,SNGL FAM SUB,2.01,AC,78600,0,78600,204800,3600,287000,70200,0,70200,168000,3600,241800,A2,AG/LTD,,,
14122,32-1-0-70-D,6788-33-1473,Cemetery,0,AC,100,0,100,0,0,100,100,0,100,0,0,100,A2,AG/LTD,,,
14123,32-4-0-3-A,6779-65-2721,SNGL FAM SUB,2,AC,78500,0,78500,211500,900,290900,70100,0,70100,174100,900,245100,A2,AG/LTD,,,
14124,38-1-0-46-A,6707-51-4831,SNGL FAM SUB,9.51,AC,86500,0,86500,101600,6500,194600,84800,0,84800,88200,6500,179500,A1,AG/GEN,,,
14126,39-1-0-80-A,6726-55-4910,AG 20-100 AC,62.5,AC,216000,143800,72200,0,0,216000,210000,140900,69100,0,0,210000,A1,AG/GEN,,,
14127,40-1-0-13-A,6737-10-9974,SNGL FAM SUB,1.19,AC,3900,3400,500,0,0,3900,3900,3400,500,0,0,3900,A1,AG/GEN,,,
14128,40-1-0-14-A1,6737-10-5084,SNGL FAM SUB,0.8,AC,2600,0,2600,0,0,2600,2600,0,2600,0,0,2600,A1,AG/GEN,,,
14129,42-1-0-65-A,6757-88-4673,General Gov,8.09,AC,940100,0,940100,0,0,940100,903800,0,903800,0,0,903800,B1,BUS/GEN,,,
14130,42-1-0-65-B,6757-88-6546,Cemetery,0,AC,100,0,100,0,0,100,100,0,100,0,0,100,B1,BUS/GEN,,,
14131,31-1-0-45-D,6769-84-6679,SNGL FAM SUB,5.47,AC,107900,0,107900,206800,19400,334100,97100,0,97100,171600,16300,285000,A2,AG/LTD,,,
14132,44-1-0-14-E,6777-50-6320,Academic-Private,10,AC,188900,0,188900,0,0,188900,168800,0,168800,0,0,168800,A2,AG/LTD,,,
14133,44-1-0-37-A1,6788-10-7095,SNGL FAM SUB,3,AC,97700,0,97700,97000,800,195500,87200,0,87200,82000,800,170000,RR,RES/RUR,,,
14134,45-1-0-10-A1,6797-28-7896,COMM & IND,0.55,AC,54100,0,54100,0,0,54100,50100,0,50100,0,0,50100,B1,BUS/GEN,,,
14135,45-1-0-56-A,6797-06-0613,SNGL FAM SUB,8.73,AC,192200,0,192200,346900,800,539900,171600,0,171600,287100,800,459500,A2,AG/LTD,,,
14136,45-1-0-56-B,6787-96-9119,SNGL FAM SUB,7.23,AC,167700,0,167700,0,0,167700,149700,0,149700,0,0,149700,A2,AG/LTD,,,
14137,45-1-0-131-A,6797-39-6212,SNGL FAM SUB,0.19,AC,2600,0,2600,0,0,2600,2300,0,2300,0,0,2300,A2,AG/LTD,,,
14138,46-1-0-25-E,7707-14-2047,SNGL FAM SUB,3,AC,143400,0,143400,299500,64600,507500,128000,0,128000,248400,62000,438400,A2,AG/LTD,,,
14139,17-1-0-9-A,6800-35-9576,AG 20-100 AC,43.484,AC,104000,81400,22600,0,0,104000,100000,79600,20400,0,0,100000,A1,AG/GEN,,,
14140,47-1-0-43-P1,7726-09-3039,COMM & IND,0.771,AC,251900,0,251900,257900,2400,512200,229000,0,229000,242800,2400,474200,B1,BUS/GEN,,,
14141,47-29-0-1-0,7716-67-9913,SNGL FAM SUB,3.198,AC,204800,0,204800,475700,27500,708000,178100,0,178100,411800,23400,613300,A2,AG/LTD,,,
14142,47-29-0-2-0,7716-77-0626,SNGL FAM SUB,2.695,AC,193600,0,193600,466000,0,659600,168400,0,168400,395300,0,563700,A2,AG/LTD,,,
14143,47-29-0-12-0,7716-67-4451,SNGL FAM SUB,10.065,AC,378200,0,378200,548500,45800,972500,328900,0,328900,458800,47400,835100,A2,AG/LTD,,,
14146,57-20-F-1-0,7715-08-7903,SNGL FAM SUB,3.065,AC,315000,0,315000,0,0,315000,288800,0,288800,0,0,288800,A2,AG/LTD,,,
14147,57-20-F-4-0,7715-18-4936,SNGL FAM SUB,4.52,AC,383300,0,383300,442000,7700,833000,351800,0,351800,433600,8500,793900,A2,AG/LTD,,,
14148,50-7-0-5-0,6726-05-7607,SNGL FAM SUB,4.16,AC,56500,0,56500,233700,0,290200,55400,0,55400,205800,0,261200,A1,AG/GEN,,,
14149,50-7-0-6-0,6726-05-8393,SNGL FAM SUB,2.26,AC,45900,0,45900,0,0,45900,44900,0,44900,0,0,44900,A1,AG/GEN,,,
14150,50-7-0-7-0,6726-04-4951,SNGL FAM SUB,10.16,AC,80400,0,80400,0,0,80400,78900,0,78900,0,0,78900,A1,AG/GEN,,,
14152,55-1-0-10-D,6776-81-8915,SNGL FAM SUB,0.35,AC,2600,0,2600,0,0,2600,2400,0,2400,0,0,2400,A2,AG/LTD,,,
14153,55-1-0-10-E,6776-91-0877,SNGL FAM SUB,2,AC,85200,0,85200,199800,56300,341300,76100,0,76100,164700,47400,288200,A2,AG/LTD,,,
14155,55-1-0-64-A,6786-54-9798,Cemetery,0,AC,100,0,100,0,0,100,100,0,100,0,0,100,A2,AG/LTD,,,
14156,56-1-0-1-K,6786-94-4224,SNGL FAM SUB,3.79,AC,112200,0,112200,0,0,112200,100300,0,100300,0,0,100300,A2,AG/LTD,,,
14158,58-1-0-112-AT,7725-37-0185-9999,COMM & IND,130.848,AC,13263700,0,13263700,26306300,100,39570100,12854200,0,12854200,26306300,100,39160600,M1,INDUS/L,,,
14160,58-30-0-3-0,7716-77-1235,SNGL FAM SUB,6.012,AC,267600,0,267600,403300,0,670900,232700,0,232700,339600,0,572300,A2,AG/LTD,,,
14172,63-1-0-108-B,7715-32-8159,SNGL FAM SUB,4.02,AC,170000,0,170000,0,0,170000,147800,0,147800,0,0,147800,A2,AG/LTD,,,
14173,63-25-0-A-1,7723-47-3706,SNGL FAM SUB,2.03,AC,191700,0,191700,225900,2500,420100,166700,0,166700,192700,2500,361900,A2R1,AG LTD/,,,
14174,64-4-1-10-0,7724-93-1976,SNGL FAM SUB,0,AC,17200,0,17200,0,0,17200,15000,0,15000,0,0,15000,RN,RESIDEN,,,
14175,66-1-0-2-A,7726-14-6429,Other Religious,0,AC,11900,0,11900,0,0,11900,10300,0,10300,0,0,10300,A2,AG/LTD,,,
14176,66-4-0-6-A,7723-33-7758,Cmn Area/Open Spc,0.247,AC,0,0,0,0,0,0,0,0,0,0,0,0,A2,AG/LTD,,,
14177,67-3-B-21-A,7723-43-8512,SNGL FAM SUB,0.244,AC,13300,0,13300,0,0,13300,11500,0,11500,0,0,11500,R1,RES/LTD,,,
14178,67-3-B-21-B,7723-43-8637,SNGL FAM SUB,0.499,AC,27100,0,27100,0,0,27100,23600,0,23600,0,0,23600,R1,RES/LTD,,,
14179,67-10-0-17-B,7733-15-1771,SNGL FAM SUB,0.539,AC,25900,0,25900,0,8100,34000,21600,0,21600,0,8400,30000,R1,RES/LTD,,,
14180,44-6-0-1-A,6787-52-2241,SNGL FAM SUB,3.14,AC,103900,0,103900,299200,300,403400,92800,0,92800,250900,300,344000,A2,AG/LTD,,,
14181,46-1-0-25-D,7707-13-4183,SNGL FAM SUB,4,AC,165600,0,165600,135300,18400,319300,147800,0,147800,112800,15600,276200,A2,AG/LTD,,,
14182,31-1-0-69-A1,6779-36-3721,SNGL FAM SUB,2.92,AC,88100,0,88100,163000,1000,252100,78700,0,78700,132800,1000,212500,A2,AG/LTD,,,
14185,68-1-0-1-C,7733-74-6804,Roads,0,AC,0,0,0,0,0,0,0,0,0,0,0,0,A2,AG/LTD,,,
14186,68-1-0-1-D,7733-64-8520,Cmn Area/Open Spc,0,AC,0,0,0,0,0,0,0,0,0,0,0,0,A2,AG/LTD,,,
14187,68-1-0-1-E,7733-64-8423,Cmn Area/Open Spc,0,AC,0,0,0,0,0,0,0,0,0,0,0,0,A2,AG/LTD,,,
14188,55-1-0-64-B,6786-54-8299,AG 20-100 AC,21.073,AC,373200,362600,10600,0,0,373200,333600,324500,9100,0,0,333600,A2,AG/LTD,,,
14189,55-1-0-64-C,6786-53-3529,AG 20-100 AC,25.65,AC,434800,422200,12600,0,0,434800,388700,377700,11000,0,0,388700,A2,AG/LTD,,,
14191,31-1-0-83-A,6779-00-5274,SNGL FAM SUB,2.82,AC,90300,0,90300,140600,17100,248000,80700,0,80700,116300,13500,210500,A2,AG/LTD,,,
14192,31-1-0-83-B,6778-18-7679,Cemetery,0.01,AC,100,0,100,0,0,100,100,0,100,0,0,100,A2,AG/LTD,,,
14193,18-1-0-8-A,6810-69-4686,SNGL FAM SUB,16.74,AC,126900,0,126900,0,0,126900,124600,0,124600,0,0,124600,A1,AG/GEN,,,
14194,18-1-0-8-B,6810-69-3757,Cemetery,0,AC,100,0,100,0,0,100,100,0,100,0,0,100,A1,AG/GEN,,,
14195,22-1-0-6-A,6769-77-7244,Place of Worship,9.886,AC,200700,0,200700,736200,2200,939100,178200,0,178200,698200,2200,878600,A2,AG/LTD,,,
14197,39-1-0-52-D,6717-82-0481,SNGL FAM SUB,4.624,AC,59100,0,59100,193400,2700,255200,57900,0,57900,168600,2700,229200,A1,AG/GEN,,,
14199,55-12-0-D-1,6785-34-4489,SNGL FAM SUB,2.87,AC,113600,0,113600,434500,0,548100,101300,0,101300,356200,0,457500,A2,AG/LTD,,,
14200,28-1-0-78-B,6739-36-0195,SNGL FAM SUB,3,AC,60800,0,60800,189300,5000,255100,58300,0,58300,157100,5000,220400,A1,AG/GEN,,,
14202,17-1-0-74-A,6810-00-6339,SNGL FAM SUB,3.72,AC,56100,54400,1700,0,0,56100,53000,51400,1600,0,0,53000,A1,AG/GEN,,,
14203,38-1-0-10-D,6707-99-3611,SNGL FAM SUB,2.02,AC,44500,0,44500,95800,0,140300,43600,0,43600,79200,0,122800,A1,AG/GEN,,,
14204,53-1-0-7-A,6766-06-7631,Parks & Rec,7.72,AC,26200,0,26200,0,33600,59800,23200,0,23200,0,28600,51800,M2A2,INDUSTR,,,
14205,62-31-0-A-0,7704-47-9561,Cmn Area/Open Spc,21.071,AC,0,0,0,0,0,0,0,0,0,0,0,0,RR,RES/RUR,,,
14206,62-31-0-B-0,7704-47-4975,Cmn Area/Open Spc,1.709,AC,0,0,0,0,0,0,0,0,0,0,0,0,RR,RES/RUR,,,
14207,62-31-0-C-0,7704-38-6326,Cmn Area/Open Spc,39.007,AC,0,0,0,0,0,0,0,0,0,0,0,0,RR,RES/RUR,,,
14208,62-31-A-1-0,7704-49-0370,SNGL FAM SUB,4.464,AC,432000,0,432000,605800,24800,1062600,360000,0,360000,573700,21100,954800,RR,RES/RUR,,,
14209,62-31-A-2-0,7704-38-9981,SNGL FAM SUB,3.477,AC,432000,0,432000,668900,0,1100900,360000,0,360000,644900,0,1004900,RR,RES/RUR,,,
14210,62-31-A-3-0,7704-38-7545,SNGL FAM SUB,7.377,AC,449300,0,449300,713000,8800,1171100,374400,0,374400,674400,9000,1057800,RR,RES/RUR,,,
14211,62-31-A-4-0,7704-38-3847,SNGL FAM SUB,7.645,AC,449300,0,449300,266500,0,715800,374400,0,374400,257500,0,631900,RR,RES/RUR,,,
14212,62-31-A-5-0,7704-39-5334,SNGL FAM SUB,4.484,AC,432000,0,432000,320600,94700,847300,360000,0,360000,307100,79300,746400,RR,RES/RUR,,,
14213,62-31-A-6-0,7704-29-8047,SNGL FAM SUB,5.409,AC,432000,0,432000,1125000,89100,1646100,360000,0,360000,1088900,81900,1530800,RR,RES/RUR,,,
14214,62-31-A-7-0,7704-29-3094,SNGL FAM SUB,5.579,AC,432000,0,432000,616000,30100,1078100,360000,0,360000,578100,29300,967400,RR,RES/RUR,,,
14215,62-31-A-8-0,7704-19-9000,SNGL FAM SUB,6.486,AC,449300,0,449300,0,0,449300,374400,0,374400,0,0,374400,RR,RES/RUR,,,
14216,62-31-A-9-0,7704-19-7388,SNGL FAM SUB,8.369,AC,449300,0,449300,616000,32900,1098200,374400,0,374400,579900,31500,985800,RR,RES/RUR,,,
14217,62-31-A-10-0,7704-29-0617,SNGL FAM SUB,3.072,AC,432000,0,432000,391500,0,823500,360000,0,360000,368100,0,728100,RR,RES/RUR,,,
14218,62-31-A-11-0,7704-29-3747,SNGL FAM SUB,4.047,AC,432000,0,432000,585700,75200,1092900,360000,0,360000,539400,70800,970200,RR,RES/RUR,,,
14219,62-31-A-12-0,7704-29-6679,SNGL FAM SUB,4.559,AC,432000,0,432000,560900,73200,1066100,360000,0,360000,531300,68500,959800,RR,RES/RUR,,,
14220,62-31-A-13-0,7704-39-0644,SNGL FAM SUB,4.715,AC,432000,0,432000,334200,0,766200,360000,0,360000,327000,0,687000,RR,RES/RUR,,,
14221,62-31-A-14-0,7704-39-3852,SNGL FAM SUB,4.838,AC,432000,0,432000,661500,110500,1204000,360000,0,360000,621900,96800,1078700,RR,RES/RUR,,,
14222,62-31-A-15-0,7705-30-7092,SNGL FAM SUB,7.91,AC,449300,0,449300,1251900,65600,1766800,374400,0,374400,1176300,62100,1612800,RR,RES/RUR,,,
14223,62-31-A-16-0,7704-49-2820,SNGL FAM SUB,5.289,AC,432000,0,432000,910900,0,1342900,360000,0,360000,852700,0,1212700,RR,RES/RUR,,,
14224,62-31-A-17-0,7704-49-6711,SNGL FAM SUB,4.575,AC,432000,0,432000,867600,54600,1354200,360000,0,360000,835100,50800,1245900,RR,RES/RUR,,,
14225,62-31-B-1-0,7704-57-1915,SNGL FAM SUB,4.949,AC,432000,0,432000,838200,73000,1343200,360000,0,360000,770800,67900,1198700,RR,RES/RUR,,,
14226,62-31-B-2-0,7704-57-3782,SNGL FAM SUB,4.601,AC,432000,0,432000,379400,0,811400,360000,0,360000,359200,0,719200,RR,RES/RUR,,,
14227,62-31-B-7-0,7704-58-8046,SNGL FAM SUB,4.527,AC,432000,0,432000,415600,4100,851700,360000,0,360000,397700,4200,761900,RR,RES/RUR,,,
14228,62-31-B-8-0,7704-58-7329,SNGL FAM SUB,5.591,AC,432000,0,432000,658300,0,1090300,360000,0,360000,630800,0,990800,RR,RES/RUR,,,
14229,62-31-B-9-0,7704-58-4663,SNGL FAM SUB,5.46,AC,432000,0,432000,0,0,432000,360000,0,360000,0,0,360000,RR,RES/RUR,,,
14230,64-21-0-1-0,7733-55-4495,Cmn Area/Open Spc,52.862,AC,0,0,0,0,0,0,0,0,0,0,0,0,RPUD,RES/PUD,,,
14231,67-24-A-1-0,7733-65-3899,SNGL FAM URB,2.463,AC,620000,0,620000,1066800,55800,1742600,540000,0,540000,1001000,52800,1593800,RPUD,RES/PUD,,,
14232,67-24-A-2-0,7733-65-2668,SNGL FAM URB,2.625,AC,558000,0,558000,900000,0,1458000,486000,0,486000,846300,0,1332300,RPUD,RES/PUD,,,
14233,67-24-A-3-0,7733-65-0622,SNGL FAM URB,2.5,AC,620000,0,620000,1290500,3000,1913500,540000,0,540000,1214800,2900,1757700,RPUD,RES/PUD,,,
14234,67-24-A-4-0,7733-55-7681,SNGL FAM URB,2.564,AC,620000,0,620000,1778000,0,2398000,540000,0,540000,1781000,0,2321000,RPUD,RES/PUD,,,
14235,67-24-A-5-0,7733-55-4880,SNGL FAM URB,3.308,AC,620000,0,620000,1519000,0,2139000,540000,0,540000,1425500,0,1965500,RPUD,RES/PUD,,,
14236,67-24-A-6-0,7733-55-1765,SNGL FAM URB,3.581,AC,620000,0,620000,1866900,256100,2743000,540000,0,540000,1793300,239300,2572600,RPUD,RES/PUD,,,
14237,67-24-A-7-0,7733-55-1438,SNGL FAM URB,2.776,AC,620000,0,620000,1342600,0,1962600,540000,0,540000,1256100,0,1796100,RPUD,RES/PUD,,,
14238,67-24-A-8-0,7733-55-2254,SNGL FAM URB,2.987,AC,620000,0,620000,788400,0,1408400,540000,0,540000,745200,0,1285200,RPUD,RES/PUD,,,
14239,67-24-A-9-0,7733-55-4130,SNGL FAM URB,4.065,AC,657200,0,657200,1191100,0,1848300,572400,0,572400,1136200,0,1708600,RPUD,RES/PUD,,,
14240,67-24-A-10-0,7733-55-7025,SNGL FAM URB,2.646,AC,657200,0,657200,1303800,16000,1977000,572400,0,572400,1230900,15500,1818800,RPUD,RES/PUD,,,
14241,67-24-A-11-0,7733-65-0033,SNGL FAM URB,4.585,AC,657200,0,657200,1534800,0,2192000,572400,0,572400,1468900,0,2041300,RPUD,RES/PUD,,,
14242,67-24-A-13-0,7733-65-5264,SNGL FAM URB,4.59,AC,620000,0,620000,842500,53700,1516200,540000,0,540000,782000,56000,1378000,RPUD,RES/PUD,,,
14243,68-2-A-14-0,7733-65-7650,SNGL FAM URB,3.06,AC,620000,0,620000,812000,2000,1434000,540000,0,540000,763300,2100,1305400,RPUD,RES/PUD,,,
14244,68-2-A-15-0,7733-65-9645,Cmn Area/Open Spc,0.335,AC,0,0,0,0,0,0,0,0,0,0,0,0,RPUD,RES/PUD,,,
14245,68-2-B-1-0,7733-66-5634,SNGL FAM URB,0.388,AC,230000,0,230000,399900,0,629900,200000,0,200000,368800,0,568800,RPUD,RES/PUD,,,
14246,68-2-B-2-0,7733-66-5541,SNGL FAM URB,0.355,AC,230000,0,230000,544600,0,774600,200000,0,200000,502200,0,702200,RPUD,RES/PUD,,,
14247,68-2-B-3-0,7733-66-5491,SNGL FAM URB,0.363,AC,230000,0,230000,588800,0,818800,200000,0,200000,543700,0,743700,RPUD,RES/PUD,,,
14248,68-2-B-4-0,7733-66-7241,SNGL FAM URB,0.336,AC,230000,0,230000,597400,0,827400,200000,0,200000,550600,0,750600,RPUD,RES/PUD,,,
14249,68-2-B-5-0,7733-66-8124,SNGL FAM URB,0.352,AC,230000,0,230000,527500,0,757500,200000,0,200000,485500,0,685500,RPUD,RES/PUD,,,
14250,68-2-B-6-0,7733-66-9017,SNGL FAM URB,0.406,AC,230000,0,230000,562200,0,792200,200000,0,200000,515300,0,715300,RPUD,RES/PUD,,,
14251,68-2-B-7-0,7733-76-0044,SNGL FAM URB,0.433,AC,230000,0,230000,543700,0,773700,200000,0,200000,502600,0,702600,RPUD,RES/PUD,,,
14252,68-2-B-8-0,7733-76-1068,SNGL FAM URB,0.392,AC,230000,0,230000,564300,0,794300,200000,0,200000,519100,0,719100,RPUD,RES/PUD,,,
14253,68-2-B-9-0,7733-76-2146,SNGL FAM URB,0.368,AC,230000,0,230000,621200,0,851200,200000,0,200000,572700,0,772700,RPUD,RES/PUD,,,
14254,68-2-B-10-0,7733-76-2295,SNGL FAM URB,0.354,AC,230000,0,230000,578400,0,808400,200000,0,200000,531600,0,731600,RPUD,RES/PUD,,,
14255,68-2-B-11-0,7733-76-3326,SNGL FAM URB,0.389,AC,230000,0,230000,668300,0,898300,200000,0,200000,615100,0,815100,RPUD,RES/PUD,,,
14256,68-2-B-12-0,7733-76-3428,SNGL FAM URB,0.379,AC,230000,0,230000,628400,3400,861800,200000,0,200000,579300,3100,782400,RPUD,RES/PUD,,,
14257,68-2-B-13-0,7733-76-3529,SNGL FAM URB,0.417,AC,230000,0,230000,664400,0,894400,200000,0,200000,615000,0,815000,RPUD,RES/PUD,,,
14258,68-2-B-14-0,7733-76-3750,SNGL FAM URB,0.414,AC,230000,0,230000,714000,0,944000,200000,0,200000,658900,0,858900,RPUD,RES/PUD,,,
14259,68-2-C-30-0,7733-66-8729,SNGL FAM URB,0.4,AC,230000,0,230000,575200,0,805200,200000,0,200000,531000,0,731000,RPUD,RES/PUD,,,
14260,68-2-C-31-0,7733-66-7679,SNGL FAM URB,0.407,AC,230000,0,230000,592900,0,822900,200000,0,200000,545600,0,745600,RPUD,RES/PUD,,,
14261,68-2-C-32-0,7733-66-7539,SNGL FAM URB,0.414,AC,230000,0,230000,589500,0,819500,200000,0,200000,540800,0,740800,RPUD,RES/PUD,,,
14262,68-2-C-33-0,7733-66-7488,SNGL FAM URB,0.337,AC,230000,0,230000,649000,1800,880800,200000,0,200000,594800,1900,796700,RPUD,RES/PUD,,,
14263,68-2-C-34-0,7733-66-8339,SNGL FAM URB,0.341,AC,230000,0,230000,578200,0,808200,200000,0,200000,533200,0,733200,RPUD,RES/PUD,,,
14264,68-2-C-35-0,7733-66-9312,SNGL FAM URB,0.328,AC,230000,0,230000,495000,0,725000,200000,0,200000,455800,0,655800,RPUD,RES/PUD,,,
14265,68-2-C-36-0,7733-66-9295,SNGL FAM URB,0.39,AC,230000,0,230000,611500,0,841500,200000,0,200000,564100,0,764100,RPUD,RES/PUD,,,
14266,68-2-C-37-0,7733-76-0297,SNGL FAM URB,0.366,AC,230000,0,230000,606500,0,836500,200000,0,200000,558200,0,758200,RPUD,RES/PUD,,,
14267,68-2-C-38-0,7733-76-1337,SNGL FAM URB,0.347,AC,230000,0,230000,561600,1600,793200,200000,0,200000,516500,1700,718200,RPUD,RES/PUD,,,
14268,68-2-C-39-0,7733-76-1438,SNGL FAM URB,0.383,AC,230000,0,230000,652300,0,882300,200000,0,200000,597300,0,797300,RPUD,RES/PUD,,,
14269,68-2-C-40-0,7733-76-1529,SNGL FAM URB,0.361,AC,230000,0,230000,546300,0,776300,200000,0,200000,497800,0,697800,RPUD,RES/PUD,,,
14270,68-2-C-41-0,7733-76-1740,SNGL FAM URB,0.374,AC,230000,0,230000,608700,1900,840600,200000,0,200000,567000,1800,768800,RPUD,RES/PUD,,,
14271,67-24-A-12-0,7733-65-3043,SNGL FAM URB,4.406,AC,657200,0,657200,1105800,0,1763000,572400,0,572400,1042300,0,1614700,RPUD,RES/PUD,,,
14272,10-1-0-22-A,6801-62-5432,SNGL FAM SUB,8.85,AC,74900,70400,4500,0,0,74900,73300,69500,3800,0,0,73300,A1,AG/GEN,,,
14273,10-1-0-22-B,6801-63-9272,AG 20-100 AC,20.05,AC,107200,58800,48400,293200,800,401200,104700,58500,46200,256600,800,362100,A1,AG/GEN,,,
14274,11-1-0-5-A,6812-93-2502,AG 20-100 AC,30.687,AC,139700,0,139700,179500,34500,353700,137400,0,137400,157600,29800,324800,A1,AG/GEN,,,
14275,12-18-0-C-1,6832-40-7607,SNGL FAM SUB,3.5,AC,60700,0,60700,159500,17000,237200,59000,0,59000,140500,17600,217100,A1,AG/GEN,,,
14277,19-7-0-B-3,6830-96-3392,SNGL FAM SUB,2.21,AC,56400,0,56400,99600,1100,157100,52200,0,52200,82000,1100,135300,A1,AG/GEN,,,
14279,40-1-0-29-E,6737-32-9371,AG 20-100 AC,68.12,AC,279300,236300,43000,0,20100,299400,272500,232100,40400,0,18000,290500,A1,AG/GEN,,,
14281,43-31-0-1-0,6767-86-3735,AG 20-100 AC,23.85,AC,275000,181900,93100,250500,5000,530500,242400,154800,87600,223600,5000,471000,A2,AG/LTD,,,
14282,43-31-0-2-0,6767-87-2149,SNGL FAM SUB,3.02,AC,92100,0,92100,226300,31000,349400,83800,0,83800,197600,28500,309900,A2,AG/LTD,,,
14283,43-31-0-3-0,6767-86-6979,SNGL FAM SUB,3.3,AC,95300,0,95300,279900,21300,396500,86700,0,86700,237500,2600,326800,A2,AG/LTD,,,
14284,43-31-0-4-0,6767-96-5450,SNGL FAM SUB,8.8,AC,157400,0,157400,391500,0,548900,143300,0,143300,345300,0,488600,A2,AG/LTD,,,
14285,43-31-0-5-0,6767-95-8907,SNGL FAM SUB,8.07,AC,149200,0,149200,333300,60700,543200,135800,0,135800,298100,54000,487900,A2,AG/LTD,,,
14286,43-31-0-6-0,6777-05-4521,AG 20-100 AC,22.03,AC,283500,208300,75200,721100,5000,1009600,257900,186000,71900,643100,5000,906000,A2,AG/LTD,,,
14287,43-31-0-7-0,6777-15-1005,AG 20-100 AC,22.03,AC,283500,0,283500,269600,21600,574700,257900,0,257900,236800,19200,513900,A2,AG/LTD,,,
14288,45-1-0-113-D,6798-60-4216,SNGL FAM SUB,4.55,AC,108600,0,108600,0,0,108600,96900,0,96900,0,0,96900,A2,AG/LTD,,,
14289,47-9-0-3-C,7717-32-7782,SNGL FAM SUB,2.01,AC,118800,0,118800,84000,1000,203800,106000,0,106000,68300,1000,175300,A2,AG/LTD,,,
14290,42-1-0-17-B,6756-78-9114,Parks & Rec,2.98,AC,8600,0,8600,0,0,8600,8200,0,8200,0,0,8200,A2,AG/LTD,,,
14291,5-1-0-21-A2,6822-09-5466,SNGL FAM SUB,2.269,AC,46200,0,46200,74100,600,120900,45300,0,45300,62900,600,108800,A1,AG/GEN,,,
14292,12-1-0-61-A1,6832-60-9626,SNGL FAM SUB,2.25,AC,50500,0,50500,94600,2500,147600,49000,0,49000,79900,2500,131400,A1,AG/GEN,,,
14293,22-1-0-10-B,6769-87-3691,SNGL FAM SUB,2.014,AC,73600,0,73600,382200,43500,499300,65600,0,65600,302100,37400,405100,A2,AG/LTD,,,
14294,30-1-0-40-A,6758-34-9858,SNGL FAM SUB,2.44,AC,68300,0,68300,183200,2100,253600,64900,0,64900,150300,2100,217300,A2,AG/LTD,,,
14295,30-1-0-40-B,6758-44-2831,SNGL FAM SUB,2.51,AC,68900,0,68900,214200,32000,315100,64800,0,64800,176700,28200,269700,A2,AG/LTD,,,
14296,30-1-0-40-C,6758-44-6609,SNGL FAM SUB,4.25,AC,85000,0,85000,433800,2500,521300,80500,0,80500,366900,2500,449900,A2,AG/LTD,,,
14297,31-26-0-D-1,6779-14-3424,SNGL FAM SUB,4.56,AC,106800,0,106800,587500,3700,698000,128900,0,128900,479100,2800,610800,A2,AG/LTD,,,
14298,39-1-0-39-A,6717-93-4185,SNGL FAM SUB,3.379,AC,52100,0,52100,51300,8500,111900,51100,0,51100,44800,8500,104400,A1,AG/GEN,,,
14299,39-1-0-39-B,6717-93-8084,SNGL FAM SUB,2.186,AC,45400,0,45400,148500,0,193900,44500,0,44500,131200,0,175700,A1,AG/GEN,,,
14301,44-1-0-10-D,6777-77-5828,Cemetery,1,AC,100,0,100,0,0,100,100,0,100,0,0,100,RP,"RURAL,P",,,
14302,44-1-0-10-E,6787-06-0679,Cemetery,0,AC,100,0,100,0,0,100,100,0,100,0,0,100,A2,AG/LTD,,,
14303,47-1-0-81-A1,7716-98-5228,COMM & IND,1.886,AC,1261100,0,1261100,383600,208500,1853200,1146400,0,1146400,382800,127300,1656500,B1,BUS/GEN,,,
14304,53-1-0-6-A1,6766-25-9047,SNGL FAM SUB,1.04,AC,1800,0,1800,0,0,1800,1600,0,1600,0,0,1600,A2,AG/LTD,,,
14305,56-16-0-13-0,6795-74-0474,AG 20-100 AC,42.52,AC,1045900,0,1045900,729200,42700,1817800,910500,0,910500,761300,40600,1712400,RR,RES/RUR,,,
14306,16-1-0-78-A,5799-67-5972,AG > 100 AC,100.59,AC,234700,149500,85200,309000,20600,564300,229200,148800,80400,268100,20700,518000,A1,AG/GEN,,,
14307,16-1-0-78-B,5799-66-0308,AG > 100 AC,108.869,AC,170800,118600,52200,0,0,170800,167700,121200,46500,0,0,167700,A1,AG/GEN,,,
14308,16-3-0-3-B,5799-36-7996,AG > 100 AC,107,AC,172200,120100,52100,0,0,172200,169000,123000,46000,0,0,169000,A1,AG/GEN,,,
14309,16-3-0-3-A,5799-48-1065,SNGL FAM SUB,9.958,AC,66400,23200,43200,342900,48600,457900,63500,21600,41900,298000,44600,406100,A1,AG/GEN,,,
14311,44-18-0-5-A,6786-28-4945,Cemetery,0,AC,100,0,100,0,0,100,100,0,100,0,0,100,A2,AG/LTD,,,
14312,43-1-0-3-A1,6768-70-5039,SNGL FAM SUB,6.36,AC,147300,74700,72600,389100,0,536400,131700,66800,64900,321600,0,453300,A2,AG/LTD,,,
14313,43-1-0-3-A3,6768-70-5768,SNGL FAM SUB,2.38,AC,90000,0,90000,234200,6400,330600,80400,0,80400,199400,5900,285700,A2,AG/LTD,,,
14314,45-22-0-1-0,6797-47-7850,COMM & IND,2.226,AC,212300,0,212300,0,0,212300,196700,0,196700,0,0,196700,B1,BUS/GEN,,,
14315,45-22-0-2-0,6797-47-9702,COMM & IND,2.682,AC,242300,0,242300,0,0,242300,224500,0,224500,0,0,224500,B1,BUS/GEN,,,
14316,45-22-0-3-0,6797-57-0663,COMM & IND,2.682,AC,242300,0,242300,63700,3200,309200,224500,0,224500,50800,3200,278500,B1,BUS/GEN,,,
14317,45-22-0-4-0,6797-57-2536,COMM & IND,1.982,AC,179100,0,179100,0,0,179100,165900,0,165900,0,0,165900,B1,BUS/GEN,,,
14318,45-22-0-5-0,6797-57-4575,COMM & IND,2.634,AC,194600,0,194600,0,0,194600,180300,0,180300,0,0,180300,B1,BUS/GEN,,,
14349,29-8-0-1-D,6749-97-5372,SNGL FAM SUB,2.96,AC,73200,0,73200,211300,800,285300,69300,0,69300,176000,800,246100,A1,AG/GEN,,,
14350,11-1-0-3-C,6812-97-5209,SNGL FAM SUB,5.08,AC,60500,0,60500,266200,2600,329300,59400,0,59400,234400,2700,296500,A1,AG/GEN,,,
14351,10-1-0-36-A,6812-43-7456,AG 20-100 AC,30.503,AC,107000,92100,14900,0,2000,109000,106800,93800,13000,0,2000,108800,A1,AG/GEN,,,
14352,10-1-0-37-A,6812-62-5070,AG 20-100 AC,47.619,AC,23000,0,23000,0,0,23000,20400,0,20400,0,0,20400,A1,AG/GEN,,,
14353,11-1-0-55-A,6822-66-6607,SNGL FAM SUB,8.64,AC,92000,0,92000,267000,56300,415300,81900,0,81900,215500,39500,336900,A1,AG/GEN,,,
14654,13-20-0-5-0,6832-97-4773,AG 20-100 AC,20.09,AC,124600,115300,9300,0,0,124600,121700,113200,8500,0,0,121700,A1,AG/GEN,,,
14655,56-17-0-3-0,6795-48-4061,AG 20-100 AC,22.5,AC,557500,547100,10400,0,0,557500,484400,474800,9600,0,0,484400,A2,AG/LTD,,,
14656,13-20-0-6-0,6842-06-6528,AG 20-100 AC,35.06,AC,177800,161600,16200,0,0,177800,169500,154600,14900,0,0,169500,A1,AG/GEN,,,
14657,56-17-0-4-0,6795-48-5716,AG 20-100 AC,25.4,AC,668100,370800,297300,4460600,232000,5360700,580500,321500,259000,4185900,188300,4954700,A2,AG/LTD,,,
14658,13-20-0-7-0,6832-95-4683,AG 20-100 AC,25,AC,133800,122300,11500,0,0,133800,130200,119600,10600,0,0,130200,A1,AG/GEN,,,
14659,16-1-0-51-C,5890-67-7517,SNGL FAM SUB,17.143,AC,88300,0,88300,289100,0,377400,86400,0,86400,246100,0,332500,A1,AG/GEN,,,
14660,16-1-0-51-D,5890-67-2155,SNGL FAM SUB,17.143,AC,88300,35700,52600,0,8000,96300,86400,33800,52600,0,8100,94500,A1,AG/GEN,,,
14661,17-1-0-1-A,6801-41-2712,AG 20-100 AC,48.651,AC,163100,136400,26700,0,0,163100,157100,132400,24700,0,0,157100,A1,AG/GEN,,,
14662,17-1-0-1-B,6801-41-6211,AG 20-100 AC,21.811,AC,57600,0,57600,0,0,57600,54500,0,54500,0,0,54500,A1,AG/GEN,,,
14663,17-1-0-101-B,6810-45-8822,SNGL FAM SUB,2,AC,46000,0,46000,11800,0,57800,43500,0,43500,12100,0,55600,A1,AG/GEN,,,
14664,19-1-0-45-C,6831-60-8815,SNGL FAM SUB,2.78,AC,71200,0,71200,50100,1800,123100,67500,0,67500,42600,1800,111900,A1,AG/GEN,,,
14814,65-2-B-23-0,7733-77-2302,SNGL FAM URB,0.347,AC,230000,0,230000,582600,26400,839000,200000,0,200000,539000,26000,765000,RPUD,RES/PUD,,,
14815,65-2-B-24-0,7733-77-0392,SNGL FAM URB,0.344,AC,230000,0,230000,615900,20100,866000,200000,0,200000,566500,19200,785700,RPUD,RES/PUD,,,
14816,65-2-B-25-0,7733-67-9392,SNGL FAM URB,0.345,AC,230000,0,230000,687900,14200,932100,200000,0,200000,633600,14700,848300,RPUD,RES/PUD,,,
14817,65-2-B-26-0,7733-67-9301,SNGL FAM URB,0.367,AC,230000,0,230000,573300,0,803300,200000,0,200000,525800,0,725800,RPUD,RES/PUD,,,
14818,65-2-B-27-0,7733-67-7257,SNGL FAM URB,1.018,AC,253000,0,253000,819300,0,1072300,220000,0,220000,753200,0,973200,RPUD,RES/PUD,,,
14820,65-2-B-29-0,7733-67-6191,SNGL FAM URB,0.346,AC,230000,0,230000,590100,1300,821400,200000,0,200000,542300,1300,743600,RPUD,RES/PUD,,,
14821,66-2-0-A-3,7723-06-7675,SNGL FAM SUB,3.134,AC,276800,0,276800,382500,0,659300,240700,0,240700,347700,0,588400,A2,AG/LTD,,,
14822,67-1-0-3-A,7723-44-6585,SNGL FAM SUB,2.684,AC,390000,0,390000,375700,2000,767700,340000,0,340000,330600,2100,672700,R1,RES/LTD,,,
14823,68-3-B-15-0,7733-76-4864,SNGL FAM URB,0.37,AC,230000,0,230000,602100,0,832100,200000,0,200000,550700,0,750700,RPUD,RES/PUD,,,
14824,68-3-B-16-0,7733-76-5903,SNGL FAM URB,0.338,AC,230000,0,230000,698400,6600,935000,200000,0,200000,644400,6000,850400,RPUD,RES/PUD,,,
14825,68-3-B-17-0,7733-77-5023,SNGL FAM URB,0.473,AC,230000,0,230000,770700,0,1000700,200000,0,200000,711000,0,911000,RPUD,RES/PUD,,,
14826,68-3-B-18-0,7733-77-6101,SNGL FAM URB,0.397,AC,230000,0,230000,539000,0,769000,200000,0,200000,496700,0,696700,RPUD,RES/PUD,,,
14827,68-3-C-42-0,7733-76-2836,SNGL FAM URB,0.418,AC,230000,0,230000,642800,0,872800,200000,0,200000,588000,0,788000,RPUD,RES/PUD,,,
14828,68-3-C-44-0,7733-77-3008,SNGL FAM URB,0.413,AC,230000,0,230000,611600,0,841600,200000,0,200000,563000,0,763000,RPUD,RES/PUD,,,
14829,68-3-C-45-0,7733-77-2103,SNGL FAM URB,0.383,AC,230000,0,230000,522800,0,752800,200000,0,200000,484000,0,684000,RPUD,RES/PUD,,,
14830,68-3-C-46-0,7733-77-1102,SNGL FAM URB,0.344,AC,230000,0,230000,572600,0,802600,200000,0,200000,529300,0,729300,RPUD,RES/PUD,,,
14831,68-3-C-47-0,7733-67-9193,SNGL FAM URB,0.395,AC,230000,0,230000,623100,15200,868300,200000,0,200000,572900,14800,787700,RPUD,RES/PUD,,,
14832,68-3-C-49-0,7733-66-8964,SNGL FAM URB,0.435,AC,230000,0,230000,605900,0,835900,200000,0,200000,558200,0,758200,RPUD,RES/PUD,,,
14835,2-1-0-16-A,6814-74-6236,SNGL FAM SUB,3.32,AC,51500,0,51500,20800,0,72300,50600,0,50600,20600,0,71200,A1,AG/GEN,,,
14836,26-1-0-65-F,6719-14-5887,SNGL FAM SUB,6.826,AC,73200,0,73200,0,0,73200,73000,0,73000,0,0,73000,A1,AG/GEN,,,
14837,29-1-0-75-C1,6749-44-1887,SNGL FAM SUB,2.26,AC,57000,0,57000,122800,3000,182800,54500,0,54500,103300,3000,160800,A1,AG/GEN,,,
14838,40-4-0-E-2,6737-63-3574,SNGL FAM SUB,3,AC,62200,0,62200,187100,0,249300,61000,0,61000,160000,0,221000,A1,AG/GEN,,,
14839,56-15-0-A-0,6795-96-0921,Roads,1.039,AC,0,0,0,0,0,0,0,0,0,0,0,0,RR,RES/RUR,,,
14840,57-29-0-A-0,7705-17-7997,Roads,7.321,AC,0,0,0,0,0,0,0,0,0,0,0,0,RR,RES/RUR,,,
14841,57-29-0-B-0,7705-18-3664,Roads,0.059,AC,0,0,0,0,0,0,0,0,0,0,0,0,RR,RES/RUR,,,
14354,11-1-0-55-B,6822-66-8888,SNGL FAM SUB,7.65,AC,85300,0,85300,326100,4400,415800,75400,0,75400,0,0,75400,A1,AG/GEN,,,
14356,12-1-0-71-E,6831-43-7100,SNGL FAM SUB,4,AC,72900,0,72900,128100,6500,207500,68100,0,68100,99600,6500,174200,A1,AG/GEN,,,
14357,13-1-0-44-C1,6841-83-0778,SNGL FAM SUB,2,AC,58600,0,58600,85600,14900,159100,57500,0,57500,72600,13600,143700,A1,AG/GEN,,,
14358,16-1-0-89-A,6800-24-8494,AG 20-100 AC,59.17,AC,123800,95400,28400,0,0,123800,117400,92200,25200,0,0,117400,A1,AG/GEN,,,
14359,17-1-0-90-A,6810-20-9526,SNGL FAM SUB,3,AC,52000,0,52000,251000,22200,325200,49000,0,49000,204200,18200,271400,A1,AG/GEN,,,
14360,17-1-0-93-B1,6810-21-0789,SNGL FAM SUB,2.44,AC,48600,0,48600,204800,0,253400,45900,0,45900,168400,0,214300,A1,AG/GEN,,,
14361,20-18-0-1-0,6840-12-9495,SNGL FAM SUB,5.001,AC,89000,0,89000,210200,14500,313700,83100,0,83100,179600,14100,276800,A1,AG/GEN,,,
14362,20-18-0-2-0,6840-22-2393,SNGL FAM SUB,2.05,AC,64300,0,64300,163400,16600,244300,60800,0,60800,135600,14000,210400,A1,AG/GEN,,,
14363,20-18-0-3-0,6840-22-4267,SNGL FAM SUB,2,AC,63800,0,63800,237800,1600,303200,60300,0,60300,197200,1600,259100,A1,AG/GEN,,,
14364,20-18-0-4-0,6840-22-6241,SNGL FAM SUB,2.27,AC,66400,0,66400,362800,1100,430300,63100,0,63100,302900,1100,367100,A1,AG/GEN,,,
14365,21-1-0-54-A,6850-83-3125,SNGL FAM SUB,0.44,AC,4400,0,4400,0,0,4400,3700,0,3700,0,0,3700,A2,AG/LTD,,,
14366,26-12-0-1-0,6718-18-5850,SNGL FAM SUB,4.742,AC,61600,0,61600,0,0,61600,60500,0,60500,0,0,60500,RR,RES/RUR,,,
14367,26-12-0-2-0,6718-28-1509,SNGL FAM SUB,5.982,AC,69200,0,69200,201600,7900,278700,67900,0,67900,185500,7700,261100,RR,RES/RUR,,,
14368,26-12-0-3-0,6718-28-1290,SNGL FAM SUB,8.513,AC,84600,0,84600,522700,73500,680800,83100,0,83100,445700,67600,596400,RR,RES/RUR,,,
14369,26-12-0-4-0,6718-18-6149,SNGL FAM SUB,4.8,AC,62000,0,62000,372700,19000,453700,60800,0,60800,319500,16800,397100,RR,RES/RUR,,,
14370,26-12-0-5-0,6718-27-1628,SNGL FAM SUB,10.629,AC,97500,0,97500,447700,11900,557100,95800,0,95800,381500,10900,488200,RR,RES/RUR,,,
14371,26-12-0-6-0,6718-17-9263,SNGL FAM SUB,6.836,AC,80200,0,80200,0,0,80200,78700,0,78700,0,0,78700,RR,RES/RUR,,,
14372,26-12-0-7-0,6718-16-6970,SNGL FAM SUB,4.41,AC,59600,0,59600,257100,7300,324000,58500,0,58500,220000,6600,285100,RR,RES/RUR,,,
14373,26-12-0-8-0,6718-26-1738,SNGL FAM SUB,5.969,AC,69100,0,69100,286700,0,355800,67800,0,67800,271200,0,339000,RR,RES/RUR,,,
14374,26-12-0-9-0,6718-26-0269,SNGL FAM SUB,7.673,AC,79500,0,79500,223300,0,302800,78000,0,78000,191100,0,269100,RR,RES/RUR,,,
14375,26-12-0-10-0,6718-16-5340,SNGL FAM SUB,7.15,AC,76300,0,76300,376300,4400,457000,74900,0,74900,321800,4400,401100,RR,RES/RUR,,,
14376,26-12-0-10-A,6718-16-6068,Cemetery,0,AC,100,0,100,0,0,100,100,0,100,0,0,100,RR,RES/RUR,,,
14377,26-12-0-11-0,6718-15-5744,SNGL FAM SUB,6.62,AC,70300,0,70300,263400,2800,336500,68900,0,68900,223900,3000,295800,RR,RES/RUR,,,
14378,26-12-0-12-0,6718-15-9552,SNGL FAM SUB,8.734,AC,69800,0,69800,323500,0,393300,68500,0,68500,270700,0,339200,RR,RES/RUR,,,
14379,26-12-0-13-0,6718-14-7946,SNGL FAM SUB,8.031,AC,78200,0,78200,0,0,78200,76700,0,76700,0,0,76700,RR,RES/RUR,,,
14380,26-12-0-14-0,6718-15-2152,SNGL FAM SUB,4.61,AC,60800,0,60800,351300,200,412300,59700,0,59700,195600,200,255500,RR,RES/RUR,,,
14381,26-12-0-15-0,6718-14-4600,SNGL FAM SUB,8.134,AC,85900,0,85900,171400,38900,296200,84400,0,84400,171400,35000,290800,RR,RES/RUR,,,
14382,26-12-0-16-0,6718-14-5088,SNGL FAM SUB,8.795,AC,86400,0,86400,373600,24800,484800,84800,0,84800,325900,21600,432300,RR,RES/RUR,,,
14383,26-12-0-17-0,6718-13-4714,SNGL FAM SUB,8.873,AC,86800,0,86800,244900,19100,350800,85200,0,85200,209400,16400,311000,RR,RES/RUR,,,
14384,27-1-0-54-A,6729-27-3089,SNGL FAM SUB,3.49,AC,54800,0,54800,0,0,54800,51700,0,51700,0,0,51700,A1,AG/GEN,,,
14385,27-1-0-54-B,6729-26-8876,SNGL FAM SUB,2.84,AC,51000,0,51000,0,0,51000,48100,0,48100,0,0,48100,A1,AG/GEN,,,
14386,27-1-0-54-C,6729-25-3987,SNGL FAM SUB,2.54,AC,49200,48000,1200,0,0,49200,46500,45400,1100,0,0,46500,A1,AG/GEN,,,
14387,27-3-0-2-B,6728-45-1471,SNGL FAM SUB,2.1,AC,45500,0,45500,120700,0,166200,44600,0,44600,100100,0,144700,A1,AG/GEN,,,
14388,27-3-0-2-C,6728-45-1291,SNGL FAM SUB,2.17,AC,45900,0,45900,128400,400,174700,45000,0,45000,111100,400,156500,A1,AG/GEN,,,
14389,28-1-0-2-B,6729-95-4139,SNGL FAM SUB,2,AC,54600,0,54600,177200,800,232600,52000,0,52000,150800,800,203600,A1,AG/GEN,,,
14390,30-1-0-21-B,6759-41-0963,SNGL FAM SUB,1.9,AC,4700,0,4700,0,0,4700,2400,0,2400,0,0,2400,A2,AG/LTD,,,
14391,30-1-0-21-C,6759-31-5712,SNGL FAM SUB,2.33,AC,61800,0,61800,0,0,61800,57400,0,57400,0,0,57400,A1,AG/GEN,,,
14392,30-1-0-21-D,6759-31-7627,SNGL FAM SUB,2.33,AC,61800,0,61800,0,0,61800,58700,0,58700,0,0,58700,A1A2,AG GEN/,,,
14393,30-1-0-21-E,6759-31-9645,SNGL FAM SUB,2.33,AC,61800,0,61800,0,0,61800,58700,0,58700,0,0,58700,A2,AG/LTD,,,
14395,30-14-0-3-A,6758-72-1523,Cemetery,0,AC,100,0,100,0,0,100,100,0,100,0,0,100,A2,AG/LTD,,,
14396,31-1-0-83-D,6778-09-3879,SNGL FAM SUB,6.15,AC,125900,0,125900,439300,78600,643800,112300,0,112300,371000,70800,554100,A2,AG/LTD,,,
14397,31-1-0-83-E,6778-19-2830,AG 20-100 AC,22.31,AC,279300,205400,73900,812800,0,1092100,249000,182700,66300,675400,0,924400,A2,AG/LTD,,,
14398,31-1-0-83-C,6778-09-6234,AG 20-100 AC,21.29,AC,295400,221700,73700,386100,0,681500,264200,198300,65900,316500,0,580700,A2,AG/LTD,,,
14399,31-25-0-A-0,6778-03-3849,Cmn Area/Open Spc,1.11,AC,0,0,0,0,0,0,0,0,0,0,0,0,RR,RES/RUR,,,
14400,33-8-0-2-0,6798-26-9527,COMM & IND,3.722,AC,260200,0,260200,0,0,260200,247900,0,247900,0,0,247900,M1,INDUS/L,,,
14401,33-8-0-3-0,6798-36-1724,COMM & IND,2.739,AC,191500,0,191500,498500,108300,798300,182400,0,182400,465900,111900,760200,M1,INDUS/L,,,
14402,33-8-0-4-0,6798-36-4628,COMM & IND,2.457,AC,171700,0,171700,457400,102600,731700,163600,0,163600,423200,104700,691500,M1,INDUS/L,,,
14403,33-8-0-5-0,6798-36-6495,COMM & IND,3.92,AC,274000,0,274000,1364800,482500,2121300,261100,0,261100,1236200,496400,1993700,M1,INDUS/L,,,
14404,33-8-0-6-0,6798-36-4273,COMM & IND,2.775,AC,194000,0,194000,117700,36700,348400,184800,0,184800,109300,37200,331300,M1,INDUS/L,,,
14405,33-8-0-1-0,6798-26-8229,COMM & IND,2.844,AC,198800,0,198800,924100,136600,1259500,189400,0,189400,856200,139200,1184800,M1,INDUS/L,,,
14406,39-10-0-1-0,6726-36-0719,SNGL FAM SUB,3.91,AC,56600,0,56600,98700,2500,157800,55500,0,55500,80700,2800,139000,A1,AG/GEN,,,
14407,40-7-0-3-0,6736-18-9689,SNGL FAM SUB,7.58,AC,88400,0,88400,164500,10500,263400,86800,0,86800,143100,10400,240300,A1,AG/GEN,,,
14408,40-1-0-25-A,6736-78-0470,AG > 100 AC,673.63,AC,2456000,1781200,674800,341400,664100,3461500,2403100,1758900,644200,305200,664100,3372400,A1,AG/GEN,,,
14409,40-1-0-25-B,6737-92-0111,Cemetery,0,AC,100,0,100,0,0,100,100,0,100,0,0,100,A1,AG/GEN,,,
14410,40-4-0-B-2,6737-62-5917,SNGL FAM SUB,2.218,AC,57600,0,57600,331300,0,388900,56500,0,56500,281400,0,337900,A1,AG/GEN,,,
14411,12-1-0-71-D,6831-43-4343,SNGL FAM SUB,2.4,AC,60600,0,60600,394700,39000,494300,55600,0,55600,349200,26000,430800,A1,AG/GEN,,,
14412,43-1-0-3-A2,6768-70-2602,SNGL FAM SUB,6.18,AC,134900,0,134900,270800,1500,407200,120600,0,120600,222000,1500,344100,A2,AG/LTD,,,
14413,43-1-0-3-A4,6768-70-8680,SNGL FAM SUB,4.72,AC,123700,0,123700,275500,47000,446200,110600,0,110600,225000,39300,374900,A2,AG/LTD,,,
14415,43-1-0-3-B,6767-79-5324,SNGL FAM SUB,2,AC,78500,0,78500,83100,1200,162800,70100,0,70100,66300,1200,137600,A2,AG/LTD,,,
14416,44-1-0-49-A,6787-43-6893,SNGL FAM SUB,2.86,AC,98200,0,98200,263600,2500,364300,87700,0,87700,215600,2500,305800,A2,AG/LTD,,,
14417,44-1-0-49-B,6787-54-0242,SNGL FAM SUB,4.73,AC,123800,0,123800,255700,0,379500,110700,0,110700,210500,0,321200,A2,AG/LTD,,,
14418,44-1-0-49-C,6787-54-1626,SNGL FAM SUB,9.92,AC,177100,0,177100,293100,28600,498800,158000,0,158000,246000,25200,429200,A2,AG/LTD,,,
14419,44-13-0-A-1,6787-62-1758,SNGL FAM SUB,2.32,AC,88300,0,88300,236800,0,325100,78800,0,78800,198800,0,277600,A2,AG/LTD,,,
14420,44-13-0-A-2,6787-62-1531,SNGL FAM SUB,2.5,AC,90800,0,90800,148500,0,239300,81100,0,81100,113200,0,194300,A2,AG/LTD,,,
14421,44-13-0-A-3,6787-62-1272,SNGL FAM SUB,3.17,AC,100000,0,100000,0,0,100000,89300,0,89300,0,0,89300,A2,AG/LTD,,,
14422,44-13-0-A-4,6787-61-2825,SNGL FAM SUB,2.33,AC,88500,0,88500,0,0,88500,79000,0,79000,0,0,79000,A2,AG/LTD,,,
14423,44-20-0-5-B,6787-42-3218,SNGL FAM SUB,3.58,AC,94100,0,94100,71600,0,165700,83900,0,83900,57400,0,141300,A2,AG/LTD,,,
14424,44-20-0-5-C,6787-31-7069,SNGL FAM SUB,6.799,AC,139700,0,139700,0,0,139700,124600,0,124600,0,0,124600,A2,AG/LTD,,,
14425,45-1-0-1-E1,6788-91-2017,COMM & IND,2.459,AC,623600,0,623600,461100,257100,1341800,577400,0,577400,495800,157800,1231000,B1,BUS/GEN,,,
14426,45-1-0-56-C,6787-97-7338,SNGL FAM SUB,2,AC,85900,0,85900,155100,500,241500,76700,0,76700,125900,500,203100,A2,AG/LTD,,,
14427,46-1-0-3-B,7708-11-7479,SNGL FAM SUB,5,AC,162800,0,162800,0,0,162800,145300,0,145300,0,0,145300,A2,AG/LTD,,,
14428,46-1-0-3-C,7708-11-5999,SNGL FAM SUB,5,AC,162800,0,162800,0,0,162800,145300,0,145300,0,0,145300,A2,AG/LTD,,,
14429,46-16-0-F-2A,7707-82-2791,SNGL FAM SUB,3,AC,143400,0,143400,242300,41700,427400,128000,0,128000,201500,35200,364700,A2,AG/LTD,,,
14430,46-25-0-2-A,7708-32-9053,SNGL FAM SUB,3,AC,127600,0,127600,284300,41300,453200,113900,0,113900,241600,34900,390400,A2,AG/LTD,,,
14431,47-1-0-43-P2,7726-08-4918,COMM & IND,0.739,AC,308900,0,308900,309000,4700,622600,280800,0,280800,293900,4700,579400,B1,BUS/GEN,,,
14432,47-27-0-8-B,7726-07-3592,COMM & IND,2.556,AC,1114900,0,1114900,2139100,74900,3328900,1061800,0,1061800,2111400,52300,3225500,B1,BUS/GEN,,,
14433,47-30-0-1-0,7717-21-7452,SNGL FAM SUB,3.85,AC,142600,0,142600,279400,25100,447100,127200,0,127200,239900,21200,388300,RR,RES/RUR,,,
14434,47-30-0-2-0,7717-21-4258,SNGL FAM SUB,6.27,AC,185200,0,185200,338600,46100,569900,165200,0,165200,283600,43200,492000,RR,RES/RUR,,,
14436,47-30-0-4-0,7717-21-2815,SNGL FAM SUB,3.17,AC,130600,0,130600,412400,600,543600,116600,0,116600,357200,600,474400,RR,RES/RUR,,,
14437,48-1-0-8-C,7728-61-6122,COMM & IND,13.16,AC,460900,320500,140400,70700,0,531600,429100,296500,132600,70700,0,499800,A2,AG/LTD,,,
14438,48-1-0-8-D,7728-80-1925,SNGL FAM SUB,4.17,AC,195700,193600,2100,0,0,195700,174600,172800,1800,0,0,174600,A2,AG/LTD,,,
14441,50-8-0-2-0,6726-36-0577,SNGL FAM SUB,3.09,AC,51500,0,51500,146000,35300,232800,50500,0,50500,124400,33300,208200,A1,AG/GEN,,,
14442,50-8-0-3-A,6726-26-9384,SNGL FAM SUB,0.17,AC,1000,0,1000,0,0,1000,1000,0,1000,0,0,1000,A1,AG/GEN,,,
14443,50-8-0-4-0,6726-36-3008,SNGL FAM SUB,2.04,AC,45100,0,45100,147000,48100,240200,44200,0,44200,125400,43300,212900,A1,AG/GEN,,,
14444,50-8-0-4-A,6726-36-1070,SNGL FAM SUB,0.04,AC,200,0,200,0,0,200,200,0,200,0,0,200,A1,AG/GEN,,,
14445,55-1-0-61-A,6786-85-0150,SNGL FAM SUB,2.38,AC,92900,0,92900,213700,600,307200,82900,0,82900,174700,600,258200,A2,AG/LTD,,,
14447,58-8-0-2-A1,7715-99-2463,SNGL FAM SUB,0.04,AC,900,0,900,0,0,900,800,0,800,0,0,800,A2,AG/LTD,,,
14448,58-9-0-A-1,7715-93-6725,Cemetery,0,AC,100,0,100,0,0,100,100,0,100,0,0,100,A2,AG/LTD,,,
14450,58-9-0-C-0,7725-03-0423,SNGL FAM SUB,17.07,AC,656200,0,656200,717600,29600,1403400,570800,0,570800,633400,25400,1229600,A2,AG/LTD,,,
14451,58-9-0-2-0,7715-72-9238,SNGL FAM SUB,3.26,AC,215200,0,215200,618000,21500,854700,187300,0,187300,522600,18300,728200,A2,AG/LTD,,,
14452,58-9-0-3-0,7715-82-1501,SNGL FAM SUB,3.6,AC,224200,0,224200,461100,8000,693300,195000,0,195000,390300,8000,593300,A2,AG/LTD,,,
14453,58-9-0-4-0,7715-82-2812,SNGL FAM SUB,3.22,AC,214200,0,214200,494700,0,708900,186300,0,186300,438400,0,624700,A2,AG/LTD,,,
14454,62-1-0-31-D,7704-66-9181,COMM & IND,16.3,AC,24500,0,24500,0,1674200,1698700,22800,0,22800,0,1669400,1692200,A2,AG/LTD,,,
14455,62-31-B-3-0,7704-57-7506,SNGL FAM SUB,4.644,AC,432000,0,432000,424700,64100,920800,360000,0,360000,404000,60300,824300,RR,RES/RUR,,,
14456,62-32-0-A-0,7704-66-4499,Cmn Area/Open Spc,14.15,AC,0,0,0,0,0,0,0,0,0,0,0,0,R1,RES/LTD,,,
14457,62-32-0-A-1,7704-76-5861,TAXED -SCC,0.23,AC,0,0,0,0,0,0,0,0,0,0,0,0,R1,RES/LTD,,,
14458,62-32-0-B-0,7704-77-8925,Cmn Area/Open Spc,13.89,AC,0,0,0,0,0,0,0,0,0,0,0,0,R1,RES/LTD,,,
14459,62-32-0-1-0,7704-66-8913,SNGL FAM SUB,4.25,AC,297000,0,297000,748100,5500,1050600,270000,0,270000,728600,4600,1003200,R1,RES/LTD,,,
14460,62-32-0-2-0,7704-67-6271,SNGL FAM SUB,3.38,AC,297000,0,297000,331200,1000,629200,270000,0,270000,331600,1000,602600,R1,RES/LTD,,,
14461,62-32-0-3-0,7704-67-5594,SNGL FAM SUB,3.4,AC,297000,0,297000,677600,0,974600,270000,0,270000,682600,0,952600,R1,RES/LTD,,,
14462,62-32-0-4-0,7704-67-2239,SNGL FAM SUB,4.4,AC,297000,0,297000,619700,0,916700,270000,0,270000,632400,0,902400,R1,RES/LTD,,,
14463,62-32-0-5-0,7704-66-2955,SNGL FAM SUB,2.84,AC,297000,0,297000,567000,0,864000,270000,0,270000,532100,0,802100,R1,RES/LTD,,,
14464,62-32-0-6-0,7704-66-5642,SNGL FAM SUB,3.38,AC,297000,0,297000,504400,13200,814600,270000,0,270000,500700,13200,783900,R1,RES/LTD,,,
14465,62-32-0-7-0,7704-66-3367,SNGL FAM SUB,3,AC,275000,0,275000,326500,1200,602700,250000,0,250000,321900,1200,573100,R1,RES/LTD,,,
14466,62-32-0-9-0,7704-57-7074,SNGL FAM SUB,4.54,AC,275000,0,275000,674800,201100,1150900,250000,0,250000,667900,179800,1097700,R1,RES/LTD,,,
14467,62-32-0-10-0,7704-67-1628,SNGL FAM SUB,4.03,AC,275000,0,275000,678300,0,953300,250000,0,250000,647100,0,897100,R1,RES/LTD,,,
14468,62-32-0-11-0,7704-67-4988,SNGL FAM SUB,4.22,AC,275000,0,275000,394600,1000,670600,250000,0,250000,369000,1000,620000,R1,RES/LTD,,,
14469,62-32-0-12-0,7704-68-6297,SNGL FAM SUB,4.19,AC,275000,0,275000,0,0,275000,250000,0,250000,0,0,250000,R1,RES/LTD,,,
14470,62-32-0-13-0,7704-68-8569,SNGL FAM SUB,4.22,AC,275000,0,275000,516700,52500,844200,250000,0,250000,516500,47900,814400,R1,RES/LTD,,,
14471,62-32-0-14-0,7704-78-0983,SNGL FAM SUB,4.66,AC,275000,0,275000,806300,0,1081300,250000,0,250000,786600,0,1036600,R1,RES/LTD,,,
14472,62-32-0-15-0,7704-79-3223,SNGL FAM SUB,4.35,AC,275000,0,275000,556400,0,831400,250000,0,250000,537800,0,787800,R1,RES/LTD,,,
14473,62-32-0-16-0,7704-79-5449,SNGL FAM SUB,5.14,AC,275000,0,275000,457600,0,732600,250000,0,250000,461600,0,711600,R1,RES/LTD,,,
14474,62-32-0-17-0,7704-79-6892,SNGL FAM SUB,4.53,AC,275000,0,275000,623700,0,898700,250000,0,250000,628400,0,878400,R1,RES/LTD,,,
14475,62-32-0-18-0,7705-70-9206,SNGL FAM SUB,5.75,AC,275000,0,275000,473500,3500,752000,250000,0,250000,469300,3500,722800,R1,RES/LTD,,,
14476,62-32-0-19-0,7705-80-2144,SNGL FAM SUB,5.93,AC,275000,0,275000,0,0,275000,250000,0,250000,0,0,250000,R1,RES/LTD,,,
14477,62-32-0-20-0,7704-89-3679,SNGL FAM SUB,4.53,AC,275000,0,275000,0,0,275000,250000,0,250000,0,0,250000,R1,RES/LTD,,,
14478,62-32-0-21-0,7704-89-1426,SNGL FAM SUB,2.75,AC,275000,0,275000,633600,17300,925900,250000,0,250000,629600,14400,894000,R1,RES/LTD,,,
14479,62-32-0-23-0,7704-78-8920,SNGL FAM SUB,3.35,AC,297000,0,297000,207300,0,504300,270000,0,270000,192600,0,462600,R1,RES/LTD,,,
14480,62-32-0-24-0,7704-78-6721,SNGL FAM SUB,3.46,AC,297000,0,297000,823900,0,1120900,270000,0,270000,781300,0,1051300,R1,RES/LTD,,,
14481,62-32-0-25-0,7704-78-5451,SNGL FAM SUB,4.35,AC,302500,0,302500,707300,0,1009800,275000,0,275000,721400,0,996400,R1,RES/LTD,,,
14482,62-32-0-26-0,7704-78-2152,SNGL FAM SUB,5.85,AC,302500,0,302500,458100,0,760600,275000,0,275000,466200,0,741200,R1,RES/LTD,,,
14483,62-32-0-27-0,7704-77-1727,SNGL FAM SUB,5.01,AC,297000,0,297000,0,0,297000,270000,0,270000,0,0,270000,R1,RES/LTD,,,
14484,62-32-0-28-0,7704-77-1469,SNGL FAM SUB,4.22,AC,297000,0,297000,538300,0,835300,270000,0,270000,553000,0,823000,R1,RES/LTD,,,
14485,62-32-0-29-0,7704-77-3159,SNGL FAM SUB,4.22,AC,247500,0,247500,375200,0,622700,225000,0,225000,388000,0,613000,R1,RES/LTD,,,
14486,63-13-0-1-0,7715-72-6091,SNGL FAM SUB,3.51,AC,155300,0,155300,269700,0,425000,135100,0,135100,227100,0,362200,A2,AG/LTD,,,
14487,64-7-0-B-1A,7734-02-2227,COMM & IND,0.382,AC,92500,0,92500,262700,0,355200,85600,0,85600,259400,0,345000,B1,BUS/GEN,,,
14488,67-4-0-4-A,7733-06-0095,SNGL FAM SUB,2.388,AC,228000,0,228000,639100,500,867600,198200,0,198200,563100,500,761800,A2,AG/LTD,,,
14489,67-4-0-4-B,7733-05-1804,SNGL FAM SUB,2.564,AC,234600,0,234600,1004800,37900,1277300,203900,0,203900,846700,35300,1085900,A2,AG/LTD,,,
14490,47-30-0-3-0,7717-21-2567,SNGL FAM SUB,3.79,AC,141500,0,141500,390200,1500,533200,126300,0,126300,328700,1500,456500,RR,RES/RUR,,,
14491,50-8-0-3-0,6726-36-2324,SNGL FAM SUB,2.39,AC,47300,0,47300,168100,0,215400,46300,0,46300,143500,0,189800,A1,AG/GEN,,,
14492,12-1-0-41-F,6831-24-8202,SNGL FAM SUB,3,AC,60200,0,60200,228000,3000,291200,58300,0,58300,195500,3000,256800,A1,AG/GEN,,,
14493,12-22-0-3-A,6832-90-3985,SNGL FAM SUB,5,AC,78500,0,78500,213500,35600,327600,77000,0,77000,183700,35100,295800,A1,AG/GEN,,,
14494,24-1-0-3-B,5799-04-7521,SNGL FAM SUB,0.057,AC,200,0,200,0,0,200,200,0,200,0,0,200,A1,AG/GEN,,,
14495,26-7-0-12-B,6708-85-4140,SNGL FAM SUB,7,AC,72400,0,72400,0,0,72400,71000,0,71000,0,0,71000,A1,AG/GEN,,,
14496,28-11-0-1-0,6728-96-4638,SNGL FAM SUB,8.44,AC,84200,0,84200,0,0,84200,82600,0,82600,0,0,82600,A1,AG/GEN,,,
14498,28-11-0-2-0,6728-86-8394,SNGL FAM SUB,7,AC,71500,0,71500,0,0,71500,70200,0,70200,0,0,70200,A1,AG/GEN,,,
14499,28-11-0-3-0,6728-86-0080,AG 20-100 AC,20.4,AC,122200,112800,9400,0,0,122200,119600,110900,8700,0,0,119600,A1,AG/GEN,,,
14500,28-11-0-4-0,6728-75-8293,AG 20-100 AC,20.4,AC,118300,108400,9900,0,0,118300,115800,107100,8700,0,0,115800,A1,AG/GEN,,,
14501,28-11-0-5-0,6728-84-1433,AG 20-100 AC,20.1,AC,117000,107700,9300,0,0,117000,114500,106000,8500,0,0,114500,A1,AG/GEN,,,
14502,28-11-0-6-0,6728-83-5896,AG 20-100 AC,20.52,AC,107300,97800,9500,0,0,107300,104900,96200,8700,0,0,104900,A1,AG/GEN,,,
14503,28-11-0-7-0,6728-94-5612,AG 20-100 AC,22.33,AC,121400,111100,10300,0,0,121400,118800,109300,9500,0,0,118800,A1,AG/GEN,,,
14504,28-11-0-8-0,6728-85-9089,AG 20-100 AC,20.6,AC,123200,113000,10200,0,0,123200,120500,111700,8800,0,0,120500,A1,AG/GEN,,,
14505,28-11-0-9-0,6728-95-0830,SNGL FAM SUB,10.3,AC,90900,47500,43400,0,16300,107200,89200,47300,41900,0,14300,103500,A1,AG/GEN,,,
14506,28-11-0-10-0,6728-95-5997,SNGL FAM SUB,7.89,AC,80800,0,80800,0,0,80800,79300,0,79300,0,0,79300,A1,AG/GEN,,,
14507,32-1-0-61-E,6789-04-8186,SNGL FAM SUB,0.2,AC,2900,0,2900,0,0,2900,2600,0,2600,0,0,2600,A2,AG/LTD,,,
14508,42-1-0-47-A,6767-03-6501,COMM & IND,1.155,AC,115200,0,115200,243100,34000,392300,110800,0,110800,225000,29800,365600,RO,RES/OF,,,
14509,15-1-0-8-C,5880-90-1286,AG > 100 AC,190.15,AC,390200,297700,92500,316000,0,706200,380300,294800,85500,0,0,380300,A1,AG/GEN,,,
14510,29-1-0-73-B1,6749-54-8797,SNGL FAM SUB,2.05,AC,57500,0,57500,97700,3500,158700,52900,0,52900,78300,4100,135300,A1,AG/GEN,,,
14511,29-19-0-A-1,6759-06-3765,SNGL FAM SUB,2.44,AC,68300,0,68300,123300,0,191600,64200,0,64200,101600,0,165800,A1,AG/GEN,,,
14512,30-1-0-39-C,6758-34-9558,SNGL FAM SUB,2.75,AC,71200,0,71200,233600,13700,318500,67200,0,67200,194100,12500,273800,A2,AG/LTD,,,
14513,55-1-0-14-L,6775-88-6315,State Exmm,5.739,AC,148300,0,148300,0,0,148300,132300,0,132300,0,0,132300,A2,AG/LTD,,,
14514,60-1-0-12-V,6784-37-1577,SNGL FAM SUB,0.46,AC,2700,0,2700,0,0,2700,2400,0,2400,0,0,2400,A2,AG/LTD,,,
14515,60-1-0-12-W,6784-26-7461,SNGL FAM SUB,1.93,AC,11200,0,11200,0,0,11200,10000,0,10000,0,0,10000,A2,AG/LTD,,,
14516,60-1-0-12-X,6784-36-0373,SNGL FAM SUB,0.27,AC,1600,0,1600,0,0,1600,1400,0,1400,0,0,1400,A2,AG/LTD,,,
14517,60-1-0-12-Y,6784-47-3027,SNGL FAM SUB,0.18,AC,1000,0,1000,0,0,1000,900,0,900,0,0,900,A2,AG/LTD,,,
14518,60-1-0-12-Z,6784-47-5109,SNGL FAM SUB,0.04,AC,200,0,200,0,0,200,200,0,200,0,0,200,A2,AG/LTD,,,
14519,60-1-0-12-AA,6784-47-6288,SNGL FAM SUB,0.06,AC,300,0,300,0,0,300,300,0,300,0,0,300,A2,AG/LTD,,,
14520,60-1-0-12-BB,6784-47-9389,SNGL FAM SUB,0.09,AC,500,0,500,0,0,500,500,0,500,0,0,500,A2,AG/LTD,,,
14521,60-1-0-12-CC,6784-58-4459,SNGL FAM SUB,0.06,AC,300,0,300,0,0,300,300,0,300,0,0,300,A2,AG/LTD,,,
14522,60-1-0-12-DD,6784-58-6432,SNGL FAM SUB,0.19,AC,1100,0,1100,0,0,1100,1000,0,1000,0,0,1000,A2,AG/LTD,,,
14523,60-1-0-12-EE,6784-58-8458,SNGL FAM SUB,0.06,AC,300,0,300,0,0,300,300,0,300,0,0,300,A2,AG/LTD,,,
14524,64-20-0-8-0,7724-87-8952,COMM & IND,20.944,AC,3501700,0,3501700,0,0,3501700,3335000,0,3335000,0,0,3335000,M1,INDUS/L,,,
14525,64-20-0-9-0,7734-07-1936,COMM & IND,19.391,AC,40900,0,40900,0,0,40900,40900,0,40900,0,0,40900,M1,INDUS/L,,,
14526,24-1-0-5-C,5799-06-7046,SNGL FAM SUB,12.616,AC,86400,0,86400,0,43600,130000,84500,0,84500,0,11500,96000,A1,AG/GEN,,,
14527,26-1-0-3-C,6709-63-0226,SNGL FAM SUB,2.44,AC,48600,0,48600,210000,0,258600,45900,0,45900,180300,0,226200,A1,AG/GEN,,,
14528,26-1-0-65-E,6719-15-6394,SNGL FAM SUB,5,AC,63500,0,63500,200400,11700,275600,62000,0,62000,165900,10300,238200,A1,AG/GEN,,,
14529,38-5-0-A-1,6707-98-5659,SNGL FAM SUB,10,AC,89200,0,89200,266000,800,356000,87500,0,87500,225400,800,313700,A1,AG/GEN,,,
14530,38-5-0-A-2,6707-98-4419,Cemetery,0,AC,100,0,100,0,0,100,100,0,100,0,0,100,A1,AG/GEN,,,
14531,45-1-0-87-A,6797-75-6803,SNGL FAM SUB,2.43,AC,99300,0,99300,285200,0,384500,88700,0,88700,232700,0,321400,A2,AG/LTD,,,
14532,46-1-0-3-A,7708-20-0932,SNGL FAM SUB,10,AC,250800,245700,5100,0,0,250800,223800,219500,4300,0,0,223800,A2,AG/LTD,,,
14533,40-3-0-A-1,6737-03-0496,SNGL FAM SUB,0,AC,0,0,0,254600,0,254600,0,0,0,215500,5900,221400,A1,AG/GEN,,,
14534,11-1-0-3-A1,6812-96-6841,SNGL FAM SUB,0,AC,0,0,0,0,105400,105400,0,0,0,0,105400,105400,A1,AG/GEN,,,
14535,1-3-0-3-T,6814-43-7304-9999,COMM & IND,2.03,AC,74400,0,74400,0,83800,158200,72200,0,72200,0,82100,154300,B1,BUS/GEN,,,
14536,2-1-0-4-C,6814-55-7273,TAXED -SCC,8,AC,0,0,0,0,0,0,0,0,0,0,0,0,B1A1,BS & AG,,,
14537,9-1-0-35-T,5892-63-3007-9999,COMM & IND,2.155,AC,122500,0,122500,0,143400,265900,121800,0,121800,0,130400,252200,A1,AG/GEN,,,
14538,13-10-0-1-T,6841-85-2516-9999,COMM & IND,8.87,AC,121000,0,121000,0,104400,225400,117100,0,117100,0,100300,217400,A1,AG/GEN,,,
14539,26-10-0-A-0,6719-11-7301,TAXED -SCC,0.8,AC,0,0,0,0,0,0,0,0,0,0,0,0,B1A1,BS & AG,,,
14540,33-7-0-9-T,6798-36-8741-9999,COMM & IND,2,AC,114600,0,114600,0,114700,229300,109200,0,109200,0,111600,220800,M1,INDUS/L,,,
14541,38-1-0-55-0,6706-48-8311,SNGL FAM SUB,1.3,AC,5300,0,5300,0,0,5300,5200,0,5200,0,0,5200,A1,AG/GEN,,,
14542,42-1-0-115-0,6767-00-7894,TAXED -SCC,0.239,AC,0,0,0,0,0,0,0,0,0,0,0,0,RO,RES/OF,,,
14543,42-1-0-115-A,6767-00-7880,TAXED -SCC,0.12,AC,0,0,0,0,0,0,0,0,0,0,0,0,RO,RES/OF,,,
14544,45-1-0-127-B1T,6797-58-7767-9999,COMM & IND,0.231,AC,28000,0,28000,0,170400,198400,26600,0,26600,0,169500,196100,A2,AG/LTD,,,
14545,45-1-0-128-A,6797-48-4649,TAXED -SCC,10.56,AC,0,0,0,0,0,0,0,0,0,0,0,0,A2,AG/LTD,,,
14546,45-20-0-3-0,6797-78-8992,TAXED -SCC,2.43,AC,0,0,0,0,0,0,0,0,0,0,0,0,A2,AG/LTD,,,
14547,46-1-0-17-T,7707-15-0286-9999,COMM & IND,2.359,AC,247500,0,247500,54500,44200,346200,235700,0,235700,51900,40900,328500,A2,AG/LTD,,,
14548,46-5-0-B-0,7717-07-2820,Vacant Land,2.35,AC,91200,0,91200,0,0,91200,81400,0,81400,0,0,81400,A2,AG/LTD,,,
14549,54-1-0-2-B,6766-46-0258,TAXED -SCC,0.78,AC,0,0,0,0,0,0,0,0,0,0,0,0,A2,AG/LTD,,,
14550,55-5-0-3-A,6785-76-2082,TAXED -SCC,10.7,AC,0,0,0,0,0,0,0,0,0,0,0,0,A2,AG/LTD,,,
14551,58-1-0-24-0,7716-34-6558,TAXED -SCC,29.6,AC,0,0,0,0,0,0,0,0,0,0,0,0,A2,AG/LTD,,,
14552,62-1-0-23-0,7714-13-4645,TAXED -SCC,0,AC,0,0,0,0,0,0,0,0,0,0,0,0,R3,RES/GEN,,,
14553,62-1-0-32-0,7704-95-8650,TAXED -SCC,0.24,AC,0,0,0,0,0,0,0,0,0,0,0,0,R1,RES/LTD,,,
14554,62-2-A-4-A,7704-93-6840,TAXED -SCC,0,AC,0,0,0,0,0,0,0,0,0,0,0,0,R1,RES/LTD,,,
14555,62-2-B-18-A,7704-95-6280,TAXED -SCC,0,AC,0,0,0,0,0,0,0,0,0,0,0,0,R1,RES/LTD,,,
14556,62-4-E-11-A,7714-05-6132,TAXED -SCC,0,AC,0,0,0,0,0,0,0,0,0,0,0,0,R1,RES/LTD,,,
14560,62-17-A-1-A,7714-05-1615-0001,TAXED -SCC,0,AC,0,0,0,0,0,0,0,0,0,0,0,0,R1,RES/LTD,,,
14561,1-1-0-22-J,6804-84-3435,AG 20-100 AC,57.05,AC,185500,122400,63100,572200,41500,799200,181900,121500,60400,500100,39500,721500,A1,AG/GEN,,,
14562,31-1-0-98-B,6778-33-0303,SNGL FAM SUB,2.15,AC,80700,0,80700,438300,27500,546500,72000,0,72000,360800,27500,460300,A2,AG/LTD,,,
14563,6-10-0-2-A,6822-98-9490,SNGL FAM SUB,10.48,AC,101500,0,101500,198100,0,299600,99000,0,99000,175100,0,274100,A1,AG/GEN,,,
14564,12-1-0-71-H,6831-42-7623,SNGL FAM SUB,2,AC,54500,0,54500,133400,1000,188900,49300,0,49300,110200,1000,160500,A1,AG/GEN,,,
14565,22-1-0-1-A4,6769-49-8014,SNGL FAM SUB,2.76,AC,94700,0,94700,364000,1500,460200,85300,0,85300,298500,1500,385300,A2,AG/LTD,,,
14566,43-32-0-1-0,6767-76-7373,SNGL FAM SUB,4.87,AC,121000,0,121000,184400,8700,314100,110000,0,110000,161100,9400,280500,RR,RES/RUR,,,
14567,29-1-0-117-B,6758-09-0026,SNGL FAM SUB,2,AC,63000,0,63000,145000,16800,224800,57700,0,57700,114300,15000,187000,A1,AG/GEN,,,
14568,43-32-0-7-0,6767-95-3400,SNGL FAM SUB,5.59,AC,129800,0,129800,275000,1600,406400,118000,0,118000,245800,1400,365200,RR,RES/RUR,,,
14569,4-1-0-6-E,6803-66-6411,SNGL FAM SUB,2.02,AC,44600,0,44600,116000,2700,163300,43600,0,43600,101400,2700,147700,A1,AG/GEN,,,
14570,5-20-0-A-0,6823-15-8080,Roads,0.47,AC,0,0,0,0,0,0,0,0,0,0,0,0,RR,RES/RUR,,,
14571,5-20-0-1-0,6823-26-8659,SNGL FAM SUB,7,AC,78600,0,78600,193300,0,271900,77000,0,77000,165400,0,242400,RR,RES/RUR,,,
14572,5-20-0-2-0,6823-26-6409,SNGL FAM SUB,6,AC,72800,0,72800,249700,0,322500,71300,0,71300,200900,4000,276200,RR,RES/RUR,,,
14573,5-20-0-3-0,6823-26-1365,SNGL FAM SUB,5,AC,67000,0,67000,324600,4000,395600,65600,0,65600,285700,4000,355300,RR,RES/RUR,,,
14574,5-20-0-4-0,6823-26-3026,SNGL FAM SUB,5.45,AC,69600,0,69600,315500,13800,398900,68200,0,68200,270600,14200,353000,RR,RES/RUR,,,
14575,5-20-0-5-0,6823-25-6855,SNGL FAM SUB,9.27,AC,87800,0,87800,373500,62500,523800,86000,0,86000,314800,59300,460100,RR,RES/RUR,,,
14576,2-1-0-4-D1,6814-64-9742,SNGL FAM SUB,8.674,AC,78800,0,78800,222600,124200,425600,77400,0,77400,197800,114200,389400,A1,AG/GEN,,,
14577,5-20-0-6-0,6823-25-6435,SNGL FAM SUB,9.88,AC,91000,0,91000,204100,31500,326600,89200,0,89200,172900,31400,293500,RR,RES/RUR,,,
14578,5-20-0-7-0,6823-25-5027,SNGL FAM SUB,10.07,AC,92000,0,92000,288300,2000,382300,90200,0,90200,243300,2000,335500,RR,RES/RUR,,,
14579,5-20-0-8-0,6823-15-5080,SNGL FAM SUB,5.44,AC,69500,0,69500,313700,2100,385300,68100,0,68100,265600,1500,335200,RR,RES/RUR,,,
14580,2-1-0-4-D2,6814-64-5436,COMM & IND,10.575,AC,499100,0,499100,0,0,499100,484300,0,484300,0,0,484300,B1,BUS/GEN,,,
14581,5-20-0-9-0,6823-15-7566,SNGL FAM SUB,5.01,AC,67000,0,67000,273800,5600,346400,65700,0,65700,230500,5900,302100,RR,RES/RUR,,,
14582,2-1-0-4-D3,6814-74-1251,SNGL FAM SUB,7.197,AC,71300,0,71300,0,0,71300,70000,0,70000,0,0,70000,A1,AG/GEN,,,
14583,5-20-0-10-0,6823-15-6913,SNGL FAM SUB,5.64,AC,70700,0,70700,272000,0,342700,69200,0,69200,231300,0,300500,RR,RES/RUR,,,
14584,5-20-0-11-0,6823-06-8988,SNGL FAM SUB,10.94,AC,96700,0,96700,365200,58100,520000,94700,0,94700,329500,52800,477000,RR,RES/RUR,,,
14585,5-20-0-12-0,6823-16-4571,SNGL FAM SUB,6.21,AC,74000,0,74000,229600,3000,306600,72500,0,72500,194800,3300,270600,RR,RES/RUR,,,
14586,43-32-0-9-0,6767-85-8149,SNGL FAM SUB,4.25,AC,110000,0,110000,268700,0,378700,100000,0,100000,237200,0,337200,RR,RES/RUR,,,
14587,4-8-0-A-0,6803-39-1000,AG 20-100 AC,32.215,AC,117100,0,117100,314700,0,431800,114900,0,114900,277000,0,391900,A1,AG/GEN,,,
14588,4-8-0-B-0,6804-40-3023,SNGL FAM SUB,5.431,AC,59200,0,59200,87200,4000,150400,58100,0,58100,71900,4000,134000,A1,AG/GEN,,,
14589,4-8-0-C-0,6803-49-4889,SNGL FAM SUB,5.68,AC,61200,0,61200,88400,6000,155600,60100,0,60100,73900,6000,140000,A1,AG/GEN,,,
14590,5-20-0-13-0,6823-16-5893,SNGL FAM SUB,6.98,AC,75600,0,75600,222200,2100,299900,74000,0,74000,196900,2200,273100,RR,RES/RUR,,,
14591,5-20-0-14-0,6823-15-7455,SNGL FAM SUB,5,AC,67000,0,67000,237500,17500,322000,65600,0,65600,201000,20300,286900,RR,RES/RUR,,,
14592,5-20-0-14-A,6823-16-9738,Cemetery,0,AC,100,0,100,0,0,100,100,0,100,0,0,100,RR,RES/RUR,,,
14593,5-20-0-15-0,6823-27-1210,SNGL FAM SUB,5,AC,67000,0,67000,189700,51900,308600,65600,0,65600,160800,47700,274100,RR,RES/RUR,,,
14594,5-1-0-33-A,6813-83-2747,SNGL FAM SUB,2.57,AC,47700,0,47700,127200,13800,188700,46900,0,46900,109400,11700,168000,A1,AG/GEN,,,
14595,5-20-0-16-0,6823-27-2398,SNGL FAM SUB,3.32,AC,57200,0,57200,380900,92000,530100,56000,0,56000,321900,92700,470600,RR,RES/RUR,,,
14596,5-1-0-33-B,6813-83-2553,SNGL FAM SUB,2.57,AC,47700,0,47700,132400,2000,182100,46900,0,46900,115000,2000,163900,A1,AG/GEN,,,
14597,5-21-0-A-0,6823-15-1069,Cmn Area/Open Spc,2,AC,0,0,0,0,0,0,0,0,0,0,0,0,RR,RES/RUR,,,
14598,5-21-0-1-0,6823-15-3550,SNGL FAM SUB,5,AC,67000,0,67000,249300,5000,321300,65600,0,65600,219700,3500,288800,RR,RES/RUR,,,
14599,5-19-C-3-A,6814-61-8522,SNGL FAM SUB,6,AC,65200,0,65200,264100,6500,335800,64000,0,64000,228400,6500,298900,RR,RES/RUR,,,
14600,5-21-0-2-0,6823-04-9615,SNGL FAM SUB,7.02,AC,75800,0,75800,204900,0,280700,74300,0,74300,175800,0,250100,RR,RES/RUR,,,
14601,5-19-C-4-0,6814-61-9125,SNGL FAM SUB,7.133,AC,71000,0,71000,141800,4500,217300,69700,0,69700,116100,3100,188900,RR,RES/RUR,,,
14602,5-21-0-3-0,6823-04-3278,SNGL FAM SUB,11.8,AC,101300,0,101300,344300,38800,484400,99200,0,99200,300300,31300,430800,RR,RES/RUR,,,
14603,5-19-C-5-0,6814-60-9687,SNGL FAM SUB,12,AC,93000,0,93000,186700,20900,300600,91300,0,91300,162600,17900,271800,RR,RES/RUR,,,
14604,5-21-0-4-0,6823-04-1893,SNGL FAM SUB,7.22,AC,79900,0,79900,312400,2200,394500,78300,0,78300,263200,3400,344900,RR,RES/RUR,,,
14605,5-21-0-5-0,6823-05-4241,SNGL FAM SUB,6.84,AC,77700,0,77700,288700,3000,369400,76100,0,76100,253100,3000,332200,RR,RES/RUR,,,
14606,10-1-0-17-C,6801-42-9871,SNGL FAM SUB,2,AC,43400,0,43400,144400,2000,189800,42500,0,42500,125600,2000,170100,A1,AG/GEN,,,
14607,5-21-0-6-0,6823-05-6429,SNGL FAM SUB,7.29,AC,80300,0,80300,289100,4100,373500,78700,0,78700,252000,2900,333600,RR,RES/RUR,,,
14608,10-1-0-17-D,6801-52-1662,SNGL FAM SUB,2,AC,43400,42500,900,0,0,43400,42500,41600,900,0,0,42500,A1,AG/GEN,,,
14609,5-21-0-7-0,6823-05-6871,SNGL FAM SUB,7.4,AC,80900,0,80900,0,0,80900,79300,0,79300,0,0,79300,RR,RES/RUR,,,
14611,5-21-0-8-0,6823-06-6194,SNGL FAM SUB,7.21,AC,79800,0,79800,387400,74200,541400,78200,0,78200,363500,70000,511700,RR,RES/RUR,,,
14612,5-21-0-9-0,6823-06-8409,SNGL FAM SUB,9.71,AC,90100,0,90100,371900,0,462000,88300,0,88300,313700,0,402000,RR,RES/RUR,,,
14614,10-1-0-22-C1,6801-73-5110,SNGL FAM SUB,8,AC,67500,63700,3800,0,0,67500,66000,62600,3400,0,0,66000,A1,AG/GEN,,,
14615,12-1-0-16-A1,6822-83-2786,SNGL FAM SUB,5.16,AC,73700,0,73700,218400,8100,300200,71700,0,71700,188000,7400,267100,A1,AG/GEN,,,
14616,12-1-0-16-A2,6822-83-5457,SNGL FAM SUB,7.22,AC,82400,0,82400,0,0,82400,80300,0,80300,0,0,80300,A1,AG/GEN,,,
14617,12-1-0-16-A3,6822-83-8168,SNGL FAM SUB,8.95,AC,94100,0,94100,0,0,94100,91800,0,91800,0,0,91800,A1,AG/GEN,,,
14618,12-1-0-16-A4,6822-84-9097,AG 20-100 AC,20.59,AC,141000,0,141000,305600,2000,448600,137700,0,137700,263700,2000,403400,A1,AG/GEN,,,
14619,46-33-0-1-0,7707-72-0762,SNGL FAM SUB,2.039,AC,122700,0,122700,362600,700,486000,109600,0,109600,302700,700,413000,A2RR,AG& RUR,,,
14620,12-1-0-43-A,6831-17-3427,SNGL FAM SUB,4,AC,24400,19800,4600,0,0,24400,24800,20200,4600,0,0,24800,A1,AG/GEN,,,
14621,46-33-0-2-0,7707-72-2996,SNGL FAM SUB,2.305,AC,128800,0,128800,422700,69900,621400,115000,0,115000,359000,59600,533600,A2,AG/LTD,,,
14622,46-33-0-3-0,7707-73-7126,SNGL FAM SUB,2.335,AC,129400,0,129400,473700,0,603100,115600,0,115600,395100,0,510700,A2,AG/LTD,,,
14623,46-33-0-4-0,7707-73-8043,SNGL FAM SUB,2.629,AC,136100,0,136100,543000,94600,773700,121600,0,121600,454100,84300,660000,A2,AG/LTD,,,
14624,46-33-0-6-0,7707-72-2400,SNGL FAM SUB,1.506,AC,110500,0,110500,277800,800,389100,98700,0,98700,237000,800,336500,RR,RES/RUR,,,
14625,46-33-0-7-0,7707-72-0340,SNGL FAM SUB,1.864,AC,118700,0,118700,253900,0,372600,106000,0,106000,213500,0,319500,RR,RES/RUR,,,
14626,47-1-0-56-A,7718-61-1746,SNGL FAM SUB,7.77,AC,214100,210200,3900,0,0,214100,191300,187900,3400,0,0,191300,A2,AG/LTD,,,
14629,12-1-0-52-B,6832-31-1654,SNGL FAM SUB,0.18,AC,1000,0,1000,0,0,1000,1000,0,1000,0,0,1000,A1,AG/GEN,,,
14630,12-14-0-E-3,6821-98-8089,SNGL FAM SUB,2.25,AC,49300,0,49300,81200,0,130500,48000,0,48000,63800,0,111800,A1,AG/GEN,,,
14631,12-1-0-71-F,6831-43-3080,SNGL FAM SUB,2.82,AC,59500,0,59500,176400,1900,237800,57100,0,57100,152500,1900,211500,A1,AG/GEN,,,
14633,12-1-0-71-G,6831-42-9965,SNGL FAM SUB,3,AC,63900,0,63900,158800,3500,226200,60300,0,60300,131200,3500,195000,A1,AG/GEN,,,
14636,12-3-0-4-B1,6831-07-7213,SNGL FAM SUB,3.52,AC,57300,0,57300,131000,800,189100,59200,0,59200,108300,800,168300,A1,AG/GEN,,,
14637,12-18-0-D-1,6832-50-1315,SNGL FAM SUB,10,AC,91200,0,91200,209600,8000,308800,88900,0,88900,185700,8000,282600,A1,AG/GEN,,,
14638,12-25-0-1-0,6832-85-3941,AG 20-100 AC,20.16,AC,134800,125500,9300,0,0,134800,131700,123100,8600,0,0,131700,A1,AG/GEN,,,
14639,12-25-0-2-0,6832-86-5389,AG 20-100 AC,20.32,AC,135600,126200,9400,0,0,135600,132500,123900,8600,0,0,132500,A1,AG/GEN,,,
14640,12-25-0-3-0,6832-86-8875,AG 20-100 AC,21.08,AC,139500,129800,9700,0,0,139500,136300,127300,9000,0,0,136300,A1,AG/GEN,,,
14641,12-25-0-4-0,6832-97-2225,AG 20-100 AC,21.3,AC,140700,95000,45700,81800,0,222500,137400,93700,43700,83700,0,221100,A1,AG/GEN,,,
14643,12-25-0-8-A,6832-94-2895,Cemetery,0,AC,100,0,100,0,0,100,100,0,100,0,0,100,A1,AG/GEN,,,
14644,12-14-0-E-4,6821-98-5145,SNGL FAM SUB,2.45,AC,50600,0,50600,163500,42100,256200,49400,0,49400,135500,36600,221500,A1,AG/GEN,,,
14645,12-14-0-E-4A,6821-98-6032,Cemetery,0,AC,100,0,100,0,0,100,100,0,100,0,0,100,A1,AG/GEN,,,
14646,12-14-0-E-5,6821-98-2128,SNGL FAM SUB,2.45,AC,50600,0,50600,174500,500,225600,49400,0,49400,144000,500,193900,A1,AG/GEN,,,
14647,54-8-0-5-0,6766-91-9283,AG 20-100 AC,68.97,AC,1141500,600500,541000,3979300,87600,5208400,1019300,568400,450900,3674900,88200,4782400,A2,AG/LTD,,,
14648,13-1-0-12-A1,6841-69-3939,SNGL FAM SUB,3.36,AC,65400,0,65400,150300,4000,219700,64100,0,64100,131700,4000,199800,A1,AG/GEN,,,
14649,13-1-0-12-A2,6841-69-1804,SNGL FAM SUB,2.15,AC,54900,0,54900,138700,3000,196600,53800,0,53800,120700,3000,177500,A1,AG/GEN,,,
14650,13-1-0-12-A3,6841-69-3660,SNGL FAM SUB,2.43,AC,57300,0,57300,138800,3000,199100,56200,0,56200,120800,3000,180000,A1,AG/GEN,,,
14651,13-3-0-3-A,6842-82-4615,SNGL FAM SUB,4.25,AC,58400,0,58400,20100,17900,96400,57400,0,57400,22500,16000,95900,A1,AG/GEN,,,
14652,56-17-0-2-0,6795-58-4456,AG 20-100 AC,28.85,AC,678200,664900,13300,0,0,678200,589100,576800,12300,0,0,589100,A2,AG/LTD,,,
14653,13-19-0-5-A1,6851-09-8354,SNGL FAM SUB,2.52,AC,56800,0,56800,152400,6500,215700,55700,0,55700,132300,6500,194500,A1,AG/GEN,,,
14665,31-1-0-69-C,6779-34-5098,SNGL FAM SUB,6.75,AC,133100,0,133100,162300,1200,296600,118700,0,118700,134200,1200,254100,A2,AG/LTD,,,
14666,59-1-0-23-D,7726-76-6468,MultiFamily,0.628,AC,435200,0,435200,0,0,435200,395600,0,395600,0,0,395600,R3,RES/GEN,,,
14667,31-1-0-69-D,6779-33-1457,AG 20-100 AC,43.329,AC,494000,0,494000,0,1500,495500,442000,0,442000,0,1500,443500,A2,AG/LTD,,,
14668,20-1-0-53-A,6841-70-7732,AG 20-100 AC,21.21,AC,194200,184400,9800,0,0,194200,190500,181500,9000,0,0,190500,A1,AG/GEN,,,
14669,20-1-0-53-D,6841-80-0066,SNGL FAM SUB,2.83,AC,65800,0,65800,0,0,65800,64600,0,64600,0,0,64600,A1,AG/GEN,,,
14670,20-1-0-53-E,6841-80-5002,SNGL FAM SUB,3.18,AC,68800,0,68800,0,1000,69800,67500,0,67500,0,1000,68500,A1,AG/GEN,,,
14671,40-1-0-26-C,6737-31-6156,SNGL FAM SUB,3.91,AC,66800,0,66800,178600,0,245400,65600,0,65600,159300,0,224900,A1,AG/GEN,,,
14672,20-1-0-65-A1,6840-77-8743,SNGL FAM SUB,11.3,AC,145600,0,145600,21800,10400,177800,142800,0,142800,25500,9200,177500,A1,AG/GEN,,,
14673,62-31-C-31-0,7705-42-1106,SNGL FAM SUB,6.544,AC,432000,0,432000,702800,51900,1186700,360000,0,360000,660500,49700,1070200,RR,RES/RUR,,,
14674,20-1-0-65-A2,6840-77-6329,SNGL FAM SUB,6.35,AC,98800,0,98800,280100,15200,394100,96900,0,96900,255300,6000,358200,A1,AG/GEN,,,
14675,21-1-0-1-B,6851-10-7167,AG 20-100 AC,31.762,AC,223700,208200,15500,0,0,223700,219400,205800,13600,0,0,219400,A1,AG/GEN,,,
14676,24-1-0-3-0,5799-04-4864,SNGL FAM SUB,4.7,AC,48200,0,48200,27600,100,75900,47100,0,47100,23300,100,70500,A1,AG/GEN,,,
14679,28-12-0-1-0,6729-81-9302,SNGL FAM SUB,4,AC,60500,0,60500,130300,2100,192900,59900,0,59900,107400,0,167300,A1,AG/GEN,,,
14680,28-12-0-2-0,6729-91-0049,SNGL FAM SUB,3.58,AC,57700,0,57700,127300,900,185900,57000,0,57000,105000,900,162900,A1,AG/GEN,,,
14681,28-12-0-3-0,6729-90-3927,SNGL FAM SUB,2,AC,47600,0,47600,126100,200,173900,46300,0,46300,104100,200,150600,A1,AG/GEN,,,
14682,28-12-0-4-0,6729-80-8148,AG 20-100 AC,20.55,AC,143500,0,143500,0,0,143500,141200,0,141200,0,0,141200,A1,AG/GEN,,,
14683,28-12-0-5-0,6729-90-5576,SNGL FAM SUB,2,AC,47600,0,47600,0,0,47600,46300,0,46300,0,0,46300,A1,AG/GEN,,,
14684,28-12-0-6-0,6728-99-2846,AG 20-100 AC,20.94,AC,144700,0,144700,0,0,144700,143200,0,143200,0,0,143200,A1,AG/GEN,,,
14685,28-13-0-1-0,6728-77-7884,SNGL FAM SUB,8.13,AC,85900,0,85900,0,0,85900,84300,0,84300,0,0,84300,A1,AG/GEN,,,
14686,28-13-0-2-0,6728-78-6615,SNGL FAM SUB,12.18,AC,101400,0,101400,0,0,101400,99500,0,99500,0,0,99500,A1,AG/GEN,,,
14687,28-13-0-3-0,6728-88-3828,SNGL FAM SUB,10.31,AC,90900,0,90900,0,0,90900,89200,0,89200,0,0,89200,A1,AG/GEN,,,
14688,28-13-0-4-0,6728-88-1045,SNGL FAM SUB,5.95,AC,69000,0,69000,0,0,69000,67700,0,67700,0,0,67700,A1,AG/GEN,,,
14689,28-13-0-5-0,6728-87-3513,SNGL FAM SUB,4.59,AC,62500,0,62500,0,0,62500,61300,0,61300,0,0,61300,A1,AG/GEN,,,
14690,47-1-0-54-A,7717-89-0021,SNGL FAM SUB,8,AC,211400,115400,96000,134200,20900,366500,188900,103400,85500,115300,16700,320900,A2,AG/LTD,,,
14691,32-1-0-70-E,6778-94-5805,SNGL FAM SUB,5.5,AC,128900,0,128900,130900,0,259800,115300,0,115300,107900,0,223200,A2,AG/LTD,,,
14692,38-1-0-2-A,6708-71-9129,SNGL FAM SUB,4,AC,55600,0,55600,221000,25200,301800,54500,0,54500,194400,22600,271500,A1,AG/GEN,,,
14693,38-1-0-98-A,6707-97-6170,AG 20-100 AC,49.58,AC,213700,143100,70600,12000,20900,246600,208000,140100,67900,12300,18600,238900,A1,AG/GEN,,,
14694,42-7-0-B-1,6757-74-3240,SNGL FAM SUB,6.35,AC,222300,0,222300,575600,44900,842800,165800,93200,72600,608700,72800,847300,R3,RES/GEN,,,
14696,64-20-0-11-0,7724-96-5205,COMM & IND,1.164,AC,7500,0,7500,0,0,7500,7500,0,7500,0,0,7500,M1,INDUS/L,,,
14697,64-20-0-12-0,7734-05-8967,COMM & IND,9.65,AC,20300,0,20300,0,0,20300,20300,0,20300,0,0,20300,M1,INDUS/L,,,
14698,62-33-0-A-0,7704-76-8137,Cmn Area/Open Spc,10.092,AC,0,0,0,0,0,0,0,0,0,0,0,0,RPUD,RES/PUD,,,
14699,62-33-0-1-0,7704-86-0721,SNGL FAM URB,1.104,AC,134000,0,134000,267700,0,401700,122000,0,122000,234700,0,356700,RPUD,RES/PUD,,,
14700,62-33-0-2-0,7704-76-8971,SNGL FAM URB,1.117,AC,134000,0,134000,318900,0,452900,122000,0,122000,281700,0,403700,RPUD,RES/PUD,,,
14701,62-33-0-3-0,7704-77-9026,SNGL FAM URB,1.221,AC,134000,0,134000,369100,0,503100,122000,0,122000,323700,0,445700,RPUD,RES/PUD,,,
14702,62-33-0-4-0,7704-87-1034,SNGL FAM URB,0.709,AC,134000,0,134000,433600,0,567600,122000,0,122000,380700,0,502700,RPUD,RES/PUD,,,
14703,43-32-0-2-0,6767-86-0128,SNGL FAM SUB,4.42,AC,121000,0,121000,232600,0,353600,110000,0,110000,203700,0,313700,RR,RES/RUR,,,
14704,43-32-0-3-0,6767-86-2073,SNGL FAM SUB,4.64,AC,121000,0,121000,272900,2000,395900,110000,0,110000,239900,2000,351900,RR,RES/RUR,,,
14705,64-20-0-13-0,7734-16-4238,COMM & IND,10.892,AC,22500,0,22500,0,0,22500,22500,0,22500,0,0,22500,M1,INDUS/L,,,
14706,62-33-0-5-0,7704-86-3906,SNGL FAM URB,0.823,AC,134000,0,134000,359400,0,493400,122000,0,122000,315000,0,437000,RPUD,RES/PUD,,,
14708,65-2-0-B-0,7733-77-2104,Roads,1.441,AC,0,0,0,0,0,0,0,0,0,0,0,0,RPUD,RES/PUD,,,
14709,62-33-0-6-0,7704-86-3801,SNGL FAM URB,0.926,AC,134000,0,134000,301200,0,435200,122000,0,122000,263900,0,385900,RPUD,RES/PUD,,,
14710,62-33-0-7-0,7704-86-3625,SNGL FAM URB,0.813,AC,134000,0,134000,476200,33400,643600,122000,0,122000,433100,27600,582700,RPUD,RES/PUD,,,
14711,43-32-0-4-0,6767-85-5924,SNGL FAM SUB,4.54,AC,121000,0,121000,242100,0,363100,110000,0,110000,214700,0,324700,RR,RES/RUR,,,
14712,62-33-0-8-0,7704-86-5816,SNGL FAM URB,1.509,AC,134000,0,134000,398400,3600,536000,122000,0,122000,351600,3000,476600,RPUD,RES/PUD,,,
14713,62-33-0-9-0,7704-86-6896,SNGL FAM URB,1.059,AC,134000,0,134000,558400,0,692400,122000,0,122000,506200,0,628200,RPUD,RES/PUD,,,
14714,62-33-0-10-0,7704-86-8873,SNGL FAM URB,0.927,AC,134000,0,134000,374400,0,508400,122000,0,122000,339600,0,461600,RPUD,RES/PUD,,,
14715,43-32-0-5-0,6767-85-9908,SNGL FAM SUB,5.63,AC,129800,0,129800,289000,0,418800,118000,0,118000,255500,0,373500,RR,RES/RUR,,,
14716,62-33-0-11-0,7704-96-0715,SNGL FAM URB,1.027,AC,134000,0,134000,0,0,134000,122000,0,122000,0,0,122000,RPUD,RES/PUD,,,
14717,62-33-0-12-0,7704-96-0598,SNGL FAM URB,0.858,AC,134000,0,134000,512600,0,646600,122000,0,122000,446100,0,568100,RPUD,RES/PUD,,,
14718,43-32-0-6-0,6767-95-3810,SNGL FAM SUB,5.91,AC,129800,0,129800,285700,62800,478300,118000,0,118000,256800,53500,428300,RR,RES/RUR,,,
14719,43-32-0-8-0,6767-85-6467,SNGL FAM SUB,3.23,AC,96800,0,96800,209700,35300,341800,88000,0,88000,182500,26300,296800,RR,RES/RUR,,,
14720,44-1-0-43-A,6787-66-8895,Cemetery,0,AC,100,0,100,0,0,100,100,0,100,0,0,100,A2,AG/LTD,,,
14721,62-33-0-13-0,7704-96-1368,SNGL FAM URB,1.429,AC,134000,0,134000,283000,800,417800,122000,0,122000,250500,800,373300,RPUD,RES/PUD,,,
14722,62-33-0-14-0,7704-96-0265,SNGL FAM URB,0.992,AC,134000,0,134000,392400,0,526400,122000,0,122000,342600,0,464600,RPUD,RES/PUD,,,
14723,62-33-0-15-0,7704-86-9172,SNGL FAM URB,0.833,AC,134000,0,134000,451300,0,585300,122000,0,122000,400600,0,522600,RPUD,RES/PUD,,,
14724,62-33-0-16-0,7704-85-8935,SNGL FAM URB,1.314,AC,134000,0,134000,419300,0,553300,122000,0,122000,368100,0,490100,RPUD,RES/PUD,,,
14725,62-33-0-17-0,7704-86-6051,SNGL FAM URB,1.11,AC,134000,0,134000,429200,0,563200,122000,0,122000,378000,0,500000,RPUD,RES/PUD,,,
14726,45-1-0-130-A,6798-50-4828,State Exmm,1.76,AC,25000,0,25000,0,0,25000,25000,0,25000,0,0,25000,A2,AG/LTD,,,
14727,62-33-0-18-0,7704-86-4191,SNGL FAM URB,1.381,AC,174200,0,174200,395100,0,569300,158600,0,158600,364100,0,522700,RPUD,RES/PUD,,,
14728,45-1-0-135-0,6798-51-8422,State Exmm,7.5,AC,1022800,0,1022800,0,215600,1238400,913100,0,913100,0,207400,1120500,A2,AG/LTD,,,
14729,62-33-0-19-0,7704-86-6225,SNGL FAM URB,0.808,AC,134000,0,134000,324500,1200,459700,122000,0,122000,283900,1200,407100,RPUD,RES/PUD,,,
14730,62-33-0-20-0,7704-86-7356,SNGL FAM URB,0.781,AC,134000,0,134000,333100,19000,486100,122000,0,122000,292300,17900,432200,RPUD,RES/PUD,,,
14731,62-33-0-21-0,7704-86-8531,SNGL FAM URB,0.888,AC,134000,0,134000,329700,0,463700,122000,0,122000,290300,0,412300,RPUD,RES/PUD,,,
14732,46-1-0-1-T,7707-09-1174-9999,State Exmm,7.5,AC,1086800,0,1086800,0,469300,1556100,982300,0,982300,0,446000,1428300,A2,AG/LTD,,,
14733,62-33-0-22-0,7704-86-7509,SNGL FAM URB,0.921,AC,134000,0,134000,303400,0,437400,122000,0,122000,268800,0,390800,RPUD,RES/PUD,,,
14734,62-33-0-23-0,7704-86-5560,SNGL FAM URB,0.764,AC,134000,0,134000,364100,2000,500100,122000,0,122000,320400,2000,444400,RPUD,RES/PUD,,,
14735,46-1-0-114-B,7717-04-1931,Cemetery,0,AC,100,0,100,0,0,100,100,0,100,0,0,100,A2,AG/LTD,,,
14736,62-33-0-24-0,7704-86-4452,SNGL FAM URB,0.831,AC,134000,0,134000,377900,0,511900,122000,0,122000,334200,0,456200,RPUD,RES/PUD,,,
14737,62-33-0-25-0,7704-86-2293,SNGL FAM URB,1.374,AC,174200,0,174200,371900,0,546100,158600,0,158600,328900,0,487500,RPUD,RES/PUD,,,
14738,62-33-0-26-0,7704-86-2358,SNGL FAM URB,0.851,AC,134000,0,134000,299300,400,433700,122000,0,122000,262300,400,384700,RPUD,RES/PUD,,,
14740,62-33-0-27-0,7704-86-0384,SNGL FAM URB,1.302,AC,174200,0,174200,376300,0,550500,158600,0,158600,335500,0,494100,RPUD,RES/PUD,,,
14741,62-33-0-28-0,7704-76-9432,SNGL FAM URB,1.297,AC,174200,0,174200,277700,0,451900,158600,0,158600,246600,0,405200,RPUD,RES/PUD,,,
14742,46-16-0-F-1B,7707-82-0970,SNGL FAM SUB,5.04,AC,154100,0,154100,373400,0,527500,137600,0,137600,314700,0,452300,A2,AG/LTD,,,
14743,46-32-0-1-0,7707-90-1332,SNGL FAM SUB,3.07,AC,146200,0,146200,459600,400,606200,130600,0,130600,393900,400,524900,RR,RES/RUR,,,
14744,46-32-0-2-0,7707-90-3179,SNGL FAM SUB,3.3,AC,151400,0,151400,198500,0,349900,135300,0,135300,166600,0,301900,RR,RES/RUR,,,
14745,46-32-0-3-0,7707-90-7617,Place of Worship,16.21,AC,436700,0,436700,4331400,226000,4994100,389600,0,389600,4109900,208000,4707500,A2,AG/LTD,,,
14746,46-32-0-4-0,7707-90-6110,SNGL FAM SUB,2.96,AC,143700,0,143700,281800,1900,427400,128400,0,128400,234800,1900,365100,A2,AG/LTD,,,
14747,46-32-0-5-0,7706-99-8959,SNGL FAM SUB,2.9,AC,142300,0,142300,337200,100,479600,127200,0,127200,286400,100,413700,A2,AG/LTD,,,
14749,65-2-B-20-0,7733-77-5332,SNGL FAM URB,0.581,AC,230000,0,230000,525200,0,755200,200000,0,200000,482200,0,682200,RPUD,RES/PUD,,,
14750,68-3-C-43-0,7733-76-2996,SNGL FAM URB,0.422,AC,230000,0,230000,575900,1200,807100,200000,0,200000,531400,1300,732700,RPUD,RES/PUD,,,
14751,68-3-C-48-0,7733-67-8087,SNGL FAM URB,0.419,AC,230000,0,230000,586600,33900,850500,200000,0,200000,542600,31100,773700,RPUD,RES/PUD,,,
14752,31-1-0-69-B,6779-22-3499,AG 20-100 AC,21.1,AC,293200,219100,74100,11000,0,304200,262200,196400,65800,11000,0,273200,A2,AG/LTD,,,
14753,46-33-0-5-0,7707-72-4646,SNGL FAM SUB,2,AC,121800,0,121800,460900,1000,583700,108800,0,108800,387600,1000,497400,A2RR,AG& RUR,,,
14756,64-20-0-10-0T,7724-95-7982,COMM & IND,27.735,AC,5150900,0,5150900,20272200,100,25423200,4906000,0,4906000,20272200,100,25178300,M1,INDUS/L,,,
14757,64-21-0-2-0,7733-66-5759,Roads,11.654,AC,0,0,0,0,0,0,0,0,0,0,0,0,RPUD,RES/PUD,,,
14758,48-1-0-21-C,7727-45-3537,SNGL FAM SUB,2,AC,132600,0,132600,169300,0,301900,118400,0,118400,143400,0,261800,A2,AG/LTD,,,
14759,56-14-0-A-0,6785-89-9749,Cmn Area/Open Spc,4.24,AC,0,0,0,0,0,0,0,0,0,0,0,0,A2,AG/LTD,,,
14760,57-1-0-41-F,7715-03-2791,SNGL FAM SUB,8.66,AC,415900,0,415900,555500,68300,1039700,361500,0,361500,461500,59100,882100,A2,AG/LTD,,,
14761,57-29-0-59-0,6795-97-9833,SNGL FAM SUB,17.77,AC,610600,0,610600,780500,12400,1403500,531400,0,531400,802500,13000,1346900,RR,RES/RUR,,,
14762,57-29-0-60-0,7705-07-8324,AG 20-100 AC,21.714,AC,708000,0,708000,1061700,0,1769700,616200,0,616200,1110200,0,1726400,RR,RES/RUR,,,
14763,57-29-0-62-0,7705-08-4674,SNGL FAM SUB,19.013,AC,641300,0,641300,0,0,641300,558100,0,558100,0,0,558100,RR,RES/RUR,,,
14765,58-3-B-1-0,7726-07-7056,State Exmm,0,AC,88000,0,88000,0,0,88000,80000,0,80000,0,0,80000,RN,RESIDEN,,,
14767,62-31-C-A-0,7704-59-0956,Cmn Area/Open Spc,3.651,AC,0,0,0,0,0,0,0,0,0,0,0,0,RR,RES/RUR,,,
14768,62-31-C-B-0,7705-20-7519,Cmn Area/Open Spc,0.352,AC,0,0,0,0,0,0,0,0,0,0,0,0,RR,RES/RUR,,,
14769,62-31-C-C-0,7705-21-9765,Cmn Area/Open Spc,0.352,AC,0,0,0,0,0,0,0,0,0,0,0,0,RR,RES/RUR,,,
14770,62-31-C-D-0,7705-51-6055,Cmn Area/Open Spc,0.989,AC,0,0,0,0,0,0,0,0,0,0,0,0,RR,RES/RUR,,,
14771,62-31-C-1-0,7705-50-1651,SNGL FAM SUB,4.229,AC,432000,0,432000,690500,148500,1271000,360000,0,360000,644900,138400,1143300,RR,RES/RUR,,,
14772,62-31-C-2-0,7705-40-8277,SNGL FAM SUB,6.608,AC,449300,0,449300,571200,0,1020500,374400,0,374400,536900,0,911300,RR,RES/RUR,,,
14773,62-31-C-3-0,7705-40-5209,SNGL FAM SUB,5.882,AC,432000,0,432000,601900,600,1034500,360000,0,360000,563900,700,924600,RR,RES/RUR,,,
14774,62-31-C-4-0,7705-40-2416,SNGL FAM SUB,3.94,AC,432000,0,432000,666200,49800,1148000,360000,0,360000,625900,47300,1033200,RR,RES/RUR,,,
14775,62-31-C-5-0,7705-30-9638,SNGL FAM SUB,4.842,AC,432000,0,432000,488300,26200,946500,360000,0,360000,461300,25800,847100,RR,RES/RUR,,,
14776,62-31-C-6-0,7705-30-6614,SNGL FAM SUB,5.014,AC,432000,0,432000,541700,3300,977000,360000,0,360000,512700,3400,876100,RR,RES/RUR,,,
14777,62-31-C-7-0,7705-30-3522,SNGL FAM SUB,5.54,AC,432000,0,432000,662900,49700,1144600,360000,0,360000,626100,47400,1033500,RR,RES/RUR,,,
14778,62-31-C-8-0,7705-20-9289,SNGL FAM SUB,5.565,AC,432000,0,432000,666100,44500,1142600,360000,0,360000,615000,38000,1013000,RR,RES/RUR,,,
14779,62-31-C-9-0,7705-20-6232,SNGL FAM SUB,3.971,AC,432000,0,432000,493800,13800,939600,360000,0,360000,464200,14300,838500,RR,RES/RUR,,,
14780,62-31-C-10-0,7705-20-1292,SNGL FAM SUB,6.319,AC,514400,0,514400,1440000,44700,1999100,469300,0,469300,1273100,42400,1784800,RR,RES/RUR,,,
14781,62-31-C-11-0,7705-20-1596,SNGL FAM SUB,4.858,AC,570000,0,570000,654000,0,1224000,520000,0,520000,582000,0,1102000,RR,RES/RUR,,,
14782,62-31-C-12-0,7705-20-3940,SNGL FAM SUB,4.796,AC,592800,0,592800,992400,72600,1657800,540800,0,540800,874200,69500,1484500,RR,RES/RUR,,,
14783,62-31-C-13-0,7705-21-6025,SNGL FAM SUB,4.735,AC,570000,0,570000,765000,0,1335000,520000,0,520000,677000,0,1197000,RR,RES/RUR,,,
14784,62-31-C-14-0,7705-31-0098,SNGL FAM SUB,5.943,AC,449300,0,449300,979400,0,1428700,374400,0,374400,913600,0,1288000,RR,RES/RUR,,,
14785,62-31-C-15-0,7705-21-8482,SNGL FAM SUB,3.763,AC,432000,0,432000,617300,0,1049300,360000,0,360000,592500,0,952500,RR,RES/RUR,,,
14786,62-31-C-16-0,7705-21-5535,SNGL FAM SUB,4.872,AC,592800,0,592800,1514000,100600,2207400,540800,0,540800,1330800,97500,1969100,RR,RES/RUR,,,
14787,62-31-C-17-0,7705-21-4816,SNGL FAM SUB,4.677,AC,592800,0,592800,0,0,592800,540800,0,540800,0,0,540800,RR,RES/RUR,,,
14788,62-31-C-18-0,7705-22-5110,SNGL FAM SUB,4.309,AC,592800,0,592800,743500,34100,1370400,540800,0,540800,654200,29300,1224300,RR,RES/RUR,,,
14789,62-31-C-19-0,7705-22-8219,SNGL FAM SUB,6.224,AC,592800,0,592800,834300,6400,1433500,540800,0,540800,733300,5400,1279500,RR,RES/RUR,,,
14790,62-31-C-20-0,7705-32-2236,SNGL FAM SUB,5.72,AC,570000,0,570000,609600,44000,1223600,520000,0,520000,549000,43100,1112100,RR,RES/RUR,,,
14791,62-31-C-21-0,7705-31-4938,SNGL FAM SUB,5.867,AC,432000,0,432000,2206000,123000,2761000,360000,0,360000,2057700,109700,2527400,RR,RES/RUR,,,
14792,62-31-C-22-0,7705-31-5730,SNGL FAM SUB,5.642,AC,432000,0,432000,821500,42100,1295600,360000,0,360000,773700,40400,1174100,RR,RES/RUR,,,
14793,62-31-C-23-0,7705-31-6288,SNGL FAM SUB,3.3,AC,432000,0,432000,813100,80700,1325800,360000,0,360000,775600,68900,1204500,RR,RES/RUR,,,
14794,62-31-C-24-0,7705-31-9723,SNGL FAM SUB,4.501,AC,432000,0,432000,463600,7900,903500,360000,0,360000,434800,8100,802900,RR,RES/RUR,,,
14795,62-31-C-25-0,7705-41-2439,SNGL FAM SUB,3.712,AC,432000,0,432000,629600,0,1061600,360000,0,360000,592000,0,952000,RR,RES/RUR,,,
14796,62-31-C-26-0,7705-41-2108,SNGL FAM SUB,5.254,AC,432000,0,432000,606800,6900,1045700,360000,0,360000,572000,6300,938300,RR,RES/RUR,,,
14797,62-31-C-27-0,7705-40-4982,SNGL FAM SUB,3.739,AC,432000,0,432000,426300,0,858300,360000,0,360000,414700,0,774700,RR,RES/RUR,,,
14798,62-31-C-28-0,7705-41-9032,SNGL FAM SUB,4.024,AC,432000,0,432000,0,0,432000,360000,0,360000,0,0,360000,RR,RES/RUR,,,
14799,62-31-C-29-0,7705-41-7386,SNGL FAM SUB,3.281,AC,432000,0,432000,653900,4400,1090300,360000,0,360000,613000,4500,977500,RR,RES/RUR,,,
14800,62-31-C-30-0,7705-41-5656,SNGL FAM SUB,3.992,AC,432000,0,432000,530500,128800,1091300,360000,0,360000,507400,117900,985300,RR,RES/RUR,,,
14801,62-31-C-32-0,7705-42-5126,SNGL FAM SUB,3.323,AC,432000,0,432000,522800,56200,1011000,360000,0,360000,509200,52900,922100,RR,RES/RUR,,,
14802,62-31-C-33-0,7705-41-9862,SNGL FAM SUB,3.178,AC,432000,0,432000,651500,0,1083500,360000,0,360000,606200,0,966200,RR,RES/RUR,,,
14803,62-31-C-34-0,7705-51-2444,SNGL FAM SUB,3.194,AC,432000,0,432000,741600,115300,1288900,360000,0,360000,708000,101700,1169700,RR,RES/RUR,,,
14804,62-31-C-35-0,7705-51-4187,SNGL FAM SUB,4.387,AC,432000,0,432000,580000,84000,1096000,360000,0,360000,546300,78300,984600,RR,RES/RUR,,,
14806,64-1-0-75-C,7733-39-9075,SNGL FAM SUB,2.2847,AC,241700,0,241700,211200,500,453400,210100,0,210100,178300,500,388900,A2,AG/LTD,,,
14810,65-2-0-A-0,7733-77-4446,Cmn Area/Open Spc,8.816,AC,0,0,0,0,0,0,0,0,0,0,0,0,RPUD,RES/PUD,,,
14811,65-2-B-19-0,7733-77-6246,SNGL FAM URB,0.653,AC,230000,0,230000,640900,1500,872400,200000,0,200000,590400,1400,791800,RPUD,RES/PUD,,,
14812,65-2-B-21-0,7733-77-4208,SNGL FAM URB,0.547,AC,230000,0,230000,595300,0,825300,200000,0,200000,549300,0,749300,RPUD,RES/PUD,,,
14813,65-2-B-22-0,7733-77-3301,SNGL FAM URB,0.403,AC,230000,0,230000,655100,0,885100,200000,0,200000,603300,0,803300,RPUD,RES/PUD,,,
14844,62-31-C-E-0,7705-40-2974,Roads,10.779,AC,0,0,0,0,0,0,0,0,0,0,0,0,RR,RES/RUR,,,
14845,4-1-0-55-A,6802-88-8489,SNGL FAM SUB,2.8,AC,49100,0,49100,100200,1200,150500,47900,0,47900,84200,1200,133300,A1,AG/GEN,,,
14846,4-1-0-55-B,6802-88-9895,SNGL FAM SUB,5.68,AC,65500,0,65500,165200,3000,233700,63700,0,63700,142400,3000,209100,A1,AG/GEN,,,
14847,6-1-0-4-C,6823-87-3362,SNGL FAM SUB,0.09,AC,500,0,500,0,0,500,500,0,500,0,0,500,A1,AG/GEN,,,
14848,6-1-0-4-G,6823-98-1105,SNGL FAM SUB,5,AC,60100,0,60100,226800,4400,291300,59000,0,59000,192500,3100,254600,A1,AG/GEN,,,
14849,6-1-0-4-H,6823-97-4458,AG 20-100 AC,35.163,AC,197500,0,197500,0,6800,204300,193600,0,193600,0,5800,199400,A1,AG/GEN,,,
14850,9-1-0-42-B,5892-41-5595,SNGL FAM SUB,2.58,AC,44500,0,44500,87600,0,132100,43500,0,43500,75400,0,118900,A1,AG/GEN,,,
14851,18-10-0-2-A,6719-89-5974,SNGL FAM SUB,2.27,AC,47600,0,47600,107500,500,155600,45600,0,45600,83200,500,129300,A1,AG/GEN,,,
14852,20-1-0-34-B,6840-40-0451,SNGL FAM SUB,2.4,AC,67600,66500,1100,0,0,67600,64500,63500,1000,0,0,64500,A1,AG/GEN,,,
14853,31-27-0-A-0,6769-86-4204,SNGL FAM SUB,4.167,AC,99000,0,99000,0,0,99000,89600,0,89600,0,0,89600,A2,AG/LTD,,,
14854,31-27-0-B-0,6769-86-1633,SNGL FAM SUB,2,AC,73400,0,73400,46200,0,119600,66000,0,66000,39200,0,105200,A2,AG/LTD,,,
14855,31-27-0-C-0,6769-76-6368,SNGL FAM SUB,7.271,AC,131600,0,131600,506800,26200,664600,120300,0,120300,432000,21500,573800,A2,AG/LTD,,,
14856,31-27-0-D-0,6769-76-0027,SNGL FAM SUB,9,AC,149300,0,149300,0,0,149300,138300,0,138300,0,0,138300,A2,AG/LTD,,,
14857,31-27-0-E-0,6769-65-7605,SNGL FAM SUB,5.719,AC,115700,0,115700,331000,42000,488700,104200,0,104200,280700,36200,421100,A2,AG/LTD,,,
14858,32-1-0-14-B,6779-73-2563,SNGL FAM SUB,2.16,AC,76600,0,76600,0,0,76600,68300,0,68300,0,0,68300,A2,AG/LTD,,,
14859,42-1-0-45-A,6767-02-6945,Place of Worship,0.453,AC,53900,0,53900,303200,0,357100,47800,0,47800,286300,0,334100,B1,BUS/GEN,,,
14860,43-12-0-2-A,6767-88-6669,SNGL FAM SUB,2,AC,84500,0,84500,255100,0,339600,75500,0,75500,209700,0,285200,A2,AG/LTD,,,
14861,48-1-0-7-A,7728-81-6369,SNGL FAM SUB,2.085,AC,127400,0,127400,280400,0,407800,113800,0,113800,235700,0,349500,A2,AG/LTD,,,
14862,50-9-0-1-0,6716-95-6217,AG 20-100 AC,21.45,AC,158400,0,158400,391900,41600,591900,155500,0,155500,340300,36500,532300,A1,AG/GEN,,,
14863,50-9-0-2-0,6716-85-6196,AG 20-100 AC,20.53,AC,153300,0,153300,435800,0,589100,150400,0,150400,381000,0,531400,A1,AG/GEN,,,
14864,50-9-0-3-0,6716-84-6410,AG 20-100 AC,23.51,AC,170000,110600,59400,295600,0,465600,166800,109200,57600,254100,0,420900,A1,AG/GEN,,,
14865,50-9-0-4-0,6716-93-3658,AG 20-100 AC,21.93,AC,161100,151000,10100,0,0,161100,158100,148800,9300,0,0,158100,A1,AG/GEN,,,
14866,50-9-0-5-0,6716-94-7134,SNGL FAM SUB,10.73,AC,98400,0,98400,245400,0,343800,96500,0,96500,212000,0,308500,A1,AG/GEN,,,
14867,50-9-0-6-0,6726-04-1314,SNGL FAM SUB,8.61,AC,86500,0,86500,264200,1000,351700,84900,0,84900,233300,1000,319200,A1,AG/GEN,,,
14868,50-9-0-7-0,6726-03-6787,SNGL FAM SUB,11.18,AC,100900,0,100900,322600,3000,426500,99000,0,99000,277900,3000,379900,A1,AG/GEN,,,
14869,50-9-0-8-0,6726-03-4292,SNGL FAM SUB,14.31,AC,118400,0,118400,384800,105300,608500,116200,0,116200,322500,99300,538000,A1,AG/GEN,,,
14870,50-9-0-9-0,6726-12-4921,AG 20-100 AC,20.1,AC,150900,0,150900,0,0,150900,148100,0,148100,0,0,148100,A1,AG/GEN,,,
14871,50-9-0-10-0,6726-13-7529,AG 20-100 AC,20.48,AC,153000,0,153000,332800,0,485800,150100,0,150100,286800,0,436900,A1,AG/GEN,,,
14872,58-1-0-61-A,7716-70-6868,AG 20-100 AC,25.36,AC,740500,728800,11700,0,0,740500,644100,633300,10800,0,0,644100,A2,AG/LTD,,,
14875,44-1-0-28-D,6787-02-0910,SNGL FAM SUB,2.405,AC,89500,0,89500,133400,1500,224400,79900,0,79900,105600,1500,187000,A2,AG/LTD,,,
14876,1-1-0-14-0,6814-45-0201,TAXED -SCC,2,AC,0,0,0,0,0,0,0,0,0,0,0,0,A1,AG/GEN,,,
14877,9-8-0-A-0,6801-08-1115,AG 20-100 AC,20.14,AC,87700,0,87700,272300,6100,366100,85900,0,85900,242100,6500,334500,A1,AG/GEN,,,
14878,9-8-0-B-0,5891-98-1067,SNGL FAM SUB,5.44,AC,54800,0,54800,163000,200,218000,53500,0,53500,141300,200,195000,A1,AG/GEN,,,
14879,9-8-0-C-0,5891-98-5323,SNGL FAM SUB,5.25,AC,54100,0,54100,154100,7600,215800,52900,0,52900,133700,8100,194700,A1,AG/GEN,,,
14880,9-8-0-D-0,5891-98-8588,SNGL FAM SUB,5.25,AC,54100,0,54100,160500,800,215400,52900,0,52900,139600,800,193300,A1,AG/GEN,,,
14881,9-8-0-E-0,6801-08-2843,SNGL FAM SUB,5.27,AC,54200,0,54200,170600,18600,243400,52900,0,52900,148400,17700,219000,A1,AG/GEN,,,
14882,9-8-0-F-0,5891-98-3899,AG 20-100 AC,21.23,AC,90500,0,90500,213400,31400,335300,88600,0,88600,184700,29300,302600,A1,AG/GEN,,,
14883,9-8-0-G-0,5891-99-1353,AG 20-100 AC,20.18,AC,87800,0,87800,0,0,87800,82100,0,82100,0,0,82100,A1,AG/GEN,,,
14884,9-8-0-H-0,5891-89-8735,AG 20-100 AC,20.07,AC,87500,0,87500,0,0,87500,81900,0,81900,0,0,81900,A1,AG/GEN,,,
14885,9-8-0-I-0,5892-80-5259,AG 20-100 AC,20.1,AC,87600,0,87600,0,0,87600,83400,0,83400,0,0,83400,A1,AG/GEN,,,
14886,9-8-0-J-0,5892-70-9437,AG 20-100 AC,20.07,AC,85600,0,85600,562600,0,648200,83300,0,83300,497500,0,580800,A1,AG/GEN,,,
14887,9-8-0-K-0,6801-19-0772,AG 20-100 AC,68.75,AC,170900,100900,70000,355100,0,526000,166700,99900,66800,309100,0,475800,A1,AG/GEN,,,
14888,21-1-0-20-A,6759-39-0950,SNGL FAM SUB,3.61,AC,85500,0,85500,424900,5000,515400,77000,0,77000,357600,3600,438200,A2,AG/LTD,,,
14889,31-1-0-71-A,6779-11-5610,AG 20-100 AC,43.86,AC,85100,0,85100,1438400,166700,1690200,75500,0,75500,1163900,156000,1395400,A2,AG/LTD,,,
14890,31-2-0-2-C2,6769-41-7553,SNGL FAM SUB,4.209,AC,99400,0,99400,155700,23100,278200,88500,0,88500,128600,19100,236200,A2,AG/LTD,,,
14891,62-31-0-D-0,7704-48-2735,Roads,9.736,AC,0,0,0,0,0,0,0,0,0,0,0,0,RR,RES/RUR,,,
14892,2-1-0-12-0,6824-14-2083,AG 20-100 AC,37.59,AC,186200,135600,50600,390700,0,576900,182700,133900,48800,333000,0,515700,A1,AG/GEN,,,
14893,4-1-0-16-A,6803-53-0900,Cemetery,0,AC,100,0,100,0,0,100,100,0,100,0,0,100,A1,AG/GEN,,,
14894,11-1-0-39-A,6821-68-9091,SNGL FAM SUB,2.91,AC,51500,0,51500,0,0,51500,49500,0,49500,0,0,49500,A1,AG/GEN,,,
14895,11-1-0-39-B,6821-67-8855,SNGL FAM SUB,3,AC,52000,0,52000,162300,0,214300,50000,0,50000,132500,0,182500,A1,AG/GEN,,,
14896,11-1-0-39-C,6821-57-6135,SNGL FAM SUB,7.04,AC,66900,0,66900,0,0,66900,66800,0,66800,0,0,66800,A1,AG/GEN,,,
14897,11-1-0-39-D,6821-67-4836,SNGL FAM SUB,3,AC,52000,0,52000,0,0,52000,51000,0,51000,0,0,51000,A1,AG/GEN,,,
14898,11-1-0-49-A,6821-49-9723,SNGL FAM SUB,3.4,AC,54300,0,54300,0,0,54300,52400,0,52400,0,0,52400,A1,AG/GEN,,,
14899,11-1-0-49-B,6821-69-2022,AG 20-100 AC,51.54,AC,228000,158900,69100,478100,2800,708900,224300,163000,61300,392700,2300,619300,A1,AG/GEN,,,
14901,6-10-0-3-A,6822-97-5724,SNGL FAM SUB,2.08,AC,49100,0,49100,213200,0,262300,47600,0,47600,188700,0,236300,A1,AG/GEN,,,
14903,12-22-0-3-0,6832-91-0159,SNGL FAM SUB,5.53,AC,87600,0,87600,0,91200,178800,80900,0,80900,0,79500,160400,A1,AG/GEN,,,
14904,12-26-0-1-0,6832-17-6574,SNGL FAM SUB,2.41,AC,54600,0,54600,166300,16800,237700,53500,0,53500,140500,15000,209000,A1,AG/GEN,,,
14905,12-26-0-2-0,6832-17-5238,SNGL FAM SUB,2.49,AC,55300,0,55300,154900,0,210200,54100,0,54100,137200,0,191300,A1,AG/GEN,,,
14906,12-26-0-3-0,6832-17-3022,SNGL FAM SUB,2.4,AC,50200,0,50200,195800,0,246000,49100,0,49100,169100,0,218200,A1,AG/GEN,,,
14907,12-26-0-4-0,6832-16-0527,SNGL FAM SUB,4.31,AC,61400,0,61400,176700,0,238100,60200,0,60200,152000,0,212200,A1,AG/GEN,,,
14908,9-9-0-1-0,5892-93-5039,AG 20-100 AC,20.01,AC,104900,0,104900,237500,7000,349400,104500,0,104500,212100,7000,323600,A1,AG/GEN,,,
14909,9-9-0-2-0,6802-03-2390,SNGL FAM SUB,5.01,AC,57100,0,57100,110200,1200,168500,56000,0,56000,97200,1300,154500,A1,AG/GEN,,,
14910,9-9-0-3-0,6802-02-0661,AG 20-100 AC,20.01,AC,104900,0,104900,199000,19600,323500,104500,0,104500,177900,17600,300000,A1,AG/GEN,,,
14911,9-9-0-4-0,6802-02-3098,AG 20-100 AC,20.01,AC,104900,0,104900,0,0,104900,104500,0,104500,0,0,104500,A1,AG/GEN,,,
14912,9-9-0-5-0,6802-01-5168,AG 20-100 AC,21,AC,107900,0,107900,109200,900,218000,108000,0,108000,90700,900,199600,A1,AG/GEN,,,
14913,9-9-0-6-0,5892-90-6929,SNGL FAM SUB,11.57,AC,82500,0,82500,117100,27400,227000,80300,0,80300,97300,27400,205000,A1,AG/GEN,,,
14914,9-9-0-6-A,5892-91-4043,Cemetery,0,AC,100,0,100,0,0,100,100,0,100,0,0,100,A1,AG/GEN,,,
14915,9-9-0-7-0,5892-91-2424,AG 20-100 AC,20.01,AC,104900,49200,55700,211800,19200,335900,104500,58400,46100,189700,18700,312900,A1,AG/GEN,,,
14916,9-9-0-8-0,5892-81-1189,SNGL FAM SUB,5.84,AC,56200,0,56200,150500,1900,208600,59800,0,59800,130700,1900,192400,A1,AG/GEN,,,
14917,9-9-0-9-0,5892-81-2578,SNGL FAM SUB,5.01,AC,57100,0,57100,0,0,57100,56000,0,56000,0,0,56000,A1,AG/GEN,,,
14918,9-9-0-10-0,5892-82-7088,AG 20-100 AC,20.81,AC,107400,0,107400,220200,13000,340600,107300,0,107300,191500,20200,319000,A1,AG/GEN,,,
14919,9-9-0-11-0,5892-82-4653,AG 20-100 AC,20.01,AC,104900,0,104900,0,8000,112900,104500,0,104500,0,8900,113400,A1,AG/GEN,,,
14920,10-1-0-2-A,6802-86-6919,AG 20-100 AC,20.11,AC,123100,113600,9500,0,0,123100,119700,111100,8600,0,0,119700,A1,AG/GEN,,,
14921,5-1-0-51-A,6823-33-3660,Cemetery,2,AC,100,0,100,0,0,100,100,0,100,0,0,100,A1,AG/GEN,,,
14922,5-1-0-67-A1,6823-49-4305,SNGL FAM SUB,2.55,AC,45200,0,45200,118200,400,163800,44500,0,44500,108000,400,152900,A1,AG/GEN,,,
14923,5-1-0-67-A2,6823-49-7076,SNGL FAM SUB,4.39,AC,54100,0,54100,164300,0,218400,53200,0,53200,142200,0,195400,A1,AG/GEN,,,
14924,5-1-0-67-A3,6823-48-6822,SNGL FAM SUB,4.03,AC,55200,0,55200,149700,3500,208400,54200,0,54200,130000,3500,187700,A1,AG/GEN,,,
14925,5-1-0-67-A4,6823-49-2124,SNGL FAM SUB,2.53,AC,47500,0,47500,148900,2000,198400,46700,0,46700,136800,2000,185500,A1,AG/GEN,,,
14926,10-6-0-B-0,6801-63-7810,SNGL FAM SUB,0.12,AC,600,0,600,0,0,600,500,0,500,0,0,500,A1,AG/GEN,,,
14927,5-5-0-E-1,6823-56-1327,SNGL FAM SUB,2,AC,44800,0,44800,173300,2000,220100,44000,0,44000,150600,2000,196600,A1,AG/GEN,,,
14928,15-1-0-7-A,5789-97-5151,AG 20-100 AC,65.208,AC,309000,0,309000,516000,165900,990900,163400,0,163400,236800,130900,531100,A1,AG/GEN,,,
14929,5-22-0-1-0,6824-00-8079,AG 20-100 AC,22.729,AC,139400,0,139400,0,0,139400,136800,0,136800,0,0,136800,A1,AG/GEN,,,
14930,5-22-0-2-0,6824-00-7965,AG 20-100 AC,21.561,AC,134100,0,134100,383400,9600,527100,131500,0,131500,333400,7600,472500,A1,AG/GEN,,,
14931,5-22-0-3-0,6824-01-5464,AG 20-100 AC,28.435,AC,150000,0,150000,0,0,150000,147100,0,147100,0,0,147100,A1,AG/GEN,,,
14932,15-1-0-8-B1,5799-08-3301,AG 20-100 AC,65.171,AC,227900,0,227900,477300,280800,986000,130300,0,130300,0,300,130600,A1,AG/GEN,,,
14933,5-22-0-4-0,6824-01-2729,AG 20-100 AC,28.157,AC,149200,0,149200,99900,20300,269400,146400,0,146400,86000,20000,252400,A1,AG/GEN,,,
14934,5-22-0-5-0,6814-92-8186,AG 20-100 AC,27.902,AC,148500,79200,69300,464400,66200,679100,145700,78300,67400,414400,57800,617900,A1,AG/GEN,,,
14935,16-1-0-27-A,5890-42-5975,Cemetery,0,AC,100,0,100,0,0,100,100,0,100,0,0,100,A1,AG/GEN,,,
14936,5-22-0-6-0,6814-92-5531,AG 20-100 AC,29.367,AC,158800,106000,52800,282900,4200,445900,155700,104600,51100,253200,3100,412000,A1,AG/GEN,,,
14937,16-1-0-56-0,5799-17-8814,AG 20-100 AC,40.5,AC,128000,61500,66500,0,0,128000,123500,53200,70300,0,0,123500,A1,AG/GEN,,,
14938,16-1-0-81-A,5799-87-7947,SNGL FAM SUB,18,AC,36800,28500,8300,0,0,36800,36000,28300,7700,0,0,36000,A1,AG/GEN,,,
14939,16-1-0-81-B,5799-87-2479,SNGL FAM SUB,6,AC,19400,16600,2800,0,0,19400,18000,15400,2600,0,0,18000,A1,AG/GEN,,,
14940,17-1-0-21-A,6709-69-4154,SNGL FAM SUB,2.034,AC,44600,0,44600,231600,0,276200,43700,0,43700,201500,0,245200,A1,AG/GEN,,,
14941,17-1-0-39-C,6801-60-6514,SNGL FAM SUB,3.58,AC,50700,0,50700,221900,700,273300,48300,0,48300,198800,700,247800,A1,AG/GEN,,,
14943,18-1-0-6-B1,6810-88-3156,SNGL FAM SUB,7.25,AC,75300,0,75300,0,0,75300,75500,0,75500,0,0,75500,A1,AG/GEN,,,
14944,18-1-0-49-A,6810-87-3584,SNGL FAM SUB,2,AC,46000,0,46000,198400,0,244400,43500,0,43500,161800,0,205300,A1,AG/GEN,,,
14945,18-1-0-49-B,6820-07-3228,AG 20-100 AC,91.11,AC,320200,266700,53500,0,0,320200,314300,264300,50000,0,0,314300,A1,AG/GEN,,,
14946,18-1-0-49-C,6810-97-1338,Cemetery,0,AC,100,0,100,0,0,100,100,0,100,0,0,100,A1,AG/GEN,,,
14947,18-10-0-3-B,6719-99-0847,SNGL FAM SUB,5,AC,63500,0,63500,268700,5100,337300,62000,0,62000,212100,3900,278000,A1,AG/GEN,,,
14949,21-10-0-B-0,6850-42-1575,Cmn Area/Open Spc,2.21,AC,0,0,0,0,0,0,0,0,0,0,0,0,RR,RES/RUR,,,
14951,21-10-0-1-0,6850-22-7518,SNGL FAM SUB,3,AC,100000,0,100000,270300,0,370300,90000,0,90000,244000,0,334000,RR,RES/RUR,,,
14952,21-10-0-2-0,6850-22-5812,SNGL FAM SUB,3,AC,100000,0,100000,293700,40600,434300,90000,0,90000,271200,34500,395700,RR,RES/RUR,,,
14953,21-10-0-3-0,6850-22-3561,SNGL FAM SUB,3.57,AC,100000,0,100000,309300,66600,475900,90000,0,90000,282800,59400,432200,RR,RES/RUR,,,
14954,21-10-0-4-0,6850-22-1360,SNGL FAM SUB,4.41,AC,100000,0,100000,271900,0,371900,90000,0,90000,239000,0,329000,RR,RES/RUR,,,
14955,21-10-0-5-0,6850-11-9995,SNGL FAM SUB,5.09,AC,100000,0,100000,297600,0,397600,90000,0,90000,270600,0,360600,RR,RES/RUR,,,
14956,21-10-0-6-0,6850-11-8380,SNGL FAM SUB,10.83,AC,125000,0,125000,431300,28900,585200,114000,0,114000,395700,25400,535100,RR,RES/RUR,,,
14957,21-10-0-11-0,6850-12-7648,SNGL FAM SUB,3.13,AC,100000,0,100000,325800,0,425800,90000,0,90000,296100,0,386100,RR,RES/RUR,,,
14958,21-10-0-12-0,6850-12-9983,SNGL FAM SUB,3.14,AC,100000,0,100000,437600,3100,540700,90000,0,90000,398600,3400,492000,RR,RES/RUR,,,
14959,21-10-0-13-0,6850-23-1182,SNGL FAM SUB,3,AC,100000,0,100000,301200,26900,428100,90000,0,90000,273300,26200,389500,RR,RES/RUR,,,
14960,21-10-0-14-0,6850-23-3269,SNGL FAM SUB,3,AC,100000,0,100000,279700,3100,382800,90000,0,90000,255100,3400,348500,RR,RES/RUR,,,
14961,21-10-0-15-0,6850-23-5445,SNGL FAM SUB,3,AC,100000,0,100000,314600,4000,418600,90000,0,90000,286900,4000,380900,RR,RES/RUR,,,
14962,21-10-0-16-0,6850-23-6599,SNGL FAM SUB,3.05,AC,100000,0,100000,386100,56100,542200,90000,0,90000,344100,49100,483200,RR,RES/RUR,,,
14963,21-10-0-17-0,6850-23-8724,SNGL FAM SUB,3,AC,100000,0,100000,352400,41400,493800,90000,0,90000,322400,36500,448900,RR,RES/RUR,,,
14964,21-10-0-18-0,6850-23-9981,SNGL FAM SUB,3,AC,100000,0,100000,252100,24100,376200,90000,0,90000,228700,21300,340000,RR,RES/RUR,,,
14965,21-10-0-19-0,6850-34-1027,SNGL FAM SUB,3,AC,100000,0,100000,306600,2500,409100,90000,0,90000,278900,2700,371600,RR,RES/RUR,,,
14966,20-19-0-7-0,6850-11-5407,SNGL FAM SUB,7.03,AC,105000,0,105000,311800,60900,477700,95000,0,95000,279800,53600,428400,RR,RES/RUR,,,
14967,21-10-0-20-0,6850-34-3214,SNGL FAM SUB,4.6,AC,100000,0,100000,311800,0,411800,90000,0,90000,283900,0,373900,RR,RES/RUR,,,
14968,21-10-0-21-0,6850-34-5480,SNGL FAM SUB,6.26,AC,105000,0,105000,382700,0,487700,95000,0,95000,350000,0,445000,RR,RES/RUR,,,
14969,21-10-0-22-0,6850-34-8689,SNGL FAM SUB,6.75,AC,105000,0,105000,345700,28400,479100,95000,0,95000,311200,24500,430700,RR,RES/RUR,,,
14970,21-10-0-23-0,6850-44-2750,SNGL FAM SUB,5.11,AC,100000,0,100000,239700,3300,343000,90000,0,90000,218200,3500,311700,RR,RES/RUR,,,
14971,20-19-0-8-0,6850-11-2884,SNGL FAM SUB,4.81,AC,100000,0,100000,433400,0,533400,90000,0,90000,393000,0,483000,RR,RES/RUR,,,
14972,21-10-0-24-0,6850-44-5669,SNGL FAM SUB,6.37,AC,105000,0,105000,485800,0,590800,95000,0,95000,433400,0,528400,RR,RES/RUR,,,
14973,20-19-0-9-0,6850-12-2189,SNGL FAM SUB,3.53,AC,100000,0,100000,329800,37400,467200,90000,0,90000,303500,35800,429300,RR,RES/RUR,,,
14974,20-19-0-10-0,6850-12-5455,SNGL FAM SUB,3,AC,100000,0,100000,267100,1600,368700,90000,0,90000,243200,1700,334900,RR,RES/RUR,,,
14975,21-10-0-25-0,6850-44-7436,SNGL FAM SUB,5.34,AC,100000,0,100000,386500,17400,503900,90000,0,90000,348600,14800,453400,RR,RES/RUR,,,
14976,21-1-0-39-B,6759-49-4502,SNGL FAM SUB,6.79,AC,113200,0,113200,366200,6400,485800,104300,0,104300,292400,6400,403100,A2,AG/LTD,,,
14977,21-1-0-46-A,6850-63-6563,SNGL FAM SUB,2.48,AC,72200,0,72200,211700,21900,305800,65300,0,65300,176200,19100,260600,A2,AG/LTD,,,
14978,21-1-0-46-B,6850-63-5430,SNGL FAM SUB,2.01,AC,66500,0,66500,182700,3300,252500,60400,0,60400,150200,2500,213100,A2,AG/LTD,,,
14979,21-10-0-26-0,6850-44-9249,SNGL FAM SUB,5.02,AC,100000,0,100000,387900,3700,491600,90000,0,90000,353000,4000,447000,RR,RES/RUR,,,
14980,21-10-0-27-0,6850-54-2123,SNGL FAM SUB,7.14,AC,105000,0,105000,283200,3300,391500,95000,0,95000,257400,2800,355200,RR,RES/RUR,,,
14981,21-10-0-28-0,6850-43-9645,SNGL FAM SUB,4.16,AC,100000,0,100000,282100,0,382100,90000,0,90000,257500,0,347500,RR,RES/RUR,,,
14982,21-10-0-29-0,6850-43-6404,SNGL FAM SUB,5,AC,100000,0,100000,336700,17500,454200,90000,0,90000,290000,0,380000,RR,RES/RUR,,,
14983,21-10-0-30-0,6850-43-3532,SNGL FAM SUB,5.8,AC,100000,0,100000,277800,45300,423100,90000,0,90000,257100,40600,387700,RR,RES/RUR,,,
14984,21-10-0-31-0,6850-43-1748,SNGL FAM SUB,3.95,AC,100000,0,100000,297600,6900,404500,90000,0,90000,271500,4800,366300,RR,RES/RUR,,,
14985,21-10-0-32-0,6850-33-9979,SNGL FAM SUB,3.44,AC,100000,0,100000,270500,32800,403300,90000,0,90000,254700,27700,372400,RR,RES/RUR,,,
14986,21-10-0-33-0,6850-33-7711,SNGL FAM SUB,3.5,AC,100000,0,100000,270300,0,370300,90000,0,90000,252500,0,342500,RR,RES/RUR,,,
14987,21-10-0-34-0,6850-33-5555,SNGL FAM SUB,3,AC,100000,0,100000,218300,6000,324300,90000,0,90000,195400,4600,290000,RR,RES/RUR,,,
14988,21-10-0-35-0,6850-33-3399,SNGL FAM SUB,3,AC,100000,0,100000,380200,1500,481700,90000,0,90000,351600,1500,443100,RR,RES/RUR,,,
14989,21-10-0-35-A,6850-33-2453,Cemetery,0,AC,100,0,100,0,0,100,100,0,100,0,0,100,RR,RES/RUR,,,
14990,21-10-0-36-0,6850-33-2233,SNGL FAM SUB,3,AC,100000,0,100000,283300,5000,388300,90000,0,90000,256200,3500,349700,RR,RES/RUR,,,
14991,21-10-0-37-0,6850-23-8161,SNGL FAM SUB,3.01,AC,100000,0,100000,414100,27400,541500,90000,0,90000,376900,25600,492500,RR,RES/RUR,,,
14992,21-10-0-38-0,6850-32-0971,SNGL FAM SUB,3.01,AC,100000,0,100000,287700,3700,391400,90000,0,90000,260300,2600,352900,RR,RES/RUR,,,
14993,22-1-0-13-0,6769-97-8851,SNGL FAM SUB,2.15,AC,75200,0,75200,191000,3000,269200,67100,0,67100,161300,3000,231400,A2,AG/LTD,,,
14994,25-1-0-5-D1,5798-98-5750,AG 20-100 AC,42.7,AC,128100,106300,21800,0,0,128100,128100,109700,18400,0,0,128100,A1,AG/GEN,,,
14995,30-1-0-43-A,6758-37-9542,SNGL FAM SUB,7.32,AC,116700,0,116700,0,9400,126100,109300,0,109300,0,8300,117600,A2,AG/LTD,,,
15295,58-1-0-50-C,7715-62-7857,SNGL FAM SUB,2.46,AC,136400,0,136400,140300,900,277600,118500,0,118500,118800,900,238200,A2,AG/LTD,,,
15296,62-1-0-35-A,7715-10-5506,SNGL FAM SUB,2.28,AC,237000,0,237000,523900,0,760900,206100,0,206100,468400,0,674500,A2,AG/LTD,,,
15297,62-1-0-35-B,7715-10-8453,SNGL FAM SUB,2.27,AC,236700,0,236700,554000,0,790700,205900,0,205900,500900,0,706800,A2,AG/LTD,,,
15300,64-20-0-6-B,7724-64-0079,Cemetery,0,AC,100,0,100,0,0,100,100,0,100,0,0,100,M1,INDUS/L,,,
15302,64-21-0-3-0,7733-57-9664,Cmn Area/Open Spc,0.36,AC,0,0,0,0,0,0,0,0,0,0,0,0,RPUD,RES/PUD,,,
15303,64-23-0-B-0,7733-57-6138,Roads,3.925,AC,0,0,0,0,0,0,0,0,0,0,0,0,RPUD,RES/PUD,,,
15304,64-23-0-C-0,7733-57-5821,Cmn Area/Open Spc,8.462,AC,0,0,0,0,0,0,0,0,0,0,0,0,RPUD,RES/PUD,,,
15305,64-23-0-52-0,7733-67-0228,SNGL FAM URB,0.404,AC,230000,0,230000,550500,0,780500,200000,0,200000,509000,0,709000,RPUD,RES/PUD,,,
15306,64-23-0-53-0,7733-57-9367,SNGL FAM URB,0.398,AC,230000,0,230000,620100,0,850100,200000,0,200000,570900,0,770900,RPUD,RES/PUD,,,
15307,64-23-0-54-0,7733-57-8344,SNGL FAM URB,0.394,AC,230000,0,230000,503100,0,733100,200000,0,200000,464600,0,664600,RPUD,RES/PUD,,,
15308,64-23-0-55-0,7733-57-7335,SNGL FAM URB,0.388,AC,230000,0,230000,656800,0,886800,200000,0,200000,607700,0,807700,RPUD,RES/PUD,,,
15309,64-23-0-56-0,7733-57-6441,SNGL FAM URB,0.364,AC,230000,0,230000,585600,0,815600,200000,0,200000,539000,0,739000,RPUD,RES/PUD,,,
15310,64-23-0-57-0,7733-57-5468,SNGL FAM URB,0.345,AC,230000,0,230000,616100,0,846100,200000,0,200000,567300,0,767300,RPUD,RES/PUD,,,
15311,64-23-0-58-0,7733-57-4466,SNGL FAM URB,0.362,AC,230000,0,230000,563600,0,793600,200000,0,200000,520600,0,720600,RPUD,RES/PUD,,,
15312,64-23-0-59-0,7733-57-3454,SNGL FAM URB,0.362,AC,230000,0,230000,569800,0,799800,200000,0,200000,525000,0,725000,RPUD,RES/PUD,,,
15313,64-23-0-60-0,7733-57-2422,SNGL FAM URB,0.362,AC,230000,0,230000,598000,0,828000,200000,0,200000,551400,0,751400,RPUD,RES/PUD,,,
15314,64-23-0-74-0,7733-67-2214,SNGL FAM URB,0.362,AC,230000,0,230000,555300,0,785300,200000,0,200000,512400,0,712400,RPUD,RES/PUD,,,
15315,64-23-0-75-0,7733-67-2305,SNGL FAM URB,0.362,AC,230000,0,230000,550000,0,780000,200000,0,200000,509300,0,709300,RPUD,RES/PUD,,,
15316,64-23-0-76-0,7733-67-1496,SNGL FAM URB,0.429,AC,230000,0,230000,538000,0,768000,200000,0,200000,495100,0,695100,RPUD,RES/PUD,,,
15317,64-23-0-77-0,7733-67-1548,SNGL FAM URB,0.643,AC,230000,0,230000,683000,0,913000,200000,0,200000,629600,0,829600,RPUD,RES/PUD,,,
15471,45-1-0-90-B,6797-86-1285,SNGL FAM SUB,0.81,AC,12800,0,12800,0,0,12800,11400,0,11400,0,0,11400,A2,AG/LTD,,,
15472,46-1-0-53-A1,7716-09-0238,SNGL FAM SUB,2.47,AC,132500,0,132500,328700,2600,463800,118400,0,118400,273000,2600,394000,A2,AG/LTD,,,
15474,46-1-0-53-A2,7716-08-0956,SNGL FAM SUB,2.14,AC,117700,0,117700,0,0,117700,105100,0,105100,0,0,105100,A2,AG/LTD,,,
15475,46-1-0-53-A3,7716-08-0708,SNGL FAM SUB,2.15,AC,117900,0,117900,219800,1200,338900,105300,0,105300,184100,1200,290600,A2,AG/LTD,,,
15476,45-1-0-92-B,6797-97-4542,SNGL FAM SUB,8,AC,169700,0,169700,285700,23200,478600,151700,0,151700,235300,21400,408400,A2,AG/LTD,,,
15477,45-21-0-3-A,6797-89-6218,SNGL FAM SUB,2.344,AC,79000,0,79000,199200,3000,281200,70500,0,70500,162500,3000,236000,A2,AG/LTD,,,
15479,46-31-0-9-0,7708-71-4963,SNGL FAM SUB,3.73,AC,170000,0,170000,356400,0,526400,156000,0,156000,300800,0,456800,RR,RES/RUR,,,
15480,13-1-0-13-B,6841-79-2100,SNGL FAM SUB,2.62,AC,49900,0,49900,192700,4300,246900,49000,0,49000,167300,4300,220600,A1,AG/GEN,,,
15481,13-1-0-13-C,6841-78-4999,SNGL FAM SUB,5.26,AC,80500,0,80500,0,0,80500,78900,0,78900,0,0,78900,A1,AG/GEN,,,
15482,13-21-0-A-0,6841-56-4678,SNGL FAM SUB,4.18,AC,77300,0,77300,152300,2000,231600,75900,0,75900,126400,2000,204300,A1,AG/GEN,,,
15484,13-21-0-C-0,6841-47-8037,SNGL FAM SUB,3.36,AC,70400,0,70400,93100,0,163500,64100,0,64100,90600,0,154700,A1,AG/GEN,,,
15486,13-21-0-E-0,6841-56-2808,SNGL FAM SUB,4.5,AC,79800,0,79800,133100,100,213000,78300,0,78300,128500,100,206900,A1,AG/GEN,,,
15487,29-1-0-24-A,6748-22-1862,SNGL FAM SUB,8,AC,135900,0,135900,192800,500,329200,129200,0,129200,158100,500,287800,A1,AG/GEN,,,
15488,29-1-0-24-B,6748-22-5642,SNGL FAM SUB,8.01,AC,136000,0,136000,0,0,136000,129300,0,129300,0,0,129300,A1,AG/GEN,,,
15489,29-1-0-24-C,6748-22-0168,SNGL FAM SUB,5.891,AC,118000,0,118000,600000,11900,729900,108400,0,108400,493300,9500,611200,A1,AG/GEN,,,
14996,30-1-0-43-B,6758-57-2482,AG 20-100 AC,32.11,AC,285900,216900,69000,285900,15900,587700,240300,179600,60700,247400,14300,502000,A2,AG/LTD,,,
14998,30-1-0-43-D,6758-47-4393,SNGL FAM SUB,11.6,AC,172900,0,172900,0,39100,212000,162000,0,162000,0,33700,195700,A2,AG/LTD,,,
14999,25-1-0-11-C,5799-24-2826,SNGL FAM SUB,19.377,AC,114100,0,114100,0,0,114100,111500,0,111500,0,0,111500,A1,AG/GEN,,,
15001,26-1-0-12-D,6709-94-6847,SNGL FAM SUB,8.25,AC,80000,0,80000,0,0,80000,81500,0,81500,0,0,81500,A1,AG/GEN,,,
15002,29-5-0-2-D,6749-74-8654,Cemetery,0,AC,100,0,100,0,0,100,100,0,100,0,0,100,A1,AG/GEN,,,
15003,29-5-0-2-E,6749-74-1938,SNGL FAM SUB,3.746,AC,80500,0,80500,177700,26200,284400,77100,0,77100,147200,22300,246600,A1,AG/GEN,,,
15004,26-13-0-1-0,6708-78-2168,SNGL FAM SUB,15,AC,117200,0,117200,255200,58200,430600,115000,0,115000,222900,55100,393000,RR,RES/RUR,,,
15005,27-1-0-74-A,6728-46-5514,SNGL FAM SUB,14.677,AC,115400,0,115400,0,0,115400,113200,0,113200,0,0,113200,A1,AG/GEN,,,
15006,28-1-0-51-A,6738-15-9688,SNGL FAM SUB,11,AC,107600,0,107600,8100,0,115700,106700,0,106700,8400,0,115100,A1,AG/GEN,,,
15007,28-1-0-51-B,6738-14-7992,SNGL FAM SUB,11,AC,105000,0,105000,0,0,105000,102900,0,102900,0,0,102900,A1,AG/GEN,,,
15008,28-1-0-51-C,6738-24-2883,SNGL FAM SUB,9.32,AC,93400,0,93400,0,0,93400,91500,0,91500,0,0,91500,A1,AG/GEN,,,
15009,28-1-0-51-C1,6738-25-5136,Cemetery,0,AC,100,0,100,0,0,100,100,0,100,0,0,100,A1,AG/GEN,,,
15010,28-1-0-51-D,6738-25-5543,SNGL FAM SUB,2,AC,43600,0,43600,0,0,43600,42200,0,42200,0,0,42200,A1,AG/GEN,,,
15011,28-1-0-51-E,6738-25-3385,SNGL FAM SUB,1,AC,37300,0,37300,0,0,37300,34900,0,34900,0,0,34900,A1,AG/GEN,,,
15012,28-1-0-51-F,6738-27-0097,SNGL FAM SUB,0.82,AC,40200,0,40200,0,0,40200,40900,0,40900,0,0,40900,A1,AG/GEN,,,
15013,28-1-0-76-B,6739-26-1677,SNGL FAM SUB,3,AC,60800,0,60800,116500,2000,179300,60300,0,60300,93400,2000,155700,A1,AG/GEN,,,
15014,32-1-0-11-C,6779-75-6117,SNGL FAM SUB,2.43,AC,84700,0,84700,0,0,84700,75600,0,75600,0,0,75600,A2,AG/LTD,,,
15015,32-1-0-30-A,6778-78-5201,SNGL FAM SUB,2.45,AC,85000,0,85000,0,0,85000,75900,0,75900,0,0,75900,A2,AG/LTD,,,
15016,31-1-0-9-C,6769-44-5089,SNGL FAM SUB,9.14,AC,147800,60800,87000,929300,17800,1094900,131600,57800,73800,781200,13100,925900,A2,AG/LTD,,,
15018,32-1-0-41-A,6778-62-2384,Cemetery,0,AC,100,0,100,0,0,100,100,0,100,0,0,100,A2,AG/LTD,,,
15019,33-1-0-9-D,6798-35-5458,SNGL FAM SUB,2,AC,90900,0,90900,163500,0,254400,81200,0,81200,138000,0,219200,A2,AG/LTD,,,
15020,40-1-0-26-D,6737-31-0900,AG 20-100 AC,20.48,AC,155200,0,155200,0,0,155200,152300,0,152300,0,0,152300,A1,AG/GEN,,,
15022,40-4-0-B-3,6737-63-1362,SNGL FAM SUB,3.261,AC,63900,0,63900,451000,0,514900,62700,0,62700,377300,0,440000,A1,AG/GEN,,,
15024,42-1-0-119-0,6766-38-1326,AG 20-100 AC,30.352,AC,348200,0,348200,0,0,348200,311100,0,311100,0,0,311100,A2,AG/LTD,,,
15025,42-1-0-119-A,6766-39-8854,SNGL FAM SUB,10,AC,188900,0,188900,0,0,188900,168800,0,168800,0,0,168800,A2,AG/LTD,,,
15026,42-1-0-119-B,6766-39-7446,SNGL FAM SUB,5.488,AC,137900,0,137900,460700,0,598600,123200,0,123200,376400,0,499600,A2,AG/LTD,,,
15027,42-7-0-B-2,6757-85-2013,SNGL FAM SUB,5.38,AC,188300,0,188300,0,0,188300,103700,0,103700,0,0,103700,R3,RES/GEN,,,
15028,31-1-0-66-TW,6779-27-0387-9998,COMM & IND,0,AC,0,0,0,0,124100,124100,0,0,0,0,123100,123100,A2,AG/LTD,,,
15029,31-1-0-69-E,6779-25-2842,AG 20-100 AC,20,AC,269300,195700,73600,221200,2300,492800,239600,174200,65400,185000,2300,426900,A2,AG/LTD,,,
15030,31-28-0-1-0,6779-34-9922,SNGL FAM SUB,4.11,AC,101400,0,101400,376500,3500,481400,90500,0,90500,319900,3500,413900,A2,AG/LTD,,,
15031,31-28-0-2-0,6779-34-7557,SNGL FAM SUB,3,AC,92900,0,92900,0,0,92900,83000,0,83000,0,0,83000,A2,AG/LTD,,,
15032,31-28-0-3-0,6779-34-5626,SNGL FAM SUB,3,AC,92900,0,92900,252000,4000,348900,83000,0,83000,204600,4000,291600,A2,AG/LTD,,,
15033,31-28-0-4-0,6779-34-4922,SNGL FAM SUB,5,AC,109700,0,109700,145900,1000,256600,98000,0,98000,116300,1000,215300,A2,AG/LTD,,,
15034,31-28-0-5-0,6779-35-1023,SNGL FAM SUB,10,AC,161300,0,161300,129300,13000,303600,143600,0,143600,102700,10500,256800,A2,AG/LTD,,,
15035,31-28-0-6-0,6779-25-7329,AG 20-100 AC,20,AC,269300,0,269300,512200,5900,787400,239600,0,239600,423600,5500,668700,A2,AG/LTD,,,
15036,31-29-0-1-0,6778-27-1155,SNGL FAM SUB,8.54,AC,145500,0,145500,0,0,145500,129600,0,129600,0,0,129600,A2,AG/LTD,,,
15037,31-29-0-2-0,6778-27-8516,SNGL FAM SUB,8.22,AC,142100,0,142100,0,0,142100,126500,0,126500,0,0,126500,A2,AG/LTD,,,
15038,31-29-0-3-0,6778-37-3645,SNGL FAM SUB,5.83,AC,116300,0,116300,0,0,116300,103600,0,103600,0,0,103600,A2,AG/LTD,,,
15039,31-29-0-4-0,6778-37-3203,SNGL FAM SUB,12.12,AC,176400,0,176400,0,0,176400,157300,0,157300,0,0,157300,A2,AG/LTD,,,
15040,31-29-0-5-0,6778-38-5110,AG 20-100 AC,26.35,AC,248400,236300,12100,0,0,248400,221100,209900,11200,0,0,221100,A2,AG/LTD,,,
15041,43-33-0-A-0,6777-03-2986,SNGL FAM SUB,1.291,AC,7000,0,7000,0,0,7000,6100,0,6100,0,0,6100,RR,RES/RUR,,,
15042,43-33-0-10-0,6767-94-0981,SNGL FAM SUB,3.64,AC,104500,0,104500,264800,1200,370500,95000,0,95000,240900,1300,337200,RR,RES/RUR,,,
15043,43-33-0-11-0,6767-95-6106,SNGL FAM SUB,5.86,AC,123300,0,123300,318900,5400,447600,112100,0,112100,279200,4500,395800,RR,RES/RUR,,,
15044,43-33-0-12-0,6767-95-9045,SNGL FAM SUB,5.05,AC,123300,0,123300,287400,0,410700,112100,0,112100,258200,0,370300,RR,RES/RUR,,,
15045,43-33-0-13-0,6777-04-2730,SNGL FAM SUB,4.91,AC,123300,0,123300,435700,0,559000,112100,0,112100,382000,0,494100,RR,RES/RUR,,,
15046,43-33-0-14-0,6777-04-4202,SNGL FAM SUB,9.39,AC,169000,0,169000,481100,38500,688600,153600,0,153600,432800,35400,621800,RR,RES/RUR,,,
15047,43-33-0-15-0,6777-03-1842,SNGL FAM SUB,8.72,AC,161900,0,161900,320700,12500,495100,147200,0,147200,281600,11600,440400,RR,RES/RUR,,,
15048,43-33-0-16-0,6767-94-6304,SNGL FAM SUB,5.25,AC,129800,0,129800,388800,47900,566500,118000,0,118000,350900,40300,509200,RR,RES/RUR,,,
15049,43-33-0-17-0,6767-94-2560,SNGL FAM SUB,6.16,AC,129800,0,129800,433200,900,563900,118000,0,118000,357600,1000,476600,RR,RES/RUR,,,
15051,45-1-0-3-B,6798-00-0668,COMM & IND,4.191,AC,392600,0,392600,482000,60000,934600,363600,0,363600,467000,40400,871000,B1,BUS/GEN,,,
15052,47-1-0-35-0,7716-78-2745,COMM & IND,4.032,AC,1773700,0,1773700,0,0,1773700,1612400,0,1612400,0,0,1612400,B1,BUS/GEN,,,
15053,47-1-0-35-A,7716-78-5604,COMM & IND,1.193,AC,524900,0,524900,313100,13800,851800,501100,0,501100,296900,10600,808600,B1,BUS/GEN,,,
15054,47-1-0-35-B,7716-78-5864,COMM & IND,2,AC,1267400,0,1267400,1121100,15000,2403500,1152200,0,1152200,1060500,15200,2227900,B1,BUS/GEN,,,
15055,47-1-0-35-C,7716-78-8841,COMM & IND,1.402,AC,994400,0,994400,399800,7000,1401200,904000,0,904000,376800,7100,1287900,B1,BUS/GEN,,,
15056,47-1-0-56-B,7718-50-6871,SNGL FAM SUB,4,AC,150000,0,150000,184100,0,334100,134000,0,134000,154600,0,288600,A2,AG/LTD,,,
15057,47-31-0-7-0,7728-31-8287,COMM & IND,4.02,AC,540700,0,540700,1180800,49200,1770700,515000,0,515000,1092600,33400,1641000,M2,INDUS/G,,,
15058,47-31-0-8-0,7728-41-0615,COMM & IND,4.75,AC,575000,0,575000,502800,46100,1123900,547600,0,547600,459400,47200,1054200,M2,INDUS/G,,,
15060,51-5-0-E-0,6735-03-6123,SNGL FAM SUB,1,AC,3000,0,3000,0,0,3000,3000,0,3000,0,0,3000,A2,AG/LTD,,,
15061,55-1-0-12-A,6776-93-0041,SNGL FAM SUB,2.064,AC,86200,0,86200,0,0,86200,77000,0,77000,0,0,77000,A2,AG/LTD,,,
15062,56-16-0-12-0,6795-84-4193,SNGL FAM SUB,16.535,AC,532000,0,532000,583500,100100,1215600,462900,0,462900,586300,95500,1144700,RR,RES/RUR,,,
15063,56-16-0-17-0,6795-63-3791,AG 20-100 AC,29.799,AC,799100,0,799100,1006900,31800,1837800,695500,0,695500,1043500,22700,1761700,RR,RES/RUR,,,
15064,56-18-0-56-0,6795-95-5892,SNGL FAM SUB,13.886,AC,474700,0,474700,726400,57300,1258400,413100,0,413100,708100,50900,1172100,RR,RES/RUR,,,
15065,56-18-0-57-0,6795-96-8401,SNGL FAM SUB,13.633,AC,469300,0,469300,781500,97000,1347800,408300,0,408300,758900,89800,1257000,RR,RES/RUR,,,
15066,56-18-0-58-0,7705-07-0190,SNGL FAM SUB,16.664,AC,534700,0,534700,0,0,534700,465300,0,465300,0,0,465300,RR,RES/RUR,,,
15067,48-14-0-A-0,7728-40-5578,Roads,4.48,AC,0,0,0,0,0,0,0,0,0,0,0,0,M2,INDUS/G,,,
15068,48-14-0-1-0,7727-49-4994,COMM & IND,3.79,AC,535900,0,535900,1023900,154000,1713800,510500,0,510500,938300,100900,1549700,M2,INDUS/G,,,
15069,48-14-0-2-0,7728-40-5311,COMM & IND,2,AC,308800,0,308800,265800,49300,623900,294000,0,294000,243700,49900,587600,M2,INDUS/G,,,
15070,48-14-0-3-0,7728-40-5529,COMM & IND,2,AC,308800,0,308800,659800,94500,1063100,294000,0,294000,620900,97500,1012400,M2,INDUS/G,,,
15071,48-14-0-4-0,7728-40-5849,COMM & IND,2,AC,308800,0,308800,466200,41000,816000,294000,0,294000,441000,35000,770000,M2,INDUS/G,,,
15072,57-1-0-54-A,7706-90-7165,SNGL FAM SUB,3.496,AC,265700,0,265700,1317300,86100,1669100,231000,0,231000,1151900,74900,1457800,A2,AG/LTD,,,
15073,48-14-0-5-0,7728-41-5241,COMM & IND,2,AC,308800,0,308800,493600,51700,854100,294000,0,294000,462300,36200,792500,M2,INDUS/G,,,
15074,57-3-0-2-B1,7706-22-8014,SNGL FAM SUB,6.87,AC,262800,0,262800,613300,0,876100,228700,0,228700,522200,0,750900,A2,AG/LTD,,,
15075,48-14-0-6-0,7728-41-2294,COMM & IND,2.3,AC,355100,0,355100,656500,72300,1083900,338100,0,338100,604300,53000,995400,M2,INDUS/G,,,
15076,48-14-0-9-0,7728-41-4680,COMM & IND,2.33,AC,359800,0,359800,486100,159200,1005100,342500,0,342500,454000,127700,924200,M2,INDUS/G,,,
15077,48-14-0-10-0,7728-41-8430,COMM & IND,2.31,AC,356700,0,356700,250200,19400,626300,339600,0,339600,234500,13700,587800,M2,INDUS/G,,,
15078,48-14-0-11-0,7728-40-8951,COMM & IND,3.4,AC,480800,0,480800,511500,35500,1027800,458000,0,458000,465500,31100,954600,M2,INDUS/G,,,
15079,48-14-0-12-0,7728-40-8247,COMM & IND,4,AC,565600,0,565600,600000,111800,1277400,538800,0,538800,555000,81400,1175200,M2,INDUS/G,,,
15081,48-14-0-13-0,7727-49-8748,COMM & IND,1.51,AC,233100,0,233100,281400,52900,567400,222000,0,222000,262800,37200,522000,M2,INDUS/G,,,
15082,48-14-0-16-0,7728-40-1324,COMM & IND,2.68,AC,360500,0,360500,0,4300,364800,343300,0,343300,0,4500,347800,M2,INDUS/G,,,
15084,57-30-0-A-0,7705-05-9915,Roads,5.067,AC,0,0,0,0,0,0,0,0,0,0,0,0,RR,RES/RUR,,,
15085,57-30-0-44-0,7705-04-7361,AG 20-100 AC,25.672,AC,786200,0,786200,710100,0,1496300,684100,0,684100,727600,0,1411700,RR,RES/RUR,,,
15086,57-30-0-47-0,7705-05-4180,SNGL FAM SUB,16.11,AC,569600,0,569600,708600,4000,1282200,495700,0,495700,754200,4000,1253900,RR,RES/RUR,,,
15087,57-30-0-49-0,7705-24-4464,AG 20-100 AC,28.838,AC,1446000,0,1446000,0,6700,1452700,1257400,0,1257400,0,7200,1264600,RR,RES/RUR,,,
15088,57-30-0-50-0,7705-25-8380,AG 20-100 AC,22.15,AC,1234200,0,1234200,709800,22700,1966700,1073200,0,1073200,711300,19300,1803800,RR,RES/RUR,,,
15089,57-30-0-53-0,7705-26-1016,AG 20-100 AC,21.314,AC,698200,0,698200,0,3100,701300,607600,0,607600,0,3100,610700,RR,RES/RUR,,,
15090,57-30-0-55-0,7705-05-4966,SNGL FAM SUB,11.669,AC,475900,0,475900,949500,151500,1576900,414100,0,414100,985000,133100,1532200,RR,RES/RUR,,,
15091,57-30-0-61-0,7705-16-3600,AG 20-100 AC,20.216,AC,671000,0,671000,0,0,671000,583900,0,583900,0,0,583900,RR,RES/RUR,,,
15092,57-30-0-54-0,7705-15-3755,SNGL FAM SUB,17.968,AC,615500,0,615500,766200,370000,1751700,535600,0,535600,771400,334400,1641400,RR,RES/RUR,,,
15093,59-1-0-41-B,7726-64-8947,Cemetery,0,AC,100,0,100,0,0,100,100,0,100,0,0,100,M1,INDUS/L,,,
15095,61-4-0-B-1,6795-60-0100,SNGL FAM SUB,10,AC,354200,111400,242800,275800,3000,633000,307800,96800,211000,232700,3000,543500,A2,AG/LTD,,,
15096,62-1-0-6-A,7704-21-5811,SNGL FAM SUB,0,AC,1800,0,1800,0,0,1800,1600,0,1600,0,0,1600,A2,AG/LTD,,,
15097,62-1-0-6-B,7704-12-8515,SNGL FAM SUB,0,AC,600,0,600,0,0,600,550,0,550,0,0,550,A2,AG/LTD,,,
15098,62-1-0-6-C,7704-22-5012,SNGL FAM SUB,0,AC,600,0,600,0,0,600,550,0,550,0,0,550,A2,AG/LTD,,,
15100,9-10-0-1-0,6801-12-5203,SNGL FAM SUB,5.45,AC,52100,0,52100,121700,500,174300,51400,0,51400,97500,500,149400,A1,AG/GEN,,,
15101,9-10-0-2-0,6801-11-6998,SNGL FAM SUB,5,AC,50600,0,50600,191200,3000,244800,50000,0,50000,166000,3000,219000,A1,AG/GEN,,,
15102,16-3-0-2-A,5799-38-4524,AG 20-100 AC,23.802,AC,73600,23900,49700,220100,1100,294800,71100,23400,47700,198300,1100,270500,A1,AG/GEN,,,
15103,16-3-0-2-B,5799-38-8760,SNGL FAM SUB,5,AC,51300,0,51300,109900,1300,162500,50000,0,50000,91300,1400,142700,A1,AG/GEN,,,
15104,16-3-0-2-C,5799-39-5172,AG 20-100 AC,20.19,AC,78000,0,78000,0,0,78000,76400,0,76400,0,0,76400,A1,AG/GEN,,,
15105,16-3-0-2-D,5799-49-0329,AG 20-100 AC,41.08,AC,88500,0,88500,0,0,88500,88200,0,88200,0,0,88200,A1,AG/GEN,,,
15106,16-7-0-3-0,6801-11-8799,SNGL FAM SUB,4,AC,47200,0,47200,114900,8900,171000,47000,0,47000,93700,8900,149600,A1,AG/GEN,,,
15107,16-7-0-4-0,6801-21-1362,AG 20-100 AC,20,AC,78600,0,78600,0,3500,82100,76000,0,76000,0,3500,79500,A1,AG/GEN,,,
15108,16-7-0-5-0,6801-10-4796,AG 20-100 AC,20,AC,78600,0,78600,0,0,78600,76000,0,76000,0,0,76000,A1,AG/GEN,,,
15109,16-7-0-6-0,6801-01-8152,AG 20-100 AC,20,AC,78600,0,78600,37100,4000,119700,76000,0,76000,34100,4000,114100,A1,AG/GEN,,,
15110,16-7-0-7-0,6801-11-2722,SNGL FAM SUB,4,AC,47200,0,47200,97000,200,144400,47000,0,47000,81200,200,128400,A1,AG/GEN,,,
15111,22-1-0-9-A1,6769-78-3961,SNGL FAM SUB,2.91,AC,84300,22300,62000,235700,3500,323500,78000,22100,55900,200900,3500,282400,A2,AG/LTD,,,
15112,64-1-0-25-0,7733-07-1304,SNGL FAM SUB,2,AC,195900,0,195900,0,0,195900,170300,0,170300,0,0,170300,R1,RES/LTD,,,
15113,26-1-0-44-B1,6719-10-7734,SNGL FAM SUB,5,AC,63200,0,63200,9500,1000,73700,62000,0,62000,10600,1000,73600,A1,AG/GEN,,,
15114,26-1-0-44-B2,6719-10-9406,SNGL FAM SUB,8.477,AC,84400,0,84400,200100,4600,289100,82900,0,82900,169700,4700,257300,A1,AG/GEN,,,
15115,26-1-0-53-0,6719-41-9676,SNGL FAM SUB,0.21,AC,1300,0,1300,0,0,1300,1200,0,1200,0,0,1200,A1,AG/GEN,,,
15116,27-1-0-12-C1,6719-51-7441,SNGL FAM SUB,2.76,AC,39000,0,39000,0,0,39000,38200,0,38200,0,0,38200,A1,AG/GEN,,,
15117,67-4-0-5-A2,7733-07-1104,SNGL FAM SUB,2,AC,195900,0,195900,0,0,195900,170300,0,170300,0,0,170300,A2,AG/LTD,,,
15118,67-4-0-5-A3,7733-06-1915,SNGL FAM SUB,2,AC,213500,0,213500,271800,0,485300,185600,0,185600,228800,0,414400,A2,AG/LTD,,,
15119,67-4-0-5-A4,7733-06-1715,SNGL FAM SUB,2,AC,200000,0,200000,0,0,200000,173900,0,173900,0,0,173900,A2,AG/LTD,,,
15120,38-1-0-7-A,6717-09-3836,SNGL FAM SUB,0.06,AC,200,0,200,0,0,200,200,0,200,0,0,200,A1,AG/GEN,,,
15121,40-1-0-20-A,6726-87-7902,Vacant Land,1,AC,49000,0,49000,0,0,49000,48000,0,48000,0,0,48000,A1,AG/GEN,,,
15122,42-1-0-30-A,6756-86-6942,Islands,0.2,AC,700,0,700,0,0,700,700,0,700,0,0,700,A2,AG/LTD,,,
15123,42-1-0-30-B,6756-87-3139,Islands,0.56,AC,1600,0,1600,0,0,1600,1600,0,1600,0,0,1600,A2,AG/LTD,,,
15124,42-1-0-30-C,6756-77-7379,Islands,0.17,AC,600,0,600,0,0,600,600,0,600,0,0,600,A2,AG/LTD,,,
15125,42-1-0-30-D,6756-87-1462,Islands,0.34,AC,1000,0,1000,0,0,1000,1000,0,1000,0,0,1000,A2,AG/LTD,,,
15126,44-1-0-3-0,6778-60-3312,SNGL FAM SUB,8.91,AC,137600,133200,4400,0,0,137600,122700,118900,3800,0,0,122700,A2,AG/LTD,,,
15127,48-1-0-13-G,7727-48-7908,COMM & IND,4.032,AC,667300,0,667300,677300,20800,1365400,635400,0,635400,615800,14800,1266000,M2,INDUS/G,,,
15128,48-1-0-67-B,7737-17-8281,COMM & IND,5,AC,471800,0,471800,429900,20900,922600,449300,0,449300,424400,14600,888300,M2,INDUS/G,,,
15129,51-1-0-49-C,6736-65-6374,SNGL FAM SUB,13.72,AC,106100,0,106100,241600,42900,390600,104200,0,104200,211200,43600,359000,A1,AG/GEN,,,
15130,57-31-0-4-0,7705-93-4683,AG 20-100 AC,22.19,AC,814600,804400,10200,0,0,814600,708100,698700,9400,0,0,708100,A2,AG/LTD,,,
15131,57-31-0-5-0,7705-82-9972,AG 20-100 AC,24,AC,707600,0,707600,244400,323100,1275100,616100,0,616100,212300,289200,1117600,A2,AG/LTD,,,
15132,57-31-0-6-0,7705-83-2523,AG 20-100 AC,26,AC,875300,678900,196400,660200,0,1535500,761900,590500,171400,580200,0,1342100,A2,AG/LTD,,,
15133,57-31-0-7-0,7705-74-1052,AG 20-100 AC,22.41,AC,776100,543100,233000,829800,37500,1643400,675600,472400,203200,701300,35400,1412300,A2,AG/LTD,,,
15134,57-31-0-8-0,7705-64-4861,AG 20-100 AC,21,AC,695200,500800,194400,636500,195000,1526700,603900,434500,169400,543500,181000,1328400,A2,AG/LTD,,,
15135,57-31-0-9-0,7705-65-7619,AG 20-100 AC,21,AC,695200,685500,9700,0,0,695200,603900,595000,8900,0,0,603900,A2,AG/LTD,,,
15136,57-31-0-10-0,7705-74-6601,AG 20-100 AC,21.25,AC,744100,522100,222000,763300,4000,1511400,647700,454700,193000,644700,4000,1296400,A2,AG/LTD,,,
15137,57-31-0-11-0,7705-85-0409,AG 20-100 AC,21.44,AC,749400,739100,10300,0,0,749400,652300,643200,9100,0,0,652300,A2,AG/LTD,,,
15138,57-31-0-12-0,7705-95-1228,AG 20-100 AC,21.64,AC,822100,635800,186300,401000,66600,1289700,714500,552600,161900,351900,62400,1128800,A2,AG/LTD,,,
15140,58-1-0-50-B,7715-52-4464,SNGL FAM SUB,3.51,AC,142600,0,142600,140200,0,282800,123900,0,123900,117700,0,241600,A2,AG/LTD,,,
15141,58-29-0-1-0,7715-22-6641,SNGL FAM SUB,3.506,AC,242000,0,242000,638300,0,880300,220000,0,220000,607000,0,827000,RR,RES/RUR,,,
15142,58-29-0-2-0,7715-22-4311,SNGL FAM SUB,4.972,AC,264000,0,264000,457100,6000,727100,240000,0,240000,418900,5600,664500,RR,RES/RUR,,,
15144,62-29-0-3-0,7715-22-2063,SNGL FAM SUB,3.464,AC,264000,0,264000,542800,12000,818800,240000,0,240000,502900,10200,753100,RR,RES/RUR,,,
15145,62-29-0-4-0,7715-21-0719,SNGL FAM SUB,3.562,AC,264000,0,264000,555500,51200,870700,240000,0,240000,504600,47300,791900,RR,RES/RUR,,,
15146,62-29-0-5-0,7715-11-7555,SNGL FAM SUB,3.14,AC,247500,0,247500,941300,95000,1283800,225000,0,225000,871400,85500,1181900,RR,RES/RUR,,,
15147,62-29-0-6-0,7715-11-9139,SNGL FAM SUB,4.005,AC,264000,0,264000,432900,8200,705100,240000,0,240000,403900,7800,651700,RR,RES/RUR,,,
15148,62-29-0-7-0,7715-10-7894,SNGL FAM SUB,6.346,AC,327300,0,327300,277500,0,604800,297500,0,297500,267500,0,565000,RR,RES/RUR,,,
15149,62-29-0-8-0,7715-11-3184,SNGL FAM SUB,3.754,AC,261300,0,261300,378600,0,639900,237500,0,237500,350500,0,588000,RR,RES/RUR,,,
15150,64-22-B-14-0,7734-10-6241,SNGL FAM SUB,2.164,AC,470000,0,470000,0,0,470000,430000,0,430000,0,0,430000,R1,RES/LTD,,,
15151,62-31-D-A-0,7705-50-6841,Cmn Area/Open Spc,1.972,AC,0,0,0,0,0,0,0,0,0,0,0,0,RR,RES/RUR,,,
15152,64-22-B-15-0,7734-10-3279,SNGL FAM SUB,2.285,AC,470000,0,470000,1142400,166100,1778500,430000,0,430000,1235900,148100,1814000,R1,RES/LTD,,,
15153,64-22-B-16-0,7734-10-0364,SNGL FAM SUB,2.731,AC,470000,0,470000,1059000,11300,1540300,430000,0,430000,1118400,9500,1557900,R1,RES/LTD,,,
15154,64-22-B-17-0,7734-10-0605,SNGL FAM SUB,3.679,AC,470000,0,470000,1127700,0,1597700,430000,0,430000,1207100,0,1637100,R1,RES/LTD,,,
15155,62-31-D-B-0,7705-50-3024,Cmn Area/Open Spc,1.198,AC,0,0,0,0,0,0,0,0,0,0,0,0,RR,RES/RUR,,,
15156,64-22-B-18-0,7734-10-1859,SNGL FAM SUB,3.554,AC,470000,0,470000,1213900,85600,1769500,430000,0,430000,1302300,79200,1811500,R1,RES/LTD,,,
15157,64-22-B-19-0,7734-10-5655,SNGL FAM SUB,2.146,AC,470000,0,470000,749200,86800,1306000,430000,0,430000,811700,81100,1322800,R1,RES/LTD,,,
15158,64-22-B-20-0,7734-10-8531,SNGL FAM SUB,2.03,AC,470000,0,470000,563500,0,1033500,430000,0,430000,600000,0,1030000,R1,RES/LTD,,,
15159,64-22-B-21-0,7734-20-0744,SNGL FAM SUB,2.121,AC,470000,0,470000,682600,0,1152600,430000,0,430000,723200,0,1153200,R1,RES/LTD,,,
15160,62-31-D-C-0,7704-68-2943,Cmn Area/Open Spc,0.267,AC,0,0,0,0,0,0,0,0,0,0,0,0,RR,RES/RUR,,,
15161,64-22-B-22-0,7734-10-7868,SNGL FAM SUB,2.147,AC,470000,0,470000,537900,0,1007900,430000,0,430000,569900,0,999900,R1,RES/LTD,,,
15162,64-22-B-23-0,7734-11-4091,SNGL FAM SUB,2.059,AC,470000,0,470000,1116900,65800,1652700,430000,0,430000,1196000,57200,1683200,R1,RES/LTD,,,
15163,62-31-D-D-0,7704-59-9740,Roads,3.211,AC,0,0,0,0,0,0,0,0,0,0,0,0,RR,RES/RUR,,,
15164,62-31-D-1-0,7705-50-6598,SNGL FAM SUB,3.486,AC,432000,0,432000,822400,2800,1257200,360000,0,360000,770100,2900,1133000,RR,RES/RUR,,,
15166,62-31-D-2-0,7705-50-9898,SNGL FAM SUB,4.311,AC,432000,0,432000,0,0,432000,360000,0,360000,0,0,360000,RR,RES/RUR,,,
15167,62-31-D-3-0,7705-60-2677,SNGL FAM SUB,4.099,AC,432000,0,432000,0,8800,440800,360000,0,360000,0,7600,367600,RR,RES/RUR,,,
15168,62-31-D-4-0,7705-60-1311,SNGL FAM SUB,4.785,AC,432000,0,432000,0,0,432000,360000,0,360000,0,0,360000,RR,RES/RUR,,,
15169,62-31-D-5-0,7705-60-0091,SNGL FAM SUB,3.996,AC,432000,0,432000,562600,20700,1015300,360000,0,360000,536300,18900,915200,RR,RES/RUR,,,
15170,62-31-D-6-0,7704-69-2769,SNGL FAM SUB,4.391,AC,432000,0,432000,659700,27800,1119500,360000,0,360000,623200,27000,1010200,RR,RES/RUR,,,
15171,62-31-D-7-0,7704-69-3582,SNGL FAM SUB,4.567,AC,432000,0,432000,721900,0,1153900,360000,0,360000,680800,0,1040800,RR,RES/RUR,,,
15172,62-31-D-8-0,7704-69-5202,SNGL FAM SUB,5.831,AC,432000,0,432000,1101400,65700,1599100,360000,0,360000,1037500,60800,1458300,RR,RES/RUR,,,
15173,62-31-D-9-0,7704-68-5854,SNGL FAM SUB,3.641,AC,432000,0,432000,800700,33500,1266200,360000,0,360000,745600,32100,1137700,RR,RES/RUR,,,
15174,62-31-D-10-0,7704-68-2482,SNGL FAM SUB,4.785,AC,432000,0,432000,786800,30200,1249000,360000,0,360000,741400,29300,1130700,RR,RES/RUR,,,
15175,62-31-D-11-0,7704-68-0687,SNGL FAM SUB,3.251,AC,432000,0,432000,593600,32000,1057600,360000,0,360000,477200,31000,868200,RR,RES/RUR,,,
15176,62-31-D-12-0,7704-59-8095,SNGL FAM SUB,4.083,AC,432000,0,432000,900000,0,1332000,360000,0,360000,863600,0,1223600,RR,RES/RUR,,,
15177,62-31-D-13-0,7704-59-6298,SNGL FAM SUB,5.905,AC,432000,0,432000,886600,0,1318600,360000,0,360000,825100,0,1185100,RR,RES/RUR,,,
15178,62-31-D-14-0,7704-59-5943,SNGL FAM SUB,4.638,AC,432000,0,432000,741700,0,1173700,360000,0,360000,696600,0,1056600,RR,RES/RUR,,,
15179,64-22-0-A-0,7733-17-8931,Cmn Area/Open Spc,12.924,AC,0,0,0,0,0,0,0,0,0,0,0,0,R1,RES/LTD,,,
15180,64-22-0-B-0,7733-38-4204,Cmn Area/Open Spc,2.845,AC,0,0,0,0,0,0,0,0,0,0,0,0,R1,RES/LTD,,,
15181,64-22-0-C-0,7733-49-0350,Cmn Area/Open Spc,1.4,AC,0,0,0,0,0,0,0,0,0,0,0,0,R1,RES/LTD,,,
15182,64-22-0-D-0,7733-39-8303,Cmn Area/Open Spc,0.675,AC,0,0,0,0,0,0,0,0,0,0,0,0,R1,RES/LTD,,,
15183,64-22-0-E-0,7734-32-1159,Cmn Area/Open Spc,10.615,AC,0,0,0,0,0,0,0,0,0,0,0,0,R1,RES/LTD,,,
15184,64-22-0-F-0,7734-41-1593,Cmn Area/Open Spc,42.146,AC,0,0,0,0,0,0,0,0,0,0,0,0,R1,RES/LTD,,,
15185,64-22-0-G-0,7734-30-6222,Cmn Area/Open Spc,36.382,AC,0,0,0,0,0,0,0,0,0,0,0,0,R1,RES/LTD,,,
15186,64-22-0-H-0,7733-29-4979,Roads,20.405,AC,0,0,0,0,0,0,0,0,0,0,0,0,R1,RES/LTD,,,
15187,64-22-A-1-0,7733-38-4427,SNGL FAM SUB,4.094,AC,493500,0,493500,0,0,493500,451500,0,451500,0,0,451500,R1,RES/LTD,,,
15188,64-22-A-2-0,7733-38-6759,SNGL FAM SUB,3.969,AC,493500,0,493500,0,0,493500,451500,0,451500,0,0,451500,R1,RES/LTD,,,
15189,64-22-A-3-0,7733-49-4425,SNGL FAM SUB,3.218,AC,470000,0,470000,1017300,58700,1546000,430000,0,430000,1078400,57100,1565500,R1,RES/LTD,,,
15190,64-22-A-4-0,7733-49-6876,SNGL FAM SUB,4.216,AC,493500,0,493500,1448300,68200,2010000,451500,0,451500,1532600,65900,2050000,R1,RES/LTD,,,
15191,64-22-A-5-0,7734-40-5486,SNGL FAM SUB,3.044,AC,915000,0,915000,1098400,103600,2117000,797000,0,797000,1189200,91900,2078100,R1,RES/LTD,,,
15192,64-22-A-6-0,7734-40-3272,SNGL FAM SUB,2.697,AC,915000,0,915000,816100,8300,1739400,797000,0,797000,869000,6800,1672800,R1,RES/LTD,,,
15194,64-22-A-7-0,7733-49-2945,SNGL FAM SUB,3.528,AC,915000,0,915000,1156200,8100,2079300,797000,0,797000,1232600,6700,2036300,R1,RES/LTD,,,
15195,64-22-A-8-0,7733-49-0676,SNGL FAM SUB,2.804,AC,915000,0,915000,1285400,87400,2287800,797000,0,797000,1418100,74800,2289900,R1,RES/LTD,,,
15197,64-22-A-9-0,7733-38-3917,SNGL FAM SUB,3.287,AC,915000,0,915000,867200,39900,1822100,797000,0,797000,932200,38800,1768000,R1,RES/LTD,,,
15198,64-22-B-24-0,7734-11-0290,SNGL FAM SUB,3.537,AC,470000,0,470000,0,0,470000,430000,0,430000,0,0,430000,R1,RES/LTD,,,
15199,64-22-A-10-0,7733-38-0719,SNGL FAM SUB,6.012,AC,896700,0,896700,2187000,242100,3325800,781100,0,781100,2285500,217000,3283600,R1,RES/LTD,,,
15200,64-22-A-11-0,7733-28-7523,SNGL FAM SUB,4.264,AC,493500,0,493500,1389000,1300,1883800,451500,0,451500,1587800,1600,2040900,R1,RES/LTD,,,
15201,64-22-A-12-0,7733-28-3422,SNGL FAM SUB,5.234,AC,493500,0,493500,1071000,82600,1647100,451500,0,451500,1193300,76300,1721100,R1,RES/LTD,,,
15202,64-22-A-13-0,7733-28-1873,SNGL FAM SUB,4.375,AC,493500,0,493500,0,0,493500,451500,0,451500,0,0,451500,R1,RES/LTD,,,
15203,64-22-A-14-0,7733-29-6002,SNGL FAM SUB,4.294,AC,896700,0,896700,0,0,896700,781100,0,781100,0,0,781100,R1,RES/LTD,,,
15204,64-22-A-15-0,7733-29-9538,SNGL FAM SUB,9.325,AC,1226300,0,1226300,0,0,1226300,1071900,0,1071900,0,0,1071900,R1,RES/LTD,,,
15205,64-22-A-16-0,7733-29-4579,SNGL FAM SUB,3.467,AC,470000,0,470000,742900,0,1212900,430000,0,430000,788500,0,1218500,R1,RES/LTD,,,
15206,64-22-A-17-0,7733-29-0298,SNGL FAM SUB,5.031,AC,493500,0,493500,1047000,61100,1601600,451500,0,451500,1126100,63400,1641000,R1,RES/LTD,,,
15207,64-22-A-18-0,7733-19-8565,SNGL FAM SUB,2.928,AC,470000,0,470000,859800,0,1329800,430000,0,430000,925000,0,1355000,R1,RES/LTD,,,
15208,64-22-A-19-0,7733-29-2820,SNGL FAM SUB,3.188,AC,470000,0,470000,750900,0,1220900,430000,0,430000,802400,0,1232400,R1,RES/LTD,,,
15209,64-22-A-20-0,7734-10-9040,SNGL FAM SUB,3.027,AC,470000,0,470000,766600,0,1236600,430000,0,430000,819700,0,1249700,R1,RES/LTD,,,
15210,64-22-A-21-0,7734-20-1340,SNGL FAM SUB,2.176,AC,470000,0,470000,0,0,470000,430000,0,430000,0,0,430000,R1,RES/LTD,,,
15211,64-22-A-22-0,7734-20-7253,SNGL FAM SUB,16.06,AC,1529400,0,1529400,2527700,438000,4495100,1339300,0,1339300,2732800,445700,4517800,R1,RES/LTD,,,
15212,64-22-A-23-0,7734-21-8093,SNGL FAM SUB,11.648,AC,1330900,0,1330900,1887400,9200,3227500,797000,0,797000,2030400,7500,2834900,R1,RES/LTD,,,
15214,64-22-B-1-0,7733-18-1119,SNGL FAM SUB,4.654,AC,493500,0,493500,2348200,128600,2970300,451500,0,451500,2494100,112000,3057600,R1,RES/LTD,,,
15215,64-22-B-2-0,7733-18-5137,SNGL FAM SUB,3.43,AC,470000,0,470000,1732600,0,2202600,430000,0,430000,1763100,0,2193100,R1,RES/LTD,,,
15216,64-22-B-3-0,7733-18-8320,SNGL FAM SUB,3.667,AC,470000,0,470000,840500,66400,1376900,430000,0,430000,889600,61300,1380900,R1,RES/LTD,,,
15217,64-22-B-4-0,7733-18-7700,SNGL FAM SUB,3.704,AC,470000,0,470000,926000,74800,1470800,430000,0,430000,1002700,69000,1501700,R1,RES/LTD,,,
15218,64-22-B-5-0,7733-18-3569,SNGL FAM SUB,3.278,AC,470000,0,470000,0,0,470000,430000,0,430000,0,0,430000,R1,RES/LTD,,,
15219,64-22-B-6-0,7733-18-0713,SNGL FAM SUB,5.746,AC,493500,0,493500,1466700,65300,2025500,451500,0,451500,1564100,61100,2076700,R1,RES/LTD,,,
15220,64-22-B-7-0,7733-19-1190,SNGL FAM SUB,3.594,AC,470000,0,470000,732000,0,1202000,430000,0,430000,787800,0,1217800,R1,RES/LTD,,,
15221,64-22-B-8-0,7733-19-5183,SNGL FAM SUB,2.975,AC,470000,0,470000,929400,70400,1469800,430000,0,430000,995400,65200,1490600,R1,RES/LTD,,,
15222,64-22-B-9-0,7733-19-4541,SNGL FAM SUB,3.095,AC,470000,0,470000,896400,60300,1426700,430000,0,430000,952400,53600,1436000,R1,RES/LTD,,,
15223,64-22-B-10-0,7733-19-0493,SNGL FAM SUB,3.572,AC,470000,0,470000,0,0,470000,430000,0,430000,0,0,430000,R1,RES/LTD,,,
15224,64-22-B-11-0,7733-09-9777,SNGL FAM SUB,3.973,AC,470000,0,470000,938400,138200,1546600,430000,0,430000,999900,128100,1558000,R1,RES/LTD,,,
15225,64-22-B-12-0,7734-10-1062,SNGL FAM SUB,2.652,AC,470000,0,470000,1463900,149300,2083200,430000,0,430000,1560100,137500,2127600,R1,RES/LTD,,,
15226,64-22-B-13-0,7733-19-5923,SNGL FAM SUB,2.144,AC,470000,0,470000,1327700,270400,2068100,430000,0,430000,1409800,249900,2089700,R1,RES/LTD,,,
15227,64-22-B-25-0,7734-11-1463,SNGL FAM SUB,3.085,AC,470000,0,470000,603200,7800,1081000,430000,0,430000,641100,6900,1078000,R1,RES/LTD,,,
15228,64-22-B-26-0,7734-11-4504,SNGL FAM SUB,2.858,AC,470000,0,470000,1430900,142100,2043000,430000,0,430000,1518100,139900,2088000,R1,RES/LTD,,,
15229,64-22-B-27-0,7734-11-6383,SNGL FAM SUB,2.26,AC,470000,0,470000,650800,0,1120800,430000,0,430000,686700,0,1116700,R1,RES/LTD,,,
15230,48-1-0-50-0,7738-01-3905,SNGL FAM SUB,0.79,AC,24100,0,24100,0,0,24100,21500,0,21500,0,0,21500,A2,AG/LTD,,,
15231,64-22-B-28-0,7734-11-6695,SNGL FAM SUB,3.673,AC,470000,0,470000,612900,0,1082900,430000,0,430000,651000,0,1081000,R1,RES/LTD,,,
15232,64-22-B-29-0,7734-11-8864,SNGL FAM SUB,2.987,AC,470000,0,470000,1000500,32200,1502700,430000,0,430000,1071200,30800,1532000,R1,RES/LTD,,,
15234,64-22-B-30-0,7734-21-0989,SNGL FAM SUB,2.312,AC,470000,0,470000,629700,39900,1139600,430000,0,430000,678800,38700,1147500,R1,RES/LTD,,,
15235,64-22-B-31-0,7734-22-3103,SNGL FAM SUB,2.012,AC,470000,0,470000,823700,1400,1295100,430000,0,430000,892000,1200,1323200,R1,RES/LTD,,,
15236,64-22-B-32-0,7734-22-6222,SNGL FAM SUB,2.536,AC,470000,0,470000,684900,0,1154900,430000,0,430000,735700,0,1165700,R1,RES/LTD,,,
15237,64-22-B-33-0,7734-21-7925,SNGL FAM SUB,2.013,AC,470000,0,470000,811200,0,1281200,430000,0,430000,965300,0,1395300,R1,RES/LTD,,,
15238,64-22-B-34-0,7734-21-4776,SNGL FAM SUB,2.699,AC,470000,0,470000,1019900,0,1489900,430000,0,430000,1091800,0,1521800,R1,RES/LTD,,,
15239,64-22-B-35-0,7734-21-1487,SNGL FAM SUB,2.696,AC,470000,0,470000,633200,0,1103200,430000,0,430000,683200,0,1113200,R1,RES/LTD,,,
15240,64-22-B-36-0,7734-21-0105,SNGL FAM SUB,2.12,AC,470000,0,470000,679400,0,1149400,430000,0,430000,722200,0,1152200,R1,RES/LTD,,,
15241,64-22-B-37-0,7734-20-2978,SNGL FAM SUB,2.175,AC,470000,0,470000,780700,120300,1371000,430000,0,430000,837500,113500,1381000,R1,RES/LTD,,,
15242,64-22-B-38-0,7734-21-4210,SNGL FAM SUB,2.43,AC,470000,0,470000,0,0,470000,430000,0,430000,0,0,430000,R1,RES/LTD,,,
15243,64-22-B-39-0,7734-21-5428,SNGL FAM SUB,2.28,AC,470000,0,470000,0,0,470000,430000,0,430000,0,0,430000,R1,RES/LTD,,,
15244,64-22-C-1-0,7734-31-4606,SNGL FAM SUB,2.494,AC,470000,0,470000,789200,45200,1304400,430000,0,430000,840900,41700,1312600,R1,RES/LTD,,,
15245,64-22-C-2-0,7734-31-8509,SNGL FAM SUB,2.439,AC,446500,0,446500,962100,0,1408600,408500,0,408500,870400,0,1278900,R1,RES/LTD,,,
15246,64-22-C-3-0,7734-41-0830,SNGL FAM SUB,3.191,AC,446500,0,446500,751500,57200,1255200,408500,0,408500,808000,47400,1263900,R1,RES/LTD,,,
15247,64-22-C-4-0,7734-32-7051,SNGL FAM SUB,3.881,AC,470000,0,470000,909900,95700,1475600,430000,0,430000,967900,89700,1487600,R1,RES/LTD,,,
15251,39-1-0-15-F,6727-16-7167,SNGL FAM SUB,5.26,AC,62700,60300,2400,0,0,62700,61400,59200,2200,0,0,61400,A1,AG/GEN,,,
15252,39-1-0-15-F1,6727-15-5911,Cemetery,0,AC,100,0,100,0,0,100,100,0,100,0,0,100,A1,AG/GEN,,,
15253,41-1-0-1-A,6748-21-7414,SNGL FAM SUB,6.374,AC,103200,0,103200,437600,0,540800,100400,0,100400,370100,0,470500,A1,AG/GEN,,,
15254,42-1-0-12-A,6757-45-1465,SNGL FAM SUB,2.326,AC,97300,15700,81600,310100,37600,445000,88700,13200,75500,250700,33300,372700,A2,AG/LTD,,,
15255,42-1-0-12-B,6757-45-3595,SNGL FAM SUB,3.015,AC,92000,90500,1500,0,0,92000,83400,82100,1300,0,0,83400,A2,AG/LTD,,,
15256,42-1-0-12-C,6757-45-6411,SNGL FAM SUB,4.071,AC,109900,107800,2100,0,0,109900,99300,97500,1800,0,0,99300,A2,AG/LTD,,,
15257,45-1-0-78-B1,6797-72-2235,SNGL FAM SUB,3.36,AC,121600,0,121600,290400,0,412000,108500,0,108500,238600,0,347100,A2,AG/LTD,,,
15258,45-1-0-78-B2,6797-72-5060,SNGL FAM SUB,3.36,AC,120000,0,120000,383600,13900,517500,107100,0,107100,314300,14200,435600,A2,AG/LTD,,,
15259,45-1-0-78-B3,6797-71-9705,SNGL FAM SUB,3.43,AC,121100,0,121100,416800,39300,577200,108100,0,108100,336400,34600,479100,A2,AG/LTD,,,
15261,48-10-0-C-1,7728-51-2489,SNGL FAM SUB,0.1,AC,16600,0,16600,0,0,16600,5000,0,5000,0,0,5000,A2,AG/LTD,,,
15262,55-13-0-B-0,6785-77-9042,SNGL FAM SUB,9.6,AC,187900,183500,4400,0,0,187900,168100,164000,4100,0,0,168100,A2,AG/LTD,,,
15263,56-16-0-18-0,6795-73-9400,AG 20-100 AC,26.55,AC,748300,0,748300,1308500,72400,2129200,651100,0,651100,1379300,64700,2095100,RR,RES/RUR,,,
15265,68-4-0-A-0,7733-77-6493,Cmn Area/Open Spc,46.6,AC,0,0,0,0,0,0,0,0,0,0,0,0,RPUD,RES/PUD,,,
15266,68-4-0-B-0,7733-75-7599,Roads,2,AC,0,0,0,0,0,0,0,0,0,0,0,0,RPUD,RES/PUD,,,
15267,68-4-0-1-0,7733-75-2543,SNGL FAM URB,2.891,AC,620000,0,620000,1486600,5200,2111800,540000,0,540000,1426800,5300,1972100,RPUD,RES/PUD,,,
15268,68-4-0-2-0,7733-75-3239,SNGL FAM URB,3.655,AC,620000,0,620000,735200,0,1355200,540000,0,540000,706500,0,1246500,RPUD,RES/PUD,,,
15269,68-4-0-3-0,7733-75-6250,SNGL FAM URB,3.8,AC,638600,0,638600,1320800,121700,2081100,556200,0,556200,1260900,115500,1932600,RPUD,RES/PUD,,,
15270,68-4-0-4-0,7733-75-9295,SNGL FAM URB,2.5,AC,638600,0,638600,1225000,30000,1893600,556200,0,556200,1151400,29200,1736800,RPUD,RES/PUD,,,
15271,68-4-0-5-0,7733-85-3116,SNGL FAM URB,2.6,AC,638600,0,638600,1290600,30800,1960000,556200,0,556200,1225500,29100,1810800,RPUD,RES/PUD,,,
15272,68-4-0-6-0,7733-85-6206,SNGL FAM URB,3.5,AC,638600,0,638600,0,0,638600,556200,0,556200,0,0,556200,RPUD,RES/PUD,,,
15273,68-4-0-7-0,7733-85-5569,SNGL FAM URB,2.8,AC,638600,0,638600,1030000,0,1668600,556200,0,556200,966400,0,1522600,RPUD,RES/PUD,,,
15274,68-4-0-8-0,7733-85-4836,SNGL FAM URB,2.4,AC,638600,0,638600,0,0,638600,556200,0,556200,0,0,556200,RPUD,RES/PUD,,,
15275,68-4-0-9-0,7733-85-2809,SNGL FAM URB,2.512,AC,620000,0,620000,1175100,91500,1886600,540000,0,540000,1117200,84000,1741200,RPUD,RES/PUD,,,
15276,68-4-0-10-0,7733-75-9841,SNGL FAM URB,3.984,AC,620000,0,620000,1203000,30700,1853700,540000,0,540000,1136300,31900,1708200,RPUD,RES/PUD,,,
15277,68-4-0-11-0,7733-75-5997,SNGL FAM URB,6.348,AC,620000,0,620000,1043800,0,1663800,540000,0,540000,979600,0,1519600,RPUD,RES/PUD,,,
15278,16-3-0-2-A1,5799-48-8253,SNGL FAM SUB,4.33,AC,50800,48600,2200,0,0,50800,49700,47900,1800,0,0,49700,A1,AG/GEN,,,
15279,19-1-0-64-A,6830-63-1559,SNGL FAM SUB,7.25,AC,108800,51600,57200,115700,1500,226000,95500,42900,52600,93100,1500,190100,A1,AG/GEN,,,
15280,31-15-0-7-A,6779-46-5591,SNGL FAM SUB,4.37,AC,102500,0,102500,0,0,102500,91600,0,91600,0,0,91600,A2,AG/LTD,,,
15281,32-2-0-3-A1,6778-87-7518,SNGL FAM SUB,2.35,AC,83500,0,83500,211300,1500,296300,74600,0,74600,173200,1500,249300,A2,AG/LTD,,,
15282,42-1-0-30-A1,6756-86-8831,Islands,0.69,AC,2000,0,2000,0,0,2000,1900,0,1900,0,0,1900,A2,AG/LTD,,,
15283,42-1-0-30-B1,6756-87-4099,Islands,0.97,AC,2800,0,2800,0,0,2800,2700,0,2700,0,0,2700,A2,AG/LTD,,,
15284,42-1-0-30-C1,6756-77-6486,Islands,0.11,AC,400,0,400,0,0,400,400,0,400,0,0,400,A2,AG/LTD,,,
15285,42-1-0-30-D1,6756-77-9651,Islands,1.16,AC,3400,0,3400,0,0,3400,3200,0,3200,0,0,3200,A2,AG/LTD,,,
15286,42-1-0-30-E,6756-77-5882,Islands,0.28,AC,800,0,800,0,0,800,800,0,800,0,0,800,A2,AG/LTD,,,
15288,46-1-0-114-C,7717-04-4994,SNGL FAM SUB,3.505,AC,165000,0,165000,288300,500,453800,150000,0,150000,242400,500,392900,R1,RES/LTD,,,
15289,48-1-0-67-C,7737-27-4679,COMM & IND,2.22,AC,138100,0,138100,174900,3200,316200,131400,0,131400,154700,3200,289300,M2,INDUS/G,,,
15290,55-1-0-14-KK,6775-83-0468,Islands,0.01,AC,200,0,200,0,0,200,200,0,200,0,0,200,A2,AG/LTD,,,
15291,55-1-0-14-MM,6775-83-6169,SNGL FAM SUB,1.27,AC,1900,0,1900,0,0,1900,1700,0,1700,0,0,1700,A2,AG/LTD,,,
15292,55-1-0-14-NN,6775-82-4830,SNGL FAM SUB,1.01,AC,1500,0,1500,0,0,1500,1400,0,1400,0,0,1400,A2,AG/LTD,,,
15293,55-1-0-14-OO,6775-82-8226,SNGL FAM SUB,0.12,AC,200,0,200,0,0,200,200,0,200,0,0,200,A2,AG/LTD,,,
15294,57-1-0-34-H,7706-40-9199,Cmn Area/Open Spc,0.59,AC,0,0,0,0,0,0,0,0,0,0,0,0,A2,AG/LTD,,,
15318,64-23-0-78-0,7733-67-0546,SNGL FAM URB,0.357,AC,230000,0,230000,608600,17200,855800,200000,0,200000,560100,16700,776800,RPUD,RES/PUD,,,
15319,64-23-0-79-0,7733-57-9534,SNGL FAM URB,0.356,AC,230000,0,230000,445100,0,675100,200000,0,200000,415000,0,615000,RPUD,RES/PUD,,,
15320,64-23-0-80-0,7733-57-8525,SNGL FAM URB,0.428,AC,230000,0,230000,621600,600,852200,200000,0,200000,575600,700,776300,RPUD,RES/PUD,,,
15321,64-23-0-81-0,7733-57-7641,SNGL FAM URB,0.469,AC,230000,0,230000,640800,0,870800,200000,0,200000,591100,0,791100,RPUD,RES/PUD,,,
15322,64-23-0-82-0,7733-57-6657,SNGL FAM URB,0.478,AC,230000,0,230000,533700,24900,788600,200000,0,200000,493900,24500,718400,RPUD,RES/PUD,,,
15323,64-23-0-83-0,7733-57-5637,SNGL FAM URB,0.344,AC,230000,0,230000,593100,0,823100,200000,0,200000,543400,0,743400,RPUD,RES/PUD,,,
15324,64-23-0-84-0,7733-57-4625,SNGL FAM URB,0.307,AC,230000,0,230000,553000,20600,803600,200000,0,200000,511100,20200,731300,RPUD,RES/PUD,,,
15325,64-23-0-85-0,7733-57-3623,SNGL FAM URB,0.31,AC,230000,0,230000,717600,0,947600,200000,0,200000,662400,0,862400,RPUD,RES/PUD,,,
15326,64-23-0-86-0,7733-57-2621,SNGL FAM URB,0.314,AC,230000,0,230000,651500,0,881500,200000,0,200000,600000,0,800000,RPUD,RES/PUD,,,
15327,64-23-0-87-0,7733-57-1519,SNGL FAM URB,0.319,AC,230000,0,230000,717200,36300,983500,200000,0,200000,657900,33700,891600,RPUD,RES/PUD,,,
15328,67-25-0-50-0,7733-67-0026,SNGL FAM URB,0.382,AC,230000,0,230000,676300,0,906300,200000,0,200000,626600,0,826600,RPUD,RES/PUD,,,
15329,67-25-0-51-0,7733-67-0126,SNGL FAM URB,0.376,AC,230000,0,230000,714400,0,944400,200000,0,200000,661600,0,861600,RPUD,RES/PUD,,,
15330,67-25-0-73-0,7733-67-2123,SNGL FAM URB,0.383,AC,230000,0,230000,581700,0,811700,200000,0,200000,536200,0,736200,RPUD,RES/PUD,,,
15331,43-16-0-K-4,6776-17-3788,SNGL FAM SUB,10,AC,167300,92600,74700,250000,10500,427800,149000,82500,66500,209100,10500,368600,A2,AG/LTD,,,
15340,55-1-0-22-0,6785-27-0970,AG 20-100 AC,28.32,AC,503400,351100,152300,1043000,32400,1578800,448900,312500,136400,893600,29300,1371800,A2,AG/LTD,,,
15344,66-2-0-A-2,7723-06-4096,AG 20-100 AC,27.196,AC,799900,0,799900,0,44900,844800,696100,0,696100,0,38200,734300,A2,AG/LTD,,,
15345,1-1-0-9-D,6814-46-5878,SNGL FAM SUB,14.872,AC,108600,96800,11800,0,10300,118900,106500,95800,10700,0,7600,114100,A1,AG/GEN,,,
15349,4-1-0-55-C,6812-07-3702,Cemetery,0,AC,100,0,100,0,0,100,100,0,100,0,0,100,A1,AG/GEN,,,
15350,5-1-0-32-B,6813-93-6536,SNGL FAM SUB,15.217,AC,105000,0,105000,0,0,105000,103000,0,103000,0,0,103000,A1,AG/GEN,,,
15351,5-23-0-A-0,6823-14-8079,Roads,2.05,AC,0,0,0,0,0,0,0,0,0,0,0,0,A1,AG/GEN,,,
15352,5-23-0-1-0,6823-24-1703,SNGL FAM SUB,4.02,AC,61300,0,61300,289600,2900,353800,60000,0,60000,245700,4600,310300,A1,AG/GEN,,,
15353,5-23-0-2-0,6823-24-1342,SNGL FAM SUB,4.58,AC,64500,0,64500,281400,26900,372800,63200,0,63200,239800,26200,329200,A1,AG/GEN,,,
15354,5-23-0-3-0,6823-24-8054,AG 20-100 AC,20.01,AC,145000,0,145000,321900,45800,512700,142100,0,142100,283000,38400,463500,A1,AG/GEN,,,
15355,5-23-0-4-0,6823-32-1793,AG 20-100 AC,20.01,AC,145000,0,145000,480900,3400,629300,142100,0,142100,424600,3000,569700,A1,AG/GEN,,,
15356,5-23-0-5-0,6823-23-5146,AG 20-100 AC,21.03,AC,150500,0,150500,309500,1000,461000,147500,0,147500,270500,1000,419000,A1,AG/GEN,,,
15357,5-23-0-6-0,6823-13-9517,SNGL FAM SUB,4.71,AC,65300,0,65300,282700,4400,352400,63900,0,63900,240300,3100,307300,A1,AG/GEN,,,
15358,5-23-0-7-0,6823-14-3077,AG 20-100 AC,20.01,AC,145000,0,145000,414400,33000,592400,142100,0,142100,350900,36500,529500,A1,AG/GEN,,,
15359,5-23-0-8-0,6823-14-4696,SNGL FAM SUB,4.42,AC,63600,0,63600,0,0,63600,62300,0,62300,0,0,62300,A1,AG/GEN,,,
15360,9-1-0-87-A,5891-97-8045,SNGL FAM SUB,2.16,AC,43000,0,43000,76700,0,119700,42100,0,42100,63100,0,105200,A1,AG/GEN,,,
15361,9-1-0-89-A,6801-16-8454,SNGL FAM SUB,8,AC,64000,0,64000,107400,1700,173100,62500,0,62500,90400,1700,154600,A1,AG/GEN,,,
15362,9-1-0-89-B,6801-16-6626,SNGL FAM SUB,6.99,AC,60400,0,60400,190100,5500,256000,59000,0,59000,172600,5500,237100,A1,AG/GEN,,,
15363,9-1-0-89-C,6801-16-3728,SNGL FAM SUB,10,AC,67800,0,67800,186100,55700,309600,65000,0,65000,165600,48200,278800,A1,AG/GEN,,,
15364,10-1-0-31-A,6812-26-0700,AG 20-100 AC,39.68,AC,110100,91800,18300,0,0,110100,108000,91100,16900,0,0,108000,A1,AG/GEN,,,
15365,10-1-0-31-B,6812-26-4199,Cemetery,0,AC,100,0,100,0,0,100,100,0,100,0,0,100,A1,AG/GEN,,,
15366,10-1-0-31-C,6812-26-1046,AG 20-100 AC,33.797,AC,93100,0,93100,0,0,93100,91300,0,91300,0,0,91300,A1,AG/GEN,,,
15367,10-1-0-32-A,6812-36-8444,SNGL FAM SUB,6.51,AC,65000,53700,11300,0,0,65000,63800,52900,10900,0,0,63800,A1,AG/GEN,,,
15368,10-1-0-32-B,6812-36-7160,SNGL FAM SUB,3.69,AC,52700,0,52700,0,0,52700,51800,0,51800,0,0,51800,A1,AG/GEN,,,
15369,10-1-0-32-B1,6812-35-6821,SNGL FAM SUB,2.83,AC,48600,0,48600,0,0,48600,47700,0,47700,0,0,47700,A1,AG/GEN,,,
15370,10-1-0-36-B,6812-32-3349,SNGL FAM SUB,12.524,AC,85400,0,85400,0,0,85400,84100,0,84100,0,0,84100,A1,AG/GEN,,,
15371,10-1-0-36-C,6812-22-4248,SNGL FAM SUB,4.522,AC,55000,0,55000,0,0,55000,53800,0,53800,0,0,53800,A1,AG/GEN,,,
15372,11-1-0-53-J,6822-23-4935,SNGL FAM SUB,5,AC,60100,0,60100,11700,5800,77600,59000,0,59000,13000,5800,77800,A1,AG/GEN,,,
15373,12-1-0-39-A,6831-33-8035,SNGL FAM SUB,4,AC,70200,0,70200,152400,500,223100,65100,0,65100,126200,500,191800,A1,AG/GEN,,,
15374,12-1-0-39-B,6831-32-9609,SNGL FAM SUB,2.79,AC,59300,0,59300,138500,2000,199800,56900,0,56900,114900,2000,173800,A1,AG/GEN,,,
15375,12-1-0-39-C,6831-32-8482,SNGL FAM SUB,2.08,AC,52600,0,52600,139100,7200,198900,52000,0,52000,115400,6200,173600,A1,AG/GEN,,,
15376,12-1-0-39-D,6831-33-9523,Cemetery,0,AC,100,0,100,0,0,100,100,0,100,0,0,100,A1,AG/GEN,,,
15377,12-1-0-46-A1,6831-06-6681,SNGL FAM SUB,2.315,AC,49700,0,49700,180500,0,230200,50400,0,50400,148900,0,199300,A1,AG/GEN,,,
15378,12-1-0-61-C,6831-59-6664,SNGL FAM SUB,2.01,AC,44500,40000,4500,0,0,44500,44100,41000,3100,0,0,44100,A1,AG/GEN,,,
15379,12-2-0-1-C1,6821-95-3227,SNGL FAM SUB,3,AC,53800,0,53800,157600,0,211400,53100,0,53100,129800,0,182900,A1,AG/GEN,,,
15380,12-13-0-A-1,6832-74-0053,SNGL FAM SUB,14,AC,133100,0,133100,195300,27200,355600,127400,0,127400,176600,23200,327200,A1,AG/GEN,,,
15381,12-13-0-1-0,6832-63-7189,SNGL FAM SUB,8.42,AC,82500,0,82500,274300,51000,407800,80900,0,80900,231700,45600,358200,RR,RES/RUR,,,
15382,12-13-0-2-0,6832-72-4536,SNGL FAM SUB,10.5,AC,87300,0,87300,0,0,87300,85600,0,85600,0,0,85600,RR,RES/RUR,,,
15383,12-13-0-3-0,6832-71-8968,SNGL FAM SUB,11.41,AC,94900,0,94900,0,0,94900,93000,0,93000,0,0,93000,RR,RES/RUR,,,
15384,12-13-0-4-0,6832-71-5293,SNGL FAM SUB,8.25,AC,82200,0,82200,662300,59000,803500,80500,0,80500,574700,62300,717500,RR,RES/RUR,,,
15385,12-13-0-5-0,6832-71-2389,SNGL FAM SUB,6.983,AC,81700,0,81700,383300,0,465000,80000,0,80000,341400,0,421400,RR,RES/RUR,,,
15386,12-13-0-6-0,6832-71-0238,SNGL FAM SUB,7.267,AC,92300,0,92300,264500,1800,358600,90400,0,90400,223900,1300,315600,RR,RES/RUR,,,
15387,12-13-0-7-0,6832-61-7702,SNGL FAM SUB,7.5,AC,94100,0,94100,290300,0,384400,92200,0,92200,246300,0,338500,RR,RES/RUR,,,
15388,12-13-0-8-0,6832-61-3653,SNGL FAM SUB,7.5,AC,94100,0,94100,502000,60600,656700,92200,0,92200,438300,53000,583500,RR,RES/RUR,,,
15389,12-13-0-9-0,6832-61-0774,SNGL FAM SUB,7,AC,78600,0,78600,328200,0,406800,77000,0,77000,287500,0,364500,RR,RES/RUR,,,
15390,12-13-0-10-0,6832-62-4689,SNGL FAM SUB,7.67,AC,80800,0,80800,0,0,80800,79200,0,79200,0,0,79200,RR,RES/RUR,,,
15391,12-13-0-11-0,6832-62-9421,SNGL FAM SUB,7.83,AC,75800,0,75800,315900,1500,393200,74200,0,74200,267600,1500,343300,RR,RES/RUR,,,
15392,12-18-0-C-2,6831-49-1464,SNGL FAM SUB,13.33,AC,97300,0,97300,397700,0,495000,94700,0,94700,352900,0,447600,A1,AG/GEN,,,
15393,13-1-0-1-H,6842-11-6111,AG 20-100 AC,37.02,AC,297200,85200,212000,330800,84200,712200,291500,84700,206800,285800,72900,650200,A1,AG/GEN,,,
15394,2-1-0-4-E,6814-54-5755,SNGL FAM SUB,7.51,AC,354500,0,354500,0,0,354500,344000,0,344000,0,0,344000,A1B1,AG GEN/,,,
15395,12-10-0-B-1,6831-43-6684,SNGL FAM SUB,2.56,AC,61400,0,61400,0,3000,64400,56900,0,56900,0,3000,59900,A1,AG/GEN,,,
15396,12-10-0-B-2,6831-43-8972,SNGL FAM SUB,2.44,AC,60300,0,60300,0,0,60300,55200,0,55200,0,0,55200,A1,AG/GEN,,,
15397,12-10-0-B-3,6831-54-1225,SNGL FAM SUB,5.03,AC,80400,0,80400,219800,12700,312900,65700,0,65700,179900,12700,258300,A1,AG/GEN,,,
15398,13-1-0-13-A,6841-69-9109,SNGL FAM SUB,3.6,AC,67400,0,67400,199000,0,266400,66100,0,66100,151800,0,217900,A1,AG/GEN,,,
15399,17-1-0-8-0,6800-31-6208,SNGL FAM SUB,2.84,AC,49100,0,49100,91500,0,140600,48100,0,48100,76300,0,124400,A1,AG/GEN,,,
15400,17-1-0-36-A,6800-98-6036,Cemetery,0,AC,100,0,100,0,0,100,100,0,100,0,0,100,A1,AG/GEN,,,
15401,18-4-0-4-A1,6820-30-8478,SNGL FAM SUB,2,,46000,0,46000,745500,4900,796400,43500,0,43500,633800,4900,682200,A1,AG/GEN,,,
15402,19-1-0-13-A,6830-25-7206,SNGL FAM SUB,2,AC,63100,0,63100,142900,1800,207800,59300,0,59300,121100,1800,182200,A1,AG/GEN,,,
15403,19-13-0-1-0,6830-13-1642,SNGL FAM SUB,15.19,AC,143800,82600,61200,288800,34500,467100,137900,81900,56000,238600,30200,406700,A1,AG/GEN,,,
15404,19-13-0-2-0,6830-12-7902,AG 20-100 AC,44.67,AC,288600,213400,75200,68500,14500,371600,277000,208400,68600,58400,11700,347100,A1,AG/GEN,,,
15405,19-13-0-3-0,6830-21-0717,AG 20-100 AC,44.51,AC,287900,184300,103600,236300,0,524200,276200,179200,97000,195800,0,472000,A1,AG/GEN,,,
15406,19-13-0-4-0,6820-92-4726,AG 20-100 AC,29.48,AC,170300,156300,14000,0,0,170300,168000,155400,12600,0,0,168000,A1,AG/GEN,,,
15407,19-13-0-5-0,6830-01-6961,AG 20-100 AC,44.67,AC,261000,239900,21100,0,0,261000,254600,235600,19000,0,0,254600,A1,AG/GEN,,,
15408,17-1-0-86-G,6719-16-1876,SNGL FAM SUB,3,AC,52000,0,52000,14200,100,66300,49000,0,49000,16000,100,65100,A1,AG/GEN,,,
15409,17-1-0-101-C,6810-45-6611,SNGL FAM SUB,2.36,AC,48200,0,48200,108200,7600,164000,45500,0,45500,84600,6800,136900,A1,AG/GEN,,,
15410,17-2-0-5-A,6810-37-9636,SNGL FAM SUB,10.99,AC,90000,0,90000,336100,5300,431400,88000,0,88000,288800,5300,382100,A1,AG/GEN,,,
15411,17-2-0-5-B,6810-46-4934,SNGL FAM SUB,11.32,AC,95700,0,95700,389100,9500,494300,94800,0,94800,320400,9500,424700,A1,AG/GEN,,,
15412,60-1-0-2-A,6784-89-1924,SNGL FAM SUB,3.85,AC,13100,0,13100,0,0,13100,11600,0,11600,0,0,11600,A2,AG/LTD,,,
15413,21-1-0-56-F,6850-82-4703,SNGL FAM SUB,3,AC,73400,0,73400,94300,1200,168900,66500,0,66500,74400,1200,142100,A2,AG/LTD,,,
15414,21-1-0-57-A,6850-92-3541,SNGL FAM SUB,3,AC,78300,0,78300,47000,2500,127800,70700,0,70700,43400,1800,115900,A2,AG/LTD,,,
15415,11-1-0-47-B,6821-49-6322,SNGL FAM SUB,2,AC,46000,0,46000,171600,0,217600,44000,0,44000,144000,0,188000,A1,AG/GEN,,,
15416,32-1-0-33-B1,6778-76-1112,SNGL FAM SUB,2.42,AC,81500,0,81500,166100,1500,249100,72800,0,72800,136500,1500,210800,A2,AG/LTD,,,
15417,32-1-0-77-A,6788-32-3769,SNGL FAM SUB,7.6,AC,296000,0,296000,571300,5500,872800,273900,0,273900,541900,4600,820400,A2,AG/LTD,,,
15420,33-1-0-9-E,6798-45-1293,SNGL FAM SUB,2.33,AC,16100,0,16100,0,0,16100,14300,0,14300,0,0,14300,A2,AG/LTD,,,
15421,33-1-0-10-A,6798-56-2240,SNGL FAM SUB,2.78,AC,93600,0,93600,0,0,93600,83600,0,83600,0,0,83600,A2,AG/LTD,,,
15422,33-1-0-20-0,6798-03-8700,COMM & IND,3.258,AC,596000,0,596000,410400,203600,1210000,552000,0,552000,422000,147700,1121700,B1,BUS/GEN,,,
15423,34-1-0-4-A,7708-34-5021,SNGL FAM SUB,2.539,AC,79400,0,79400,0,0,79400,70900,0,70900,0,0,70900,A2,AG/LTD,,,
15424,34-1-0-4-B,7708-33-9817,SNGL FAM SUB,3.071,AC,86200,0,86200,0,0,86200,77000,0,77000,0,0,77000,A2,AG/LTD,,,
15425,38-1-0-39-F,6707-64-2281,SNGL FAM SUB,2.5,AC,47200,0,47200,103500,0,150700,46300,0,46300,84200,0,130500,A1,AG/GEN,,,
15426,39-1-0-52-F,6717-83-7469,SNGL FAM SUB,3.04,AC,50200,0,50200,120100,2600,172900,49200,0,49200,100700,400,150300,A1,AG/GEN,,,
15427,39-1-0-52-G,6717-83-8074,SNGL FAM SUB,4,AC,55600,0,55600,0,0,55600,54500,0,54500,0,0,54500,A1,AG/GEN,,,
15428,39-1-0-84-A,6726-67-3532,SNGL FAM SUB,2.64,AC,48000,0,48000,274500,700,323200,47000,0,47000,232000,700,279700,A1,AG/GEN,,,
15429,39-1-0-84-B,6726-66-0797,SNGL FAM SUB,5.78,AC,65600,0,65600,203200,16600,285400,64300,0,64300,173300,16600,254200,A1,AG/GEN,,,
15430,25-1-0-5-D2,5799-80-3506,SNGL FAM SUB,18.67,AC,106100,0,106100,325000,0,431100,103700,0,103700,298000,0,401700,A1,AG/GEN,,,
15431,25-1-0-5-D3,5798-79-8617,AG 20-100 AC,31.7,AC,95100,79100,16000,0,0,95100,95100,81500,13600,0,0,95100,A1,AG/GEN,,,
15432,26-1-0-70-B,6719-36-4414,SNGL FAM SUB,12,AC,99400,0,99400,398600,0,498000,98500,0,98500,332900,0,431400,A1,AG/GEN,,,
15433,26-2-0-2-H1,6708-67-8956,SNGL FAM SUB,6.25,AC,68200,0,68200,331200,0,399400,66900,0,66900,281500,0,348400,RR,RES/RUR,,,
15434,29-1-0-36-C,6748-54-1067,Cemetery,0,AC,100,0,100,0,0,100,100,0,100,0,0,100,A1,AG/GEN,,,
15435,26-14-0-1-0,6708-89-8971,SNGL FAM SUB,7.29,AC,77200,0,77200,268000,0,345200,75700,0,75700,239900,0,315600,RR,RES/RUR,,,
15436,26-14-0-2-0,6708-99-0062,SNGL FAM SUB,12.71,AC,104400,0,104400,259100,600,364100,102400,0,102400,220300,600,323300,RR,RES/RUR,,,
15437,26-14-0-3-0,6708-89-6475,SNGL FAM SUB,5,AC,63200,0,63200,0,0,63200,62000,0,62000,0,0,62000,RR,RES/RUR,,,
15438,26-14-0-4-0,6708-89-4849,SNGL FAM SUB,5,AC,63200,0,63200,224800,800,288800,62000,0,62000,203700,800,266500,RR,RES/RUR,,,
15439,28-1-0-97-B,6738-36-6164,SNGL FAM SUB,2.19,AC,56300,0,56300,201600,800,258700,56700,0,56700,174600,800,232100,A1,AG/GEN,,,
15440,29-1-0-36-B,6748-54-3028,Cemetery,0.56,AC,100,0,100,0,0,100,100,0,100,0,0,100,A1,AG/GEN,,,
15441,29-1-0-117-C,6758-09-1189,SNGL FAM SUB,3.84,AC,77400,0,77400,137300,0,214700,72100,0,72100,106500,0,178600,A1,AG/GEN,,,
15442,29-5-0-2-E1,6749-65-8270,SNGL FAM SUB,3,AC,73600,0,73600,97900,700,172200,69700,0,69700,77400,800,147900,A1,AG/GEN,,,
15443,31-1-0-20-A,6768-47-6307,SNGL FAM SUB,3.81,AC,94900,0,94900,316700,2000,413600,88800,0,88800,263400,2000,354200,A2,AG/LTD,,,
15444,31-1-0-84-A,6778-55-0610,SNGL FAM SUB,7.64,AC,135800,0,135800,0,0,135800,120900,0,120900,0,0,120900,A2,AG/LTD,,,
15445,31-1-0-84-B,6778-55-6849,SNGL FAM SUB,9.94,AC,166000,0,166000,0,0,166000,148400,0,148400,0,0,148400,A2,AG/LTD,,,
15446,26-1-0-15-D,6709-93-2146,SNGL FAM SUB,2.806,AC,50800,0,50800,225900,13500,290200,47900,0,47900,184100,11800,243800,A1,AG/GEN,,,
15447,41-1-0-2-E,6748-11-8189,TAXED -SCC,2.008,AC,0,0,0,0,0,0,0,0,0,0,0,0,A1,AG/GEN,,,
15448,41-3-0-1-0,6748-10-7842,AG 20-100 AC,20,AC,204800,194800,10000,0,0,204800,198100,189500,8600,0,0,198100,A1,AG/GEN,,,
15449,41-3-0-2-0,6748-10-6236,AG 20-100 AC,20,AC,204800,194800,10000,0,0,204800,198100,189500,8600,0,0,198100,A1,AG/GEN,,,
15450,41-3-0-3-0,6747-19-0738,SNGL FAM SUB,11.47,AC,151600,0,151600,458900,6700,617200,148300,0,148300,404200,6700,559200,A1,AG/GEN,,,
15451,41-3-0-4-0,6747-19-7614,SNGL FAM SUB,10.12,AC,138400,0,138400,702900,28400,869700,135600,0,135600,615300,26400,777300,A1,AG/GEN,,,
15452,41-3-0-5-0,6747-18-3817,SNGL FAM SUB,17.77,AC,191500,182700,8800,0,0,191500,194300,186700,7600,0,0,194300,A1,AG/GEN,,,
15453,41-3-0-6-0,6747-17-2971,AG 20-100 AC,21.41,AC,216400,205500,10900,0,30500,246900,204100,194900,9200,0,28400,232500,A1,AG/GEN,,,
15454,41-3-0-7-0,6747-07-1378,AG 20-100 AC,81.53,AC,516100,420900,95200,426200,119000,1061300,505900,409400,96500,411500,105800,1023200,A1,AG/GEN,,,
15455,41-3-0-7-A,6747-16-4877,Cemetery,0,AC,100,0,100,0,0,100,100,0,100,0,0,100,A1,AG/GEN,,,
15456,41-3-0-8-0,6747-08-2221,AG 20-100 AC,21,AC,224300,214200,10100,0,0,224300,218400,209400,9000,0,0,218400,A1,AG/GEN,,,
15457,41-3-0-9-0,6747-09-5089,AG 20-100 AC,21.39,AC,226000,0,226000,609100,0,835100,221400,0,221400,525800,0,747200,A1,AG/GEN,,,
15458,41-3-0-10-0,6737-99-7413,AG 20-100 AC,30.77,AC,302900,0,302900,0,0,302900,294600,0,294600,0,0,294600,A1,AG/GEN,,,
15459,12-1-0-71-J,6831-52-3529,SNGL FAM SUB,2.01,AC,56900,0,56900,142800,35300,235000,52600,0,52600,113200,31500,197300,A1,AG/GEN,,,
15461,39-1-0-52-H,6717-72-7416,SNGL FAM SUB,6.94,AC,69100,0,69100,0,0,69100,67700,0,67700,0,0,67700,A1,AG/GEN,,,
15462,42-1-0-73-D,6758-90-2819,SNGL FAM SUB,3.16,AC,80200,0,80200,190400,20800,291400,75800,0,75800,163200,17600,256600,R1,RES/LTD,,,
15463,42-1-0-73-E,6758-81-7065,SNGL FAM SUB,2.48,AC,72200,0,72200,0,0,72200,67700,0,67700,0,0,67700,R1,RES/LTD,,,
15464,42-1-0-73-F,6758-80-8768,SNGL FAM SUB,2.49,AC,72300,0,72300,489300,0,561600,67800,0,67800,398000,0,465800,R1,RES/LTD,,,
15465,42-21-0-4-A,6766-19-8838,General Gov,0.129,AC,34800,0,34800,0,0,34800,33600,0,33600,0,0,33600,A2,AG/LTD,,,
15467,44-1-0-37-B,6787-09-1650,SNGL FAM SUB,2.33,AC,77100,0,77100,0,0,77100,65800,0,65800,0,0,65800,A2,AG/LTD,,,
15468,44-1-0-37-C,6787-09-1229,SNGL FAM SUB,2.33,AC,84100,0,84100,0,0,84100,65800,0,65800,0,0,65800,A2,AG/LTD,,,
15469,44-1-0-37-D,6787-08-0995,SNGL FAM SUB,2.33,AC,91100,0,91100,259000,0,350100,81400,0,81400,212300,0,293700,A2,AG/LTD,,,
15470,45-1-0-70-B,6797-64-9512,SNGL FAM SUB,1.703,AC,87800,0,87800,0,0,87800,78400,0,78400,0,0,78400,A2,AG/LTD,,,
15491,47-1-0-35-D,7716-78-3548,COMM & IND,0.54,AC,237600,0,237600,587100,0,824700,216000,0,216000,548700,0,764700,B1,BUS/GEN,,,
15492,47-1-0-98-C1,7727-20-0645,SNGL FAM SUB,0.96,AC,101400,0,101400,0,0,101400,90500,0,90500,0,0,90500,A2,AG/LTD,,,
15493,46-31-0-10-0,7708-71-5508,SNGL FAM SUB,3.39,AC,170000,0,170000,359200,0,529200,156000,0,156000,302700,0,458700,RR,RES/RUR,,,
15494,46-31-0-11-0,7708-71-3202,SNGL FAM SUB,3.86,AC,170000,0,170000,360200,36600,566800,156000,0,156000,302300,31600,489900,RR,RES/RUR,,,
15496,48-1-0-74-0,7727-91-9166,AG > 100 AC,102,AC,1845600,0,1845600,0,0,1845600,1650800,0,1650800,0,0,1650800,A2,AG/LTD,,,
15497,48-8-0-1-A,7727-62-2199,Cemetery,0,AC,100,0,100,0,0,100,100,0,100,0,0,100,A2,AG/LTD,,,
15498,9-1-0-61-C,5891-88-4291,SNGL FAM SUB,2.722,AC,45000,0,45000,0,0,45000,44000,0,44000,0,0,44000,A1,AG/GEN,,,
15500,16-1-0-20-A,5890-23-8835,SNGL FAM SUB,6.17,AC,57400,0,57400,0,0,57400,56100,0,56100,0,0,56100,A1,AG/GEN,,,
15501,16-1-0-20-B,5890-33-2194,SNGL FAM SUB,9.528,AC,61000,0,61000,0,0,61000,59300,0,59300,0,0,59300,A1,AG/GEN,,,
15502,26-1-0-4-D,6709-93-0841,SNGL FAM SUB,2.8,AC,50800,0,50800,52900,2500,106200,48800,0,48800,44600,2500,95900,A1,AG/GEN,,,
15659,38-1-0-114-A,6718-50-5003,SNGL FAM SUB,0.51,AC,2100,1900,200,0,0,2100,2000,1800,200,0,0,2000,A1,AG/GEN,,,
15660,39-1-0-1-A,6717-68-4679,AG > 100 AC,141.94,AC,511000,445600,65400,0,0,511000,496800,436500,60300,0,0,496800,A1,AG/GEN,,,
15661,39-1-0-95-A,6727-57-0671,Cemetery,0,AC,100,0,100,0,0,100,100,0,100,0,0,100,A1,AG/GEN,,,
15662,42-1-0-45-B,6757-93-1395,Vacant Land,0.025,AC,2500,0,2500,0,0,2500,2400,0,2400,0,0,2400,A2,AG/LTD,,,
15663,42-1-0-60-F,6757-56-8601,SNGL FAM SUB,2.94,AC,82200,0,82200,0,3000,85200,73300,0,73300,0,3300,76600,A2,AG/LTD,,,
15665,42-1-0-118-A,6766-37-2178,SNGL FAM SUB,2.413,AC,91400,0,91400,354200,5900,451500,81700,0,81700,309500,5400,396600,A2,AG/LTD,,,
15666,42-1-0-118-B,6766-37-2666,SNGL FAM SUB,5.551,AC,94300,0,94300,347500,2000,443800,84100,0,84100,288100,2000,374200,A2,AG/LTD,,,
15667,42-1-0-118-C,6766-27-9519,SNGL FAM SUB,5.923,AC,114300,0,114300,322200,0,436500,102100,0,102100,269900,0,372000,A2,AG/LTD,,,
15668,42-1-0-118-D,6766-27-9082,SNGL FAM SUB,4,AC,115400,0,115400,215700,6500,337600,103100,0,103100,183500,6500,293100,A2,AG/LTD,,,
15669,43-1-0-11-A,6767-77-8688,SNGL FAM SUB,2.345,AC,89500,0,89500,197900,10400,297800,80000,0,80000,163700,10400,254100,A2,AG/LTD,,,
15670,45-1-0-60-B,6797-38-4899,SNGL FAM SUB,2.002,AC,84500,0,84500,0,0,84500,75500,0,75500,0,0,75500,A2,AG/LTD,,,
15671,45-1-0-60-C,6797-38-8789,SNGL FAM SUB,2.516,AC,91900,0,91900,0,0,91900,82200,0,82200,0,0,82200,A2,AG/LTD,,,
15672,46-1-0-16-A,7707-34-1974,SNGL FAM SUB,3.81,AC,163100,0,163100,416200,5600,584900,145700,0,145700,375200,4800,525700,A2,AG/LTD,,,
15673,46-1-0-16-B,7707-34-0642,SNGL FAM SUB,3.49,AC,256800,0,256800,687000,6000,949800,229300,0,229300,635900,4300,869500,A2,AG/LTD,,,
15674,46-1-0-16-C,7707-24-9344,SNGL FAM SUB,3.6,AC,108800,0,108800,0,0,108800,97200,0,97200,0,0,97200,A2,AG/LTD,,,
15675,46-1-0-16-D,7707-24-6863,SNGL FAM SUB,7.31,AC,239100,136900,102200,259800,8500,507400,213300,122200,91100,216900,8500,438700,A2,AG/LTD,,,
15676,46-1-0-114-E,7717-07-9162,SNGL FAM SUB,0.824,AC,10500,0,10500,0,0,10500,9400,0,9400,0,0,9400,A2,AG/LTD,,,
15677,46-35-0-A-0,7718-10-5992,SNGL FAM SUB,6.99,AC,197800,0,197800,153800,500,352100,176500,0,176500,131600,500,308600,A2,AG/LTD,,,
15678,46-35-0-B-0,7718-10-6583,AG 20-100 AC,20.47,AC,435100,333000,102100,157900,23900,616900,388200,297400,90800,136000,23900,548100,A2,AG/LTD,,,
15679,46-35-0-C-0,7717-09-7896,SNGL FAM SUB,5.57,AC,182000,0,182000,198600,0,380600,162500,0,162500,171000,0,333500,A2,AG/LTD,,,
15827,20-20-0-32-0,6840-23-8466,SNGL FAM SUB,5.22,AC,73200,0,73200,220300,0,293500,70400,0,70400,198000,0,268400,A1,AG/GEN,,,
15828,20-20-0-33-0,6840-23-8068,SNGL FAM SUB,3.73,AC,69700,0,69700,242300,3000,315000,67000,0,67000,216700,3000,286700,A1,AG/GEN,,,
15830,20-20-0-2-0,6840-12-2525,SNGL FAM SUB,4.25,AC,67400,0,67400,164700,0,232100,64800,0,64800,147400,0,212200,A1,AG/GEN,,,
15832,20-20-0-4-0,6840-13-7506,SNGL FAM SUB,12.44,AC,97400,0,97400,0,0,97400,93600,0,93600,0,0,93600,A1,AG/GEN,,,
15833,20-20-0-5-0,6840-23-3379,SNGL FAM SUB,3.11,AC,69700,0,69700,204200,28200,302100,67000,0,67000,183600,24600,275200,A1,AG/GEN,,,
15834,20-20-0-6-0,6840-23-4037,SNGL FAM SUB,3.62,AC,69700,0,69700,207200,0,276900,67000,0,67000,186000,0,253000,A1,AG/GEN,,,
15835,20-20-0-7-0,6840-12-9981,SNGL FAM SUB,4.21,AC,69700,0,69700,211000,3000,283700,67000,0,67000,191700,3400,262100,A1,AG/GEN,,,
15836,20-20-0-8-0,6840-22-4659,SNGL FAM SUB,3,AC,69700,0,69700,251500,4000,325200,67000,0,67000,227000,3800,297800,A1,AG/GEN,,,
15837,20-20-0-9-0,6840-22-7699,SNGL FAM SUB,3.16,AC,69700,0,69700,251100,2100,322900,67000,0,67000,234800,2200,304000,A1,AG/GEN,,,
15838,20-20-0-10-0,6840-32-0475,SNGL FAM SUB,3.73,AC,69700,0,69700,224800,1100,295600,67000,0,67000,202900,1200,271100,A1,AG/GEN,,,
15503,40-1-0-29-G,6737-52-0539,AG 20-100 AC,21.394,AC,147900,138000,9900,0,0,147900,145000,135900,9100,0,0,145000,A1,AG/GEN,,,
15504,54-3-0-H-1,6766-95-2003,SNGL FAM SUB,5,AC,118100,0,118100,622800,0,740900,105400,0,105400,521100,0,626500,A2,AG/LTD,,,
15505,54-5-0-11-A,6766-63-9534,SNGL FAM SUB,0.14,AC,1400,0,1400,0,0,1400,1300,0,1300,0,0,1300,A2,AG/LTD,,,
15506,56-16-0-16-0,6795-53-2762,AG 20-100 AC,38.753,AC,972800,0,972800,0,0,972800,846800,0,846800,0,0,846800,RR,RES/RUR,,,
15508,58-1-0-9-A,7716-46-3556,SNGL FAM SUB,3,AC,133000,0,133000,77600,400,211000,118800,0,118800,62600,400,181800,A2,AG/LTD,,,
15509,58-1-0-86-A,7716-85-8327,SNGL FAM SUB,11.41,AC,345700,219600,126100,703900,82800,1132400,300400,190800,109600,609100,72000,981500,A2,AG/LTD,,,
15510,58-1-0-86-B,7716-84-1878,SNGL FAM SUB,8.16,AC,271600,0,271600,463800,7600,743000,236100,0,236100,394800,4400,635300,A2,AG/LTD,,,
15511,58-1-0-86-C,7716-84-7837,SNGL FAM SUB,4.18,AC,180900,0,180900,406700,2700,590300,157300,0,157300,349000,2800,509100,A2,AG/LTD,,,
15512,58-1-0-86-D,7716-84-6486,SNGL FAM SUB,6.25,AC,228100,0,228100,468700,17700,714500,198300,0,198300,399400,17700,615400,A2,AG/LTD,,,
15514,59-1-0-23-D1,7726-76-5477,State Exmm,0.035,AC,34700,0,34700,0,0,34700,31500,0,31500,0,0,31500,R3,RES/GEN,,,
15515,61-7-0-26-0,6795-71-4552,AG 20-100 AC,56.173,AC,1736700,0,1736700,1609000,103800,3449500,1511200,0,1511200,1726600,99900,3337700,RR,RES/RUR,,,
15517,61-7-0-B-0,6795-81-4904,Roads,0.465,AC,0,0,0,0,0,0,0,0,0,0,0,0,RR,RES/RUR,,,
15518,63-1-0-114-C,7715-61-3816,SNGL FAM SUB,3.481,AC,152100,0,152100,0,0,152100,132200,0,132200,0,0,132200,A2,AG/LTD,,,
15519,63-34-0-2-0T,7724-36-6448,COMM & IND,4.7,AC,885400,0,885400,3265100,200,4150700,843200,0,843200,3265100,100,4108400,M1,INDUS/L,,,
15520,64-1-0-16-A,7724-51-6442,SNGL FAM SUB,16.62,AC,719700,0,719700,345500,66600,1131800,625500,0,625500,318300,60600,1004400,R1,RES/LTD,,,
15521,64-1-0-75-0,7733-48-4604,SNGL FAM SUB,2.577,AC,235100,0,235100,245300,23500,503900,204500,0,204500,207900,19600,432000,R1,RES/LTD,,,
15522,20-1-0-34-C,6749-39-9551,SNGL FAM SUB,4.15,AC,88900,0,88900,418700,0,507600,82700,0,82700,356800,0,439500,A1,AG/GEN,,,
15523,46-34-0-4-0,7717-04-8779,SNGL FAM SUB,2.01,AC,165000,0,165000,270700,1600,437300,150000,0,150000,227200,1600,378800,R1,RES/LTD,,,
15524,46-34-0-3-0,7717-14-1707,SNGL FAM SUB,2.2,AC,165000,0,165000,265400,0,430400,150000,0,150000,223900,0,373900,R1,RES/LTD,,,
15525,46-34-0-2-0,7717-05-9199,SNGL FAM SUB,3,AC,165000,0,165000,551100,2500,718600,150000,0,150000,474400,2500,626900,R1,RES/LTD,,,
15526,46-34-0-1-0,7717-05-6242,SNGL FAM SUB,3,AC,165000,0,165000,446400,1000,612400,150000,0,150000,390600,1000,541600,R1,RES/LTD,,,
15527,63-11-0-A-1A,7714-74-5718,SNGL FAM SUB,3.008,AC,169100,0,169100,502900,1500,673500,147100,0,147100,443500,1500,592100,A2,AG/LTD,,,
15528,40-1-0-26-A1,6737-21-1042,SNGL FAM SUB,6.77,AC,82000,0,82000,0,0,82000,80500,0,80500,0,0,80500,A1,AG/GEN,,,
15529,15-6-0-6-0,5880-41-1481,AG 20-100 AC,21.62,AC,86900,76900,10000,0,0,86900,86600,77400,9200,0,0,86600,A1,AG/GEN,,,
15530,15-6-0-5-A,5880-40-3550,Cemetery,0,AC,100,0,100,0,0,100,100,0,100,0,0,100,A1,AG/GEN,,,
15531,15-6-0-5-0,5880-40-4899,AG 20-100 AC,20.65,AC,80100,70600,9500,0,0,80100,77300,68500,8800,0,0,77300,A1,AG/GEN,,,
15533,15-6-0-3-0,5880-40-1137,SNGL FAM SUB,6.7,AC,59300,56200,3100,0,0,59300,58000,55200,2800,0,0,58000,A1,AG/GEN,,,
15534,15-6-0-2-0,5880-40-7016,SNGL FAM SUB,5.7,AC,55700,53100,2600,0,0,55700,54500,52100,2400,0,0,54500,A1,AG/GEN,,,
15535,15-6-0-1-0,5880-50-0237,SNGL FAM SUB,4.76,AC,52300,50100,2200,0,0,52300,51200,49200,2000,0,0,51200,A1,AG/GEN,,,
15536,15-6-0-A-0,5789-49-9817,SNGL FAM SUB,0.91,AC,3300,0,3300,0,0,3300,3200,0,3200,0,0,3200,A1,AG/GEN,,,
15537,15-6-0-4-0,5880-30-7562,SNGL FAM SUB,4.27,AC,50600,45100,5500,0,0,50600,49400,44100,5300,0,0,49400,A1,AG/GEN,,,
15538,28-1-0-113-0,6739-82-7008,SNGL FAM SUB,3.64,AC,74800,0,74800,0,0,74800,71500,0,71500,0,0,71500,A1,AG/GEN,,,
15540,5-19-B-6-A,6814-62-0145,SNGL FAM SUB,0.14,AC,700,0,700,0,0,700,700,0,700,0,0,700,A1,AG/GEN,,,
15541,6-1-0-47-A,6832-28-1251,SNGL FAM SUB,4.27,AC,63600,0,63600,308700,5500,377800,63300,0,63300,270100,3800,337200,A1,AG/GEN,,,
15542,12-1-0-37-A,6831-23-7712,SNGL FAM SUB,3.01,AC,60300,0,60300,186400,2000,248700,58400,0,58400,154600,2000,215000,A1,AG/GEN,,,
15543,12-1-0-55-A,6832-64-5021,SNGL FAM SUB,3.79,AC,66700,0,66700,222000,0,288700,62700,0,62700,199500,0,262200,A1,AG/GEN,,,
15544,26-1-0-57-E,6719-22-1081,SNGL FAM SUB,1.82,AC,53600,0,53600,0,0,53600,52500,0,52500,0,0,52500,A1B1,AG GEN/,,,
15545,30-20-0-1-0,6758-36-8256,SNGL FAM SUB,5,AC,91600,0,91600,399400,1400,492400,87500,0,87500,341700,1500,430700,A2,AG/LTD,,,
15546,30-20-0-2-0,6758-46-2222,SNGL FAM SUB,5.27,AC,93900,0,93900,777900,0,871800,90000,0,90000,668100,0,758100,A2,AG/LTD,,,
15547,30-20-0-3-0,6758-46-7240,SNGL FAM SUB,10.28,AC,127300,0,127300,430900,2000,560200,117600,0,117600,372300,2000,491900,A2,AG/LTD,,,
15549,46-1-0-47-A,7707-20-8725,AG 20-100 AC,24.79,AC,585900,390000,195900,182200,405800,1173900,522800,348100,174700,153500,405500,1081800,A2,AG/LTD,,,
15550,55-1-0-71-D1,6786-62-8312,SNGL FAM SUB,2,AC,86600,0,86600,202800,0,289400,77300,0,77300,165600,0,242900,A2,AG/LTD,,,
15551,63-1-0-114-D,7715-51-9622,SNGL FAM SUB,3.28,AC,148000,0,148000,245600,0,393600,128700,0,128700,212700,0,341400,A2,AG/LTD,,,
15553,32-3-0-7-A,6778-67-7474,COMM & IND,1.456,AC,106000,0,106000,234000,11600,351600,100900,0,100900,228600,8900,338400,B1,BUS/GEN,,,
15554,47-1-0-41-0,7716-98-1867,COMM & IND,1.694,AC,1137300,0,1137300,929500,51000,2117800,1033900,0,1033900,886700,34300,1954900,MPUD,MIXPUD,,,
15555,47-1-0-80-0,7716-88-8474,COMM & IND,4.471,AC,2586000,1292200,1293800,558800,13500,3158300,2350900,1174800,1176100,531100,10200,2892200,B1,BUS/GEN,,,
15556,63-1-0-33-0T,7714-43-5882,General Gov,1.899,AC,201900,0,201900,1252500,12200,1466600,175500,0,175500,1244100,11200,1430800,R3,RES/GEN,,,
15559,1-1-0-8-A,6814-59-4509,SNGL FAM SUB,5.29,AC,57200,54800,2400,0,0,57200,56200,54000,2200,0,0,56200,A1,AG/GEN,,,
15560,1-7-0-1-0,6815-11-6409,SNGL FAM SUB,4.18,AC,59700,0,59700,146300,0,206000,58400,0,58400,123400,0,181800,A1,AG/GEN,,,
15561,1-7-0-2-0,6815-11-9527,SNGL FAM SUB,2.26,AC,49400,0,49400,150500,1200,201100,48400,0,48400,127400,1200,177000,A1,AG/GEN,,,
15562,1-7-0-3-0,6815-21-1637,SNGL FAM SUB,2.31,AC,49700,0,49700,145600,1500,196800,48600,0,48600,122800,1500,172900,A1,AG/GEN,,,
15563,1-7-0-4-0,6815-21-3799,SNGL FAM SUB,3.47,AC,55900,0,55900,141800,2500,200200,54700,0,54700,119800,2500,177000,A1,AG/GEN,,,
15564,1-7-0-5-0,6815-21-2117,AG 20-100 AC,20.4,AC,113500,0,113500,149400,14300,277200,111200,0,111200,125400,12100,248700,A1,AG/GEN,,,
15565,4-1-0-67-B,6813-34-7090,SNGL FAM SUB,5,AC,41600,0,41600,342600,83500,467700,40700,0,40700,307200,74300,422200,A1,AG/GEN,,,
15566,13-1-0-1-L,6842-20-0788,AG 20-100 AC,20.427,AC,181200,171000,10200,0,0,181200,177700,169000,8700,0,0,177700,A1,AG/GEN,,,
15567,4-9-0-1-0,6813-19-3415,SNGL FAM SUB,2.89,AC,49700,0,49700,167000,1000,217700,48700,0,48700,147500,1000,197200,A1,AG/GEN,,,
15568,4-9-0-2-0,6813-19-6361,SNGL FAM SUB,2.77,AC,49100,0,49100,165500,7500,222100,48000,0,48000,163200,6400,217600,A1,AG/GEN,,,
15569,4-9-0-3-0,6813-29-0128,SNGL FAM SUB,2.35,AC,46800,0,46800,172100,1500,220400,45900,0,45900,152200,1500,199600,A1,AG/GEN,,,
15570,4-9-0-4-0,6813-29-5035,SNGL FAM SUB,5.47,AC,63500,0,63500,181700,1000,246200,62200,0,62200,160600,1000,223800,A1,AG/GEN,,,
15572,5-10-0-3-A,6813-89-8777,SNGL FAM SUB,3.73,AC,53600,0,53600,225900,2500,282000,52700,0,52700,196800,1800,251300,A1,AG/GEN,,,
15573,5-10-0-3-B,6813-89-5120,SNGL FAM SUB,11.44,AC,91800,0,91800,0,0,91800,90100,0,90100,0,0,90100,A1,AG/GEN,,,
15574,5-24-0-B-0,6822-49-3719,AG > 100 AC,151.5,AC,626700,0,626700,134400,238400,999500,611000,0,611000,121100,238100,970200,A1,AG/GEN,,,
15577,5-24-0-C-0,6822-57-0220,AG > 100 AC,107.4,AC,412300,0,412300,75800,122700,610800,399400,0,399400,73000,124300,596700,A1,AG/GEN,,,
15581,6-12-0-1-0,6832-09-5278,SNGL FAM SUB,2.66,AC,52300,0,52300,160500,500,213300,51300,0,51300,135400,500,187200,A1,AG/GEN,,,
15582,6-12-0-2-0,6832-09-7724,SNGL FAM SUB,2.6,AC,49900,0,49900,171300,1000,222200,48800,0,48800,144400,1000,194200,A1,AG/GEN,,,
15583,6-12-0-3-0,6832-09-9655,SNGL FAM SUB,2.48,AC,49200,0,49200,160500,0,209700,48100,0,48100,135400,0,183500,A1,AG/GEN,,,
15584,6-12-0-4-0,6832-09-6085,SNGL FAM SUB,3.39,AC,56600,0,56600,164500,500,221600,55400,0,55400,144100,500,200000,A1,AG/GEN,,,
15585,7-1-0-10-A,6842-39-9827,SNGL FAM SUB,0.29,AC,1700,0,1700,0,0,1700,1600,0,1600,0,0,1600,A1,AG/GEN,,,
15586,9-1-0-36-C,5892-52-7355,SNGL FAM SUB,2,AC,42400,0,42400,122800,5900,171100,41500,0,41500,100900,6500,148900,A1,AG/GEN,,,
15587,9-1-0-72-D,5892-83-3670,SNGL FAM SUB,2,AC,32700,0,32700,0,0,32700,31500,0,31500,0,0,31500,A1,AG/GEN,,,
15588,9-1-0-73-A,5892-83-5348,Cemetery,0,AC,100,0,100,0,0,100,100,0,100,0,0,100,A1,AG/GEN,,,
15589,10-1-0-35-A1,6812-44-6523,SNGL FAM SUB,9.101,AC,72800,0,72800,0,0,72800,71500,0,71500,0,0,71500,A1,AG/GEN,,,
15590,11-13-0-50-0,6822-25-4436,AG 20-100 AC,23.5,AC,139400,0,139400,407300,1200,547900,137400,0,137400,344500,1300,483200,RR,RES/RUR,,,
15591,11-13-0-51-0,6822-25-9075,AG 20-100 AC,20,AC,124400,0,124400,306200,42900,473500,120600,0,120600,252200,37000,409800,RR,RES/RUR,,,
15592,11-13-0-52-0,6822-35-5291,SNGL FAM SUB,13.8,AC,93900,0,93900,418100,0,512000,90800,0,90800,365200,0,456000,RR,RES/RUR,,,
15593,11-13-0-53-0,6822-45-1668,SNGL FAM SUB,18.7,AC,115000,0,115000,417200,0,532200,114400,0,114400,360100,0,474500,RR,RES/RUR,,,
15594,11-14-0-A-0,6822-24-1786,Cmn Area/Open Spc,45.5,AC,0,0,0,0,0,0,0,0,0,0,0,0,RR,RES/RUR,,,
15595,12-1-0-71-K,6831-52-1309,SNGL FAM SUB,2.5,AC,57500,0,57500,181500,0,239000,52700,0,52700,162200,0,214900,A1,AG/GEN,,,
15596,13-1-0-A-0,6842-67-3420,Cemetery,0,AC,100,0,100,0,0,100,100,0,100,0,0,100,A1,AG/GEN,,,
15597,13-1-0-1-J,6842-00-7081,COMM & IND,2.48,AC,73500,0,73500,93300,0,166800,71400,0,71400,89600,0,161000,RO,RES/OF,,,
15598,13-1-0-1-K,6841-09-6842,SNGL FAM SUB,2.49,AC,56600,0,56600,187900,21300,265800,56700,0,56700,162700,17500,236900,RO,RES/OF,,,
15599,13-1-0-42-A,6841-75-6611,SNGL FAM SUB,6.17,AC,92400,0,92400,259900,11600,363900,90700,0,90700,225000,8200,323900,A1,AG/GEN,,,
15600,13-22-0-1-0,6841-48-9115,SNGL FAM SUB,4.24,AC,70000,0,70000,222200,0,292200,69900,0,69900,193100,0,263000,A1,AG/GEN,,,
15601,13-22-0-2-0,6841-58-1335,SNGL FAM SUB,3.04,AC,60800,0,60800,224600,800,286200,60300,0,60300,194100,800,255200,A1,AG/GEN,,,
15602,13-22-0-3-0,6841-58-4643,SNGL FAM SUB,11.13,AC,107500,0,107500,0,0,107500,104800,0,104800,0,0,104800,A1,AG/GEN,,,
15603,13-22-0-4-0,6841-68-1209,AG 20-100 AC,31.72,AC,160900,146300,14600,0,0,160900,157700,144200,13500,0,0,157700,A1,AG/GEN,,,
15604,13-22-0-5-0,6841-57-6266,SNGL FAM SUB,2.05,AC,59000,0,59000,340200,3900,403100,54300,0,54300,308800,3100,366200,A1,AG/GEN,,,
15605,13-22-0-6-0,6841-57-4376,SNGL FAM SUB,2.18,AC,60100,0,60100,221700,0,281800,59000,0,59000,191600,0,250600,A1,AG/GEN,,,
15606,13-22-0-7-0,6841-57-2470,SNGL FAM SUB,2.08,AC,59300,0,59300,226000,0,285300,58200,0,58200,197500,0,255700,A1,AG/GEN,,,
15607,13-22-0-8-0,6841-57-4734,SNGL FAM SUB,7.47,AC,89400,0,89400,385900,0,475300,87700,0,87700,342700,0,430400,A1,AG/GEN,,,
15608,16-1-0-8-B,5890-69-7672,SNGL FAM SUB,2,AC,42400,0,42400,118500,700,161600,41500,0,41500,78600,700,120800,A1,AG/GEN,,,
15609,17-1-0-21-A1,6709-69-5076,SNGL FAM SUB,0.31,AC,1700,0,1700,0,0,1700,1700,0,1700,0,0,1700,A1,AG/GEN,,,
15610,17-1-0-56-A,6810-36-6239,Cemetery,0,AC,100,0,100,0,0,100,100,0,100,0,0,100,A1,AG/GEN,,,
15611,17-1-0-65-A,6810-24-7983,SNGL FAM SUB,0.82,AC,4900,0,4900,0,0,4900,4500,0,4500,0,0,4500,A1,AG/GEN,,,
15612,18-11-0-2-0,6811-80-0374,SNGL FAM SUB,4,AC,55600,0,55600,194900,1500,252000,54500,0,54500,158000,1500,214000,A1,AG/GEN,,,
15614,18-11-0-3-0,6811-80-4790,SNGL FAM SUB,5.26,AC,62700,0,62700,245100,0,307800,61400,0,61400,217100,0,278500,A1,AG/GEN,,,
15615,18-11-0-4-0,6811-80-1810,SNGL FAM SUB,7.41,AC,74700,0,74700,234200,1700,310600,73300,0,73300,195200,6900,275400,A1,AG/GEN,,,
15616,19-1-0-14-D,6830-05-6830,SNGL FAM SUB,0.26,AC,1300,0,1300,0,0,1300,1200,0,1200,0,0,1200,A1,AG/GEN,,,
15617,19-1-0-14-E,6830-14-1765,AG 20-100 AC,84.89,AC,481100,441600,39500,0,0,481100,463500,427400,36100,0,0,463500,A1,AG/GEN,,,
15618,19-1-0-14-F,6830-33-2461,AG 20-100 AC,97.79,AC,585200,485700,99500,150800,0,736000,553200,462100,91100,124700,0,677900,A1,AG/GEN,,,
15619,19-1-0-14-G,6830-34-7687,SNGL FAM SUB,5,AC,90800,0,90800,334700,22700,448200,83100,0,83100,277900,18900,379900,A1,AG/GEN,,,
15620,19-1-0-14-H,6830-35-0144,SNGL FAM SUB,2,AC,63900,0,63900,5500,0,69400,59800,0,59800,5500,0,65300,A1,AG/GEN,,,
15621,19-1-0-46-B,6831-71-4758,SNGL FAM SUB,18.05,AC,188100,125400,62700,484800,9500,682400,174400,117200,57200,410400,9500,594300,A1,AG/GEN,,,
15622,19-1-0-69-A,6739-28-6455,SNGL FAM SUB,2.02,AC,61700,0,61700,16000,0,77700,57300,0,57300,15100,0,72400,A1,AG/GEN,,,
15624,28-14-0-1-0,6739-92-8310,SNGL FAM SUB,6.51,AC,97300,0,97300,288100,700,386100,92900,0,92900,251300,800,345000,A1,AG/GEN,,,
15625,28-14-0-2-0,6739-91-7837,SNGL FAM SUB,8.64,AC,109000,0,109000,516100,0,625100,104100,0,104100,454300,0,558400,A1,AG/GEN,,,
15626,28-14-0-3-0,6739-91-6481,SNGL FAM SUB,10.07,AC,116900,0,116900,563500,11000,691400,111600,0,111600,508700,9200,629500,A1,AG/GEN,,,
15627,28-14-0-4-0,6739-90-6972,SNGL FAM SUB,6.8,AC,105600,0,105600,345500,71900,523000,100900,0,100900,314400,66300,481600,A1,AG/GEN,,,
15628,28-14-0-5-0,6739-90-6522,SNGL FAM SUB,6.94,AC,99700,0,99700,316500,3400,419600,95200,0,95200,280300,3600,379100,A1,AG/GEN,,,
15629,28-14-0-6-0,6739-90-6139,SNGL FAM SUB,5.02,AC,89100,0,89100,353900,0,443000,85100,0,85100,314500,0,399600,A1,AG/GEN,,,
15630,28-14-0-7-0,6738-99-7723,SNGL FAM SUB,5.72,AC,93000,0,93000,523100,27900,644000,88800,0,88800,480400,24600,593800,A1,AG/GEN,,,
15632,28-14-0-8-0,6738-99-5302,SNGL FAM SUB,10.41,AC,118800,0,118800,431800,0,550600,113400,0,113400,370600,0,484000,A1,AG/GEN,,,
15633,28-14-0-10-0,6739-80-8106,SNGL FAM SUB,6,AC,94500,0,94500,312200,3100,409800,90300,0,90300,274400,2300,367000,A1,AG/GEN,,,
15634,28-14-0-11-0,6739-80-8561,SNGL FAM SUB,5.8,AC,93400,0,93400,421300,0,514700,89200,0,89200,368900,0,458100,A1,AG/GEN,,,
15635,28-14-0-12-A,6739-80-7903,Cemetery,0,AC,100,0,100,0,0,100,100,0,100,0,0,100,A1,AG/GEN,,,
15636,28-14-0-12-0,6739-80-9804,SNGL FAM SUB,5.78,AC,93300,0,93300,314200,0,407500,89100,0,89100,279900,0,369000,A1,AG/GEN,,,
15637,28-14-0-13-0,6739-81-9117,SNGL FAM SUB,5.97,AC,94300,0,94300,406300,0,500600,90100,0,90100,381100,0,471200,A1,AG/GEN,,,
15638,28-14-0-14-0,6739-81-8486,SNGL FAM SUB,4.43,AC,85900,0,85900,304500,0,390400,82000,0,82000,270200,0,352200,A1,AG/GEN,,,
15639,28-14-0-15-0,6739-81-9714,SNGL FAM SUB,4.11,AC,84100,0,84100,310300,0,394400,80300,0,80300,272100,0,352400,A1,AG/GEN,,,
15640,28-14-0-16-0,6739-92-1159,SNGL FAM SUB,5.48,AC,91600,0,91600,328900,28800,449300,87500,0,87500,289800,24600,401900,A1,AG/GEN,,,
15641,29-1-0-83-A,6749-65-9798,SNGL FAM SUB,18.22,AC,182000,0,182000,0,0,182000,180300,0,180300,0,0,180300,A1,AG/GEN,,,
15642,30-1-0-100-E,6768-27-3720,SNGL FAM SUB,8,AC,132100,0,132100,227400,5500,365000,122700,0,122700,185900,5500,314100,A2,AG/LTD,,,
15643,30-12-0-3-A,6758-99-7319,TAXED -SCC,0.115,AC,0,0,0,0,0,0,0,0,0,0,0,0,M1,INDUS/L,,,
15644,31-1-0-45-E,6769-94-0684,SNGL FAM SUB,6.64,AC,112300,0,112300,235900,1500,349700,101900,0,101900,199600,1500,303000,A2,AG/LTD,,,
15646,31-30-0-2-0,6769-52-6387,SNGL FAM SUB,5.7,AC,115600,0,115600,60400,48800,224800,104000,0,104000,50500,44000,198500,A2,AG/LTD,,,
15647,31-30-0-3-0,6769-62-2524,SNGL FAM SUB,12.43,AC,181900,0,181900,224900,60000,466800,168300,0,168300,186100,56400,410800,A2,AG/LTD,,,
15648,31-30-0-4-0,6769-63-0091,SNGL FAM SUB,2.4,AC,78200,0,78200,267300,23600,369100,70400,0,70400,221200,21100,312700,A2,AG/LTD,,,
15649,31-30-0-5-0,6769-63-1256,SNGL FAM SUB,3.5,AC,91200,0,91200,374800,28200,494200,82400,0,82400,309900,26700,419000,A2,AG/LTD,,,
15650,31-30-0-6-0,6769-62-7821,SNGL FAM SUB,9.16,AC,166000,0,166000,508900,127200,802100,149500,0,149500,422800,110900,683200,A2,AG/LTD,,,
15651,32-16-0-1-0,6779-76-4281,SNGL FAM SUB,4,AC,107300,0,107300,363600,33700,504600,95900,0,95900,298500,30500,424900,A2,AG/LTD,,,
15652,32-16-0-2-0,6779-76-5568,SNGL FAM SUB,4.48,AC,114200,0,114200,418700,25100,558000,102100,0,102100,343300,23000,468400,A2,AG/LTD,,,
15654,32-16-0-3-0,6779-76-8664,SNGL FAM SUB,0.9,AC,13000,0,13000,0,0,13000,11600,0,11600,0,0,11600,A2,AG/LTD,,,
15655,32-16-0-4-0,6779-86-2533,SNGL FAM SUB,2.13,AC,80400,0,80400,323900,1200,405500,71800,0,71800,271200,1200,344200,A2,AG/LTD,,,
15656,32-16-0-5-0,6779-76-9169,SNGL FAM SUB,7.23,AC,138900,0,138900,433900,1500,574300,123900,0,123900,358800,1500,484200,A2,AG/LTD,,,
15657,33-1-0-11-B,6798-23-9399,Cemetery,0,AC,100,0,100,0,0,100,100,0,100,0,0,100,A2,AG/LTD,,,
15680,46-35-0-D-0,7718-10-1126,SNGL FAM SUB,7.9,AC,227600,131700,95900,278900,22700,529200,203300,117800,85500,240800,19200,463300,A2,AG/LTD,,,
15681,46-35-0-E-0,7717-19-8994,SNGL FAM SUB,7.86,AC,213100,117200,95900,337800,1500,552400,190200,104700,85500,294500,1500,486200,A2,AG/LTD,,,
15682,46-35-0-F-0,7717-19-4463,AG 20-100 AC,23.29,AC,484700,380900,103800,152300,19500,656500,432500,340400,92100,127100,19500,579100,A2,AG/LTD,,,
15683,46-35-0-F-1,7717-19-5552,Cemetery,0,AC,100,0,100,0,0,100,100,0,100,0,0,100,A2,AG/LTD,,,
15684,46-35-0-G-0,7717-18-9953,SNGL FAM SUB,14.25,AC,325600,226400,99200,168700,600,494900,290500,202300,88200,141200,600,432300,A2,AG/LTD,,,
15685,46-35-0-H-0,7717-18-9092,AG 20-100 AC,20.73,AC,427800,325900,101900,135500,0,563300,382400,291400,91000,117100,0,499500,A2,AG/LTD,,,
15686,46-36-0-1-0,7707-26-6251,SNGL FAM SUB,2.13,AC,124800,0,124800,0,0,124800,111500,0,111500,0,0,111500,A2,AG/LTD,,,
15687,46-36-0-2-0,7707-26-8576,SNGL FAM SUB,2.14,AC,111700,0,111700,231600,600,343900,99700,0,99700,209900,600,310200,A2,AG/LTD,,,
15688,46-36-0-3-0,7707-26-6623,SNGL FAM SUB,2.01,AC,121400,0,121400,0,0,121400,108400,0,108400,0,0,108400,A2,AG/LTD,,,
15689,46-36-0-4-0,7707-26-4350,SNGL FAM SUB,2.01,AC,122000,0,122000,323600,0,445600,109000,0,109000,272300,0,381300,A2,AG/LTD,,,
15690,47-1-0-43-C1,7726-08-0839,COMM & IND,3.908,AC,1539800,0,1539800,2647300,279200,4466300,1399800,0,1399800,2526100,192000,4117900,B1,BUS/GEN,,,
15691,47-32-0-A-0,7728-30-9289,Roads,2.06,AC,0,0,0,0,0,0,0,0,0,0,0,0,M2,INDUS/G,,,
15692,47-32-0-14-0,7728-40-2921,COMM & IND,2.43,AC,326800,0,326800,324300,49800,700900,311300,0,311300,304000,34300,649600,M2,INDUS/G,,,
15693,47-32-0-15-0,7728-40-1672,COMM & IND,2.61,AC,351000,0,351000,0,63300,414300,334300,0,334300,0,65200,399500,M2,INDUS/G,,,
15694,47-32-0-17-0,7727-49-1959,COMM & IND,2.77,AC,372600,0,372600,0,0,372600,354800,0,354800,0,0,354800,M2,INDUS/G,,,
15695,47-32-0-18-0,7727-49-2563,COMM & IND,4.34,AC,554500,0,554500,0,71300,625800,528200,0,528200,0,72000,600200,M2,INDUS/G,,,
15696,47-32-0-19-0,7727-39-8750,COMM & IND,3.53,AC,474800,0,474800,0,0,474800,452200,0,452200,0,0,452200,M2,INDUS/G,,,
15697,47-32-0-20-0,7728-30-6091,COMM & IND,3.51,AC,428300,0,428300,518200,109000,1055500,407900,0,407900,475000,88300,971200,M2,INDUS/G,,,
15698,47-32-0-21-0,7728-30-5304,COMM & IND,4.42,AC,454800,0,454800,632100,89400,1176300,433100,0,433100,590500,63400,1087000,M2,INDUS/G,,,
15699,47-32-0-22-0,7728-30-5692,COMM & IND,4.4,AC,591800,0,591800,285300,0,877100,563600,0,563600,261200,0,824800,M2,INDUS/G,,,
15700,47-32-0-23-0,7728-30-7973,COMM & IND,3.01,AC,404800,0,404800,168900,34200,607900,385600,0,385600,152900,17000,555500,M2,INDUS/G,,,
15701,51-1-0-55-A,6736-83-9133,AG > 100 AC,191.098,AC,601100,459200,141900,429300,241000,1271400,589300,458200,131100,358500,210800,1158600,A1,AG/GEN,,,
15702,55-1-0-11-A,6776-93-1450,SNGL FAM SUB,2.01,AC,85400,0,85400,163800,4900,254100,76200,0,76200,132500,3600,212300,A2,AG/LTD,,,
15703,55-1-0-11-B,6776-83-9287,SNGL FAM SUB,2.278,AC,89400,0,89400,276200,2000,367600,79900,0,79900,226700,2000,308600,A2,AG/LTD,,,
15704,55-1-0-14-J1,6776-81-6182,State Exmm,0.042,AC,700,0,700,0,0,700,600,0,600,0,0,600,A2,AG/LTD,,,
15705,55-1-0-71-E,6786-62-7590,Cemetery,0.1,AC,100,0,100,0,0,100,100,0,100,0,0,100,A2,AG/LTD,,,
15706,55-1-0-93-B,6785-65-6643,SNGL FAM SUB,6,AC,121600,0,121600,34800,500,156900,108500,0,108500,28200,500,137200,A2,AG/LTD,,,
15707,55-1-0-93-CT,6785-64-9920-9999,SNGL FAM SUB,11.008,AC,230600,0,230600,0,0,230600,216400,0,216400,0,0,216400,A2,AG/LTD,,,
15708,57-1-0-35-F,7705-48-7400,AG 20-100 AC,40.969,AC,1002400,628300,374100,735200,96400,1834000,871100,544700,326400,654600,84300,1610000,A2,AG/LTD,,,
15709,57-1-0-36-A,7705-59-3717,AG 20-100 AC,29.911,AC,797800,693500,104300,0,0,797800,693300,601900,91400,0,0,693300,A2,AG/LTD,,,
15710,57-3-0-2-B2,7706-22-7730,SNGL FAM SUB,4.5,AC,200500,0,200500,317400,16100,534000,174500,0,174500,270100,14500,459100,A2,AG/LTD,,,
15711,57-27-0-K-1,7705-56-0388,Cmn Area/Open Spc,13.104,AC,0,0,0,0,0,0,0,0,0,0,0,0,RR,RES/RUR,,,
15712,57-28-0-1-0,7715-22-1808,SNGL FAM SUB,8.438,AC,360700,0,360700,702600,34500,1097800,313600,0,313600,665300,31000,1009900,RR,RES/RUR,,,
15713,57-28-0-2-0,7715-12-7612,SNGL FAM SUB,6.205,AC,304200,0,304200,369500,800,674500,264500,0,264500,341900,800,607200,RR,RES/RUR,,,
15714,57-28-0-3-0,7715-12-4399,SNGL FAM SUB,7.607,AC,339700,0,339700,463000,0,802700,295400,0,295400,428900,0,724300,RR,RES/RUR,,,
15715,57-28-0-4-0,7715-12-3008,SNGL FAM SUB,10.12,AC,403200,0,403200,531400,23000,957600,350600,0,350600,491800,23000,865400,RR,RES/RUR,,,
15716,57-28-0-6-0,7715-02-7164,SNGL FAM SUB,4.538,AC,264000,0,264000,853400,31900,1149300,240000,0,240000,771200,25700,1036900,RR,RES/RUR,,,
15717,57-28-0-7-0,7715-02-2167,SNGL FAM SUB,4.03,AC,264000,0,264000,615000,28000,907000,240000,0,240000,566600,26000,832600,RR,RES/RUR,,,
15718,57-28-0-11-0,7705-92-8527,SNGL FAM SUB,5.602,AC,264000,0,264000,625700,0,889700,240000,0,240000,578400,0,818400,RR,RES/RUR,,,
15719,57-28-0-12-0,7705-92-4418,SNGL FAM SUB,3.04,AC,264000,0,264000,558700,0,822700,240000,0,240000,537900,0,777900,RR,RES/RUR,,,
15720,57-32-0-A-0,7705-33-8232,Cmn Area/Open Spc,0.327,AC,0,0,0,0,0,0,0,0,0,0,0,0,RR,RES/RUR,,,
15721,57-32-0-B-0,7705-73-2002,Cmn Area/Open Spc,0.808,AC,0,0,0,0,0,0,0,0,0,0,0,0,RR,RES/RUR,,,
15722,57-32-0-C-0,7705-53-4047,Roads,9.784,AC,0,0,0,0,0,0,0,0,0,0,0,0,RR,RES/RUR,,,
15724,57-32-0-2-0,7705-63-8435,SNGL FAM SUB,4.065,AC,432000,0,432000,861900,35200,1329100,360000,0,360000,792700,35200,1187900,RR,RES/RUR,,,
15725,57-32-0-3-0,7705-63-5632,SNGL FAM SUB,5.209,AC,432000,0,432000,566100,62800,1060900,360000,0,360000,537500,59700,957200,RR,RES/RUR,,,
15726,57-32-0-4-0,7705-63-2726,SNGL FAM SUB,6.106,AC,449300,0,449300,636300,0,1085600,374400,0,374400,593800,0,968200,RR,RES/RUR,,,
15727,57-32-0-5-0,7705-53-5360,SNGL FAM SUB,3.526,AC,432000,0,432000,645500,17600,1095100,360000,0,360000,600000,17100,977100,RR,RES/RUR,,,
15728,57-32-0-6-0,7705-53-1189,SNGL FAM SUB,3.883,AC,432000,0,432000,612300,0,1044300,360000,0,360000,580600,0,940600,RR,RES/RUR,,,
15729,57-32-0-7-0,7705-43-7185,SNGL FAM SUB,3.514,AC,432000,0,432000,660400,1000,1093400,360000,0,360000,633100,1000,994100,RR,RES/RUR,,,
15730,57-32-0-8-0,7705-42-9708,SNGL FAM SUB,4.166,AC,432000,0,432000,1051400,0,1483400,360000,0,360000,970200,0,1330200,RR,RES/RUR,,,
15731,57-32-0-9-0,7705-42-6551,SNGL FAM SUB,4.159,AC,432000,0,432000,902800,0,1334800,360000,0,360000,847700,0,1207700,RR,RES/RUR,,,
15732,57-32-0-10-0,7705-42-3606,SNGL FAM SUB,4.05,AC,432000,0,432000,794600,27700,1254300,360000,0,360000,756900,26400,1143300,RR,RES/RUR,,,
15733,57-32-0-11-0,7705-43-3169,SNGL FAM SUB,3.387,AC,432000,0,432000,817000,29800,1278800,360000,0,360000,766600,27900,1154500,RR,RES/RUR,,,
15734,57-32-0-12-0,7705-43-0088,SNGL FAM SUB,3.758,AC,432000,0,432000,0,0,432000,360000,0,360000,0,0,360000,RR,RES/RUR,,,
15735,57-32-0-13-0,7705-32-8658,SNGL FAM SUB,4.733,AC,432000,0,432000,1169200,150000,1751200,360000,0,360000,1137500,136400,1633900,RR,RES/RUR,,,
15736,57-32-0-14-0,7705-32-5962,SNGL FAM SUB,3.896,AC,570000,0,570000,0,0,570000,520000,0,520000,0,0,520000,RR,RES/RUR,,,
15737,57-32-0-15-0,7705-33-2170,SNGL FAM SUB,5.663,AC,592800,0,592800,1310000,76900,1979700,540800,0,540800,1155000,70800,1766600,RR,RES/RUR,,,
15738,57-32-0-16-0,7705-33-4401,SNGL FAM SUB,3.944,AC,592800,0,592800,1544500,113100,2250400,540800,0,540800,1380700,105200,2026700,RR,RES/RUR,,,
15739,57-32-0-17-0,7705-33-6635,SNGL FAM SUB,3.93,AC,570000,0,570000,1570100,39200,2179300,520000,0,520000,1480200,38000,2038200,RR,RES/RUR,,,
15740,57-32-0-18-0,7705-33-8813,SNGL FAM SUB,4.906,AC,570000,0,570000,1269500,20200,1859700,520000,0,520000,1134000,20700,1674700,RR,RES/RUR,,,
15741,57-32-0-19-0,7705-43-1762,SNGL FAM SUB,3.353,AC,432000,0,432000,514900,29400,976300,360000,0,360000,479300,29000,868300,RR,RES/RUR,,,
15742,57-32-0-20-0,7705-43-4790,SNGL FAM SUB,3.345,AC,432000,0,432000,765500,0,1197500,360000,0,360000,722600,0,1082600,RR,RES/RUR,,,
15743,57-32-0-21-0,7705-44-2086,SNGL FAM SUB,3.128,AC,432000,0,432000,613600,18000,1063600,360000,0,360000,589800,15700,965500,RR,RES/RUR,,,
15744,57-32-0-22-0,7705-34-8286,SNGL FAM SUB,4.059,AC,570000,0,570000,1460400,21000,2051400,520000,0,520000,1301700,21900,1843600,RR,RES/RUR,,,
15745,57-32-0-23-0,7705-44-0535,SNGL FAM SUB,3.349,AC,592800,0,592800,1061700,0,1654500,540800,0,540800,965300,0,1506100,RR,RES/RUR,,,
15746,57-32-0-24-0,7705-44-4559,SNGL FAM SUB,4.237,AC,570000,0,570000,832300,0,1402300,520000,0,520000,697000,0,1217000,RR,RES/RUR,,,
15747,57-32-0-25-0,7705-44-7303,SNGL FAM SUB,4.507,AC,449300,0,449300,1268200,19200,1736700,374400,0,374400,1223400,17500,1615300,RR,RES/RUR,,,
15748,57-32-0-26-0,7705-43-8782,SNGL FAM SUB,6.449,AC,449300,0,449300,892600,30600,1372500,374400,0,374400,860900,29100,1264400,RR,RES/RUR,,,
15751,58-31-0-3-0,7715-65-9740,Cmn Area/Open Spc,72.406,AC,0,0,0,0,0,0,0,0,0,0,0,0,RPUD,RES/PUD,,,
15752,58-31-0-4-0,7715-74-9365,COMM & IND,269.029,AC,7565100,0,7565100,6113800,2596400,16275300,7002800,0,7002800,5949700,2446300,15398800,RPUD,RES/PUD,,,
15753,58-31-0-5-0,7725-06-4043,Cemetery,0,AC,100,0,100,0,0,100,100,0,100,0,0,100,RPUD,RES/PUD,,,
15754,61-2-0-A-1,6795-21-0670,SNGL FAM SUB,8,AC,3700,0,3700,0,0,3700,3400,0,3400,0,0,3400,A2,AG/LTD,,,
15755,61-3-0-K-0,6794-48-7763,AG 20-100 AC,46.99,AC,21700,0,21700,0,0,21700,20000,0,20000,0,0,20000,A2,AG/LTD,,,
15756,61-8-0-A-0,6795-70-4015,Roads,2.068,AC,0,0,0,0,0,0,0,0,0,0,0,0,RR,RES/RUR,,,
15757,61-8-0-B-0,6795-80-7692,Roads,0.829,AC,0,0,0,0,0,0,0,0,0,0,0,0,RR,RES/RUR,,,
15758,61-8-0-27-0,6795-81-6225,SNGL FAM SUB,16.898,AC,662600,0,662600,661700,1000,1325300,576500,0,576500,658000,1000,1235500,RR,RES/RUR,,,
15759,61-8-0-30-0,6795-70-0050,AG 20-100 AC,20.532,AC,651800,0,651800,125000,800,777600,567200,0,567200,124800,800,692800,RR,RES/RUR,,,
15760,61-8-0-31-0,6795-70-7341,SNGL FAM SUB,11.365,AC,468000,0,468000,1616200,3000,2087200,407100,0,407100,1619500,3000,2029600,RR,RES/RUR,,,
15761,62-1-0-1-0,7704-18-7419,AG 20-100 AC,26.445,AC,542800,0,542800,869000,0,1411800,472100,0,472100,738900,0,1211000,RR,RES/RUR,,,
15763,62-34-0-5-0,7715-01-9675,SNGL FAM SUB,10.408,AC,410500,0,410500,865000,0,1275500,357000,0,357000,792500,0,1149500,RR,RES/RUR,,,
15764,62-34-0-8-0,7715-01-2860,SNGL FAM SUB,3.642,AC,261300,0,261300,502900,0,764200,237500,0,237500,458200,0,695700,RR,RES/RUR,,,
15765,62-34-0-9-0,7705-91-7869,SNGL FAM SUB,3.895,AC,261300,0,261300,627600,36500,925400,237500,0,237500,581500,34400,853400,RR,RES/RUR,,,
15766,62-34-0-10-0,7705-92-8200,SNGL FAM SUB,4.385,AC,261300,0,261300,470900,58400,790600,237500,0,237500,433100,49400,720000,RR,RES/RUR,,,
15767,62-34-0-13-0,7705-92-2145,SNGL FAM SUB,3.414,AC,261300,0,261300,697000,2000,960300,237500,0,237500,652400,2000,891900,RR,RES/RUR,,,
15768,64-24-0-61-0,7733-57-1309,SNGL FAM URB,0.471,AC,230000,0,230000,591900,0,821900,200000,0,200000,544900,0,744900,RPUD,RES/PUD,,,
15769,64-24-0-62-0,7733-57-0296,SNGL FAM URB,0.445,AC,230000,0,230000,557800,0,787800,200000,0,200000,516500,0,716500,RPUD,RES/PUD,,,
15770,64-24-0-63-0,7733-57-1189,SNGL FAM URB,0.477,AC,230000,0,230000,547100,0,777100,200000,0,200000,495600,0,695600,RPUD,RES/PUD,,,
15771,64-24-0-88-0,7733-57-0517,SNGL FAM URB,0.351,AC,230000,0,230000,623200,0,853200,200000,0,200000,580000,0,780000,RPUD,RES/PUD,,,
15772,64-24-0-89-0,7733-47-9512,SNGL FAM URB,0.587,AC,230000,0,230000,710700,0,940700,200000,0,200000,659700,0,859700,RPUD,RES/PUD,,,
15773,64-24-0-90-0,7733-47-9308,SNGL FAM URB,0.352,AC,230000,0,230000,525500,0,755500,200000,0,200000,486500,0,686500,RPUD,RES/PUD,,,
15774,64-24-0-91-0,7733-47-8298,SNGL FAM URB,0.356,AC,230000,0,230000,766400,0,996400,200000,0,200000,711300,0,911300,RPUD,RES/PUD,,,
15776,67-26-0-B-0,7733-56-0927,Roads,0.38,AC,0,0,0,0,0,0,0,0,0,0,0,0,RPUD,RES/PUD,,,
15777,67-26-0-A-0,7733-47-9051,Cmn Area/Open Spc,13.461,AC,0,0,0,0,0,0,0,0,0,0,0,0,RPUD,RES/PUD,,,
15778,67-26-0-64-0,7733-57-3187,SNGL FAM URB,0.563,AC,230000,0,230000,775600,0,1005600,200000,0,200000,709700,0,909700,RPUD,RES/PUD,,,
15780,67-26-0-66-0,7733-57-5144,SNGL FAM URB,0.569,AC,230000,0,230000,622700,0,852700,200000,0,200000,572400,0,772400,RPUD,RES/PUD,,,
15781,67-26-0-67-0,7733-57-6067,SNGL FAM URB,0.392,AC,230000,0,230000,813700,0,1043700,200000,0,200000,747300,0,947300,RPUD,RES/PUD,,,
15782,67-26-0-68-0,7733-56-7938,SNGL FAM URB,0.362,AC,230000,0,230000,574600,8300,812900,200000,0,200000,528200,8500,736700,RPUD,RES/PUD,,,
15783,67-26-0-69-0,7733-56-7898,SNGL FAM URB,0.362,AC,230000,0,230000,608300,0,838300,200000,0,200000,562700,0,762700,RPUD,RES/PUD,,,
15784,67-26-0-92-0,7733-47-9117,SNGL FAM URB,0.452,AC,230000,0,230000,769800,35700,1035500,200000,0,200000,700500,33900,934400,RPUD,RES/PUD,,,
15785,67-26-0-93-0,7733-47-9017,SNGL FAM URB,0.505,AC,230000,0,230000,538300,0,768300,200000,0,200000,497300,0,697300,RPUD,RES/PUD,,,
15786,67-26-0-94-0,7733-46-8986,SNGL FAM URB,0.387,AC,230000,0,230000,837500,0,1067500,200000,0,200000,789500,0,989500,RPUD,RES/PUD,,,
15787,67-26-0-95-0,7733-46-8881,SNGL FAM URB,0.743,AC,230000,0,230000,694000,0,924000,200000,0,200000,649900,0,849900,RPUD,RES/PUD,,,
15788,67-26-0-96-0,7733-56-0736,SNGL FAM URB,0.867,AC,230000,0,230000,720400,0,950400,200000,0,200000,668900,0,868900,RPUD,RES/PUD,,,
15789,67-26-0-97-0,7733-56-1847,SNGL FAM URB,0.493,AC,230000,0,230000,821200,6400,1057600,200000,0,200000,761500,5600,967100,RPUD,RES/PUD,,,
15790,67-26-0-98-0,7733-57-1040,SNGL FAM URB,0.529,AC,230000,0,230000,756700,0,986700,200000,0,200000,697000,0,897000,RPUD,RES/PUD,,,
15791,67-26-0-99-0,7733-56-3947,SNGL FAM URB,0.351,AC,230000,0,230000,663200,0,893200,200000,0,200000,611000,0,811000,RPUD,RES/PUD,,,
15792,67-26-0-100-0,7733-56-4957,SNGL FAM URB,0.393,AC,230000,0,230000,754400,0,984400,200000,0,200000,693500,0,893500,RPUD,RES/PUD,,,
15793,67-26-0-101-0,7733-56-5941,SNGL FAM URB,0.348,AC,230000,0,230000,690600,0,920600,200000,0,200000,637600,0,837600,RPUD,RES/PUD,,,
15794,67-26-0-102-0,7733-56-5892,SNGL FAM URB,0.362,AC,230000,0,230000,766400,0,996400,200000,0,200000,705600,0,905600,RPUD,RES/PUD,,,
15795,62-34-0-14-0,7705-82-8195,SNGL FAM SUB,4.483,AC,275000,0,275000,586400,115800,977200,250000,0,250000,547400,104200,901600,RR,RES/RUR,,,
15798,63-7-0-C-1A,7723-17-2667,SNGL FAM SUB,7,AC,336600,0,336600,534600,3100,874300,292600,0,292600,491400,3200,787200,A2,AG/LTD,,,
15800,4-1-0-46-C1,6803-96-7905,SNGL FAM SUB,2.07,AC,45200,0,45200,155400,38400,239000,44400,0,44400,135100,32400,211900,A1,AG/GEN,,,
15801,5-1-0-31-A,6813-82-6591,SNGL FAM SUB,4.42,AC,57100,0,57100,139600,6000,202700,56100,0,56100,121700,4100,181900,A1,AG/GEN,,,
15802,5-1-0-49-A,6823-34-1607,SNGL FAM SUB,2.112,AC,38500,0,38500,86100,2500,127100,37900,0,37900,71600,1700,111200,A1,AG/GEN,,,
15803,11-1-0-39-E,6821-67-5611,SNGL FAM SUB,3.9,AC,57100,0,57100,177000,1300,235400,55400,0,55400,140800,0,196200,A1,AG/GEN,,,
15804,12-1-0-40-A,6831-33-7829,SNGL FAM SUB,2.138,AC,52600,0,52600,166300,800,219700,51800,0,51800,116600,800,169200,A1,AG/GEN,,,
15805,43-1-0-65-B,6777-69-0319,AG 20-100 AC,32.91,AC,411400,263800,147600,0,0,411400,368600,303400,65200,0,0,368600,A2,AG/LTD,,,
15807,43-10-0-B-3,6767-66-4143,SNGL FAM SUB,2.01,AC,44700,0,44700,0,0,44700,39900,0,39900,0,0,39900,A2,AG/LTD,,,
15808,33-7-0-16-A,6798-25-9135,COMM & IND,0.071,AC,11200,0,11200,0,0,11200,10600,0,10600,0,0,10600,M1,INDUS/L,,,
15809,26-15-0-A-0,6708-86-5614,SNGL FAM SUB,13.698,AC,109900,0,109900,123300,2000,235200,107800,0,107800,98400,2000,208200,A1,AG/GEN,,,
15810,26-15-0-B-0,6708-96-0774,SNGL FAM SUB,12.95,AC,105700,0,105700,0,0,105700,103700,0,103700,0,0,103700,A1,AG/GEN,,,
15811,26-15-0-C-0,6708-96-5524,SNGL FAM SUB,5,AC,61200,0,61200,128300,4500,194000,60000,0,60000,103000,4800,167800,A1,AG/GEN,,,
15812,26-15-0-D-0,6718-06-1523,AG 20-100 AC,22,AC,135400,0,135400,81700,2400,219500,132500,0,132500,66600,2500,201600,A1,AG/GEN,,,
15813,29-5-0-2-E2,6749-74-3685,SNGL FAM SUB,3,AC,73600,0,73600,121000,0,194600,69700,0,69700,95400,0,165100,A1,AG/GEN,,,
15814,13-1-0-57-A,6841-18-3782,SNGL FAM SUB,2.52,AC,55600,0,55600,21000,2000,78600,54700,0,54700,24200,2000,80900,A1,AG/GEN,,,
15815,19-1-0-40-C,6831-52-4181,SNGL FAM SUB,3.224,AC,66100,0,66100,133500,4200,203800,61200,0,61200,110400,2400,174000,A1,AG/GEN,,,
15816,20-1-0-66-A,6850-18-1808,SNGL FAM SUB,2.14,AC,59800,0,59800,218000,0,277800,58700,0,58700,193300,0,252000,A1,AG/GEN,,,
15817,47-1-0-91-E,7726-39-3561,AG 20-100 AC,26.58,AC,431400,0,431400,15600,18200,465200,384700,0,384700,0,0,384700,A2,AG/LTD,,,
15818,55-2-0-10-0,6785-35-7956,SNGL FAM SUB,1.136,AC,72300,0,72300,242600,1500,316400,64600,0,64600,204400,1500,270500,R1,RES/LTD,,,
15819,56-16-0-19-0,6795-72-5673,AG 20-100 AC,37.586,AC,950200,0,950200,1311600,0,2261800,827100,0,827100,1269300,0,2096400,RR,RES/RUR,,,
15820,57-32-0-1-0,7705-73-0197,SNGL FAM SUB,5.225,AC,432000,0,432000,758100,0,1190100,360000,0,360000,715200,0,1075200,RR,RES/RUR,,,
15821,28-14-0-9-0,6738-99-0757,SNGL FAM SUB,8.31,AC,107200,0,107200,464000,6100,577300,102400,0,102400,391800,6500,500700,A1,AG/GEN,,,
15824,29-1-0-26-0,6748-32-4557,SNGL FAM SUB,19.35,AC,202300,192400,9900,0,28700,231000,183900,175600,8300,0,27100,211000,A1,AG/GEN,,,
15825,20-20-0-30-0,6840-23-9877,SNGL FAM SUB,3.55,AC,69700,0,69700,196700,2000,268400,67000,0,67000,176600,2100,245700,A1,AG/GEN,,,
15826,20-20-0-31-0,6840-23-3706,SNGL FAM SUB,3.66,AC,69700,0,69700,250300,1600,321600,67000,0,67000,223900,1700,292600,A1,AG/GEN,,,
15839,20-20-0-11-0,6840-32-4231,SNGL FAM SUB,2.38,AC,62700,0,62700,211400,3100,277200,60300,0,60300,188900,2600,251800,A1,AG/GEN,,,
15840,20-20-0-12-0,6840-32-5472,SNGL FAM SUB,2,AC,60800,0,60800,195100,3400,259300,58500,0,58500,176400,2600,237500,A1,AG/GEN,,,
15841,20-20-0-13-0,6840-32-4639,SNGL FAM SUB,3,AC,69700,0,69700,237600,0,307300,67000,0,67000,214400,0,281400,A1,AG/GEN,,,
15842,20-20-0-14-0,6840-32-2859,SNGL FAM SUB,3.5,AC,69700,0,69700,245000,500,315200,67000,0,67000,219600,500,287100,A1,AG/GEN,,,
15843,20-20-0-15-0,6840-33-3284,SNGL FAM SUB,4.29,AC,69700,0,69700,274300,0,344000,67000,0,67000,244600,0,311600,A1,AG/GEN,,,
15844,20-20-0-16-0,6840-33-3853,SNGL FAM SUB,6.66,AC,86100,0,86100,231200,1400,318700,82800,0,82800,208800,1400,293000,A1,AG/GEN,,,
15845,20-20-0-17-0,6840-34-8096,SNGL FAM SUB,3.75,AC,69700,0,69700,408600,0,478300,67000,0,67000,361100,0,428100,A1,AG/GEN,,,
15846,20-20-0-17-A,6840-34-6000,Cemetery,0,AC,100,0,100,0,0,100,100,0,100,0,0,100,A1,AG/GEN,,,
15847,20-20-0-18-0,6840-34-9352,SNGL FAM SUB,3.55,AC,69700,0,69700,260100,0,329800,67000,0,67000,231000,0,298000,A1,AG/GEN,,,
15848,20-20-0-19-0,6840-34-9559,SNGL FAM SUB,4.44,AC,74900,0,74900,187600,37500,300000,72000,0,72000,167900,35600,275500,A1,AG/GEN,,,
15849,20-20-0-20-0,6840-34-9806,SNGL FAM SUB,5.12,AC,78600,0,78600,310300,0,388900,75600,0,75600,274700,0,350300,A1,AG/GEN,,,
15850,20-20-0-21-0,6840-45-0077,SNGL FAM SUB,4.15,AC,74900,0,74900,280300,0,355200,72000,0,72000,250600,0,322600,A1,AG/GEN,,,
15851,20-20-0-22-0,6840-34-4533,SNGL FAM SUB,7.2,AC,86100,0,86100,258400,0,344500,82800,0,82800,231600,0,314400,A1,AG/GEN,,,
15852,20-20-0-23-0,6840-34-0442,SNGL FAM SUB,4.26,AC,69700,0,69700,218700,2700,291100,67000,0,67000,195100,2800,264900,A1,AG/GEN,,,
15853,20-20-0-24-0,6840-25-6082,SNGL FAM SUB,11.39,AC,104900,0,104900,222600,500,328000,100800,0,100800,199000,500,300300,A1,AG/GEN,,,
15854,20-20-0-25-0,6840-24-7432,SNGL FAM SUB,3.18,AC,69700,0,69700,224500,12200,306400,67000,0,67000,202000,11200,280200,A1,AG/GEN,,,
15855,20-20-0-26-0,6840-24-4456,SNGL FAM SUB,3.1,AC,69700,0,69700,179000,1400,250100,67000,0,67000,158600,1400,227000,A1,AG/GEN,,,
15856,20-20-0-27-0,6840-14-9234,SNGL FAM SUB,8.89,AC,89900,0,89900,251200,0,341100,86400,0,86400,224100,0,310500,A1,AG/GEN,,,
15857,20-20-0-28-0,6840-24-3007,SNGL FAM SUB,3.37,AC,69700,0,69700,263200,40100,373000,67000,0,67000,238100,34500,339600,A1,AG/GEN,,,
15858,20-20-0-29-0,6840-23-6966,SNGL FAM SUB,3.51,AC,69700,0,69700,209700,29400,308800,67000,0,67000,188200,25900,281100,A1,AG/GEN,,,
15859,10-1-0-3-A,6802-76-5180,SNGL FAM SUB,2.884,AC,49500,9700,39800,190300,4500,244300,48400,9600,38800,170100,4500,223000,A1,AG/GEN,,,
15860,26-2-0-3-K1,6709-72-7080,SNGL FAM SUB,3.39,AC,54200,0,54200,211500,0,265700,52300,0,52300,184100,0,236400,RR,RES/RUR,,,
15862,27-1-0-67-C,6728-59-3284,SNGL FAM SUB,11.15,AC,95600,0,95600,0,0,95600,93800,0,93800,0,0,93800,A1,AG/GEN,,,
15863,27-1-0-67-D,6728-58-3628,SNGL FAM SUB,11.15,AC,95600,0,95600,0,0,95600,93800,0,93800,0,0,93800,A1,AG/GEN,,,
15864,27-1-0-67-E,6728-58-4126,SNGL FAM SUB,11.15,AC,95600,0,95600,0,0,95600,93800,0,93800,0,0,93800,A1,AG/GEN,,,
15865,30-1-0-26-A,6758-39-2271,AG 20-100 AC,29,AC,242400,173800,68600,0,0,242400,240700,173200,67500,0,0,240700,A1A2,AG GEN/,,,
15866,46-35-0-B-1,7718-10-3463,SNGL FAM SUB,2.25,AC,120200,0,120200,235500,500,356200,107300,0,107300,214100,500,321900,A2,AG/LTD,,,
15867,42-1-0-119-C,6766-39-4072,SNGL FAM SUB,10,AC,222600,0,222600,551000,115900,889500,198900,0,198900,448200,40700,687800,A2,AG/LTD,,,
15868,48-13-0-A-2,7727-60-5199,SNGL FAM SUB,2.8,AC,140400,0,140400,0,0,140400,125400,0,125400,0,0,125400,A2,AG/LTD,,,
15870,4-1-0-25-C,6803-62-4075,SNGL FAM SUB,4.48,AC,58600,0,58600,198000,8000,264600,57100,0,57100,175600,8000,240700,A1,AG/GEN,,,
15871,4-10-0-Y-0,6803-49-0008,SNGL FAM SUB,4,AC,51000,0,51000,0,0,51000,50100,0,50100,0,0,50100,A1,AG/GEN,,,
15872,26-1-0-57-F,6719-43-4157,AG 20-100 AC,59,AC,182900,155700,27200,0,0,182900,177000,151900,25100,0,0,177000,A1,AG/GEN,,,
15875,5-25-0-B-0,6823-60-9320,Cmn Area/Open Spc,1.941,AC,0,0,0,0,0,0,0,0,0,0,0,0,RR,RES/RUR,,,
15876,5-25-0-1-0,6822-79-6985,SNGL FAM SUB,7.481,AC,76000,0,76000,261200,0,337200,72000,0,72000,226900,0,298900,RR,RES/RUR,,,
15877,5-25-0-2-0,6822-79-1687,SNGL FAM SUB,5.075,AC,76000,0,76000,288100,5800,369900,69000,0,69000,274400,4000,347400,RR,RES/RUR,,,
15878,5-25-0-3-0,6822-68-8541,SNGL FAM SUB,7.807,AC,76000,0,76000,311400,1700,389100,76000,0,76000,249100,1900,327000,RR,RES/RUR,,,
15880,5-25-0-5-0,6822-57-7764,SNGL FAM SUB,11.789,AC,95000,0,95000,708400,91300,894700,95000,0,95000,621100,96700,812800,RR,RES/RUR,,,
15881,5-25-0-6-0,6822-57-1945,SNGL FAM SUB,6.219,AC,76000,0,76000,336700,3700,416400,76000,0,76000,280500,4000,360500,RR,RES/RUR,,,
15882,5-25-0-7-0,6822-47-8222,SNGL FAM SUB,5.363,AC,76000,0,76000,615500,0,691500,76000,0,76000,508800,0,584800,RR,RES/RUR,,,
15883,5-25-0-8-0,6822-47-5246,SNGL FAM SUB,5.25,AC,76000,0,76000,521600,24700,622300,76000,0,76000,457300,20200,553500,RR,RES/RUR,,,
15884,5-25-0-9-0,6822-47-1360,SNGL FAM SUB,8.393,AC,79800,0,79800,0,0,79800,79800,0,79800,0,0,79800,RR,RES/RUR,,,
15885,5-25-0-10-0,6822-47-6868,SNGL FAM SUB,5.116,AC,76000,0,76000,0,0,76000,76000,0,76000,0,0,76000,RR,RES/RUR,,,
15886,5-25-0-45-0,6822-49-6116,SNGL FAM SUB,8.99,AC,76000,0,76000,341700,0,417700,76000,0,76000,288600,0,364600,RR,RES/RUR,,,
15887,5-25-0-46-0,6822-58-2500,SNGL FAM SUB,5.165,AC,76000,0,76000,373700,5500,455200,76000,0,76000,311200,5000,392200,RR,RES/RUR,,,
15888,5-25-0-46-A,6822-48-9471,Cemetery,0,AC,100,0,100,0,0,100,100,0,100,0,0,100,RR,RES/RUR,,,
15889,5-25-0-46-B,6822-58-2348,Cemetery,0,AC,100,0,100,0,0,100,100,0,100,0,0,100,RR,RES/RUR,,,
15890,5-25-0-47-0,6823-60-7078,SNGL FAM SUB,5.057,AC,76000,0,76000,606800,0,682800,76000,0,76000,505900,0,581900,RR,RES/RUR,,,
15891,5-25-0-48-0,6823-60-0069,SNGL FAM SUB,5.306,AC,76000,0,76000,0,0,76000,76000,0,76000,0,0,76000,RR,RES/RUR,,,
15892,5-25-0-49-0,6823-50-5293,SNGL FAM SUB,6.087,AC,76000,0,76000,734200,0,810200,76000,0,76000,633500,0,709500,RR,RES/RUR,,,
15894,63-11-0-A-5A,7714-57-0934,SNGL FAM SUB,2,AC,142000,0,142000,580600,0,722600,123500,0,123500,492200,0,615700,A2,AG/LTD,,,
15897,17-1-0-84-B,6719-09-3011,SNGL FAM SUB,3.45,AC,54600,0,54600,134000,1500,190100,51500,0,51500,103200,1500,156200,A1,AG/GEN,,,
15898,17-1-0-84-C,6719-09-3350,SNGL FAM SUB,2.5,AC,49000,0,49000,0,0,49000,46300,0,46300,0,0,46300,A1,AG/GEN,,,
15899,58-1-0-50-D,7715-63-2078,SNGL FAM SUB,2.5,AC,131800,0,131800,92400,200,224400,114700,0,114700,74600,200,189500,A2,AG/LTD,,,
15901,13-12-0-C-1,6841-88-8652,SNGL FAM SUB,3.5,AC,71600,0,71600,227400,25700,324700,70300,0,70300,208400,23000,301700,A1,AG/GEN,,,
15902,13-12-0-C-2,6841-88-8923,SNGL FAM SUB,3.5,AC,71600,0,71600,180300,27300,279200,70300,0,70300,157000,23700,251000,A1,AG/GEN,,,
15903,27-5-0-3-D,6728-77-2192,SNGL FAM SUB,4.21,AC,60000,0,60000,226400,0,286400,58900,0,58900,188400,0,247300,A1,AG/GEN,,,
15904,42-1-0-119-B1,6766-39-3445,SNGL FAM SUB,2.51,AC,92900,0,92900,317900,10100,420900,83000,0,83000,261600,10100,354700,A2,AG/LTD,,,
15905,42-1-0-119-B2,6766-39-7213,SNGL FAM SUB,2,AC,85200,0,85200,309100,800,395100,76100,0,76100,257000,800,333900,A2,AG/LTD,,,
15906,47-1-0-13-A,7716-49-4548,SNGL FAM SUB,5.904,AC,248600,0,248600,0,0,248600,221800,0,221800,0,0,221800,A2,AG/LTD,,,
15907,47-3-0-A-1,7727-16-5329,MINERALS,0,AC,0,0,0,100,0,100,0,0,0,772900,0,772900,A2,AG/LTD,,,
15908,46-37-0-1-0,7717-13-6440,SNGL FAM SUB,7.07,AC,199200,0,199200,468000,36300,703500,177800,0,177800,392900,35600,606300,A2,AG/LTD,,,
15909,46-37-0-2-0,7717-23-1640,SNGL FAM SUB,3.43,AC,135200,0,135200,283400,72900,491500,120700,0,120700,237200,62200,420100,A2,AG/LTD,,,
15910,46-37-0-3-0,7717-23-1350,SNGL FAM SUB,3.89,AC,143300,0,143300,268700,192400,604400,127900,0,127900,222500,173900,524300,A2,AG/LTD,,,
15911,46-37-0-4-0,7717-13-9090,SNGL FAM SUB,5.22,AC,166700,0,166700,278300,2600,447600,148800,0,148800,248000,2600,399400,A2,AG/LTD,,,
15913,46-37-0-6-0,7717-22-1485,SNGL FAM SUB,3.87,AC,142900,0,142900,234400,1500,378800,127600,0,127600,208400,1500,337500,A2,AG/LTD,,,
15914,33-10-0-4-0,6798-95-6185,SNGL FAM SUB,4.836,AC,125300,49100,76200,185300,6600,317200,112100,44100,68000,153000,6600,271700,A2,AG/LTD,,,
15915,18-6-0-8-A,6820-18-3619,SNGL FAM SUB,3.35,AC,52000,0,52000,0,0,52000,50900,0,50900,0,0,50900,A1,AG/GEN,,,
15917,63-1-0-114-E,7715-51-6769,SNGL FAM SUB,3.15,AC,145400,0,145400,86900,0,232300,126400,0,126400,70400,0,196800,A2,AG/LTD,,,
15918,4-1-0-43-D1,6813-19-1359,SNGL FAM SUB,1,AC,39700,0,39700,85400,1500,126600,39000,0,39000,73000,1500,113500,A1,AG/GEN,,,
15919,5-6-0-B-0,6813-66-8505,SNGL FAM SUB,4.22,AC,47700,0,47700,0,0,47700,46900,0,46900,0,0,46900,A1,AG/GEN,,,
15920,20-20-0-3-0,6840-13-3150,SNGL FAM SUB,9.05,AC,89900,0,89900,274400,29100,393400,86400,0,86400,251800,28400,366600,A1,AG/GEN,,,
15922,38-1-0-39-0,6707-54-1494,AG 20-100 AC,22.601,AC,127400,117000,10400,0,0,127400,124400,114800,9600,0,0,124400,A1,AG/GEN,,,
15923,45-18-0-23-0,6797-23-6304,SNGL FAM SUB,5.188,AC,200000,0,200000,500300,1900,702200,180000,0,180000,453600,2000,635600,A2,AG/LTD,,,
15924,58-4-B-8-0,7716-46-9018,SNGL FAM SUB,1.1,AC,92400,0,92400,175500,900,268800,84000,0,84000,145900,900,230800,A2,AG/LTD,,,
15925,63-21-0-1-B,7715-81-9657,SNGL FAM SUB,10.5,AC,316500,0,316500,0,0,316500,274800,0,274800,0,0,274800,A2,AG/LTD,,,
15927,3-4-0-A-0,5893-90-9468,SNGL FAM SUB,0.818,AC,2900,0,2900,0,0,2900,2900,0,2900,0,0,2900,A1,AG/GEN,,,
15928,3-4-0-1-0,5893-90-8067,SNGL FAM SUB,14.885,AC,81700,0,81700,102600,1000,185300,86600,0,86600,84000,1000,171600,A1,AG/GEN,,,
15929,3-4-0-2-0,5892-99-8400,AG 20-100 AC,21,AC,95300,0,95300,389900,0,485200,98000,0,98000,338000,0,436000,A1,AG/GEN,,,
15930,3-4-0-3-0,5892-98-6817,AG 20-100 AC,22.693,AC,99600,44700,54900,0,11600,111200,103100,51500,51600,0,10200,113300,A1,AG/GEN,,,
15931,3-4-0-4-0,5892-98-2458,AG 20-100 AC,21,AC,95300,0,95300,142300,3000,240600,98000,0,98000,126300,3000,227300,A1,AG/GEN,,,
15932,3-4-0-5-0,5892-88-6014,SNGL FAM SUB,11.268,AC,75500,0,75500,303500,1200,380200,73900,0,73900,264800,1200,339900,A1,AG/GEN,,,
15933,3-4-0-6-0,5892-97-1217,AG 20-100 AC,30.939,AC,108000,0,108000,193200,17200,318400,132300,0,132300,171300,7900,311500,A1,AG/GEN,,,
15934,6-1-0-12-B,6823-84-6068,SNGL FAM SUB,4,AC,55000,0,55000,165100,4000,224100,54000,0,54000,144200,4000,202200,A1,AG/GEN,,,
15935,20-1-0-97-A,6759-07-4636,SNGL FAM SUB,2,AC,64000,0,64000,205500,18700,288200,59800,0,59800,169200,14900,243900,A1,AG/GEN,,,
15936,26-15-0-D-1,6718-06-5713,SNGL FAM SUB,3.89,AC,55000,0,55000,46700,600,102300,53900,0,53900,49200,600,103700,A1,AG/GEN,,,
15937,32-4-0-3-B,6779-65-3938,SNGL FAM SUB,2.46,AC,85100,0,85100,0,0,85100,76000,0,76000,0,0,76000,A2,AG/LTD,,,
15938,40-1-0-1-0,6727-86-3934,AG > 100 AC,157,AC,480400,408000,72400,0,0,480400,471000,404300,66700,0,0,471000,A1,AG/GEN,,,
15939,40-1-0-29-G1,6737-44-6457,AG 20-100 AC,24.93,AC,160700,149200,11500,0,0,160700,157700,147100,10600,0,0,157700,A1,AG/GEN,,,
15940,42-1-0-8-A1,6757-18-5181,AG 20-100 AC,21.04,AC,262800,253100,9700,0,0,262800,238300,229400,8900,0,0,238300,A2,AG/LTD,,,
15941,42-1-0-8-A2,6757-27-1870,AG 20-100 AC,21.62,AC,267800,257800,10000,0,0,267800,243700,234500,9200,0,0,243700,A2,AG/LTD,,,
15942,42-1-0-8-A3,6757-27-8541,AG 20-100 AC,37.73,AC,357300,339900,17400,0,0,357300,321700,305700,16000,0,0,321700,A2,AG/LTD,,,
15943,42-1-0-8-A4,6757-37-7358,AG 20-100 AC,45.03,AC,425500,404700,20800,0,0,425500,390300,371200,19100,0,0,390300,A2,AG/LTD,,,
15944,45-1-0-8-A,6797-19-5984,SNGL FAM SUB,2.49,AC,91600,0,91600,170700,0,262300,81800,0,81800,139600,0,221400,A2,AG/LTD,,,
15949,57-1-0-45-D1,7715-14-9269,SNGL FAM SUB,0.06,AC,1800,0,1800,0,0,1800,1500,0,1500,0,0,1500,A2,AG/LTD,,,
15950,58-7-0-3-A,7716-64-2309,SNGL FAM SUB,2.25,AC,133900,0,133900,385200,0,519100,116400,0,116400,325900,0,442300,A2,AG/LTD,,,
15951,58-7-0-3-B,7716-64-4462,SNGL FAM SUB,2,AC,128800,0,128800,0,0,128800,112000,0,112000,0,0,112000,A2,AG/LTD,,,
15954,12-1-0-12-A,6832-04-4536,AG 20-100 AC,26.21,AC,156500,143400,13100,0,0,156500,153000,141800,11200,0,0,153000,A1,AG/GEN,,,
15955,12-1-0-12-B,6832-14-2897,SNGL FAM SUB,12.73,AC,89700,83700,6000,0,0,89700,87500,82000,5500,0,0,87500,A1,AG/GEN,,,
15957,2-4-0-1-0,6814-82-4389,SNGL FAM SUB,6.43,AC,67400,0,67400,100900,0,168300,66200,0,66200,89200,0,155400,A1,AG/GEN,,,
15958,2-4-0-2-0,6814-83-5050,SNGL FAM SUB,4.3,AC,56500,0,56500,269200,2800,328500,55500,0,55500,233900,1900,291300,A1,AG/GEN,,,
15959,2-4-0-3-0,6814-83-9247,SNGL FAM SUB,5.07,AC,64500,0,64500,274200,32200,370900,63300,0,63300,240900,29000,333200,A1,AG/GEN,,,
15960,2-4-0-4-0,6814-82-8862,SNGL FAM SUB,4.36,AC,56800,0,56800,209500,0,266300,55800,0,55800,181600,0,237400,A1,AG/GEN,,,
15962,5-10-0-2-A,6813-79-6160,SNGL FAM SUB,7.63,AC,68400,0,68400,0,0,68400,67200,0,67200,0,0,67200,A1,AG/GEN,,,
15963,6-1-0-4-E1,6823-89-1004,SNGL FAM SUB,5.001,AC,60100,0,60100,155600,1000,216700,59000,0,59000,135400,1100,195500,A1,AG/GEN,,,
15964,13-23-0-1-0,6852-11-1346,AG 20-100 AC,22.63,AC,143900,133500,10400,0,0,143900,141200,131600,9600,0,0,141200,A1,AG/GEN,,,
15965,13-23-0-2-0,6852-00-8700,AG 20-100 AC,20.09,AC,133400,124100,9300,0,0,133400,130900,122400,8500,0,0,130900,A1,AG/GEN,,,
15966,13-23-0-3-0,6852-00-3370,AG 20-100 AC,20.01,AC,150500,141300,9200,0,0,150500,147600,139100,8500,0,0,147600,A1,AG/GEN,,,
15967,13-23-0-4-0,6842-91-9276,SNGL FAM SUB,2.01,AC,58700,0,58700,185800,0,244500,57600,0,57600,165100,0,222700,A1,AG/GEN,,,
15968,13-23-0-5-0,6852-01-2540,SNGL FAM SUB,2.41,AC,55900,0,55900,0,0,55900,54900,0,54900,0,0,54900,A1,AG/GEN,,,
15969,13-23-0-6-0,6842-91-9575,SNGL FAM SUB,2.28,AC,61000,0,61000,0,0,61000,59900,0,59900,0,0,59900,A1,AG/GEN,,,
15970,14-1-0-2-A,6852-13-7151,AG 20-100 AC,21.3,AC,126900,79100,47800,215700,4000,346600,125700,82700,43000,190400,4000,320100,A1,AG/GEN,,,
15971,16-1-0-37-A,5890-43-2592,SNGL FAM SUB,9.09,AC,65700,0,65700,133900,5400,205000,62300,0,62300,111800,5900,180000,A1,AG/GEN,,,
15972,17-1-0-55-B,6810-26-1994,Cemetery,0,AC,100,0,100,0,0,100,100,0,100,0,0,100,A1,AG/GEN,,,
15973,17-1-0-59-A,6810-36-6650,SNGL FAM SUB,3,AC,50000,0,50000,0,0,50000,49000,0,49000,0,0,49000,A1,AG/GEN,,,
15974,17-1-0-59-B,6810-27-7645,SNGL FAM SUB,0.16,AC,900,0,900,0,0,900,900,0,900,0,0,900,A1,AG/GEN,,,
15975,19-1-0-36-H,6830-18-1406,SNGL FAM SUB,6.48,AC,87100,0,87100,259500,0,346600,82000,0,82000,213300,0,295300,A1,AG/GEN,,,
15977,58-31-0-4-A,7725-06-4125,General Gov,1.533,AC,5100,0,5100,0,0,5100,4600,0,4600,0,0,4600,RPUD,RES/PUD,,,
15979,21-1-0-29-B,6759-27-9273,SNGL FAM SUB,3.02,AC,78500,0,78500,0,0,78500,70900,0,70900,0,0,70900,A2,AG/LTD,,,
15981,27-1-0-10-0,6719-65-4671,SNGL FAM SUB,15.59,AC,92000,0,92000,0,0,92000,92500,0,92500,0,0,92500,A1,AG/GEN,,,
15982,28-1-0-25-A,6738-08-3442,SNGL FAM SUB,2.36,AC,50000,0,50000,0,0,50000,47900,0,47900,0,0,47900,A1,AG/GEN,,,
15983,28-1-0-25-B,6728-98-8641,SNGL FAM SUB,2.73,AC,52300,0,52300,114400,500,167200,50200,0,50200,94200,500,144900,A1,AG/GEN,,,
15984,28-1-0-25-C,6738-08-0718,SNGL FAM SUB,3.17,AC,55000,0,55000,184800,0,239800,53000,0,53000,158400,0,211400,A1,AG/GEN,,,
15985,28-1-0-25-D,6738-08-4758,SNGL FAM SUB,9.68,AC,92800,0,92800,5000,100,97900,89000,0,89000,5000,100,94100,A1,AG/GEN,,,
15986,32-2-0-1-A,6778-95-0456,SNGL FAM SUB,2.77,AC,89600,0,89600,308000,2000,399600,80000,0,80000,253400,2000,335400,A2,AG/LTD,,,
15987,32-2-0-1-B,6778-95-1826,SNGL FAM SUB,4.19,AC,110000,0,110000,471400,56200,637600,98400,0,98400,418700,46100,563200,A2,AG/LTD,,,
15988,32-2-0-1-C,6778-96-1772,SNGL FAM SUB,11.5,AC,145500,0,145500,0,0,145500,129400,0,129400,0,0,129400,A2,AG/LTD,,,
15989,33-1-0-9-F,6798-35-4287,SNGL FAM SUB,2,AC,90900,0,90900,316800,34600,442300,81200,0,81200,264300,30100,375600,A2,AG/LTD,,,
15990,41-4-0-H-4,6757-09-8202,AG 20-100 AC,26.79,AC,160300,147900,12400,0,0,160300,152100,140700,11400,0,0,152100,A2,AG/LTD,,,
15991,41-4-0-H-5,6758-10-2432,AG 20-100 AC,21.06,AC,244000,234300,9700,0,0,244000,238900,229900,9000,0,0,238900,A2,AG/LTD,,,
15992,42-27-0-H-1,6757-39-3527,AG 20-100 AC,29.33,AC,297100,283600,13500,0,0,297100,275700,263200,12500,0,0,275700,A2,AG/LTD,,,
15993,42-27-0-H-2,6757-29-5434,AG 20-100 AC,37.04,AC,422600,341200,81400,31600,0,454200,388700,323500,65200,26200,0,414900,A2,AG/LTD,,,
15994,42-27-0-H-3,6757-19-7321,AG 20-100 AC,25.1,AC,260100,248500,11600,0,0,260100,235900,225200,10700,0,0,235900,A2,AG/LTD,,,
15995,42-27-0-H-6,6758-11-7113,AG 20-100 AC,21.76,AC,210600,200600,10000,0,0,210600,204500,195300,9200,0,0,204500,A2,AG/LTD,,,
15996,42-27-0-H-7,6758-20-6840,AG 20-100 AC,23.45,AC,206400,195600,10800,0,0,206400,194600,184600,10000,0,0,194600,A2,AG/LTD,,,
15997,42-27-0-H-8,6758-21-8554,AG 20-100 AC,33.84,AC,248600,233000,15600,0,0,248600,247000,232600,14400,0,0,247000,A2,AG/LTD,,,
15998,42-27-0-H-9,6758-32-4469,AG 20-100 AC,48.6,AC,275900,253500,22400,0,0,275900,277000,256300,20700,0,0,277000,A2,AG/LTD,,,
15999,30-18-0-5-A,6759-41-2039,Cemetery,0,AC,100,0,100,0,0,100,100,0,100,0,0,100,A2,AG/LTD,,,
16000,42-1-0-112-A,6767-01-8440,COMM & IND,0.26,AC,34500,0,34500,0,28800,63300,33200,0,33200,0,24800,58000,B1,BUS/GEN,,,
16001,45-13-0-B-1,6797-79-7131,TAXED -SCC,0,AC,0,0,0,0,0,0,0,0,0,0,0,0,A2,AG/LTD,,,
16002,43-1-0-11-B,6767-77-5662,SNGL FAM SUB,5.04,AC,120600,0,120600,305500,44600,470700,107800,0,107800,261800,41200,410800,A2,AG/LTD,,,
16004,2-1-0-18-B,6814-73-7000,SNGL FAM SUB,0.53,AC,2700,0,2700,0,0,2700,2700,0,2700,0,0,2700,A1,AG/GEN,,,
16005,4-1-0-33-B,6803-87-5623,SNGL FAM SUB,1,AC,5600,0,5600,0,0,5600,5500,0,5500,0,0,5500,A1,AG/GEN,,,
16006,4-1-0-48-E,6803-95-5819,SNGL FAM SUB,0.13,AC,700,0,700,0,0,700,700,0,700,0,0,700,A1,AG/GEN,,,
16007,5-1-0-30-C,6813-91-2021,SNGL FAM SUB,0.08,AC,400,0,400,0,0,400,400,0,400,0,0,400,A1,AG/GEN,,,
16008,6-2-0-2-0,6832-19-3956,SNGL FAM SUB,2.75,AC,21300,0,21300,0,0,21300,20700,0,20700,0,0,20700,A1,AG/GEN,,,
16213,58-33-2-56-0,7725-48-0312,COMM & IND,27.5,AC,746400,0,746400,0,0,746400,746400,0,746400,0,0,746400,M1,INDUS/L,,,
16214,58-33-2-57-0,7725-19-6317,COMM & IND,17,AC,1198200,0,1198200,0,0,1198200,1198200,0,1198200,0,0,1198200,M1,INDUS/L,,,
16215,58-33-2-58-0,7725-39-1721,COMM & IND,19.1,AC,492000,0,492000,0,0,492000,492200,0,492200,0,0,492200,M1,INDUS/L,,,
16216,58-33-2-59-0,7725-49-1309,COMM & IND,15.42,AC,422500,0,422500,0,0,422500,422500,0,422500,0,0,422500,M1,INDUS/L,,,
16217,58-33-2-60-0,7726-40-0982,COMM & IND,25,AC,823600,0,823600,0,0,823600,823600,0,823600,0,0,823600,M1,INDUS/L,,,
16218,58-33-2-61-0,7726-42-3721,COMM & IND,45.81,AC,1380500,0,1380500,0,0,1380500,1380500,0,1380500,0,0,1380500,M1,INDUS/L,,,
16219,58-33-2-62-0,7726-33-5308,COMM & IND,41,AC,1506800,0,1506800,0,0,1506800,1506800,0,1506800,0,0,1506800,M1,INDUS/L,,,
16220,58-33-2-63-0,7726-23-6155,COMM & IND,19.4,AC,802700,0,802700,0,0,802700,802700,0,802700,0,0,802700,M1,INDUS/L,,,
16221,58-33-2-64-0,7726-13-9195,COMM & IND,16.4,AC,680300,0,680300,0,0,680300,680300,0,680300,0,0,680300,M1,INDUS/L,,,
16222,58-33-2-65-0,7726-13-2089,COMM & IND,14.5,AC,1024200,0,1024200,0,0,1024200,1024200,0,1024200,0,0,1024200,M1,INDUS/L,,,
16223,58-33-2-F-P6,7726-44-4002,COMM & IND,13.7,AC,28700,0,28700,0,0,28700,28700,0,28700,0,0,28700,M1,INDUS/L,,,
16224,58-33-2-R-13,7726-20-7459,COMM & IND,21.5,AC,45400,0,45400,0,0,45400,45400,0,45400,0,0,45400,M1,INDUS/L,,,
16225,58-33-2-R-14,7725-39-1323,COMM & IND,3.7,AC,7700,0,7700,0,0,7700,7700,0,7700,0,0,7700,M1,INDUS/L,,,
16226,58-33-2-W-1,7726-22-4109,COMM & IND,29.5,AC,63000,0,63000,0,0,63000,63000,0,63000,0,0,63000,M1,INDUS/L,,,
16227,58-33-2-W-2,7725-39-2078,COMM & IND,12,AC,329800,0,329800,0,0,329800,329800,0,329800,0,0,329800,M1,INDUS/L,,,
16228,58-33-3-66-0,7725-47-2598,COMM & IND,11.16,AC,306900,0,306900,0,0,306900,306900,0,306900,0,0,306900,M1,INDUS/L,,,
16229,59-3-2-75-0,7725-68-2279,COMM & IND,33.57,AC,646100,0,646100,0,0,646100,646100,0,646100,0,0,646100,M1,INDUS/L,,,
16230,4-1-0-6-F,6803-56-9623,AG 20-100 AC,24.563,AC,135500,123400,12100,0,0,135500,132300,121700,10600,0,0,132300,A1,AG/GEN,,,
16232,4-1-0-6-H,6803-45-8625,AG 20-100 AC,54.95,AC,246700,221400,25300,0,0,246700,237400,214000,23400,0,0,237400,A1,AG/GEN,,,
16233,4-1-0-63-A,6813-20-3658,AG 20-100 AC,37.397,AC,182000,0,182000,318300,78600,578900,169100,118400,50700,274700,57200,501000,A1,AG/GEN,,,
16235,4-1-0-63-C,6812-39-0640,AG 20-100 AC,30.617,AC,177100,158800,18300,0,34700,211800,173800,156700,17100,0,29800,203600,A1,AG/GEN,,,
16236,4-1-0-63-D,6813-30-5610,AG 20-100 AC,30.617,AC,166700,87600,79100,408700,144400,719800,163500,86400,77100,354300,124000,641800,A1,AG/GEN,,,
16238,5-26-0-11-0,6822-38-9086,SNGL FAM SUB,9.044,AC,91200,0,91200,0,0,91200,91200,0,91200,0,0,91200,RR,RES/RUR,,,
16239,5-26-0-12-0,6822-38-2197,SNGL FAM SUB,5.101,AC,76000,0,76000,0,0,76000,76000,0,76000,0,0,76000,RR,RES/RUR,,,
16240,5-26-0-37-0,6822-28-8108,SNGL FAM SUB,5.962,AC,76000,0,76000,317800,22000,415800,69000,0,69000,264000,19900,352900,RR,RES/RUR,,,
16411,63-1-0-193-A,7723-19-7304,Cemetery,0.165,AC,100,0,100,0,0,100,100,0,100,0,0,100,A2,AG/LTD,,,
16412,63-1-0-191-A,7724-20-4332,Academic-Private,28.52,AC,861300,0,861300,297100,24700,1183100,750100,0,750100,285500,23800,1059400,A2R1,AG LTD/,,,
16413,13-1-0-1-N1T,6832-94-7716-9999,SNGL FAM SUB,2,AC,42800,0,42800,0,0,42800,41600,0,41600,0,0,41600,A1,AG/GEN,,,
16414,47-1-0-43-C2,7716-98-5886,COMM & IND,0.17,AC,121600,0,121600,392400,0,514000,110500,0,110500,374000,0,484500,B1,BUS/GEN,,,
16417,26-9-0-G-0,6719-34-0309,SNGL FAM SUB,0.172,AC,1000,0,1000,0,0,1000,900,0,900,0,0,900,A1,AG/GEN,,,
16009,10-1-0-29-D,6812-35-0200,SNGL FAM SUB,0.6,AC,2800,0,2800,0,0,2800,2700,0,2700,0,0,2700,A1,AG/GEN,,,
16010,13-1-0-38-B,6841-93-2090,SNGL FAM SUB,0.14,AC,1200,0,1200,0,0,1200,1100,0,1100,0,0,1100,A1,AG/GEN,,,
16012,15-1-0-33-A,5789-17-8671,SNGL FAM SUB,0.333,AC,1200,0,1200,0,0,1200,1200,0,1200,0,0,1200,A1,AG/GEN,,,
16013,17-1-0-6-A,6801-50-3491,SNGL FAM SUB,0.23,AC,1000,0,1000,0,0,1000,900,0,900,0,0,900,A1,AG/GEN,,,
16014,17-7-0-A-2,6801-50-9060,SNGL FAM SUB,0.15,AC,700,0,700,0,0,700,700,0,700,0,0,700,A1,AG/GEN,,,
16015,19-2-0-C-0,6830-93-1094,SNGL FAM SUB,7.869,AC,113400,109800,3600,0,0,113400,106900,103600,3300,0,0,106900,A1,AG/GEN,,,
16016,19-3-0-3-0,6830-06-9405,AG 20-100 AC,33,AC,196800,181600,15200,0,0,196800,188100,174100,14000,0,0,188100,A1,AG/GEN,,,
16018,21-1-0-15-C,6850-53-5324,SNGL FAM SUB,0.385,AC,4300,0,4300,0,0,4300,3800,0,3800,0,0,3800,A2,AG/LTD,,,
16019,26-3-0-2-0,6719-11-5572,COMM & IND,0.58,AC,27600,0,27600,114200,40500,182300,26800,0,26800,127400,25400,179600,B1,BUS/GEN,,,
16020,27-1-0-5-B,6719-51-3842,SNGL FAM SUB,3,AC,52000,0,52000,0,0,52000,49000,0,49000,0,0,49000,A1,AG/GEN,,,
16021,27-5-0-4-0,6728-66-4702,SNGL FAM SUB,14.3,AC,119900,0,119900,0,0,119900,117800,0,117800,0,0,117800,A1,AG/GEN,,,
16022,28-1-0-95-D,6738-26-7685,SNGL FAM SUB,0.07,AC,400,300,100,0,0,400,500,400,100,0,0,500,A1,AG/GEN,,,
16023,29-3-0-16-0,6749-63-2097,SNGL FAM SUB,1.874,AC,54900,0,54900,96900,0,151800,51500,0,51500,76500,0,128000,A1,AG/GEN,,,
16024,31-1-0-34-A,6768-88-1680,AG 20-100 AC,30,AC,360000,346200,13800,0,0,360000,321000,308200,12800,0,0,321000,A2,AG/LTD,,,
16026,32-1-0-46-D,6778-84-4970,SNGL FAM SUB,0.16,AC,2300,0,2300,0,0,2300,2100,0,2100,0,0,2100,A2,AG/LTD,,,
16028,38-1-0-110-A,6717-18-5902,SNGL FAM SUB,0.24,AC,1100,0,1100,0,0,1100,1100,0,1100,0,0,1100,A1,AG/GEN,,,
16032,40-3-0-B-0,6727-90-5531,SNGL FAM SUB,8.45,AC,91500,87200,4300,0,0,91500,89900,86300,3600,0,0,89900,A1,AG/GEN,,,
16033,40-3-0-C-0,6736-09-1751,SNGL FAM SUB,16.3,AC,129600,122100,7500,0,0,129600,127200,120300,6900,0,0,127200,A1,AG/GEN,,,
16034,42-1-0-32-A,6767-01-4399,SNGL FAM SUB,0.17,AC,2100,0,2100,0,0,2100,2000,0,2000,0,0,2000,R3,RES/GEN,,,
16037,42-1-0-66-C,6757-98-6584,COMM & IND,0.11,AC,12400,0,12400,0,0,12400,11900,0,11900,0,0,11900,B1,BUS/GEN,,,
16038,42-1-0-98-B,6767-13-2081,General Gov,0.07,AC,8700,0,8700,0,0,8700,8400,0,8400,0,0,8400,B1,BUS/GEN,,,
16040,42-3-0-14-0,6767-05-8004,SNGL FAM SUB,0.688,AC,70000,0,70000,0,0,70000,65000,0,65000,0,0,65000,R3,RES/GEN,,,
16041,42-6-0-3-B,6767-03-9234,COMM & IND,0.135,AC,19200,0,19200,0,0,19200,18500,0,18500,0,0,18500,B1,BUS/GEN,,,
16042,42-13-0-2-0,6767-04-4114,COMM & IND,0.278,AC,31100,0,31100,0,0,31100,29800,0,29800,0,0,29800,BN,BUS/NHD,,,
16043,43-5-0-B-0,6776-29-6394,SNGL FAM SUB,1.5,AC,77000,76300,700,0,0,77000,68800,68200,600,0,0,68800,A2,AG/LTD,,,
16044,43-9-0-B-0,6778-41-6796,SNGL FAM SUB,3.81,AC,104600,0,104600,0,0,104600,93400,0,93400,0,0,93400,A2,AG/LTD,,,
16045,44-1-0-23-A,6777-91-4537,Cemetery,0.509,AC,100,0,100,0,0,100,100,0,100,0,0,100,A2,AG/LTD,,,
16046,44-3-0-4-0,6777-81-5873,SNGL FAM SUB,4.932,AC,124400,0,124400,0,0,124400,111800,0,111800,35400,300,147500,A2,AG/LTD,,,
16048,44-16-0-14-B,6787-48-9766,SNGL FAM SUB,6.808,AC,148400,0,148400,444700,0,593100,132300,0,132300,399200,0,531500,A2,AG/LTD,,,
16049,45-1-0-91-B,6797-86-2634,SNGL FAM SUB,1,AC,76700,0,76700,0,0,76700,68500,0,68500,0,0,68500,A2,AG/LTD,,,
16053,46-1-0-65-A,7716-09-5741,SNGL FAM SUB,10,AC,359400,249200,110200,604500,55200,1019100,321100,222900,98200,508300,55200,884600,A2,AG/LTD,,,
16058,46-3-0-3-0,7707-60-7636,SNGL FAM SUB,7.46,AC,242400,238600,3800,0,0,242400,216300,213100,3200,0,0,216300,A2,AG/LTD,,,
16061,47-3-0-B-0,7717-74-7113,AG > 100 AC,136.97,AC,4291800,4057100,234700,10000,0,4301800,3830800,3621000,209800,10000,0,3840800,A2,AG/LTD,,,
16062,47-3-0-C-0,7717-95-1469,TAXED -SCC,3.149,AC,0,0,0,0,0,0,0,0,0,0,0,0,A2,AG/LTD,,,
16063,47-3-0-D-0,7717-97-2369,COMM & IND,6.4,AC,333900,0,333900,0,0,333900,318200,0,318200,0,0,318200,M2,INDUS/G,,,
16064,47-3-0-E-0,7717-97-8473,COMM & IND,24,AC,1265400,0,1265400,0,0,1265400,1206100,0,1206100,0,0,1206100,M2,INDUS/G,,,
16065,47-4-0-2-0,7727-23-1804,SNGL FAM SUB,0.22,AC,3400,3300,100,0,0,3400,3000,2900,100,0,0,3000,A2,AG/LTD,,,
16066,48-5-0-3-0,7728-91-2634,SNGL FAM SUB,3.88,AC,180200,0,180200,0,0,180200,161000,0,161000,0,0,161000,A2,AG/LTD,,,
16067,48-5-0-4-0,7728-82-2557,SNGL FAM SUB,14.333,AC,350400,343800,6600,0,0,350400,312900,306800,6100,0,0,312900,A2,AG/LTD,,,
16068,51-1-0-16-A,6735-27-6976,SNGL FAM SUB,0.051,AC,300,0,300,0,0,300,300,0,300,0,0,300,A1,AG/GEN,,,
16069,51-1-0-19-0,6735-47-7115,SNGL FAM SUB,0.14,AC,600,0,600,0,0,600,600,500,100,0,0,600,A1,AG/GEN,,,
16070,51-1-0-20-A,6735-32-5155,ALSO,0,AC,0,0,0,0,0,0,0,0,0,0,0,0,A1,AG/GEN,,,
16071,51-1-0-20-B,6735-32-9156,ALSO,0,AC,0,0,0,0,0,0,0,0,0,0,0,0,A1,AG/GEN,,,
16072,51-1-0-20-C,6735-32-8171,ALSO,0,AC,0,0,0,0,0,0,0,0,0,0,0,0,A1,AG/GEN,,,
16073,51-1-0-20-D,6735-32-7103,ALSO,0,AC,0,0,0,0,0,0,0,0,0,0,0,0,A1,AG/GEN,,,
16074,51-1-0-23-0,6735-48-9004,SNGL FAM SUB,0.08,AC,400,0,400,0,0,400,400,0,400,0,0,400,A1,AG/GEN,,,
16075,51-3-0-B-0,6736-41-7315,SNGL FAM SUB,1.317,AC,36700,0,36700,0,0,36700,35900,0,35900,0,0,35900,A1,AG/GEN,,,
16076,51-5-0-B-0,6735-25-5015,AG > 100 AC,155,AC,535700,463000,72700,0,0,535700,520800,454700,66100,0,0,520800,A1,AG/GEN,,,
16077,51-5-0-C-0,6735-03-7830,AG 20-100 AC,80,AC,40700,0,40700,0,0,40700,35400,0,35400,0,0,35400,A1,AG/GEN,,,
16078,53-1-0-3-B,6766-36-4317,SNGL FAM SUB,0.4,AC,4800,0,4800,0,0,4800,4300,0,4300,0,0,4300,A2,AG/LTD,,,
16080,55-1-0-14-A,6785-06-5069,ALSO,0,AC,0,0,0,0,0,0,0,0,0,0,0,0,A2,AG/LTD,,,
16081,55-1-0-14-D,6786-00-5003,ALSO,0,AC,0,0,0,0,0,0,0,0,0,0,0,0,A2,AG/LTD,,,
16082,55-1-0-47-0,6786-33-2627,AG 20-100 AC,79.66,AC,995800,956200,39600,0,0,995800,892200,858000,34200,0,0,892200,A2,AG/LTD,,,
16083,55-1-0-37-E,6785-58-4746,SNGL FAM SUB,0.09,AC,1400,0,1400,0,0,1400,1200,0,1200,0,0,1200,A2,AG/LTD,,,
16084,55-2-0-9-A,6785-35-8792,SNGL FAM SUB,0.4,AC,6600,0,6600,0,0,6600,5900,0,5900,0,0,5900,R1,RES/LTD,,,
16085,56-1-0-7-A,6786-93-5598,SNGL FAM SUB,0.72,AC,9500,9200,300,0,0,9500,8500,8200,300,0,0,8500,A2,AG/LTD,,,
16086,56-10-0-A-0,7706-02-1021,SNGL FAM SUB,0.17,AC,3500,0,3500,0,0,3500,3000,0,3000,0,0,3000,A2,AG/LTD,,,
16087,56-10-0-C-0,6796-92-7252,SNGL FAM SUB,0.05,AC,1000,0,1000,0,0,1000,900,0,900,0,0,900,A2,AG/LTD,,,
16089,56-15-0-B-0,6795-55-9982,Roads,1.206,AC,0,0,0,0,0,0,0,0,0,0,0,0,RR,RES/RUR,,,
16090,57-1-0-41-B,7715-04-8030,SNGL FAM SUB,0.04,AC,1100,0,1100,0,0,1100,900,0,900,0,0,900,A2,AG/LTD,,,
16091,57-1-0-56-B,7716-12-2256,SNGL FAM SUB,0.422,AC,3400,0,3400,0,0,3400,3100,0,3100,0,0,3100,A2,AG/LTD,,,
16093,58-1-0-77-B,7726-04-3475,SNGL FAM SUB,0.28,AC,10200,0,10200,0,0,10200,8900,0,8900,0,0,8900,A2,AG/LTD,,,
16095,58-11-0-B-1,7725-04-2846,SNGL FAM SUB,0.154,AC,3100,0,3100,0,0,3100,2700,0,2700,0,0,2700,A2,AG/LTD,,,
16096,58-21-A-1-C,7716-53-3505,Cmn Area/Open Spc,0.213,AC,0,0,0,0,0,0,0,0,0,0,0,0,A2,AG/LTD,,,
16098,60-1-0-3-E,6774-88-6996,SNGL FAM SUB,0.01,AC,200,0,200,0,0,200,200,0,200,0,0,200,A2,AG/LTD,,,
16099,61-2-0-D-0,6795-11-8129,SNGL FAM SUB,0.93,AC,3800,0,3800,0,0,3800,3300,0,3300,0,0,3300,A2,AG/LTD,,,
16100,61-2-0-F-0,6795-20-8852,SNGL FAM SUB,0.06,AC,200,0,200,0,0,200,200,0,200,0,0,200,A2,AG/LTD,,,
16101,61-2-0-G-0,6795-30-9532,SNGL FAM SUB,0.22,AC,900,0,900,0,0,900,800,0,800,0,0,800,A2,AG/LTD,,,
16102,62-3-D-2-B,7714-03-5748,Cmn Area/Open Spc,0.09,AC,0,0,0,0,0,0,0,0,0,0,0,0,R1,RES/LTD,,,
16106,63-1-0-96-B,7715-60-0076,SNGL FAM SUB,0.056,AC,1100,0,1100,0,0,1100,1000,0,1000,0,0,1000,A2,AG/LTD,,,
16107,58-1-0-50-E,7715-62-7542,SNGL FAM SUB,2.92,AC,140700,0,140700,90900,0,231600,122300,0,122300,72600,0,194900,A2,AG/LTD,,,
16108,63-1-0-110-C,7715-32-2241,SNGL FAM SUB,0.3,AC,6100,0,6100,0,0,6100,5300,0,5300,0,0,5300,A2,AG/LTD,,,
16111,63-11-0-A-0,7714-66-5955,AG > 100 AC,367.453,AC,7219800,0,7219800,0,0,7219800,6317400,0,6317400,0,0,6317400,A2,AG/LTD,,,
16113,64-4-1-11-0,7724-94-1075,SNGL FAM SUB,0,AC,92400,0,92400,163200,1000,256600,80400,0,80400,138300,1000,219700,RN,RESIDEN,,,
16114,67-1-0-12-B,7723-82-7374,Cemetery,0,AC,100,0,100,0,0,100,100,0,100,0,0,100,A2,AG/LTD,,,
16115,64-4-2-26-0,7724-93-6807,SNGL FAM SUB,0,AC,20200,0,20200,0,0,20200,17600,0,17600,0,0,17600,RN,RESIDEN,,,
16117,64-12-A-6-0,7724-50-7547,SNGL FAM SUB,0.49,AC,57800,0,57800,0,0,57800,50300,0,50300,0,0,50300,R1,RES/LTD,,,
16118,66-1-0-7-0,7713-97-3017,SNGL FAM SUB,0.03,AC,600,0,600,0,0,600,500,0,500,0,0,500,A2,AG/LTD,,,
16120,67-7-0-1-B,7723-56-8900,SNGL FAM SUB,0.14,AC,5200,5100,100,0,0,5200,4600,4500,100,0,0,4600,R1,RES/LTD,,,
16121,67-8-0-3-A,7723-57-8149,SNGL FAM SUB,0.16,AC,6000,0,6000,0,0,6000,5200,0,5200,0,0,5200,R1,RES/LTD,,,
16122,67-9-0-E-0,7733-24-1445,SNGL FAM SUB,1.4,AC,52400,51800,600,0,0,52400,45500,44900,600,0,0,45500,A2,AG/LTD,,,
16123,67-9-0-F-0,7733-24-9308,SNGL FAM SUB,0.75,AC,28100,27800,300,0,0,28100,24400,24100,300,0,0,24400,A2,AG/LTD,,,
16124,67-9-0-H-0,7733-34-1340,SNGL FAM SUB,0.32,AC,12000,11900,100,0,0,12000,10400,10300,100,0,0,10400,A2,AG/LTD,,,
16126,47-3-0-D-1,7727-06-3467,COMM & IND,35.4,AC,1866500,0,1866500,0,0,1866500,1779000,0,1779000,0,0,1779000,M2,INDUS/G,,,
16127,55-1-0-37-D,6785-58-3741,ALSO,0,AC,0,0,0,0,0,0,0,0,0,0,0,0,A2,AG/LTD,,,
16134,11-1-0-49-B1,6821-78-0930,SNGL FAM SUB,2.58,AC,51500,0,51500,0,0,51500,47500,0,47500,0,0,47500,A1,AG/GEN,,,
16135,12-27-0-A-0,6821-96-7761,SNGL FAM SUB,9.053,AC,96000,0,96000,284200,16500,396700,94300,0,94300,238500,13100,345900,A1,AG/GEN,,,
16136,12-27-0-A1-0,6821-96-1856,Cemetery,0,AC,100,0,100,0,0,100,100,0,100,0,0,100,A1,AG/GEN,,,
16137,12-27-0-B-0,6831-06-2820,SNGL FAM SUB,2.11,AC,48400,0,48400,131900,25100,205400,48200,0,48200,106600,22300,177100,A1,AG/GEN,,,
16138,12-27-0-C-0,6821-97-7098,SNGL FAM SUB,9.219,AC,93000,0,93000,354300,100,447400,95400,0,95400,314900,100,410400,A1,AG/GEN,,,
16139,13-1-0-1-M,6842-00-2855,SNGL FAM SUB,2.46,AC,57600,0,57600,101500,2000,161100,56400,0,56400,89000,2000,147400,A1,AG/GEN,,,
16140,28-15-0-A-0,6739-62-3122,SNGL FAM SUB,6.071,AC,94900,0,94900,229900,10100,334900,90600,0,90600,208700,700,300000,A1,AG/GEN,,,
16141,28-15-0-B-0,6739-52-9197,SNGL FAM SUB,7.16,AC,100900,0,100900,285800,800,387500,96300,0,96300,251600,800,348700,A1,AG/GEN,,,
16142,28-15-0-C-0,6739-51-8319,AG 20-100 AC,20.009,AC,141100,0,141100,305900,14300,461300,135300,0,135300,270300,12700,418300,A1,AG/GEN,,,
16143,28-15-0-D-0,6739-50-3795,AG 20-100 AC,20.012,AC,141100,0,141100,424000,4800,569900,135300,0,135300,374400,4600,514300,A1,AG/GEN,,,
16144,28-15-0-E-0,6739-41-5476,AG 20-100 AC,20,AC,141100,0,141100,334100,13300,488500,135300,0,135300,280900,13000,429200,A1,AG/GEN,,,
16145,28-15-0-F-0,6739-42-8230,AG 20-100 AC,20,AC,141100,0,141100,336100,2400,479600,135300,0,135300,307800,3300,446400,A1,AG/GEN,,,
16146,28-15-0-G-0,6739-52-5368,SNGL FAM SUB,10.106,AC,117100,0,117100,276500,15900,409500,111800,0,111800,250500,16500,378800,A1,AG/GEN,,,
16147,28-15-0-H-0,6739-52-1865,SNGL FAM SUB,10.025,AC,116600,0,116600,223100,800,340500,111400,0,111400,196200,800,308400,A1,AG/GEN,,,
16148,28-15-0-J-0,6739-51-5955,Roads,2,AC,0,0,0,0,0,0,0,0,0,0,0,0,A1,AG/GEN,,,
16149,28-16-0-A-0,6739-71-7184,Roads,3.182,AC,0,0,0,0,0,0,0,0,0,0,0,0,A1,AG/GEN,,,
16150,28-16-0-1-0,6739-81-3868,SNGL FAM SUB,10,AC,116500,0,116500,247300,1000,364800,111300,0,111300,216700,0,328000,A1,AG/GEN,,,
16151,28-16-0-2-0,6739-81-0904,SNGL FAM SUB,8.941,AC,110700,0,110700,295000,2200,407900,105700,0,105700,264400,2200,372300,A1,AG/GEN,,,
16152,28-16-0-3-0,6739-80-1811,AG 20-100 AC,20.001,AC,141100,0,141100,262100,0,403200,135300,0,135300,229700,0,365000,A1,AG/GEN,,,
16153,28-16-0-4-0,6738-79-6131,AG 20-100 AC,42.559,AC,204800,93000,111800,395800,71500,672100,196500,90600,105900,344400,29500,570400,A1,AG/GEN,,,
16154,28-16-0-5-0,6738-79-3709,AG 20-100 AC,20.01,AC,141100,0,141100,317100,0,458200,135300,0,135300,272800,0,408100,A1,AG/GEN,,,
16155,28-16-0-6-0,6739-70-0433,AG 20-100 AC,20.061,AC,141300,0,141300,283800,0,425100,135500,0,135500,247900,0,383400,A1,AG/GEN,,,
16156,28-16-0-7-0,6739-71-5787,SNGL FAM SUB,10.451,AC,119000,0,119000,281300,55200,455500,113600,0,113600,246100,51500,411200,A1,AG/GEN,,,
16157,28-16-0-8-0,6739-71-1417,AG 20-100 AC,20.081,AC,141400,0,141400,242400,37500,421300,135600,0,135600,214800,39600,390000,A1,AG/GEN,,,
16158,28-16-0-9-0,6739-61-9926,SNGL FAM SUB,8.183,AC,106500,0,106500,287700,1300,395500,101700,0,101700,251700,1300,354700,A1,AG/GEN,,,
16159,28-16-0-10-0,6739-61-4029,AG 20-100 AC,23.244,AC,140700,0,140700,350800,79500,571000,134900,0,134900,268900,78900,482700,A1,AG/GEN,,,
16160,40-4-0-E-3,6737-63-1759,SNGL FAM SUB,2.281,AC,57500,0,57500,222100,0,279600,56300,0,56300,189000,0,245300,A1,AG/GEN,,,
16161,40-4-0-E-4,6737-53-9978,SNGL FAM SUB,2.817,AC,48800,0,48800,275600,0,324400,47800,0,47800,230200,0,278000,A1,AG/GEN,,,
16162,43-18-0-3-A,6777-39-7010,SNGL FAM SUB,3.04,AC,99500,0,99500,383500,2300,485300,88900,0,88900,299100,2500,390500,A2,AG/LTD,,,
16163,43-18-0-3-B,6777-38-3884,SNGL FAM SUB,3.04,AC,64500,0,64500,0,0,64500,57600,0,57600,0,0,57600,A2,AG/LTD,,,
16164,46-16-0-F-1A1,7707-83-4034,SNGL FAM SUB,0.12,AC,2000,0,2000,0,0,2000,1800,0,1800,0,0,1800,A2,AG/LTD,,,
16165,54-3-0-K-1,6776-27-0220,SNGL FAM SUB,10,AC,172700,0,172700,390700,34600,598000,154400,0,154400,313800,30700,498900,A2,AG/LTD,,,
16166,63-35-0-1-0,7714-26-7592,AG > 100 AC,242.296,AC,7184100,3373600,3810500,528700,500,7713300,6247000,2929400,3317600,470800,500,6718300,A2,AG/LTD,,,
16167,63-36-0-1-0,7714-44-2116,SNGL FAM SUB,5.624,AC,246000,0,246000,0,0,246000,213900,0,213900,0,0,213900,R3,RES/GEN,,,
16168,6-1-0-57-TW,6833-25-6154-9998,COMM & IND,0,AC,0,0,0,0,130300,130300,0,0,0,0,126300,126300,A1,AG/GEN,,,
16169,62-1-0-10-TW,7704-91-8292-9998,COMM & IND,0,AC,0,0,0,0,115000,115000,0,0,0,0,111700,111700,M2,INDUS/G,,,
16170,63-37-1-9-A,7724-33-2693,COMM & IND,2,AC,6500,0,6500,0,0,6500,6500,0,6500,0,0,6500,M1,INDUS/L,,,
16171,64-25-1-9-E,7734-23-4101,COMM & IND,4.649,AC,15900,0,15900,0,0,15900,15900,0,15900,0,0,15900,M1,INDUS/L,,,
16172,63-37-1-9-C,7724-33-3212,COMM & IND,0.2,AC,600,0,600,0,0,600,600,0,600,0,0,600,M1,INDUS/L,,,
16173,63-37-1-9-B,7724-33-0294,COMM & IND,0.2,AC,600,0,600,0,0,600,600,0,600,0,0,600,M1,INDUS/L,,,
16174,64-25-1-9-D,7734-12-2978,COMM & IND,4,AC,13700,0,13700,0,0,13700,13700,0,13700,0,0,13700,M1,INDUS/L,,,
16175,64-25-1-9-F,7734-04-3271,COMM & IND,8,AC,569600,0,569600,0,0,569600,537400,0,537400,0,0,537400,RN,RESIDEN,,,
16177,64-25-1-9-H,7724-68-7406,COMM & IND,0.3,AC,1100,0,1100,0,0,1100,1100,0,1100,0,0,1100,M1,INDUS/L,,,
16178,55-1-0-85-A,6785-75-5132,SNGL FAM SUB,0,AC,0,0,0,65000,0,65000,0,0,0,52200,0,52200,A2,AG/LTD,,,
16180,58-32-3-32-0,7725-41-9058,COMM & IND,0.4,AC,800,0,800,0,0,800,800,0,800,0,0,800,M1,INDUS/L,,,
16198,58-54-0-2-0,7725-12-9107,AG 20-100 AC,24.321,AC,1975300,0,1975300,0,0,1975300,2892200,0,2892200,0,0,2892200,RPUD,RES/PUD,,,
16199,58-32-3-52-0,7725-17-3203,COMM & IND,11.691,AC,1291000,0,1291000,0,0,1291000,1217300,0,1217300,0,0,1217300,RPUD,RES/PUD,,,
16200,58-32-3-53-0,7725-17-3839,COMM & IND,24.31,AC,2549400,0,2549400,0,0,2549400,2403900,0,2403900,0,0,2403900,M1,INDUS/L,,,
16211,58-33-2-54-0,7725-18-5864,COMM & IND,19.6,AC,1378400,0,1378400,0,0,1378400,1378400,0,1378400,0,0,1378400,M1,INDUS/L,,,
16212,58-33-2-55-0,7725-38-0359,COMM & IND,11.8,AC,324300,0,324300,0,0,324300,324300,0,324300,0,0,324300,M1,INDUS/L,,,
16241,5-26-0-38-0,6822-28-4569,SNGL FAM SUB,7.1,AC,76000,0,76000,479700,0,555700,72000,0,72000,435700,0,507700,RR,RES/RUR,,,
16242,5-26-0-39-0,6822-28-7992,SNGL FAM SUB,8.097,AC,76000,0,76000,374800,0,450800,76000,0,76000,327700,0,403700,RR,RES/RUR,,,
16243,5-26-0-40-0,6822-29-9396,SNGL FAM SUB,7.982,AC,79800,0,79800,437500,0,517300,79800,0,79800,371300,0,451100,RR,RES/RUR,,,
16244,5-26-0-41-0,6822-39-4137,SNGL FAM SUB,5.023,AC,76000,0,76000,528100,3200,607300,76000,0,76000,460200,2300,538500,RR,RES/RUR,,,
16245,5-26-0-42-0,6822-38-4656,SNGL FAM SUB,5.023,AC,76000,0,76000,0,0,76000,76000,0,76000,0,0,76000,RR,RES/RUR,,,
16246,5-26-0-43-0,6822-39-8338,SNGL FAM SUB,8.409,AC,79800,0,79800,0,0,79800,79800,0,79800,0,0,79800,RR,RES/RUR,,,
16247,5-26-0-44-0,6822-48-2701,SNGL FAM SUB,5.004,AC,76000,0,76000,0,0,76000,76000,0,76000,0,0,76000,RR,RES/RUR,,,
16249,5-27-0-13-0,6822-37-1676,SNGL FAM SUB,5.138,AC,76000,0,76000,390700,5800,472500,76000,0,76000,338800,4200,419000,RR,RES/RUR,,,
16250,5-27-0-32-0,6822-27-1193,SNGL FAM SUB,6.55,AC,76000,0,76000,444100,2000,522100,69000,0,69000,386200,1800,457000,RR,RES/RUR,,,
16251,5-27-0-33-0,6822-17-6475,SNGL FAM SUB,9.4,AC,76000,0,76000,0,0,76000,69000,0,69000,0,0,69000,RR,RES/RUR,,,
16252,5-27-0-34-0,6822-17-8955,SNGL FAM SUB,10.7,AC,76000,0,76000,322300,9000,407300,76000,0,76000,271700,7900,355600,RR,RES/RUR,,,
16253,5-27-0-35-0,6822-28-2094,SNGL FAM SUB,5.2,AC,76000,0,76000,328700,0,404700,69000,0,69000,282700,0,351700,RR,RES/RUR,,,
16254,5-27-0-36-0,6822-27-6615,SNGL FAM SUB,5.205,AC,76000,0,76000,0,0,76000,69000,0,69000,0,0,69000,RR,RES/RUR,,,
16255,11-15-0-14-0,6822-37-1212,SNGL FAM SUB,5.193,AC,76000,0,76000,360000,25200,461200,76000,0,76000,299900,24900,400800,RR,RES/RUR,,,
16256,11-15-0-14-A,6822-27-9159,Cemetery,0,AC,100,0,100,0,0,100,100,0,100,0,0,100,RR,RES/RUR,,,
16257,11-15-0-15-0,6822-36-3791,SNGL FAM SUB,5.4,AC,76000,0,76000,0,0,76000,76000,0,76000,0,0,76000,RR,RES/RUR,,,
16258,11-15-0-16-0,6822-36-0598,SNGL FAM SUB,5.4,AC,76000,0,76000,311000,3200,390200,76000,0,76000,263600,3500,343100,RR,RES/RUR,,,
16259,11-15-0-16-A,6822-36-0634,Cemetery,0,AC,100,0,100,0,0,100,100,0,100,0,0,100,RR,RES/RUR,,,
16260,11-15-0-17-0,6822-26-7772,SNGL FAM SUB,5.008,AC,76000,0,76000,386300,24000,486300,76000,0,76000,323400,21400,420800,RR,RES/RUR,,,
16261,11-15-0-18-0,6822-26-5579,SNGL FAM SUB,5.02,AC,76000,0,76000,0,0,76000,69000,0,69000,0,0,69000,RR,RES/RUR,,,
16262,11-15-0-19-0,6822-26-3452,SNGL FAM SUB,5.012,AC,76000,0,76000,449400,4300,529700,69000,0,69000,319700,3600,392300,RR,RES/RUR,,,
16264,12-1-0-47-A,6831-26-5670,SNGL FAM SUB,5.84,AC,72400,0,72400,369800,52100,494300,67100,0,67100,303800,47700,418600,A1,AG/GEN,,,
16265,13-1-0-1-N,6842-25-6075,AG > 100 AC,294.3,AC,752700,616500,136200,0,0,752700,738000,612900,125100,0,0,738000,A1,AG/GEN,,,
16267,26-1-0-16-B,6709-90-8882,SNGL FAM SUB,0.08,AC,400,0,400,0,0,400,400,0,400,0,0,400,A1,AG/GEN,,,
16268,28-1-0-58-J,6738-18-4624,SNGL FAM SUB,2.01,AC,47700,0,47700,39300,0,87000,46400,0,46400,33100,0,79500,A1,AG/GEN,,,
16269,29-1-0-112-E,6748-79-3505,SNGL FAM SUB,2.19,AC,64700,0,64700,231900,26700,323300,60400,0,60400,196100,22000,278500,A1,AG/GEN,,,
16270,39-1-0-48-C,6726-09-3221,SNGL FAM SUB,17.016,AC,112500,0,112500,228800,2700,344000,110100,0,110100,200600,2800,313500,RR,RES/RUR,,,
16271,46-1-0-64-A,7716-19-1165,SNGL FAM SUB,2.996,AC,143300,0,143300,195500,1200,340000,127900,0,127900,163200,1200,292300,A2,AG/LTD,,,
16272,57-33-0-A-0,7705-62-1993,Cmn Area/Open Spc,0.406,AC,0,0,0,0,0,0,0,0,0,0,0,0,RR,RES/RUR,,,
16273,57-33-0-C-0,7705-62-4140,Cmn Area/Open Spc,3.03,AC,0,0,0,0,0,0,0,0,0,0,0,0,RR,RES/RUR,,,
16274,57-33-0-5-0,7705-63-5031,SNGL FAM SUB,3.742,AC,432000,0,432000,592300,0,1024300,360000,0,360000,557900,0,917900,RR,RES/RUR,,,
16275,57-33-0-6-0,7705-62-4586,SNGL FAM SUB,3.309,AC,432000,0,432000,813500,41400,1286900,360000,0,360000,764400,39300,1163700,RR,RES/RUR,,,
16276,57-33-0-7-0,7705-62-2360,SNGL FAM SUB,6.033,AC,449300,0,449300,1563800,62600,2075700,374400,0,374400,1467100,59500,1901000,RR,RES/RUR,,,
16277,57-33-0-8-0,7705-52-8465,SNGL FAM SUB,5.825,AC,432000,0,432000,1441700,18900,1892600,360000,0,360000,1347000,19500,1726500,RR,RES/RUR,,,
16278,57-33-0-9-0,7705-52-4670,SNGL FAM SUB,7.394,AC,449300,0,449300,610500,28500,1088300,374400,0,374400,571900,29100,975400,RR,RES/RUR,,,
16279,57-33-0-10-0,7705-52-5964,SNGL FAM SUB,5.062,AC,432000,0,432000,873600,0,1305600,360000,0,360000,813300,0,1173300,RR,RES/RUR,,,
16280,57-33-0-11-0,7705-53-9179,SNGL FAM SUB,3.981,AC,432000,0,432000,456700,13700,902400,360000,0,360000,428500,12000,800500,RR,RES/RUR,,,
16282,60-7-0-A-2,6785-10-2093,SNGL FAM SUB,7.201,AC,281700,278000,3700,0,0,281700,251200,248100,3100,0,0,251200,A2,AG/LTD,,,
16283,61-9-0-A-0,6795-80-6565,Roads,0.181,AC,0,0,0,0,0,0,0,0,0,0,0,0,RR,RES/RUR,,,
16284,61-9-0-32-0,6794-89-0937,SNGL FAM SUB,19.403,AC,624000,0,624000,86500,46700,757200,543000,0,543000,85800,45800,674600,RR,RES/RUR,,,
16285,61-9-0-33-0,6794-89-6679,AG 20-100 AC,32.564,AC,1079000,0,1079000,1950600,78500,3108100,938900,0,938900,1982300,73400,2994600,RR,RES/RUR,,,
16286,62-35-0-B-0,7705-51-8383,Cmn Area/Open Spc,0.45,AC,0,0,0,0,0,0,0,0,0,0,0,0,RR,RES/RUR,,,
16287,62-35-0-D-0,7705-51-7735,Roads,2.201,AC,0,0,0,0,0,0,0,0,0,0,0,0,RR,RES/RUR,,,
16288,62-35-0-1-0,7705-51-5693,SNGL FAM SUB,4.895,AC,432000,0,432000,1027200,31600,1490800,360000,0,360000,987400,30800,1378200,RR,RES/RUR,,,
16289,62-35-0-2-0,7705-52-1133,SNGL FAM SUB,7.145,AC,449300,0,449300,1261800,1300,1712400,374400,0,374400,1196100,1300,1571800,RR,RES/RUR,,,
16290,62-35-0-3-0,7705-52-7024,SNGL FAM SUB,4.135,AC,432000,0,432000,829500,0,1261500,360000,0,360000,825300,0,1185300,RR,RES/RUR,,,
16291,62-35-0-4-0,7705-61-0851,SNGL FAM SUB,3.057,AC,432000,0,432000,753000,0,1185000,360000,0,360000,737900,0,1097900,RR,RES/RUR,,,
16293,63-32-0-C-1,7723-08-6686,SNGL FAM SUB,3,AC,220600,0,220600,379900,4900,605400,191800,0,191800,326300,4700,522800,R1,RES/LTD,,,
16295,65-1-0-6-0,7733-88-0847,SNGL FAM SUB,5.52,AC,52400,49900,2500,0,0,52400,45800,43500,2300,0,0,45800,R1,RES/LTD,,,
16296,59-3-2-76-0,7725-68-0992,COMM & IND,25,AC,498400,0,498400,0,0,498400,498400,0,498400,0,0,498400,M1,INDUS/L,,,
16297,59-3-2-77-0,7725-59-8357,COMM & IND,21,AC,417400,0,417400,0,0,417400,417400,0,417400,0,0,417400,M1,INDUS/L,,,
16298,59-3-2-78-0,7726-50-8459,COMM & IND,29,AC,546400,0,546400,0,0,546400,546400,0,546400,0,0,546400,M1,INDUS/L,,,
16299,59-3-2-79-0,7726-51-6431,COMM & IND,27,AC,473100,0,473100,0,0,473100,473100,0,473100,0,0,473100,M1,INDUS/L,,,
16308,59-3-2-88-0,7726-74-5220,Non-Profit,12.099,AC,4767000,0,4767000,82122100,1524600,88413700,4333900,0,4333900,79730200,1466500,85530600,M1,INDUS/L,,,
16313,59-3-2-93-0,7726-95-5226,COMM & IND,7.75,AC,30200,0,30200,0,0,30200,27100,0,27100,0,0,27100,M1,INDUS/L,,,
16314,59-3-2-F-0,7726-61-7127,COMM & IND,91.59,AC,240400,0,240400,0,0,240400,219800,0,219800,0,0,219800,M1,INDUS/L,,,
16317,59-3-2-I-0,7725-78-5315,COMM & IND,9.12,AC,28900,0,28900,0,0,28900,28900,0,28900,0,0,28900,M1,INDUS/L,,,
16318,59-3-2-F-P7,7726-95-8253,COMM & IND,6.933,AC,3037900,0,3037900,0,0,3037900,2761600,0,2761600,0,0,2761600,B1,BUS/GEN,,,
16319,59-3-2-R-16,7726-50-0279,COMM & IND,13.8,AC,36700,0,36700,0,0,36700,36700,0,36700,0,0,36700,M1,INDUS/L,,,
16325,59-3-2-W-6,7725-59-4881,COMM & IND,25.17,AC,518200,0,518200,0,0,518200,518200,0,518200,0,0,518200,M1,INDUS/L,,,
16326,59-3-2-W-7,7726-51-1685,COMM & IND,24.925,AC,254800,0,254800,0,0,254800,254800,0,254800,0,0,254800,M1,INDUS/L,,,
16327,59-3-2-W-8,7726-63-8055,COMM & IND,11.11,AC,2757700,0,2757700,0,0,2757700,2686200,0,2686200,0,0,2686200,M1,INDUS/L,,,
16329,59-3-3-26-0,7725-62-2879,COMM & IND,57.431,AC,8654800,0,8654800,4093000,179800,12927600,8242700,0,8242700,4362700,152900,12758300,M1,INDUS/L,,,
16330,59-3-3-67-0,7725-72-7453,COMM & IND,13.371,AC,1675300,0,1675300,0,0,1675300,1595800,0,1595800,0,0,1595800,M1,INDUS/L,,,
16331,59-3-3-68-0,7725-73-4730,COMM & IND,17.04,AC,1228700,0,1228700,0,0,1228700,1172800,0,1172800,0,0,1172800,M1,INDUS/L,,,
16332,59-3-3-69-0,7725-74-1309,COMM & IND,21.75,AC,1523900,0,1523900,0,0,1523900,1455000,0,1455000,0,0,1455000,M1,INDUS/L,,,
16334,59-3-3-70-0,7725-65-8081,COMM & IND,16.8,AC,1167300,0,1167300,0,0,1167300,1114700,0,1114700,0,0,1114700,M1,INDUS/L,,,
16336,59-3-3-71-0,7725-65-7554,COMM & IND,14.45,AC,496700,0,496700,0,0,496700,480300,0,480300,0,0,480300,M1,INDUS/L,,,
16337,59-3-3-72-0,7725-66-5013,COMM & IND,15,AC,405500,0,405500,0,0,405500,390600,0,390600,0,0,390600,M1,INDUS/L,,,
16338,59-3-3-73-0,7725-66-3585,COMM & IND,13,AC,276300,0,276300,0,0,276300,267700,0,267700,0,0,267700,M1,INDUS/L,,,
16339,59-3-3-74-0,7725-67-4523,COMM & IND,24.21,AC,470700,0,470700,0,0,470700,470700,0,470700,0,0,470700,M1,INDUS/L,,,
16340,59-3-3-C-0,7725-82-0923,COMM & IND,5.64,AC,16800,0,16800,0,0,16800,16800,0,16800,0,0,16800,M1,INDUS/L,,,
16341,59-3-3-D-0,7725-75-9075,COMM & IND,78.54,AC,162500,0,162500,0,0,162500,162500,0,162500,0,0,162500,M1,INDUS/L,,,
16343,59-3-3-R-15,7725-75-1425,COMM & IND,18,AC,38300,0,38300,0,0,38300,38300,0,38300,0,0,38300,M1,INDUS/L,,,
16345,59-3-3-W-4,7725-56-6970,COMM & IND,22.763,AC,469600,0,469600,0,0,469600,469600,0,469600,0,0,469600,M1,INDUS/L,,,
16346,63-37-1-1-0,7724-46-3087,COMM & IND,23.18,AC,3752100,0,3752100,0,0,3752100,3573400,0,3573400,0,0,3573400,M1,INDUS/L,,,
16347,63-37-1-2-0,7724-35-6193,COMM & IND,40.3,AC,6138300,0,6138300,0,0,6138300,5846000,0,5846000,0,0,5846000,M1,INDUS/L,,,
16348,63-37-1-3-0,7724-34-7157,COMM & IND,13.18,AC,1331000,0,1331000,0,0,1331000,1267600,0,1267600,0,0,1267600,M1,INDUS/L,,,
16349,63-37-1-4-0,7724-47-5922,COMM & IND,3.78,AC,455800,0,455800,0,0,455800,434100,0,434100,0,0,434100,M1,INDUS/L,,,
16350,63-37-1-5-0,7724-47-5697,COMM & IND,14.86,AC,2422600,0,2422600,0,0,2422600,2307300,0,2307300,0,0,2307300,M1,INDUS/L,,,
16351,63-37-1-5-A,7724-37-7276,COMM & IND,0.92,AC,3000,0,3000,0,0,3000,3000,0,3000,0,0,3000,M1,INDUS/L,,,
16352,63-37-1-6-0,7724-36-1111,COMM & IND,13.78,AC,2202300,0,2202300,0,0,2202300,2097400,0,2097400,0,0,2097400,M1,INDUS/L,,,
16353,63-37-1-7-0,7724-25-6626,COMM & IND,9.4,AC,1509400,0,1509400,0,0,1509400,1437600,0,1437600,0,0,1437600,M1,INDUS/L,,,
16354,63-37-1-8-0,7724-25-1225,COMM & IND,14.048,AC,1819300,0,1819300,0,0,1819300,1732700,0,1732700,0,0,1732700,M1,INDUS/L,,,
16355,63-37-1-9-0,7724-24-5479,COMM & IND,22.9,AC,3096100,0,3096100,0,0,3096100,2948600,0,2948600,0,0,2948600,M1,INDUS/L,,,
16356,63-37-1-10-0,7724-23-7664,COMM & IND,14.6,AC,1399000,0,1399000,0,0,1399000,1332400,0,1332400,0,0,1332400,M1,INDUS/L,,,
16364,64-20-0-14-0,7734-04-9723,COMM & IND,7.3,AC,1209000,0,1209000,10780100,100,11989200,1151600,0,1151600,10780100,100,11931800,M1,INDUS/L,,,
16365,64-25-1-R-1,7724-78-4922,COMM & IND,1.95,AC,5700,0,5700,0,0,5700,5700,0,5700,0,0,5700,M1,INDUS/L,,,
16367,64-25-1-11-0,7734-22-1902,COMM & IND,11.42,AC,1020300,0,1020300,0,0,1020300,1008300,0,1008300,0,0,1008300,M1,INDUS/L,,,
16368,64-25-1-12-0,7734-03-9441,COMM & IND,12.19,AC,1950800,0,1950800,0,0,1950800,1857900,0,1857900,0,0,1857900,M1,INDUS/L,,,
16369,64-25-1-13-0,7734-05-6296,COMM & IND,4.425,AC,644000,0,644000,0,0,644000,613400,0,613400,0,0,613400,M1,INDUS/L,,,
16370,64-25-1-14-0,7724-78-9239,COMM & IND,9.984,AC,1600800,0,1600800,0,0,1600800,1524600,0,1524600,0,0,1524600,M1,INDUS/L,,,
16371,59-3-3-W-3,7725-73-3145,COMM & IND,9,AC,1177900,0,1177900,0,0,1177900,1121800,0,1121800,0,0,1121800,M1,INDUS/L,,,
16372,64-25-1-15-0,7724-88-4746,COMM & IND,21.72,AC,3447600,0,3447600,3343600,441000,7232200,3283500,0,3283500,3168700,454500,6906700,M1,INDUS/L,,,
16373,64-25-1-16-0,7724-78-1873,COMM & IND,15.71,AC,2638500,0,2638500,0,0,2638500,2512800,0,2512800,0,0,2512800,M1,INDUS/L,,,
16374,64-25-1-17-0,7724-79-6562,COMM & IND,22.6,AC,3395900,0,3395900,0,0,3395900,3234200,0,3234200,0,0,3234200,M1,INDUS/L,,,
16375,64-25-1-18-0,7724-69-0123,COMM & IND,22.471,AC,9943100,0,9943100,0,99080000,109023100,9469600,0,9469600,0,91257200,100726800,M1,INDUS/L,,,
16376,64-25-1-19-0,7724-69-8936,COMM & IND,20.26,AC,3389400,0,3389400,0,0,3389400,3228000,0,3228000,0,0,3228000,M1,INDUS/L,,,
16377,64-25-1-20-0,7725-50-8392,COMM & IND,7.328,AC,1206500,0,1206500,0,0,1206500,1149000,0,1149000,0,0,1149000,M1,INDUS/L,,,
16378,64-25-1-F-P4,7734-15-3036,COMM & IND,26.09,AC,56600,0,56600,0,0,56600,56600,0,56600,0,0,56600,M1,INDUS/L,,,
16379,64-25-3-L-2,7725-60-4853,COMM & IND,38.8,AC,17900,0,17900,0,0,17900,16500,0,16500,0,0,16500,M1,INDUS/L,,,
16380,64-25-3-R-P1,7725-81-0930,COMM & IND,5.431,AC,18300,0,18300,0,0,18300,18300,0,18300,0,0,18300,M1,INDUS/L,,,
16381,64-25-1-F-P1,7724-88-8964,COMM & IND,2.91,AC,1300,0,1300,0,0,1300,1200,0,1200,0,0,1200,M1,INDUS/L,,,
16382,64-25-1-F-P2,7725-70-9448,COMM & IND,23.6,AC,10900,0,10900,0,0,10900,10000,0,10000,0,0,10000,M1,INDUS/L,,,
16383,64-25-1-F-P3,7734-23-1750,COMM & IND,38.65,AC,79400,0,79400,0,0,79400,79400,0,79400,0,0,79400,M1,INDUS/L,,,
16384,64-25-1-F-P5,7734-06-2983,COMM & IND,69.05,AC,147400,0,147400,0,0,147400,147400,0,147400,0,0,147400,M1,INDUS/L,,,
16385,64-25-1-L-1,7724-75-9760,COMM & IND,22.05,AC,55500,0,55500,0,0,55500,55500,0,55500,0,0,55500,M1,INDUS/L,,,
16386,64-25-3-21-0,7725-71-4591,COMM & IND,16.3,AC,1949300,0,1949300,0,0,1949300,1856800,0,1856800,0,0,1856800,M1,INDUS/L,,,
16387,64-25-3-22-0,7725-61-8740,COMM & IND,8.554,AC,1231700,0,1231700,0,0,1231700,1173000,0,1173000,0,0,1173000,M1,INDUS/L,,,
16388,64-25-3-23-0,7725-51-8651,COMM & IND,13.431,AC,1757800,0,1757800,0,0,1757800,1674100,0,1674100,0,0,1674100,M1,INDUS/L,,,
16390,64-25-3-A-0,7725-81-1169,COMM & IND,21.8,AC,10100,0,10100,0,0,10100,9300,0,9300,0,0,9300,M1,INDUS/L,,,
16391,6-1-0-30-A3,6823-70-8712,Cemetery,0,AC,100,0,100,0,0,100,100,0,100,0,0,100,A1,AG/GEN,,,
16392,6-1-0-30-A2,6823-60-7773,SNGL FAM SUB,16.21,AC,125200,0,125200,0,0,125200,122500,0,122500,0,0,122500,A1,AG/GEN,,,
16393,6-1-0-30-A1,6823-70-6975,COMM & IND,5.5,AC,122800,0,122800,87100,14600,224500,119300,0,119300,71100,12800,203200,B1,BUS/GEN,,,
16394,6-1-0-46-A,6832-27-8758,SNGL FAM SUB,15,AC,120300,73500,46800,163600,3500,287400,117400,72400,45000,140900,2600,260900,A1,AG/GEN,,,
16395,11-1-0-39-F,6821-49-8008,SNGL FAM SUB,2.331,AC,48000,0,48000,15000,400,63400,46700,0,46700,14000,400,61100,A1,AG/GEN,,,
16397,13-1-0-1-N2,6842-05-4586,AG 20-100 AC,20.28,AC,125300,116000,9300,0,0,125300,123900,115300,8600,0,0,123900,A1,AG/GEN,,,
16398,13-1-0-1-N3,6842-05-6282,AG 20-100 AC,20,AC,125200,116000,9200,0,0,125200,122700,114200,8500,0,0,122700,A1,AG/GEN,,,
16399,17-4-0-4-A,6810-32-0415,SNGL FAM SUB,2.983,AC,51900,0,51900,200900,1000,253800,48900,0,48900,174800,1000,224700,A1,AG/GEN,,,
16400,17-4-0-4-B,6810-22-7556,Cemetery,0,AC,100,0,100,0,0,100,100,0,100,0,0,100,A1,AG/GEN,,,
16401,19-1-0-15-0,6820-70-7972,SNGL FAM SUB,18.18,AC,62800,54400,8400,0,0,62800,46400,38700,7700,0,0,46400,A1,AG/GEN,,,
16402,19-1-0-25-0,6729-89-1638,AG 20-100 AC,41.16,AC,104400,85400,19000,0,0,104400,102900,85400,17500,0,0,102900,A1,AG/GEN,,,
16403,19-1-0-47-B,6831-80-0092,SNGL FAM SUB,4.03,AC,82500,0,82500,152800,12000,247300,75000,0,75000,126600,12000,213600,A1,AG/GEN,,,
16404,19-1-0-47-C,6831-70-7249,SNGL FAM SUB,6.23,AC,100900,0,100900,423100,1200,525200,93300,0,93300,351400,1200,445900,A1,AG/GEN,,,
16405,20-1-0-59-B,6851-11-0050,SNGL FAM SUB,3.99,AC,75800,0,75800,206000,2000,283800,74400,0,74400,185100,2000,261500,A1,AG/GEN,,,
16406,30-1-0-26-C,6758-38-8549,SNGL FAM SUB,7.781,AC,121300,0,121300,0,0,121300,117000,0,117000,0,0,117000,A2,AG/LTD,,,
16407,31-1-0-43-E,6769-91-4943,SNGL FAM SUB,10.61,AC,184200,0,184200,998000,0,1182200,164800,0,164800,831400,0,996200,A2,AG/LTD,,,
16408,44-21-0-C-1,6786-38-1459,SNGL FAM SUB,1.38,AC,2100,0,2100,0,0,2100,1900,0,1900,0,0,1900,A2,AG/LTD,,,
16409,46-1-0-84-A,7708-81-0791,SNGL FAM SUB,6.703,AC,192800,0,192800,317600,7400,517800,172000,0,172000,290400,6900,469300,A2,AG/LTD,,,
16410,55-1-0-1-0,6776-83-3508,Roads,1.77,AC,0,0,0,0,0,0,0,0,0,0,0,0,A2,AG/LTD,,,
16423,6-1-0-34-A,6822-79-2159,SNGL FAM SUB,7.34,AC,76000,0,76000,267100,0,343100,72000,0,72000,224500,0,296500,A1,AG/GEN,,,
16424,6-1-0-34-B,6822-79-7342,SNGL FAM SUB,5.42,AC,74900,0,74900,221700,13000,309600,72900,0,72900,192700,10900,276500,A1,AG/GEN,,,
16425,12-1-0-59-C,6832-43-7275,SNGL FAM SUB,4.5,AC,64900,0,64900,0,0,64900,79700,0,79700,0,0,79700,A1,AG/GEN,,,
16426,12-1-0-59-D,6832-52-0738,AG 20-100 AC,26.179,AC,169500,0,169500,37900,4200,211600,165700,0,165700,32300,2400,200400,A1,AG/GEN,,,
16427,43-1-0-6-A1,6767-36-9659,SNGL FAM SUB,11.84,AC,193700,0,193700,0,0,193700,173200,0,173200,0,0,173200,A2,AG/LTD,,,
16428,43-1-0-6-A2,6767-36-7954,SNGL FAM SUB,3.93,AC,96800,0,96800,0,0,96800,86600,0,86600,0,0,86600,A2,AG/LTD,,,
16429,43-1-0-6-A3,6767-47-3019,SNGL FAM SUB,2.26,AC,89100,0,89100,325600,7500,422200,79600,0,79600,266200,7500,353300,A2,AG/LTD,,,
16430,56-1-0-28-A,6785-82-5592,Cemetery,0,AC,100,0,100,0,0,100,100,0,100,0,0,100,A2,AG/LTD,,,
16431,59-3-3-W-5,7725-75-6374,COMM & IND,16.88,AC,51700,0,51700,0,0,51700,51700,0,51700,0,0,51700,M1,INDUS/L,,,
16432,31-1-0-79-A,6778-59-1271,SNGL FAM SUB,6,AC,126600,0,126600,195400,23000,345000,113200,0,113200,160500,21700,295400,A2,AG/LTD,,,
16433,59-1-0-18-TW,7726-87-3223-9998,COMM & IND,0,AC,0,0,0,0,139200,139200,0,0,0,0,137300,137300,B1,BUS/GEN,,,
16434,6-1-0-12-C,6823-84-3123,SNGL FAM SUB,5.83,AC,64300,0,64300,0,0,64300,63200,0,63200,0,0,63200,A1,AG/GEN,,,
16435,12-1-0-59-E,6832-52-3354,SNGL FAM SUB,10.01,AC,95200,0,95200,0,0,95200,92800,0,92800,0,0,92800,A1,AG/GEN,,,
16436,16-1-0-53-A,5890-79-2484,SNGL FAM SUB,3,AC,46000,0,46000,138600,400,185000,45000,0,45000,126400,500,171900,A1,AG/GEN,,,
16437,16-1-0-53-B,5890-79-1295,SNGL FAM SUB,3,AC,46000,0,46000,162400,500,208900,45000,0,45000,127800,500,173300,A1,AG/GEN,,,
16438,19-14-0-A-0,6830-74-1354,AG 20-100 AC,28.51,AC,234600,128200,106400,556500,0,791100,206700,110800,95900,461800,0,668500,A1,AG/GEN,,,
16440,19-14-0-C-0,6830-75-6263,AG 20-100 AC,26.34,AC,209000,196900,12100,0,0,209000,194300,183100,11200,0,0,194300,A1,AG/GEN,,,
16442,19-14-0-E-0,6830-84-0400,AG 20-100 AC,20.72,AC,174700,128900,45800,0,38100,212800,162300,123300,39000,0,33400,195700,A1,AG/GEN,,,
16443,19-14-0-F-0,6830-74-6245,Cemetery,0.25,AC,100,0,100,0,0,100,100,0,100,0,0,100,A1,AG/GEN,,,
16444,19-14-0-G-0,6830-75-3530,SNGL FAM SUB,10.42,AC,112900,0,112900,275200,2500,390600,108300,0,108300,229100,2500,339900,A1,AG/GEN,,,
16445,19-14-0-H-0,6830-95-6409,AG 20-100 AC,47.23,AC,215300,187500,27800,0,0,215300,206100,178900,27200,0,0,206100,A1,AG/GEN,,,
16446,29-1-0-108-0,6759-11-1852,SNGL FAM SUB,2.75,AC,44200,0,44200,0,0,44200,40400,0,40400,0,0,40400,A1,AG/GEN,,,
16447,39-1-0-48-C1,6716-89-7812,AG 20-100 AC,21,AC,130800,82800,48000,205800,0,336600,128000,81500,46500,181200,0,309200,A1,AG/GEN,,,
16448,39-1-0-48-C2,6716-99-7082,AG 20-100 AC,21.95,AC,135200,84800,50400,209400,700,345300,132300,83600,48700,177800,700,310800,A1,AG/GEN,,,
16450,64-7-0-B-1TW,7734-01-6575-9998,COMM & IND,0,AC,0,0,0,0,107600,107600,0,0,0,0,104500,104500,A2,AG/LTD,,,
16605,20-21-0-31-0,6840-83-9431,SNGL FAM SUB,3,AC,100000,0,100000,463500,0,563500,90000,0,90000,429900,0,519900,RR,RES/RUR,,,
16606,20-21-0-32-0,6840-93-2137,SNGL FAM SUB,3,AC,100000,0,100000,493400,21200,614600,90000,0,90000,450500,19500,560000,RR,RES/RUR,,,
16607,20-21-0-33-0,6840-92-4867,SNGL FAM SUB,3.01,AC,100000,0,100000,358700,60400,519100,90000,0,90000,326100,56600,472700,RR,RES/RUR,,,
16608,20-21-0-34-0,6840-92-7934,SNGL FAM SUB,3.01,AC,100000,0,100000,459100,0,559100,90000,0,90000,420800,0,510800,RR,RES/RUR,,,
16609,20-21-0-35-0,6840-92-9977,SNGL FAM SUB,3.01,AC,100000,0,100000,298300,29700,428000,90000,0,90000,263400,26600,380000,RR,RES/RUR,,,
16610,20-21-0-36-0,6840-93-7376,SNGL FAM SUB,3.9,AC,100000,0,100000,375700,2500,478200,90000,0,90000,345200,2500,437700,RR,RES/RUR,,,
16611,20-21-0-28-0,6840-82-9899,SNGL FAM SUB,3.05,AC,100000,0,100000,400900,5000,505900,90000,0,90000,362400,5400,457800,RR,RES/RUR,,,
16612,20-21-0-37-0,6840-93-4427,SNGL FAM SUB,3,AC,100000,0,100000,446700,23200,569900,90000,0,90000,406300,22600,518900,RR,RES/RUR,,,
16613,20-21-0-38-0,6840-93-1625,SNGL FAM SUB,3,AC,100000,0,100000,286800,0,386800,90000,0,90000,255100,0,345100,RR,RES/RUR,,,
16614,20-21-0-39-0,6840-83-6973,SNGL FAM SUB,4,AC,100000,0,100000,338900,0,438900,90000,0,90000,308700,0,398700,RR,RES/RUR,,,
17047,44-27-0-13-0,6787-28-7042,SNGL FAM SUB,2.152,AC,140000,0,140000,481500,2600,624100,125000,0,125000,439500,2600,567100,RP,"RURAL,P",,,
17048,44-27-0-14-0,6787-27-4985,SNGL FAM SUB,2.079,AC,140000,0,140000,333800,0,473800,125000,0,125000,307300,0,432300,RP,"RURAL,P",,,
17049,44-27-0-15-0,6787-28-3028,SNGL FAM SUB,2.052,AC,140000,0,140000,459000,8000,607000,125000,0,125000,421000,5800,551800,RP,"RURAL,P",,,
17050,44-27-0-16-0,6787-28-2414,SNGL FAM SUB,2,AC,140000,0,140000,337000,0,477000,125000,0,125000,311600,0,436600,RP,"RURAL,P",,,
17051,44-27-0-17-0,6787-28-0266,SNGL FAM SUB,2.005,AC,140000,0,140000,414500,0,554500,125000,0,125000,384000,0,509000,RP,"RURAL,P",,,
16451,44-1-0-10-F,6787-44-5102,SNGL FAM SUB,2.31,AC,90800,0,90800,464000,0,554800,81100,0,81100,377600,0,458700,A2,AG/LTD,,,
16453,57-34-0-A-0,7705-02-8182,Cmn Area/Open Spc,11.415,AC,0,0,0,0,0,0,0,0,0,0,0,0,RR,RES/RUR,,,
16454,57-34-0-B-0,7705-13-3817,Roads,4.1,AC,0,0,0,0,0,0,0,0,0,0,0,0,RR,RES/RUR,,,
16455,57-34-0-42-0,7705-12-2808,SNGL FAM SUB,12.23,AC,1030100,0,1030100,1144500,75700,2250300,895700,0,895700,1158500,67100,2121300,RR,RES/RUR,,,
16456,57-34-0-43-0,7705-13-4388,SNGL FAM SUB,10.77,AC,937200,0,937200,1841900,65700,2844800,815100,0,815100,1826900,55100,2697100,RR,RES/RUR,,,
16457,57-34-0-48-0,7705-13-8617,SNGL FAM SUB,15.095,AC,1107900,0,1107900,955100,4800,2067800,963400,0,963400,991000,3700,1958100,RR,RES/RUR,,,
16458,67-27-0-A-0,7733-56-3256,Cmn Area/Open Spc,9.943,AC,0,0,0,0,0,0,0,0,0,0,0,0,RPUD,RES/PUD,,,
16459,67-27-0-B-0,7733-56-7230,Roads,1.116,AC,0,0,0,0,0,0,0,0,0,0,0,0,RPUD,RES/PUD,,,
16460,67-27-0-70-0,7733-56-8729,SNGL FAM URB,0.364,AC,230000,0,230000,620000,0,850000,200000,0,200000,568700,0,768700,RPUD,RES/PUD,,,
16461,67-27-0-71-0,7733-56-9768,SNGL FAM URB,0.411,AC,230000,0,230000,655600,0,885600,200000,0,200000,604100,0,804100,RPUD,RES/PUD,,,
16462,67-27-0-72-0,7733-66-0827,SNGL FAM URB,0.425,AC,230000,0,230000,641000,0,871000,200000,0,200000,591200,0,791200,RPUD,RES/PUD,,,
16463,67-27-0-103-0,7733-56-7636,SNGL FAM URB,0.318,AC,230000,0,230000,602900,8600,841500,200000,0,200000,528700,8200,736900,RPUD,RES/PUD,,,
16464,67-27-0-104-0,7733-56-6650,SNGL FAM URB,0.345,AC,230000,0,230000,725900,0,955900,200000,0,200000,668200,0,868200,RPUD,RES/PUD,,,
16465,67-27-0-105-0,7733-56-5564,SNGL FAM URB,0.345,AC,230000,0,230000,659800,0,889800,200000,0,200000,619100,0,819100,RPUD,RES/PUD,,,
16467,67-27-0-106-0,7733-56-4469,SNGL FAM URB,0.359,AC,230000,0,230000,667100,0,897100,200000,0,200000,614500,0,814500,RPUD,RES/PUD,,,
16468,67-27-0-107-0,7733-56-4401,SNGL FAM URB,0.703,AC,230000,0,230000,748000,0,978000,200000,0,200000,685900,0,885900,RPUD,RES/PUD,,,
16469,67-27-0-108-0,7733-56-4219,SNGL FAM URB,0.522,AC,230000,0,230000,691300,0,921300,200000,0,200000,636800,0,836800,RPUD,RES/PUD,,,
16470,67-27-0-109-0,7733-56-4280,SNGL FAM URB,0.352,AC,230000,0,230000,671700,0,901700,200000,0,200000,618600,0,818600,RPUD,RES/PUD,,,
16471,67-27-0-110-0,7733-56-5196,SNGL FAM URB,0.323,AC,230000,0,230000,739000,0,969000,200000,0,200000,678100,0,878100,RPUD,RES/PUD,,,
16472,67-27-0-111-0,7733-56-6191,SNGL FAM URB,0.322,AC,230000,0,230000,642600,0,872600,200000,0,200000,590900,0,790900,RPUD,RES/PUD,,,
16473,67-27-0-112-0,7733-56-7087,SNGL FAM URB,0.388,AC,230000,0,230000,587200,0,817200,200000,0,200000,542700,0,742700,RPUD,RES/PUD,,,
16474,67-27-0-113-0,7733-56-8086,SNGL FAM URB,0.355,AC,230000,0,230000,740000,0,970000,200000,0,200000,682900,0,882900,RPUD,RES/PUD,,,
16475,67-27-0-114-0,7733-66-0008,SNGL FAM URB,0.403,AC,230000,0,230000,824000,0,1054000,200000,0,200000,772300,0,972300,RPUD,RES/PUD,,,
16476,67-27-0-115-0,7733-66-0265,SNGL FAM URB,0.732,AC,230000,0,230000,625900,0,855900,200000,0,200000,576800,0,776800,RPUD,RES/PUD,,,
16477,67-27-0-116-0,7733-56-9269,SNGL FAM URB,0.365,AC,230000,0,230000,891200,0,1121200,200000,0,200000,839700,0,1039700,RPUD,RES/PUD,,,
16478,67-27-0-117-0,7733-56-8238,SNGL FAM URB,0.421,AC,230000,0,230000,689200,600,919800,200000,0,200000,636500,600,837100,RPUD,RES/PUD,,,
16479,67-27-0-118-0,7733-56-7331,SNGL FAM URB,0.336,AC,230000,0,230000,716400,0,946400,200000,0,200000,660400,0,860400,RPUD,RES/PUD,,,
16480,67-27-0-119-0,7733-56-6356,SNGL FAM URB,0.34,AC,230000,0,230000,742200,0,972200,200000,0,200000,677500,0,877500,RPUD,RES/PUD,,,
16481,67-27-0-120-0,7733-56-7475,SNGL FAM URB,0.395,AC,230000,0,230000,586300,0,816300,200000,0,200000,540500,0,740500,RPUD,RES/PUD,,,
16482,67-27-0-121-0,7733-56-8562,SNGL FAM URB,0.393,AC,230000,0,230000,672200,0,902200,200000,0,200000,618600,0,818600,RPUD,RES/PUD,,,
16483,67-27-0-122-0,7733-56-9640,SNGL FAM URB,0.444,AC,230000,0,230000,695300,0,925300,200000,0,200000,640600,0,840600,RPUD,RES/PUD,,,
16484,67-27-0-123-0,7733-66-0652,SNGL FAM URB,0.39,AC,230000,0,230000,569900,0,799900,200000,0,200000,524700,0,724700,RPUD,RES/PUD,,,
16485,67-27-0-124-0,7733-66-1655,SNGL FAM URB,0.514,AC,230000,0,230000,576900,0,806900,200000,0,200000,535800,0,735800,RPUD,RES/PUD,,,
16486,67-27-0-125-0,7733-66-2709,SNGL FAM URB,0.376,AC,230000,0,230000,721400,0,951400,200000,0,200000,668100,0,868100,RPUD,RES/PUD,,,
16489,42-1-0-58-D,6767-06-0168,General Gov,3.708,AC,463100,0,463100,1970600,60800,2494500,445300,0,445300,1878000,42400,2365700,R3,RES/GEN,,,
16490,43-1-0-81-A,6777-01-9622,SNGL FAM SUB,2.01,AC,84600,0,84600,17700,17500,119800,75600,0,75600,19900,14100,109600,A2,AG/LTD,,,
16492,48-1-0-13-K,7727-49-7314,COMM & IND,4.564,AC,755300,0,755300,0,204500,959800,719300,0,719300,0,204500,923800,M2,INDUS/G,,,
16495,62-15-0-C-1,7704-36-6821,SNGL FAM SUB,15.5,AC,501900,494000,7900,0,0,501900,437700,431000,6700,0,0,437700,A2,AG/LTD,,,
16496,62-15-0-C-2,7704-25-8868,SNGL FAM SUB,12.5,AC,433800,255400,178400,757700,10600,1202100,378500,221600,156900,667300,9200,1055000,A2,AG/LTD,,,
16497,62-15-0-C-3,7704-35-3921,SNGL FAM SUB,12.5,AC,433800,255600,178200,0,28900,462700,378500,221500,157000,0,27500,406000,A2,AG/LTD,,,
16498,62-15-0-C-4,7704-25-4546,SNGL FAM SUB,7.5,AC,324000,0,324000,444200,4100,772300,284000,0,284000,417200,4500,705700,A2,AG/LTD,,,
16499,62-15-0-C-5,7704-25-7033,SNGL FAM SUB,7.5,AC,324000,0,324000,211100,500,535600,284000,0,284000,186400,500,470900,A2,AG/LTD,,,
16500,64-1-0-31-B,7723-79-6696,Academic-Private,66.905,AC,2502200,0,2502200,1833600,1125900,5461700,2174400,0,2174400,1941400,1118500,5234300,A2,AG/LTD,,,
16501,5-4-0-5-A,6823-01-1033,SNGL FAM SUB,2.67,AC,48200,0,48200,0,0,48200,47400,0,47400,0,0,47400,A1,AG/GEN,,,
16502,5-4-0-5-B,6823-01-3043,SNGL FAM SUB,2.22,AC,45900,0,45900,0,0,45900,45100,0,45100,0,0,45100,A1,AG/GEN,,,
16504,9-1-0-63-B,5891-69-4548,AG 20-100 AC,41.022,AC,120900,63600,57300,237000,5300,363200,123000,63000,60000,210100,5500,338600,A1,AG/GEN,,,
16505,9-1-0-63-B1,5891-79-6841,SNGL FAM SUB,0.042,AC,200,0,200,0,0,200,200,0,200,0,0,200,A1,AG/GEN,,,
16506,9-1-0-63-C,5891-68-7973,AG 20-100 AC,40,AC,119500,61300,58200,31400,26400,177300,121000,61200,59800,34500,19200,174700,A1,AG/GEN,,,
16507,11-1-0-41-C,6821-37-6749,SNGL FAM SUB,10,AC,89100,44500,44600,223600,1000,313700,87500,45700,41800,191500,1000,280000,A1,AG/GEN,,,
16509,29-1-0-38-C,6748-77-3946,AG 20-100 AC,26.33,AC,196800,184300,12500,0,0,196800,195100,183900,11200,0,0,195100,A1,AG/GEN,,,
16510,29-1-0-38-D,6748-88-1582,AG 20-100 AC,22.26,AC,178100,167800,10300,0,0,178100,173600,164100,9500,0,0,173600,A1,AG/GEN,,,
16511,32-4-0-7-A,6779-54-9584,SNGL FAM SUB,2.16,AC,77300,0,77300,210200,1000,288500,69000,0,69000,171100,1000,241100,A2,AG/LTD,,,
16512,39-11-0-1-0,6727-29-6199,AG 20-100 AC,26.19,AC,167300,0,167300,841100,107500,1115900,164000,0,164000,762000,96100,1022100,A1,AG/GEN,,,
16513,39-11-0-2-0,6727-39-4095,AG 20-100 AC,26.54,AC,169100,133700,35400,0,0,169100,165700,131500,34200,0,0,165700,A1,AG/GEN,,,
16514,39-11-0-3-0,6727-49-5969,AG 20-100 AC,42.11,AC,248500,224400,24100,0,1400,249900,243600,221100,22500,0,1500,245100,A1,AG/GEN,,,
16515,39-11-0-4-0,6728-50-9029,AG 20-100 AC,75.72,AC,335500,297000,38500,0,97900,433400,327400,291600,35800,0,88500,415900,A1,AG/GEN,,,
16517,39-11-0-6-0,6727-27-7994,SNGL FAM SUB,4.19,AC,58300,0,58300,226300,800,285400,57100,0,57100,191000,900,249000,A1,AG/GEN,,,
16518,39-11-0-7-0,6727-28-8226,SNGL FAM SUB,3.56,AC,54400,0,54400,253000,50900,358300,53400,0,53400,214800,49300,317500,A1,AG/GEN,,,
16519,41-1-0-8-J1,6747-78-5439,AG 20-100 AC,37.85,AC,211500,164600,46900,0,0,211500,200500,156900,43600,0,0,200500,A1,AG/GEN,,,
16520,41-1-0-8-J2,6747-88-3303,AG 20-100 AC,25.01,AC,157500,145000,12500,0,0,157500,152200,141500,10700,0,0,152200,A1,AG/GEN,,,
16521,44-1-0-73-B,6786-58-1126,SNGL FAM SUB,2.12,AC,87000,0,87000,244900,1000,332900,77700,0,77700,199400,1000,278100,A2,AG/LTD,,,
16522,44-1-0-73-C,6786-58-2715,SNGL FAM SUB,4.395,AC,121400,0,121400,379400,24300,525100,108400,0,108400,314000,21000,443400,A2,AG/LTD,,,
16524,63-11-0-A-5B,7714-48-8137,SNGL FAM SUB,2.259,AC,149000,0,149000,0,0,149000,129600,0,129600,0,0,129600,A2,AG/LTD,,,
16525,5-4-0-5-C,6823-01-4384,SNGL FAM SUB,2,AC,44800,0,44800,0,0,44800,44000,0,44000,0,0,44000,A1,AG/GEN,,,
16526,29-1-0-38-B,6748-87-1540,AG 20-100 AC,21.17,AC,161500,111700,49800,378100,0,539600,144000,128600,15400,316500,0,460500,A1,AG/GEN,,,
16527,39-11-0-5-0,6727-37-9947,AG 20-100 AC,42.39,AC,249900,142200,107700,0,11600,261500,245000,140100,104900,0,9800,254800,A1,AG/GEN,,,
16528,6-1-0-4-B1,6823-88-6328,SNGL FAM SUB,3,AC,49900,0,49900,47400,500,97800,49000,0,49000,51400,500,100900,A1,AG/GEN,,,
16529,9-1-0-42-C,5892-41-8625,SNGL FAM SUB,2.08,AC,42700,0,42700,139300,0,182000,41800,0,41800,120500,0,162300,A1,AG/GEN,,,
16531,17-12-0-2-0,6719-07-1266,SNGL FAM SUB,4.47,AC,60400,0,60400,83600,800,144800,57100,0,57100,68700,800,126600,A1,AG/GEN,,,
16532,17-12-0-3-0,6719-06-4810,SNGL FAM SUB,7.28,AC,75500,0,75500,131700,200,207400,72500,0,72500,108200,200,180900,A1,AG/GEN,,,
16533,19-1-0-62-C,6830-72-8669,SNGL FAM SUB,12.92,AC,142900,136300,6600,0,0,142900,136900,131300,5600,0,0,136900,A1,AG/GEN,,,
16534,20-1-0-34-D,6840-40-8437,SNGL FAM SUB,5.729,AC,105800,102900,2900,0,0,105800,99100,96600,2500,0,0,99100,A1,AG/GEN,,,
16535,20-1-0-34-E,6749-59-0929,SNGL FAM SUB,3.279,AC,79000,0,79000,366900,13900,459800,73600,0,73600,310200,12300,396100,A1,AG/GEN,,,
16536,26-1-0-57-H,6719-22-5204,Cemetery,0,AC,100,0,100,0,0,100,100,0,100,0,0,100,A1,AG/GEN,,,
16538,47-1-0-45-B,7727-01-9364,Cemetery,0.5,AC,100,0,100,0,0,100,100,0,100,0,0,100,A2,AG/LTD,,,
16540,13-1-0-1-NTW,6832-94-7716-9998,COMM & IND,0,AC,0,0,0,0,132800,132800,0,0,0,0,128400,128400,A1,AG/GEN,,,
16545,31-10-2-8-A,6779-50-4467,SNGL FAM SUB,0.05,AC,700,0,700,0,0,700,600,0,600,0,0,600,A2,AG/LTD,,,
16546,2-5-0-A-0,6814-53-6520,Roads,1.37,AC,0,0,0,0,0,0,0,0,0,0,0,0,B1A1,BS & AG,,,
16547,2-5-0-B-1,6814-53-2783,SNGL FAM SUB,3.346,AC,51700,0,51700,256000,0,307700,50700,0,50700,237800,0,288500,A1,AG/GEN,,,
16548,2-5-0-B-2,6814-63-1915,COMM & IND,20.3,AC,796900,787500,9400,0,0,796900,773100,0,773100,0,0,773100,B1,BUS/GEN,,,
16549,2-5-0-1-0,6814-53-8694,SNGL FAM SUB,5.001,AC,69200,0,69200,305800,7100,382100,66600,0,66600,264800,5400,336800,RR,RES/RUR,,,
16550,2-5-0-2-0,6814-63-2216,SNGL FAM SUB,7.77,AC,83400,0,83400,154900,19100,257400,80300,0,80300,150200,16600,247100,RR,RES/RUR,,,
16551,2-5-0-3-0,6814-62-0671,SNGL FAM SUB,13.253,AC,109700,0,109700,295200,0,404900,107100,0,107100,252500,0,359600,RR,RES/RUR,,,
16552,2-5-0-4-0,6814-52-5404,SNGL FAM SUB,10.628,AC,94700,0,94700,356000,9200,459900,91800,0,91800,303900,9200,404900,RR,RES/RUR,,,
16553,2-5-0-5-0,6814-52-3970,SNGL FAM SUB,5.936,AC,74700,0,74700,0,0,74700,76500,0,76500,0,0,76500,RR,RES/RUR,,,
16554,2-5-0-6-0,6814-53-2157,SNGL FAM SUB,5.781,AC,73700,0,73700,256400,18000,348100,81100,0,81100,218100,15300,314500,RR,RES/RUR,,,
16555,5-1-0-18-A,6813-82-1186,Cemetery,0,AC,100,0,100,0,0,100,100,0,100,0,0,100,A1,AG/GEN,,,
16556,5-1-0-43-B,6823-18-1248,SNGL FAM SUB,4,AC,55000,0,55000,259800,2000,316800,54000,0,54000,225200,2000,281200,A1,AG/GEN,,,
16557,5-1-0-65-A1,6823-28-9686,SNGL FAM SUB,2.5,AC,47400,0,47400,0,0,47400,46500,0,46500,0,0,46500,A1,AG/GEN,,,
16558,5-1-0-71-C,6823-68-9386,SNGL FAM SUB,7.088,AC,68700,0,68700,89800,500,159000,67500,0,67500,81600,700,149800,A1,AG/GEN,,,
16559,6-1-0-4-H1,6823-97-0820,SNGL FAM SUB,6.017,AC,65300,0,65300,276100,0,341400,64100,0,64100,243100,0,307200,A1,AG/GEN,,,
16560,18-1-0-64-D,6820-46-8288,SNGL FAM SUB,3.376,AC,54100,0,54100,99900,4700,158700,52300,0,52300,77300,4700,134300,A1,AG/GEN,,,
16561,18-10-0-2-B,6719-89-8706,SNGL FAM SUB,2.92,AC,51500,0,51500,24900,0,76400,48600,0,48600,26600,0,75200,A1,AG/GEN,,,
16562,18-10-0-6-A,6729-09-0663,SNGL FAM SUB,5,AC,63500,0,63500,253000,1500,318000,62000,0,62000,205700,1500,269200,A1,AG/GEN,,,
16563,19-1-0-6-B,6831-01-1526,SNGL FAM SUB,2.07,AC,48100,0,48100,226200,0,274300,47800,0,47800,186500,0,234300,A1,AG/GEN,,,
16564,22-1-0-14-0,6769-57-2799,SNGL FAM SUB,4,AC,97100,0,97100,523600,3300,624000,87800,0,87800,431400,3300,522500,A2,AG/LTD,,,
16565,27-1-0-4-A1,6719-85-3323,AG 20-100 AC,30,AC,140600,0,140600,0,2500,143100,135000,0,135000,0,2800,137800,A1,AG/GEN,,,
16566,27-5-0-3-A1,6728-66-7395,SNGL FAM SUB,2.94,AC,50600,0,50600,137500,0,188100,49600,0,49600,109700,0,159300,A1,AG/GEN,,,
16567,30-1-0-107-TW,6759-92-0870-9998,COMM & IND,0,AC,0,0,0,0,148200,148200,0,0,0,0,146000,146000,A2,AG/LTD,,,
16568,19-1-0-6-C,6831-01-1746,SNGL FAM SUB,2.08,AC,48100,0,48100,106100,2700,156900,47900,0,47900,83200,2700,133800,A1,AG/GEN,,,
16569,19-15-0-A-0,6830-09-5277,SNGL FAM SUB,0.36,AC,1400,0,1400,0,0,1400,1900,0,1900,0,0,1900,RR,RES/RUR,,,
16570,19-15-0-1-0,6820-99-9328,SNGL FAM SUB,14.663,AC,114500,0,114500,320600,7500,442600,108900,0,108900,264600,6500,380000,RR,RES/RUR,,,
16571,19-15-0-2-0,6820-99-2214,SNGL FAM SUB,5.982,AC,80300,0,80300,293200,25300,398800,75600,0,75600,243600,21900,341100,RR,RES/RUR,,,
16572,19-15-0-3-0,6820-98-1937,SNGL FAM SUB,6.183,AC,81600,0,81600,579400,0,661000,76800,0,76800,492900,0,569700,RR,RES/RUR,,,
16573,19-15-0-4-0,6820-98-7756,SNGL FAM SUB,14.512,AC,114000,0,114000,302900,20700,437600,108200,0,108200,251300,23500,383000,RR,RES/RUR,,,
16575,20-21-0-B-0,6840-91-5555,Cmn Area/Open Spc,0.32,AC,0,0,0,0,0,0,0,0,0,0,0,0,RR,RES/RUR,,,
16576,20-21-0-1-0,6850-02-3447,SNGL FAM SUB,3.11,AC,100000,0,100000,279200,0,379200,90000,0,90000,253700,0,343700,RR,RES/RUR,,,
16577,20-21-0-2-0,6850-02-3153,SNGL FAM SUB,3,AC,100000,0,100000,442700,4000,546700,90000,0,90000,406600,3100,499700,RR,RES/RUR,,,
16578,20-21-0-3-0,6850-01-1970,SNGL FAM SUB,3,AC,100000,0,100000,238100,0,338100,90000,0,90000,216100,0,306100,RR,RES/RUR,,,
16579,20-21-0-4-0,6840-91-8745,SNGL FAM SUB,3.89,AC,100000,0,100000,383500,29100,512600,90000,0,90000,349200,24900,464100,RR,RES/RUR,,,
16580,20-21-0-5-0,6840-91-9464,SNGL FAM SUB,6.06,AC,105000,0,105000,359300,8100,472400,95000,0,95000,328900,8100,432000,RR,RES/RUR,,,
16581,20-21-0-6-0,6840-91-7261,SNGL FAM SUB,3.18,AC,95000,0,95000,238600,2500,336100,85500,0,85500,214900,2700,303100,RR,RES/RUR,,,
16582,20-21-0-7-0,6840-90-8913,SNGL FAM SUB,3.01,AC,100000,0,100000,343300,0,443300,90000,0,90000,315600,0,405600,RR,RES/RUR,,,
16583,20-21-0-8-0,6840-90-7489,SNGL FAM SUB,3.01,AC,100000,0,100000,381200,0,481200,90000,0,90000,348500,0,438500,RR,RES/RUR,,,
16584,20-21-0-9-0,6840-90-5302,SNGL FAM SUB,3.21,AC,100000,0,100000,483800,31100,614900,90000,0,90000,440200,29500,559700,RR,RES/RUR,,,
16585,20-21-0-10-0,6840-90-3631,SNGL FAM SUB,3.01,AC,100000,0,100000,348400,0,448400,90000,0,90000,317300,0,407300,RR,RES/RUR,,,
16586,20-21-0-11-0,6840-90-0893,SNGL FAM SUB,3.45,AC,100000,0,100000,486700,4000,590700,90000,0,90000,442800,4300,537100,RR,RES/RUR,,,
16587,20-21-0-12-0,6840-90-3937,SNGL FAM SUB,3,AC,100000,0,100000,490300,6900,597200,90000,0,90000,450500,6300,546800,RR,RES/RUR,,,
16588,20-21-0-13-0,6840-91-2289,SNGL FAM SUB,3.72,AC,100000,0,100000,275600,2000,377600,90000,0,90000,256600,2000,348600,RR,RES/RUR,,,
16589,20-21-0-14-0,6840-91-3747,SNGL FAM SUB,3,AC,100000,0,100000,263600,0,363600,90000,0,90000,245400,0,335400,RR,RES/RUR,,,
16590,20-21-0-15-0,6840-92-5004,SNGL FAM SUB,3,AC,100000,0,100000,350100,2100,452200,90000,0,90000,319500,2200,411700,RR,RES/RUR,,,
16591,20-21-0-16-0,6840-92-7255,SNGL FAM SUB,3,AC,100000,0,100000,287600,32400,420000,90000,0,90000,262900,29700,382600,RR,RES/RUR,,,
16592,20-21-0-17-0,6840-92-8593,SNGL FAM SUB,3,AC,100000,0,100000,372400,25500,497900,90000,0,90000,340900,22700,453600,RR,RES/RUR,,,
16593,20-21-0-18-0,6840-92-4417,SNGL FAM SUB,3,AC,100000,0,100000,473400,25300,598700,90000,0,90000,418800,2500,511300,RR,RES/RUR,,,
16594,20-21-0-19-0,6840-92-1250,SNGL FAM SUB,3,AC,100000,0,100000,264500,4400,368900,90000,0,90000,243500,3100,336600,RR,RES/RUR,,,
16595,20-21-0-20-0,6840-91-0788,SNGL FAM SUB,3.02,AC,100000,0,100000,352400,0,452400,90000,0,90000,321000,0,411000,RR,RES/RUR,,,
16596,20-21-0-21-0,6840-81-8599,SNGL FAM SUB,3.17,AC,100000,0,100000,732700,3900,836600,90000,0,90000,665600,2700,758300,RR,RES/RUR,,,
16597,20-21-0-22-0,6840-81-5681,SNGL FAM SUB,3.33,AC,100000,0,100000,499000,0,599000,90000,0,90000,452500,0,542500,RR,RES/RUR,,,
16598,20-21-0-23-0,6840-81-4706,SNGL FAM SUB,3.55,AC,100000,0,100000,497200,0,597200,90000,0,90000,452600,0,542600,RR,RES/RUR,,,
16599,20-21-0-24-0,6840-82-5164,SNGL FAM SUB,3,AC,100000,0,100000,655800,99600,855400,90000,0,90000,597300,94200,781500,RR,RES/RUR,,,
16600,20-21-0-25-0,6840-82-6377,SNGL FAM SUB,3,AC,100000,0,100000,584600,23500,708100,90000,0,90000,532900,22300,645200,RR,RES/RUR,,,
16601,20-21-0-26-0,6840-82-7548,SNGL FAM SUB,3,AC,100000,0,100000,336100,1000,437100,90000,0,90000,305800,1000,396800,RR,RES/RUR,,,
16602,20-21-0-27-0,6840-82-8753,SNGL FAM SUB,3,AC,100000,0,100000,332900,0,432900,90000,0,90000,301600,0,391600,RR,RES/RUR,,,
16603,20-21-0-29-0,6840-83-5101,SNGL FAM SUB,3,AC,100000,0,100000,371300,0,471300,90000,0,90000,338200,0,428200,RR,RES/RUR,,,
16604,20-21-0-30-0,6840-83-6309,SNGL FAM SUB,3,AC,100000,0,100000,381500,0,481500,90000,0,90000,344800,0,434800,RR,RES/RUR,,,
16615,20-21-0-40-0,6840-84-8126,SNGL FAM SUB,3.58,AC,100000,0,100000,292400,0,392400,90000,0,90000,267000,0,357000,RR,RES/RUR,,,
16616,20-21-0-41-0,6840-94-0367,SNGL FAM SUB,4.8,AC,100000,0,100000,374100,0,474100,90000,0,90000,347800,0,437800,RR,RES/RUR,,,
16617,20-21-0-42-0,6840-94-2192,SNGL FAM SUB,3,AC,100000,0,100000,384300,0,484300,90000,0,90000,349600,0,439600,RR,RES/RUR,,,
16618,20-21-0-43-0,6840-93-5971,SNGL FAM SUB,3,AC,100000,0,100000,477900,3100,581000,90000,0,90000,433300,3400,526700,RR,RES/RUR,,,
16619,20-21-0-44-0,6840-93-9709,SNGL FAM SUB,3.01,AC,100000,0,100000,512700,0,612700,90000,0,90000,465200,0,555200,RR,RES/RUR,,,
16620,20-21-0-45-0,6840-94-7119,SNGL FAM SUB,3,AC,100000,0,100000,403700,2800,506500,90000,0,90000,366800,1900,458700,RR,RES/RUR,,,
16621,20-21-0-46-0,6840-94-3593,SNGL FAM SUB,3.13,AC,100000,0,100000,268300,2500,370800,90000,0,90000,244100,2500,336600,RR,RES/RUR,,,
16622,20-21-0-47-0,6840-94-5714,SNGL FAM SUB,3.04,AC,100000,0,100000,326000,4000,430000,90000,0,90000,296700,4000,390700,RR,RES/RUR,,,
16623,20-21-0-48-0,6840-94-8707,SNGL FAM SUB,3.09,AC,100000,0,100000,0,0,100000,90000,0,90000,0,0,90000,RR,RES/RUR,,,
16624,20-21-0-49-0,6850-04-0414,SNGL FAM SUB,3,AC,100000,0,100000,333800,0,433800,90000,0,90000,303600,0,393600,RR,RES/RUR,,,
16625,6-1-0-58-A,6833-83-3881,SNGL FAM SUB,5.08,AC,58300,0,58300,195900,16400,270600,57200,0,57200,169200,14700,241100,RR,RES/RUR,,,
16626,6-1-0-58-B,6833-73-8128,SNGL FAM SUB,8.32,AC,73200,0,73200,182600,14300,270100,71700,0,71700,152200,2000,225900,RR,RES/RUR,,,
16627,6-1-0-58-C,6833-72-6528,SNGL FAM SUB,8.74,AC,75100,0,75100,0,0,75100,73600,0,73600,0,0,73600,RR,RES/RUR,,,
16628,9-1-0-52-B,5891-46-4985,AG > 100 AC,100.152,AC,205500,159300,46200,0,0,205500,200300,157700,42600,0,0,200300,A1,AG/GEN,,,
16629,9-1-0-54-A,5891-72-7906,Cemetery,0,AC,100,0,100,0,0,100,100,0,100,0,0,100,A1,AG/GEN,,,
16630,9-1-0-54-B,5891-43-7098,AG > 100 AC,381.18,AC,782200,606500,175700,0,0,782200,762400,600400,162000,0,0,762400,A1,AG/GEN,,,
16631,9-1-0-54-B1,5891-73-7372,SNGL FAM SUB,3,AC,46000,0,46000,144700,500,191200,45000,0,45000,130000,500,175500,A1,AG/GEN,,,
16632,9-1-0-58-A,6801-06-8107,SNGL FAM SUB,6.43,AC,58300,0,58300,131900,2200,192400,57000,0,57000,115800,2300,175100,A1,AG/GEN,,,
16633,9-1-0-58-B,6801-05-5918,SNGL FAM SUB,5.37,AC,54500,0,54500,134900,500,189900,53300,0,53300,117800,500,171600,A1,AG/GEN,,,
16634,9-1-0-58-C,6801-05-3801,SNGL FAM SUB,4.59,AC,51700,0,51700,134900,2000,188600,50600,0,50600,117800,2200,170600,A1,AG/GEN,,,
16635,9-1-0-58-D,6801-05-0683,SNGL FAM SUB,6.86,AC,59900,0,59900,136400,0,196300,58500,0,58500,118400,0,176900,A1,AG/GEN,,,
16636,9-11-0-1-0,5891-74-4771,AG 20-100 AC,21.18,AC,90400,0,90400,0,0,90400,88500,0,88500,0,0,88500,A1,AG/GEN,,,
16637,9-11-0-2-0,5891-75-7176,AG 20-100 AC,20.78,AC,89400,0,89400,137400,800,227600,87500,0,87500,111700,800,200000,A1,AG/GEN,,,
16638,9-11-0-3-0,5891-85-0577,AG 20-100 AC,20.38,AC,88300,0,88300,264900,200,353400,86500,0,86500,229100,200,315800,A1,AG/GEN,,,
16639,9-11-0-4-0,5891-86-3033,AG 20-100 AC,20.71,AC,89200,0,89200,0,0,89200,87300,0,87300,0,0,87300,A1,AG/GEN,,,
16640,9-11-0-5-0,5891-77-2320,AG > 100 AC,150.72,AC,346000,0,346000,7400,50800,404200,337400,0,337400,7800,40100,385300,A1,AG/GEN,,,
16641,9-11-0-6-0,5891-96-1223,SNGL FAM SUB,18.456,AC,83400,0,83400,11200,0,94600,87100,0,87100,10600,0,97700,A1,AG/GEN,,,
16643,42-28-0-A-0,6767-16-6000,Cmn Area/Open Spc,1.52,AC,0,0,0,0,0,0,0,0,0,0,0,0,R1,RES/LTD,,,
16644,42-28-0-B-0,6767-25-7303,Cmn Area/Open Spc,9.58,AC,0,0,0,0,0,0,0,0,0,0,0,0,R1,RES/LTD,,,
16646,9-11-0-7-A,5891-96-6523,SNGL FAM SUB,3.081,AC,46300,0,46300,120300,1000,167600,45300,0,45300,104200,1100,150600,A1,AG/GEN,,,
16647,42-28-0-1-0,6767-16-7060,SNGL FAM SUB,0.704,AC,81500,0,81500,272500,0,354000,80000,0,80000,251300,0,331300,R1,RES/LTD,,,
16648,42-28-0-2-0,6767-16-8060,SNGL FAM SUB,0.664,AC,81500,0,81500,338500,18700,438700,80000,0,80000,310700,16300,407000,R1,RES/LTD,,,
16649,9-11-0-7-B,5891-96-3688,SNGL FAM SUB,4.35,AC,50900,0,50900,122400,1000,174300,49700,0,49700,112300,1100,163100,A1,AG/GEN,,,
16651,42-28-0-3-0,6767-16-9060,SNGL FAM SUB,0.624,AC,81500,0,81500,275400,0,356900,80000,0,80000,254800,0,334800,R1,RES/LTD,,,
16652,42-28-0-4-0,6767-26-0060,SNGL FAM SUB,0.599,AC,81500,0,81500,368700,1500,451700,80000,0,80000,339500,1100,420600,R1,RES/LTD,,,
16653,42-28-0-5-0,6767-26-1050,SNGL FAM SUB,0.59,AC,81500,0,81500,357800,0,439300,80000,0,80000,321000,0,401000,R1,RES/LTD,,,
16654,42-28-0-6-0,6767-26-2062,SNGL FAM SUB,0.598,AC,81500,0,81500,332700,19400,433600,80000,0,80000,310400,18700,409100,R1,RES/LTD,,,
16655,9-11-0-7-D,5891-87-9168,SNGL FAM SUB,6.884,AC,60000,0,60000,248100,3200,311300,50900,0,50900,224000,4300,279200,A1,AG/GEN,,,
16656,42-28-0-7-0,6767-26-4010,SNGL FAM SUB,0.941,AC,81500,0,81500,293400,0,374900,80000,0,80000,270300,0,350300,R1,RES/LTD,,,
16657,42-28-0-8-0,6767-25-3795,SNGL FAM SUB,0.941,AC,81500,0,81500,261400,800,343700,80000,0,80000,240400,0,320400,R1,RES/LTD,,,
16658,42-28-0-9-0,6767-25-2689,SNGL FAM SUB,0.564,AC,81500,0,81500,259600,800,341900,80000,0,80000,238500,800,319300,R1,RES/LTD,,,
16659,42-28-0-10-0,6767-25-1780,SNGL FAM SUB,0.577,AC,81500,0,81500,302700,0,384200,80000,0,80000,278400,0,358400,R1,RES/LTD,,,
16660,42-28-0-11-0,6767-25-0689,SNGL FAM SUB,0.598,AC,81500,0,81500,302700,0,384200,80000,0,80000,278400,0,358400,R1,RES/LTD,,,
16661,9-12-0-1-0,5891-83-3031,AG 20-100 AC,21.63,AC,91400,0,91400,370500,0,461900,89600,0,89600,312600,0,402200,A1,AG/GEN,,,
16662,42-28-0-12-0,6767-15-9714,SNGL FAM SUB,0.805,AC,81500,0,81500,326000,0,407500,80000,0,80000,301900,0,381900,R1,RES/LTD,,,
16663,42-28-0-13-0,6767-15-9621,SNGL FAM SUB,0.556,AC,81500,0,81500,358200,1200,440900,80000,0,80000,330900,1300,412200,R1,RES/LTD,,,
16664,42-28-0-14-0,6767-15-9520,SNGL FAM SUB,0.555,AC,81500,0,81500,269000,0,350500,80000,0,80000,266000,0,346000,R1,RES/LTD,,,
16665,42-28-0-15-0,6767-15-8371,SNGL FAM SUB,0.611,AC,81500,0,81500,267100,1500,350100,80000,0,80000,245800,0,325800,R1,RES/LTD,,,
16666,42-28-0-16-0,6767-15-9394,SNGL FAM SUB,0.586,AC,81500,0,81500,278500,0,360000,80000,0,80000,253400,0,333400,R1,RES/LTD,,,
16667,42-28-0-17-0,6767-25-0491,SNGL FAM SUB,0.585,AC,81500,0,81500,384000,0,465500,80000,0,80000,354400,0,434400,R1,RES/LTD,,,
16668,9-12-0-2-0,5891-83-4932,SNGL FAM SUB,10,AC,67800,0,67800,0,0,67800,65000,0,65000,0,0,65000,RR,RES/RUR,,,
16669,42-28-0-18-0,6767-25-1485,SNGL FAM SUB,0.707,AC,81500,0,81500,284800,4700,371000,80000,0,80000,262600,4900,347500,R1,RES/LTD,,,
16670,42-28-0-19-0,6767-25-2496,SNGL FAM SUB,0.639,AC,81500,0,81500,281600,0,363100,80000,0,80000,263100,0,343100,R1,RES/LTD,,,
16671,42-28-0-20-0,6767-25-4403,SNGL FAM SUB,0.582,AC,81500,0,81500,358300,600,440400,80000,0,80000,329500,700,410200,R1,RES/LTD,,,
16672,9-12-0-3-0,5891-93-0914,AG 20-100 AC,20.43,AC,88500,0,88500,0,0,88500,86600,0,86600,0,0,86600,A1,AG/GEN,,,
16673,42-28-0-21-0,6767-25-5416,SNGL FAM SUB,0.553,AC,81500,0,81500,326500,0,408000,80000,0,80000,300200,0,380200,R1,RES/LTD,,,
16674,42-28-0-22-0,6767-25-5538,SNGL FAM SUB,0.551,AC,81500,0,81500,350700,800,433000,80000,0,80000,323100,3100,406200,R1,RES/LTD,,,
16675,42-28-0-23-0,6767-25-5668,SNGL FAM SUB,0.551,AC,81500,0,81500,270400,1400,353300,80000,0,80000,254000,1500,335500,R1,RES/LTD,,,
16676,42-28-0-24-0,6767-25-5797,SNGL FAM SUB,0.561,AC,81500,0,81500,239800,800,322100,80000,0,80000,221800,800,302600,R1,RES/LTD,,,
16677,42-28-0-25-0,6767-25-5993,SNGL FAM SUB,1.007,AC,81500,0,81500,270100,0,351600,80000,0,80000,252800,0,332800,R1,RES/LTD,,,
16678,9-12-0-4-0,5891-94-3470,AG 20-100 AC,28.7,AC,104300,52700,51600,274100,500,378900,107300,57500,49800,239200,500,347000,A1,AG/GEN,,,
16679,42-28-0-26-0,6767-26-7010,SNGL FAM SUB,0.863,AC,81500,0,81500,316100,0,397600,80000,0,80000,295000,0,375000,R1,RES/LTD,,,
16680,42-28-0-27-0,6767-25-9908,SNGL FAM SUB,0.99,AC,81500,0,81500,263800,0,345300,80000,0,80000,246100,0,326100,R1,RES/LTD,,,
16681,42-28-0-28-0,6767-25-9853,SNGL FAM SUB,0.835,AC,81500,0,81500,370000,1300,452800,80000,0,80000,342300,1300,423600,R1,RES/LTD,,,
16682,9-12-0-5-0,5891-94-9905,AG 20-100 AC,36.54,AC,88100,0,88100,471600,0,559700,84000,0,84000,413300,0,497300,A1,AG/GEN,,,
16683,42-28-0-29-0,6767-25-8780,SNGL FAM SUB,0.556,AC,81500,0,81500,307500,1200,390200,80000,0,80000,283500,1300,364800,R1,RES/LTD,,,
16684,42-28-0-30-0,6767-25-8641,SNGL FAM SUB,0.551,AC,81500,0,81500,295900,0,377400,80000,0,80000,273400,0,353400,R1,RES/LTD,,,
16685,42-28-0-31-0,6767-25-8512,SNGL FAM SUB,0.551,AC,81500,0,81500,290800,0,372300,80000,0,80000,272000,0,352000,R1,RES/LTD,,,
16686,9-12-0-6-A,6801-05-8576,SNGL FAM SUB,12.39,AC,74500,0,74500,0,0,74500,72200,0,72200,0,0,72200,A1,AG/GEN,,,
16687,42-28-0-32-0,6767-25-7472,SNGL FAM SUB,0.576,AC,81500,0,81500,277700,0,359200,80000,0,80000,257300,0,337300,R1,RES/LTD,,,
16688,42-28-0-33-0,6767-25-7341,SNGL FAM SUB,0.712,AC,81500,0,81500,265600,0,347100,80000,0,80000,244300,0,324300,R1,RES/LTD,,,
16689,42-28-0-34-0,6767-25-6251,SNGL FAM SUB,0.784,AC,81500,0,81500,325400,1000,407900,80000,0,80000,298300,0,378300,R1,RES/LTD,,,
16690,9-12-0-6-B,6801-15-2229,AG 20-100 AC,20.06,AC,87500,78300,9200,0,0,87500,85700,77200,8500,0,0,85700,A1,AG/GEN,,,
16691,42-28-0-35-0,6767-25-5144,SNGL FAM SUB,0.842,AC,81500,0,81500,315400,29100,426000,80000,0,80000,287400,25600,393000,R1,RES/LTD,,,
16692,42-28-0-36-0,6767-25-4124,SNGL FAM SUB,0.675,AC,81500,0,81500,293500,800,375800,80000,0,80000,271900,800,352700,R1,RES/LTD,,,
16693,42-28-0-37-0,6767-25-3115,SNGL FAM SUB,0.6,AC,81500,0,81500,279200,1600,362300,80000,0,80000,266100,1700,347800,R1,RES/LTD,,,
16694,42-28-0-38-0,6767-25-2114,SNGL FAM SUB,0.564,AC,81500,0,81500,294700,0,376200,80000,0,80000,274900,0,354900,R1,RES/LTD,,,
16695,42-28-0-39-0,6767-25-0192,SNGL FAM SUB,0.633,AC,81500,0,81500,346100,0,427600,80000,0,80000,327500,0,407500,R1,RES/LTD,,,
16696,42-28-0-40-0,6767-15-7007,SNGL FAM SUB,0.554,AC,81500,0,81500,356200,0,437700,80000,0,80000,329200,0,409200,R1,RES/LTD,,,
16697,42-28-0-41-0,6767-15-5065,SNGL FAM SUB,0.556,AC,81500,0,81500,272200,0,353700,80000,0,80000,254400,0,334400,R1,RES/LTD,,,
16698,42-28-0-42-0,6767-15-3065,SNGL FAM SUB,0.816,AC,81500,0,81500,263200,0,344700,80000,0,80000,249000,0,329000,R1,RES/LTD,,,
16699,42-28-0-43-0,6767-15-3220,SNGL FAM SUB,0.898,AC,81500,0,81500,325500,0,407000,80000,0,80000,303900,0,383900,R1,RES/LTD,,,
16700,42-28-0-44-0,6767-15-4239,SNGL FAM SUB,0.646,AC,81500,0,81500,374700,0,456200,80000,0,80000,344700,0,424700,R1,RES/LTD,,,
16701,42-28-0-45-0,6767-15-6249,SNGL FAM SUB,0.664,AC,81500,0,81500,250700,0,332200,80000,0,80000,230600,0,310600,R1,RES/LTD,,,
16702,42-28-0-46-0,6767-15-6451,SNGL FAM SUB,0.592,AC,81500,0,81500,375700,0,457200,80000,0,80000,346100,0,426100,R1,RES/LTD,,,
16703,42-28-0-47-0,6767-15-6541,SNGL FAM SUB,0.585,AC,81500,0,81500,311000,600,393100,80000,0,80000,279700,700,360400,R1,RES/LTD,,,
16704,42-28-0-48-0,6767-15-6641,SNGL FAM SUB,0.583,AC,81500,0,81500,348600,800,430900,80000,0,80000,344100,900,425000,R1,RES/LTD,,,
16705,42-28-0-49-0,6767-15-6722,SNGL FAM SUB,0.779,AC,81500,0,81500,377400,0,458900,80000,0,80000,347700,0,427700,R1,RES/LTD,,,
16706,10-1-0-43-B,6811-24-3795,SNGL FAM SUB,7,AC,64200,0,64200,0,0,64200,62000,0,62000,0,0,62000,A1,AG/GEN,,,
16707,10-1-0-43-C,6811-24-4456,SNGL FAM SUB,3,AC,47500,0,47500,220000,0,267500,46000,0,46000,191900,0,237900,A1,AG/GEN,,,
16708,10-10-0-1-0,6801-87-8494,AG 20-100 AC,33.59,AC,145100,128800,16300,0,0,145100,142900,128500,14400,0,0,142900,A1,AG/GEN,,,
16709,10-10-0-2-0,6801-97-7366,AG 20-100 AC,28.1,AC,130500,114200,16300,0,41600,172100,125300,110600,14700,0,36900,162200,A1,AG/GEN,,,
16710,10-10-0-3-0,6801-98-9423,AG 20-100 AC,23.43,AC,117300,105400,11900,0,0,117300,116500,106500,10000,0,0,116500,A1,AG/GEN,,,
16711,10-10-0-4-0,6801-98-2950,AG 20-100 AC,27.66,AC,133700,120700,13000,0,0,133700,131300,119500,11800,0,0,131300,A1,AG/GEN,,,
16712,10-10-0-5-0,6811-09-7202,SNGL FAM SUB,12.87,AC,86900,0,86900,0,0,86900,85500,0,85500,0,0,85500,A1,AG/GEN,,,
16713,10-10-0-6-0,6811-09-2373,SNGL FAM SUB,7.42,AC,68300,0,68300,0,0,68300,66900,0,66900,0,0,66900,A1,AG/GEN,,,
16714,10-10-0-7-0,6811-09-0603,SNGL FAM SUB,3.01,AC,48000,0,48000,0,0,48000,47000,0,47000,0,0,47000,A1,AG/GEN,,,
16715,10-10-0-8-0,6811-29-2729,AG > 100 AC,157.67,AC,386100,0,386100,0,0,386100,378400,0,378400,0,0,378400,A1,AG/GEN,,,
16716,10-10-0-9-0,6811-27-2042,AG 20-100 AC,55.07,AC,184300,120300,64000,482100,20200,686600,184000,122900,61100,433800,20200,638000,A1,AG/GEN,,,
16717,10-10-0-10-0,6811-15-5338,AG 20-100 AC,60,AC,151700,124000,27700,0,0,151700,150000,124500,25500,0,0,150000,A1,AG/GEN,,,
16718,10-10-0-11-0,6811-16-0731,AG 20-100 AC,21,AC,107000,97300,9700,0,0,107000,104500,95600,8900,0,0,104500,A1,AG/GEN,,,
16719,10-10-0-12-0,6811-06-4294,AG 20-100 AC,21,AC,110600,100900,9700,0,0,110600,108000,0,108000,0,0,108000,A1,AG/GEN,,,
16720,10-10-0-13-0,6801-95-9935,AG 20-100 AC,23.64,AC,117800,106900,10900,0,0,117800,117200,107200,10000,0,0,117200,A1,AG/GEN,,,
16721,11-1-0-3-D,6812-74-9002,AG > 100 AC,150,AC,73000,0,73000,0,0,73000,64200,0,64200,0,0,64200,A1,AG/GEN,,,
16722,12-1-0-46-E1,6831-15-8823,SNGL FAM SUB,6.06,AC,73800,31200,42600,301400,27000,402200,68300,26600,41700,250600,22700,341600,A1,AG/GEN,,,
16723,12-1-0-61-D,6832-60-5835,SNGL FAM SUB,3.673,AC,62100,0,62100,318200,10500,390800,60400,0,60400,277300,7300,345000,A1,AG/GEN,,,
16724,13-1-0-1-P,6842-00-7866,SNGL FAM SUB,19.56,AC,170600,0,170600,336700,58600,565900,167300,0,167300,310800,54600,532700,A1,AG/GEN,,,
16725,18-1-0-26-D1,6729-17-6694,SNGL FAM SUB,3.932,AC,57300,0,57300,222000,9200,288500,55600,0,55600,182700,10100,248400,A1,AG/GEN,,,
16726,32-8-0-4-A,6778-82-2808,SNGL FAM SUB,2.29,AC,80200,0,80200,269100,4000,353300,71600,0,71600,221500,4000,297100,A2,AG/LTD,,,
16727,38-1-0-39-G,6707-54-9116,SNGL FAM SUB,2,AC,44400,0,44400,140700,1100,186200,43500,0,43500,112400,1100,157000,A1,AG/GEN,,,
16731,45-1-0-114-C,6797-79-7467,SNGL FAM SUB,3.38,AC,92400,0,92400,182000,200,274600,82500,0,82500,140700,200,223400,A2,AG/LTD,,,
16732,46-1-0-54-B,7716-07-3998,SNGL FAM SUB,10.442,AC,284100,0,284100,0,0,284100,253600,0,253600,0,0,253600,A2,AG/LTD,,,
16733,46-31-0-3-0,7708-61-9768,SNGL FAM SUB,3.4,AC,170000,0,170000,372600,30200,572800,156000,0,156000,321900,26100,504000,RR,RES/RUR,,,
16734,48-1-0-8-A1,7728-71-4841,SNGL FAM SUB,2,AC,125200,0,125200,161300,1400,287900,111800,0,111800,134200,1400,247400,A2,AG/LTD,,,
16735,48-1-0-13-L,7727-59-1352,COMM & IND,3.11,AC,514700,0,514700,962800,100900,1578400,490100,0,490100,899600,72800,1462500,M2,INDUS/G,,,
16737,48-1-0-35-A2,7726-77-5116,COMM & IND,8.028,AC,230700,0,230700,0,0,230700,209500,0,209500,0,0,209500,A2,AG/LTD,,,
16738,49-1-0-1-B,6706-84-8925,AG 20-100 AC,89.632,AC,399900,358000,41900,0,16900,416800,391200,353100,38100,0,14100,405300,A1,AG/GEN,,,
16739,50-1-0-13-0,6726-16-5391,SNGL FAM SUB,2.47,AC,47000,0,47000,297800,0,344800,46100,0,46100,253700,0,299800,A1,AG/GEN,,,
16740,50-1-0-13-A,6726-15-6752,SNGL FAM SUB,4.25,AC,57000,0,57000,0,0,57000,55900,0,55900,0,0,55900,A1,AG/GEN,,,
16741,56-8-0-4-A,6795-07-2972,SNGL FAM SUB,2,AC,96500,0,96500,804900,0,901400,86100,0,86100,667800,0,753900,A2,AG/LTD,,,
16742,57-35-0-A-0,7705-54-2656,Roads,3.42,AC,0,0,0,0,0,0,0,0,0,0,0,0,RR,RES/RUR,,,
16743,57-35-0-B-0,7705-55-0885,Cmn Area/Open Spc,1.301,AC,0,0,0,0,0,0,0,0,0,0,0,0,RR,RES/RUR,,,
16744,57-35-0-1-0,7705-53-7853,SNGL FAM SUB,5.982,AC,432000,0,432000,1089500,85800,1607300,360000,0,360000,1034500,80100,1474600,RR,RES/RUR,,,
16745,57-35-0-2-0,7705-54-6179,SNGL FAM SUB,6.472,AC,449300,0,449300,1182500,0,1631800,374400,0,374400,1104800,0,1479200,RR,RES/RUR,,,
16746,57-35-0-3-0,7705-54-6591,SNGL FAM SUB,7.57,AC,449300,0,449300,967900,47000,1464200,374400,0,374400,906800,44600,1325800,RR,RES/RUR,,,
16747,57-35-0-4-0,7705-54-6898,SNGL FAM SUB,6.348,AC,449300,0,449300,1186800,18200,1654300,374400,0,374400,1117000,18900,1510300,RR,RES/RUR,,,
16748,57-35-0-5-0,7705-55-6119,SNGL FAM SUB,6.049,AC,449300,0,449300,1217500,108300,1775100,374400,0,374400,1172500,99800,1646700,RR,RES/RUR,,,
16749,57-35-0-6-0,7705-55-7515,SNGL FAM SUB,6.273,AC,449300,0,449300,1189000,2000,1640300,374400,0,374400,1119200,2000,1495600,RR,RES/RUR,,,
16750,57-35-0-7-0,7705-55-6978,SNGL FAM SUB,6.057,AC,449300,0,449300,920500,62400,1432200,374400,0,374400,864000,52800,1291200,RR,RES/RUR,,,
16751,57-35-0-8-0,7705-55-3802,SNGL FAM SUB,4.003,AC,432000,0,432000,1089800,39700,1561500,360000,0,360000,1036100,37700,1433800,RR,RES/RUR,,,
16752,57-35-0-9-0,7705-45-9803,SNGL FAM SUB,4.055,AC,535800,0,535800,1480800,0,2016600,488800,0,488800,1341600,0,1830400,RR,RES/RUR,,,
16753,57-35-0-10-0,7705-45-6678,SNGL FAM SUB,3.21,AC,570000,0,570000,1148900,7800,1726700,520000,0,520000,1040800,6400,1567200,RR,RES/RUR,,,
16754,57-35-0-11-0,7705-45-5442,SNGL FAM SUB,3.122,AC,570000,0,570000,845200,1300,1416500,520000,0,520000,770500,1100,1291600,RR,RES/RUR,,,
16755,57-35-0-12-0,7705-45-4176,SNGL FAM SUB,3.655,AC,655500,0,655500,0,0,655500,598000,0,598000,0,0,598000,RR,RES/RUR,,,
16756,57-35-0-13-0,7705-45-9042,SNGL FAM SUB,7.35,AC,462700,0,462700,1089000,0,1551700,385600,0,385600,1048400,0,1434000,RR,RES/RUR,,,
16757,57-35-0-14-0,7705-54-0414,SNGL FAM SUB,5.37,AC,453600,0,453600,1686800,60200,2200600,378000,0,378000,1275300,57100,1710400,RR,RES/RUR,,,
16758,9-12-0-7-0,6801-14-6930,AG 20-100 AC,25.02,AC,99500,49600,49900,374300,0,473800,98100,49900,48200,335700,0,433800,A1,AG/GEN,,,
16759,9-12-0-8-A,6801-13-4681,AG 20-100 AC,55.54,AC,119100,88500,30600,0,0,119100,118000,89300,28700,0,0,118000,A1,AG/GEN,,,
16760,57-35-0-15-0,7705-53-3703,SNGL FAM SUB,4.812,AC,432000,0,432000,791100,51200,1274300,360000,0,360000,749600,47700,1157300,RR,RES/RUR,,,
16761,58-1-0-87-A,7716-94-0590,SNGL FAM SUB,7.63,AC,259600,0,259600,547100,2000,808700,225600,0,225600,467500,2000,695100,RR,RES/RUR,,,
16762,58-1-0-87-B,7716-94-5886,SNGL FAM SUB,5.84,AC,218800,0,218800,0,7100,225900,190100,0,190100,0,6300,196400,RR,RES/RUR,,,
16763,9-12-0-9-0,6801-24-3185,AG 20-100 AC,31.17,AC,116700,0,116700,393400,1000,511100,113400,0,113400,346900,1000,461300,A1,AG/GEN,,,
16764,58-32-3-B-0,7725-22-4215,COMM & IND,29.118,AC,62300,0,62300,0,0,62300,62300,0,62300,0,0,62300,M1,INDUS/L,,,
16765,9-12-0-8-B,5891-92-9226,AG > 100 AC,120.61,AC,247500,0,247500,0,0,247500,241200,0,241200,0,0,241200,A1,AG/GEN,,,
16766,62-36-0-A-0,7714-07-6112,Cmn Area/Open Spc,2.709,AC,0,0,0,0,0,0,0,0,0,0,0,0,R1,RES/LTD,,,
16768,62-36-0-D-0,7714-06-4789,TAXED -SCC,0.312,AC,0,0,0,0,0,0,0,0,0,0,0,0,R1,RES/LTD,,,
16769,62-36-A-1-0,7714-06-8747,SNGL FAM SUB,0.566,AC,137000,0,137000,429200,0,566200,125000,0,125000,403500,0,528500,R1,RES/LTD,,,
16770,62-36-A-2-0,7714-06-9830,SNGL FAM SUB,0.611,AC,137000,0,137000,424200,0,561200,125000,0,125000,396500,0,521500,R1,RES/LTD,,,
16771,62-36-A-3-0,7714-16-0833,SNGL FAM SUB,0.639,AC,137000,0,137000,530700,1500,669200,125000,0,125000,497600,1500,624100,R1,RES/LTD,,,
16772,62-36-A-4-0,7714-16-1848,SNGL FAM SUB,0.619,AC,137000,0,137000,448900,0,585900,125000,0,125000,432300,0,557300,R1,RES/LTD,,,
16773,62-36-A-5-0,7714-16-2934,SNGL FAM SUB,0.557,AC,137000,0,137000,433800,0,570800,125000,0,125000,405800,0,530800,R1,RES/LTD,,,
16774,62-36-A-6-0,7714-17-3020,SNGL FAM SUB,0.57,AC,137000,0,137000,402900,0,539900,125000,0,125000,377400,0,502400,R1,RES/LTD,,,
16775,62-36-A-7-0,7714-17-4013,SNGL FAM SUB,0.559,AC,137000,0,137000,425700,0,562700,125000,0,125000,397800,0,522800,R1,RES/LTD,,,
16776,62-36-A-8-0,7714-17-5006,SNGL FAM SUB,0.59,AC,137000,0,137000,435900,0,572900,125000,0,125000,407600,0,532600,R1,RES/LTD,,,
16777,62-36-A-9-0,7714-17-5098,SNGL FAM SUB,0.648,AC,137000,0,137000,353500,0,490500,125000,0,125000,331100,0,456100,R1,RES/LTD,,,
16778,62-36-A-10-0,7714-17-6181,SNGL FAM SUB,0.608,AC,137000,0,137000,412600,0,549600,125000,0,125000,385900,0,510900,R1,RES/LTD,,,
16779,62-36-A-11-0,7714-17-8149,SNGL FAM SUB,0.835,AC,137000,0,137000,346000,0,483000,125000,0,125000,325400,0,450400,R1,RES/LTD,,,
16780,62-36-A-12-0,7714-17-8011,SNGL FAM SUB,0.581,AC,137000,0,137000,483300,0,620300,125000,0,125000,458600,0,583600,R1,RES/LTD,,,
16781,62-36-B-1-0,7714-27-0168,SNGL FAM SUB,0.722,AC,137000,0,137000,438200,5000,580200,125000,0,125000,408800,5000,538800,R1,RES/LTD,,,
16782,62-36-B-2-0,7714-27-1187,SNGL FAM SUB,0.597,AC,137000,0,137000,483100,0,620100,125000,0,125000,453200,0,578200,R1,RES/LTD,,,
16783,62-36-B-3-0,7714-26-0959,SNGL FAM SUB,0.575,AC,137000,0,137000,356200,0,493200,125000,0,125000,335100,0,460100,R1,RES/LTD,,,
16784,62-36-B-4-0,7714-26-0807,SNGL FAM SUB,0.597,AC,137000,0,137000,368900,0,505900,125000,0,125000,347600,0,472600,R1,RES/LTD,,,
16785,62-36-C-1-0,7714-06-5869,SNGL FAM SUB,0.575,AC,137000,0,137000,416600,1500,555100,125000,0,125000,397900,1500,524400,R1,RES/LTD,,,
16786,62-36-C-2-0,7714-07-6051,SNGL FAM SUB,0.661,AC,137000,0,137000,372500,800,510300,125000,0,125000,349500,800,475300,R1,RES/LTD,,,
16787,63-1-0-96-C,7714-59-5667,SNGL FAM SUB,3.215,AC,153600,0,153600,380500,0,534100,133500,0,133500,317400,0,450900,A2,AG/LTD,,,
16788,63-1-0-170-0,7724-30-3812,SNGL FAM SUB,5.691,AC,116100,0,116100,0,0,116100,100700,0,100700,0,0,100700,A2,AG/LTD,,,
16789,64-22-0-E-1,7734-32-6337,Cmn Area/Open Spc,0.586,AC,0,0,0,0,0,0,0,0,0,0,0,0,R1,RES/LTD,,,
16790,62-36-C-3-0,7714-07-7150,SNGL FAM SUB,0.99,AC,137000,0,137000,392500,34200,563700,125000,0,125000,366900,32100,524000,R1,RES/LTD,,,
16791,62-36-C-4-0,7714-07-9110,SNGL FAM SUB,0.773,AC,137000,0,137000,458300,800,596100,125000,0,125000,439900,800,565700,R1,RES/LTD,,,
16792,62-36-C-5-0,7714-17-0146,SNGL FAM SUB,0.704,AC,137000,0,137000,377000,0,514000,125000,0,125000,362500,0,487500,R1,RES/LTD,,,
16793,62-36-C-6-0,7714-17-1228,SNGL FAM SUB,1.041,AC,137000,0,137000,284400,0,421400,125000,0,125000,266700,0,391700,R1,RES/LTD,,,
16794,62-36-C-7-0,7714-17-2333,SNGL FAM SUB,0.875,AC,137000,0,137000,308000,0,445000,125000,0,125000,290200,0,415200,R1,RES/LTD,,,
16795,62-36-C-8-0,7714-17-3347,SNGL FAM SUB,0.77,AC,137000,0,137000,348900,42200,528100,125000,0,125000,325500,39500,490000,R1,RES/LTD,,,
16796,62-36-C-9-0,7714-17-4450,SNGL FAM SUB,0.716,AC,137000,0,137000,351700,0,488700,125000,0,125000,320400,0,445400,R1,RES/LTD,,,
16798,62-36-C-11-0,7714-17-7399,SNGL FAM SUB,0.735,AC,137000,0,137000,479700,0,616700,125000,0,125000,450600,0,575600,R1,RES/LTD,,,
16799,62-36-C-12-0,7714-17-7439,SNGL FAM SUB,0.652,AC,137000,0,137000,431000,0,568000,125000,0,125000,404800,0,529800,R1,RES/LTD,,,
16800,62-36-C-13-0,7714-17-6536,SNGL FAM SUB,1.029,AC,137000,0,137000,433400,800,571200,125000,0,125000,409300,800,535100,R1,RES/LTD,,,
16801,62-36-C-14-0,7714-17-5634,SNGL FAM SUB,0.714,AC,137000,0,137000,454200,0,591200,125000,0,125000,427400,0,552400,R1,RES/LTD,,,
16802,62-36-C-15-0,7714-17-4619,SNGL FAM SUB,0.766,AC,137000,0,137000,418000,0,555000,125000,0,125000,394200,0,519200,R1,RES/LTD,,,
16803,62-36-C-16-0,7714-17-2674,SNGL FAM SUB,0.992,AC,137000,0,137000,430800,0,567800,125000,0,125000,404700,0,529700,R1,RES/LTD,,,
16804,62-36-C-17-0,7714-17-0428,SNGL FAM SUB,1.766,AC,137000,0,137000,436000,0,573000,125000,0,125000,407400,0,532400,R1,RES/LTD,,,
16805,62-36-C-18-0,7714-07-9689,SNGL FAM SUB,0.953,AC,137000,0,137000,423100,500,560600,125000,0,125000,401300,500,526800,R1,RES/LTD,,,
16806,62-36-C-19-0,7714-17-1829,SNGL FAM SUB,0.672,AC,137000,0,137000,481200,0,618200,125000,0,125000,453400,0,578400,R1,RES/LTD,,,
16807,62-36-C-20-0,7714-18-2021,SNGL FAM SUB,1.01,AC,137000,0,137000,539800,0,676800,125000,0,125000,505700,0,630700,R1,RES/LTD,,,
16808,62-36-C-21-0,7714-17-3959,SNGL FAM SUB,0.732,AC,137000,0,137000,584400,6600,728000,125000,0,125000,549800,4600,679400,R1,RES/LTD,,,
16809,62-36-C-22-0,7714-17-4984,SNGL FAM SUB,0.559,AC,137000,0,137000,490800,0,627800,125000,0,125000,460400,0,585400,R1,RES/LTD,,,
16810,62-36-C-23-0,7714-17-6914,SNGL FAM SUB,0.663,AC,137000,0,137000,524300,0,661300,125000,0,125000,480600,0,605600,R1,RES/LTD,,,
16811,62-36-C-24-0,7714-18-7035,SNGL FAM SUB,0.875,AC,137000,0,137000,399800,0,536800,125000,0,125000,375700,0,500700,R1,RES/LTD,,,
16812,62-36-C-25-0,7714-17-9942,SNGL FAM SUB,1.404,AC,137000,0,137000,449900,3400,590300,125000,0,125000,422800,3000,550800,R1,RES/LTD,,,
16813,62-36-C-26-0,7714-17-8746,SNGL FAM SUB,0.944,AC,130200,0,130200,492400,0,622600,118800,0,118800,461500,0,580300,R1,RES/LTD,,,
16814,62-36-C-27-0,7714-27-1703,SNGL FAM SUB,2.037,AC,137000,0,137000,364700,9900,511600,125000,0,125000,339200,10000,474200,R1,RES/LTD,,,
16815,62-36-C-28-0,7714-27-0439,SNGL FAM SUB,0.824,AC,137000,0,137000,362400,0,499400,125000,0,125000,341000,0,466000,R1,RES/LTD,,,
16816,62-36-C-29-0,7714-27-1583,SNGL FAM SUB,1,AC,137000,0,137000,470300,0,607300,125000,0,125000,440600,0,565600,R1,RES/LTD,,,
16817,62-36-C-30-0,7714-27-3526,SNGL FAM SUB,1.442,AC,137000,0,137000,392200,0,529200,125000,0,125000,366700,0,491700,R1,RES/LTD,,,
16818,58-32-3-A-0T,7725-33-0619-9999,COMM & IND,286.944,AC,25768700,0,25768700,193665500,100,219434300,25201300,0,25201300,191925100,100,217126500,M1,INDUS/L,,,
16819,43-1-0-58-B,6768-82-0270,SNGL FAM SUB,0.107,AC,1500,0,1500,0,0,1500,1400,0,1400,0,0,1400,A1,AG/GEN,,,
16820,63-7-0-D-1A,7723-07-3922,SNGL FAM SUB,2.002,AC,191700,0,191700,636100,0,827800,166700,0,166700,560400,0,727100,A2,AG/LTD,,,
16821,6-1-0-4-J,6823-98-4309,SNGL FAM SUB,2,AC,44800,0,44800,0,0,44800,44000,0,44000,0,0,44000,A1,AG/GEN,,,
16822,6-1-0-26-A,6823-80-9546,COMM & IND,5.65,AC,266700,0,266700,649700,0,916400,258800,0,258800,649700,0,908500,B1,BUS/GEN,,,
16823,16-1-0-39-C,5890-54-0031,SNGL FAM SUB,4.36,AC,50900,0,50900,113600,1600,166100,49800,0,49800,101600,1600,153000,A1,AG/GEN,,,
16824,28-1-0-87-H1,6739-23-2855,SNGL FAM SUB,4,AC,67500,0,67500,120600,700,188800,65100,0,65100,94500,800,160400,A1,AG/GEN,,,
16825,44-26-0-A-0,6788-11-6357,Roads,4.923,AC,0,0,0,0,0,0,0,0,0,0,0,0,RP,"RURAL,P",,,
16826,44-26-0-B-0,6788-31-1405,Cmn Area/Open Spc,2.743,AC,0,0,0,0,0,0,0,0,0,0,0,0,RP,"RURAL,P",,,
16827,44-26-0-C-0,6788-01-2516,Cmn Area/Open Spc,20.91,AC,0,0,0,0,0,0,0,0,0,0,0,0,RP,"RURAL,P",,,
16828,44-26-0-D-0,6788-20-1792,AG 20-100 AC,24.513,AC,121400,0,121400,268800,54100,444300,107700,0,107700,247400,49300,404400,RP,"RURAL,P",,,
16829,44-26-0-1-0,6788-21-8478,SNGL FAM SUB,2,AC,140000,0,140000,574000,55000,769000,125000,0,125000,525200,48300,698500,RP,"RURAL,P",,,
16830,44-26-0-2-0,6788-21-6592,SNGL FAM SUB,2.002,AC,140000,0,140000,497800,23300,661100,125000,0,125000,457100,20600,602700,RP,"RURAL,P",,,
16831,44-26-0-3-0,6788-21-5516,SNGL FAM SUB,2,AC,140000,0,140000,0,0,140000,125000,0,125000,0,0,125000,RP,"RURAL,P",,,
16832,44-26-0-4-0,6788-21-2543,SNGL FAM SUB,2,AC,140000,0,140000,418800,1700,560500,125000,0,125000,383900,1800,510700,RP,"RURAL,P",,,
16833,44-26-0-5-0,6788-21-2707,SNGL FAM SUB,2,AC,140000,0,140000,416400,0,556400,125000,0,125000,382000,0,507000,RP,"RURAL,P",,,
16834,44-26-0-6-0,6788-11-7897,SNGL FAM SUB,2,AC,140000,0,140000,519300,2100,661400,125000,0,125000,439900,1300,566200,RP,"RURAL,P",,,
16835,44-26-0-7-0,6788-11-6784,SNGL FAM SUB,2,AC,147000,0,147000,456800,0,603800,131300,0,131300,429700,0,561000,RP,"RURAL,P",,,
16836,44-26-0-8-0,6788-11-8570,SNGL FAM SUB,2,AC,147000,0,147000,448700,0,595700,131300,0,131300,409300,0,540600,RP,"RURAL,P",,,
16837,44-26-0-9-0,6788-11-6411,SNGL FAM SUB,2.001,AC,147000,0,147000,470500,0,617500,131300,0,131300,429400,0,560700,RP,"RURAL,P",,,
16838,44-26-0-10-0,6788-11-4621,SNGL FAM SUB,2,AC,147000,0,147000,511700,0,658700,131300,0,131300,465100,0,596400,RP,"RURAL,P",,,
16839,44-26-0-11-0,6788-11-2716,SNGL FAM SUB,2,AC,140000,0,140000,0,0,140000,125000,0,125000,0,0,125000,RP,"RURAL,P",,,
16840,44-26-0-12-0,6788-11-3936,SNGL FAM SUB,2,AC,140000,0,140000,473000,0,613000,125000,0,125000,422700,0,547700,RP,"RURAL,P",,,
16841,44-26-0-13-0,6788-12-1180,SNGL FAM SUB,2,AC,140000,0,140000,418700,10300,569000,125000,0,125000,381700,8900,515600,RP,"RURAL,P",,,
16842,44-26-0-14-0,6788-02-7193,SNGL FAM SUB,2,AC,140000,0,140000,463500,21800,625300,125000,0,125000,425300,21300,571600,RP,"RURAL,P",,,
16843,44-26-0-15-0,6788-01-7954,SNGL FAM SUB,2,AC,140000,0,140000,401000,0,541000,125000,0,125000,366700,0,491700,RP,"RURAL,P",,,
16844,44-26-0-16-0,6788-01-7705,SNGL FAM SUB,2,AC,140000,0,140000,435800,0,575800,125000,0,125000,399700,0,524700,RP,"RURAL,P",,,
16845,44-26-0-17-0,6788-01-6566,SNGL FAM SUB,2,AC,140000,0,140000,584700,44400,769100,125000,0,125000,550400,41100,716500,RP,"RURAL,P",,,
16846,44-26-0-18-0,6788-01-5385,SNGL FAM SUB,2.5,AC,140000,0,140000,405000,108400,653400,125000,0,125000,372700,92100,589800,RP,"RURAL,P",,,
16847,44-26-0-19-0,6788-01-5027,SNGL FAM SUB,3.261,AC,140000,0,140000,426300,12900,579200,125000,0,125000,391300,0,516300,RP,"RURAL,P",,,
16848,44-26-0-20-0,6788-00-5766,SNGL FAM SUB,3.802,AC,140000,0,140000,529800,0,669800,125000,0,125000,496100,0,621100,RP,"RURAL,P",,,
16849,44-26-0-21-0,6788-11-0118,SNGL FAM SUB,2.408,AC,140000,0,140000,459200,41900,641100,125000,0,125000,419600,36100,580700,RP,"RURAL,P",,,
16850,44-26-0-22-0,6788-11-0495,SNGL FAM SUB,2.004,AC,140000,0,140000,580300,129200,849500,125000,0,125000,531800,115900,772700,RP,"RURAL,P",,,
16851,44-26-0-23-0,6788-11-3138,SNGL FAM SUB,2.2,AC,140000,0,140000,509300,0,649300,125000,0,125000,478300,0,603300,RP,"RURAL,P",,,
16852,44-26-0-24-0,6788-10-0923,SNGL FAM SUB,2.2,AC,140000,0,140000,471000,0,611000,125000,0,125000,429500,0,554500,RP,"RURAL,P",,,
16853,44-26-0-25-0,6788-00-8761,SNGL FAM SUB,2.175,AC,140000,0,140000,371400,0,511400,125000,0,125000,340400,0,465400,RP,"RURAL,P",,,
16854,44-26-0-26-0,6788-00-9564,SNGL FAM SUB,2.525,AC,140000,0,140000,451200,2400,593600,125000,0,125000,414200,2500,541700,RP,"RURAL,P",,,
16855,44-26-0-27-0,6788-10-2456,SNGL FAM SUB,2.2,AC,140000,0,140000,368100,2100,510200,125000,0,125000,341400,2200,468600,RP,"RURAL,P",,,
16856,44-26-0-28-0,6788-10-4517,SNGL FAM SUB,2,AC,140000,0,140000,442600,0,582600,125000,0,125000,414600,0,539600,RP,"RURAL,P",,,
16857,44-26-0-29-0,6788-10-4798,SNGL FAM SUB,2,AC,140000,0,140000,538900,3300,682200,125000,0,125000,492200,3000,620200,RP,"RURAL,P",,,
16858,44-26-0-30-0,6788-10-6949,SNGL FAM SUB,2,AC,140000,0,140000,431600,54100,625700,125000,0,125000,396600,49200,570800,RP,"RURAL,P",,,
16859,44-26-0-31-0,6788-11-9139,SNGL FAM SUB,2,AC,140000,0,140000,0,0,140000,125000,0,125000,0,0,125000,RP,"RURAL,P",,,
16860,46-38-0-1-0,7717-12-0546,SNGL FAM SUB,3.51,AC,113500,0,113500,0,0,113500,101300,0,101300,0,0,101300,A2,AG/LTD,,,
16861,46-38-0-2-0,7717-12-4399,SNGL FAM SUB,6.09,AC,158900,0,158900,0,0,158900,141800,0,141800,0,0,141800,A2,AG/LTD,,,
16862,46-38-0-3-0,7717-12-8406,SNGL FAM SUB,3.86,AC,119600,0,119600,0,0,119600,106800,0,106800,0,0,106800,A2,AG/LTD,,,
16863,46-38-0-4-0,7717-22-1734,SNGL FAM SUB,3.28,AC,132500,0,132500,0,0,132500,118300,0,118300,0,0,118300,A2,AG/LTD,,,
16865,6-13-0-B-0,6833-41-7391,Cmn Area/Open Spc,3.86,AC,0,0,0,0,0,0,0,0,0,0,0,0,M1,INDUS/L,,,
16866,6-13-0-C-0,6833-53-3397,COMM & IND,0.92,AC,1000,0,1000,0,0,1000,1000,0,1000,0,0,1000,M2,INDUS/G,,,
16867,6-13-0-1-0,6833-31-9604,COMM & IND,5.81,AC,167800,0,167800,0,0,167800,162700,0,162700,0,0,162700,M1,INDUS/L,,,
16868,6-13-0-2-0,6833-41-0948,COMM & IND,3.86,AC,91400,0,91400,0,0,91400,88600,0,88600,0,0,88600,M1,INDUS/L,,,
16869,6-13-0-3-0,6833-42-3204,COMM & IND,3.43,AC,90200,0,90200,0,0,90200,87500,0,87500,0,0,87500,M2,INDUS/G,,,
16870,6-13-0-4-0,6833-42-5570,Cmn Area/Open Spc,3.5,AC,0,0,0,0,0,0,0,0,0,0,0,0,M2,INDUS/G,,,
16871,6-13-0-5-0,6833-42-8715,COMM & IND,2.75,AC,72300,0,72300,270400,36000,378700,70100,0,70100,275000,26700,371800,M2,INDUS/G,,,
16872,6-13-0-6-0,6833-52-0917,COMM & IND,2.75,AC,72300,0,72300,0,0,72300,70100,0,70100,0,0,70100,M2,INDUS/G,,,
16873,6-13-0-7-0,6833-53-2231,COMM & IND,3.21,AC,67500,0,67500,0,0,67500,65500,0,65500,0,0,65500,M2,INDUS/G,,,
16874,6-13-0-8-0,6833-53-5532,COMM & IND,2.85,AC,60000,0,60000,0,0,60000,58100,0,58100,0,0,58100,M2,INDUS/G,,,
16875,6-13-0-9-0,6833-53-7745,COMM & IND,2.85,AC,75000,0,75000,0,0,75000,72700,0,72700,0,0,72700,M2,INDUS/G,,,
16876,6-13-0-10-0,6833-54-9073,COMM & IND,4.44,AC,92300,0,92300,0,0,92300,89500,0,89500,0,0,89500,M2,INDUS/G,,,
16877,6-13-0-11-0,6833-64-3091,COMM & IND,4.49,AC,83000,0,83000,0,0,83000,80500,0,80500,0,0,80500,M2,INDUS/G,,,
16878,6-13-0-12-0,6833-63-8943,COMM & IND,5.55,AC,102600,0,102600,0,0,102600,99500,0,99500,0,0,99500,M2,INDUS/G,,,
16879,6-13-0-13-0,6833-73-3916,COMM & IND,4.43,AC,81900,0,81900,0,0,81900,79400,0,79400,0,0,79400,M2,INDUS/G,,,
16880,6-13-0-14-0,6833-73-7758,COMM & IND,10.59,AC,150900,0,150900,0,0,150900,146100,0,146100,0,0,146100,M2,INDUS/G,,,
16881,6-13-0-15-0,6833-73-3304,COMM & IND,6.13,AC,106900,0,106900,0,0,106900,103500,0,103500,0,0,103500,M2,INDUS/G,,,
16882,6-13-0-16-0,6833-73-0067,COMM & IND,6.07,AC,101100,0,101100,0,0,101100,97900,0,97900,0,0,97900,M2,INDUS/G,,,
16883,6-13-0-17-0,6833-62-8882,COMM & IND,5.43,AC,88000,0,88000,0,0,88000,85300,0,85300,0,0,85300,M2,INDUS/G,,,
16884,6-13-0-18-0,6833-62-6680,COMM & IND,5.17,AC,89900,0,89900,0,0,89900,87100,0,87100,0,0,87100,M2,INDUS/G,,,
16885,6-13-0-19-0,6833-62-3398,COMM & IND,7.34,AC,62300,0,62300,0,0,62300,60200,0,60200,0,0,60200,M2,INDUS/G,,,
16886,6-13-0-20-0,6833-62-1151,COMM & IND,5.41,AC,82600,0,82600,0,0,82600,80000,0,80000,0,0,80000,M2,INDUS/G,,,
16887,6-13-0-21-0,6833-51-9930,COMM & IND,5.54,AC,67100,0,67100,0,0,67100,64900,0,64900,0,0,64900,M2,INDUS/G,,,
16888,6-13-0-22-0,6833-61-0372,COMM & IND,3.97,AC,63100,0,63100,0,0,63100,61200,0,61200,0,0,61200,M1,INDUS/L,,,
16889,6-13-0-23-0,6833-51-7325,COMM & IND,5.45,AC,89000,0,89000,0,0,89000,86300,0,86300,0,0,86300,M1,INDUS/L,,,
16890,6-13-0-24-0,6833-51-5625,COMM & IND,5.34,AC,133300,0,133300,0,0,133300,129200,0,129200,0,0,129200,M2,INDUS/G,,,
16891,6-13-0-25-0,6833-51-1228,COMM & IND,2.92,AC,76000,0,76000,0,0,76000,73700,0,73700,0,0,73700,M1,INDUS/L,,,
16892,6-13-0-26-0,6833-51-0548,COMM & IND,2.01,AC,52900,0,52900,0,0,52900,51300,0,51300,0,0,51300,M1,INDUS/L,,,
16893,6-13-0-27-0,6833-51-0813,COMM & IND,2.8,AC,73600,0,73600,0,27000,100600,71400,0,71400,0,24700,96100,M2,INDUS/G,,,
16894,6-13-0-28-0,6833-52-2045,COMM & IND,2.62,AC,68900,0,68900,0,54300,123200,66800,0,66800,0,51900,118700,M2,INDUS/G,,,
16895,6-13-0-29-0,6833-52-4246,COMM & IND,2.62,AC,68900,0,68900,0,54300,123200,66800,0,66800,0,51900,118700,M2,INDUS/G,,,
16896,6-13-0-30-0,6833-52-6458,COMM & IND,2.62,AC,68900,0,68900,0,37900,106800,66800,0,66800,0,36200,103000,M2,INDUS/G,,,
16897,6-13-0-31-0,6833-52-8750,COMM & IND,2.62,AC,68900,0,68900,0,0,68900,66800,0,66800,0,0,66800,M2,INDUS/G,,,
16898,6-13-0-32-0,6833-62-0839,COMM & IND,2.18,AC,57300,0,57300,0,0,57300,55600,0,55600,0,0,55600,M2,INDUS/G,,,
16899,6-13-0-33-0,6833-63-2007,COMM & IND,2.18,AC,57300,0,57300,0,0,57300,55600,0,55600,0,0,55600,M2,INDUS/G,,,
16900,6-13-0-34-0,6833-63-4208,COMM & IND,2.62,AC,68900,0,68900,0,0,68900,66800,0,66800,0,0,66800,M2,INDUS/G,,,
16901,6-13-0-35-0,6833-63-6540,COMM & IND,2.94,AC,77300,0,77300,0,0,77300,75000,0,75000,0,0,75000,M2,INDUS/G,,,
16902,6-13-0-36-0,6833-63-1587,COMM & IND,3.82,AC,100500,0,100500,0,19100,119600,97400,0,97400,0,16800,114200,M2,INDUS/G,,,
16903,6-13-0-37-0,6833-53-9332,COMM & IND,2.18,AC,57300,0,57300,0,0,57300,55600,0,55600,0,0,55600,M2,INDUS/G,,,
16904,6-13-0-38-0,6833-53-7164,COMM & IND,2.18,AC,57300,0,57300,0,54200,111500,55600,0,55600,0,51700,107300,M2,INDUS/G,,,
16905,6-13-0-39-0,6833-52-5984,COMM & IND,2.62,AC,68900,0,68900,0,65100,134000,66800,0,66800,0,62200,129000,M2,INDUS/G,,,
16906,6-13-0-40-0,6833-52-3772,COMM & IND,2.62,AC,68900,0,68900,0,65100,134000,66800,0,66800,0,62200,129000,M2,INDUS/G,,,
16907,6-13-0-41-0,6833-42-8175,Cmn Area/Open Spc,1.563,AC,0,0,0,0,0,0,0,0,0,0,0,0,M2,INDUS/G,,,
16909,6-13-0-43-0,6833-42-7014,COMM & IND,3.65,AC,86400,0,86400,0,0,86400,83800,0,83800,0,0,83800,M2,INDUS/G,,,
16910,6-13-0-44-0,6833-41-4553,General Gov,6.74,AC,175200,0,175200,0,0,175200,169800,0,169800,0,0,169800,M1,INDUS/L,,,
16911,9-1-0-54-B2,5891-73-6034,SNGL FAM SUB,4.44,AC,51200,0,51200,180300,0,231500,50000,0,50000,160000,0,210000,A1,AG/GEN,,,
16912,9-1-0-54-B3,5891-72-2858,SNGL FAM SUB,3.79,AC,48800,0,48800,144700,2000,195500,47800,0,47800,130000,2000,179800,A1,AG/GEN,,,
16913,9-1-0-54-B4,5891-62-9600,SNGL FAM SUB,5.03,AC,53300,0,53300,91200,2600,147100,52100,0,52100,78800,2400,133300,A1,AG/GEN,,,
16914,2-1-0-1-TW,6814-57-9911-9998,COMM & IND,0,AC,0,0,0,0,133900,133900,0,0,0,0,127600,127600,A1,AG/GEN,,,
16916,49-1-0-1-A,6716-03-0939,AG 20-100 AC,36.313,AC,218900,0,218900,153800,26300,399000,214600,0,214600,131400,26300,372300,A1,AG/GEN,,,
16917,59-1-0-4-0,7726-57-8112,MultiFamily,1.333,AC,901700,0,901700,0,3400,905100,860700,0,860700,0,3100,863800,R3,RES/GEN,,,
16918,9-1-0-54-C,5891-61-2880,SNGL FAM SUB,3.42,AC,47500,0,47500,137600,1300,186400,46500,0,46500,112100,1300,159900,A1,AG/GEN,,,
16919,9-1-0-54-D,5891-62-4254,SNGL FAM SUB,3.44,AC,47600,46000,1600,0,0,47600,46500,45000,1500,0,0,46500,A1,AG/GEN,,,
16920,20-1-0-36-A,6840-31-8724,SNGL FAM SUB,3.32,AC,70700,69200,1500,0,0,70700,69000,67600,1400,0,0,69000,A1,AG/GEN,,,
16921,25-1-0-5-K,6709-00-7085,SNGL FAM SUB,3.635,AC,50900,0,50900,161300,16600,228800,49900,0,49900,137500,14500,201900,A1,AG/GEN,,,
16923,46-39-0-1-0,7717-14-8953,SNGL FAM SUB,3.63,AC,170000,0,170000,721400,48200,939600,156000,0,156000,619300,44300,819600,R1,RES/LTD,,,
16924,46-39-0-2-0,7717-14-7579,SNGL FAM SUB,3.043,AC,170000,0,170000,497700,1000,668700,156000,0,156000,436400,1000,593400,R1,RES/LTD,,,
16925,46-39-0-3-0,7717-14-6265,SNGL FAM SUB,2.5,AC,170000,0,170000,579700,1000,750700,156000,0,156000,524500,1000,681500,R1,RES/LTD,,,
16926,46-39-0-4-0,7717-13-5819,SNGL FAM SUB,3.164,AC,170000,0,170000,547200,0,717200,156000,0,156000,481500,0,637500,R1,RES/LTD,,,
16927,46-39-0-5-0,7717-13-4102,SNGL FAM SUB,4.337,AC,170000,0,170000,430800,2800,603600,156000,0,156000,378000,2500,536500,R1,RES/LTD,,,
16928,46-39-0-6-0,7717-12-1986,SNGL FAM SUB,3.66,AC,170000,0,170000,552000,0,722000,156000,0,156000,483600,0,639600,R1,RES/LTD,,,
16929,46-39-0-7-0,7717-02-9936,SNGL FAM SUB,3.579,AC,170000,0,170000,539900,0,709900,156000,0,156000,472900,0,628900,R1,RES/LTD,,,
16930,46-39-0-8-0,7717-03-9357,SNGL FAM SUB,2.241,AC,170000,0,170000,566100,8500,744600,156000,0,156000,499400,9100,664500,R1,RES/LTD,,,
16931,46-39-0-9-0,7717-13-0796,SNGL FAM SUB,2.15,AC,170000,0,170000,557600,0,727600,156000,0,156000,489000,0,645000,R1,RES/LTD,,,
16932,46-39-0-10-0,7717-14-2017,SNGL FAM SUB,2.27,AC,170000,0,170000,650200,0,820200,156000,0,156000,575100,0,731100,R1,RES/LTD,,,
16933,46-39-0-11-0,7717-14-1387,SNGL FAM SUB,3.572,AC,170000,0,170000,397500,0,567500,156000,0,156000,333300,0,489300,R1,RES/LTD,,,
16934,46-39-0-12-0,7717-14-3672,SNGL FAM SUB,2.641,AC,170000,0,170000,426300,13500,609800,156000,0,156000,372900,12400,541300,R1,RES/LTD,,,
16935,47-1-0-99-A,7727-30-8239,SNGL FAM SUB,5,AC,204400,0,204400,231400,0,435800,182700,0,182700,194200,0,376900,A2,AG/LTD,,,
16936,56-19-0-1-0,6795-92-2635,SNGL FAM SUB,0.23,AC,7000,0,7000,0,0,7000,6100,0,6100,0,0,6100,A2,AG/LTD,,,
16937,61-3-0-1-A1,6795-91-5422,SNGL FAM SUB,10.757,AC,437400,0,437400,206700,6300,650400,380600,0,380600,200200,5300,586100,A2,AG/LTD,,,
16938,9-1-0-69-B,5892-71-7435,SNGL FAM SUB,4.22,AC,47900,0,47900,0,0,47900,47000,0,47000,0,0,47000,A1,AG/GEN,,,
16940,64-1-0-48-A,7734-12-2293-0001,Place of Worship,35.983,AC,3228800,0,3228800,10431400,869300,14529500,2807800,0,2807800,9930200,878800,13616800,A2,AG/LTD,,,
16942,48-15-0-2-0,7727-58-4225,COMM & IND,3.298,AC,655500,0,655500,1542600,285200,2483300,624300,0,624300,1541400,217800,2383500,M2,INDUS/G,,,
16943,48-15-0-3-0,7727-58-5677,COMM & IND,2.081,AC,376000,0,376000,1013200,144500,1533700,358100,0,358100,946100,147500,1451700,M2,INDUS/G,,,
16944,48-15-0-4-0,7727-58-1421,COMM & IND,2.262,AC,408700,0,408700,1055900,22100,1486700,389300,0,389300,973500,15200,1378000,M2,INDUS/G,,,
16945,48-15-0-5-0,7727-48-9603,COMM & IND,2.143,AC,387200,0,387200,376300,27400,790900,368800,0,368800,344600,18900,732300,M2,INDUS/G,,,
16946,48-15-0-6-0,7727-58-2900,COMM & IND,2.471,AC,446500,0,446500,1478600,133400,2058500,425300,0,425300,1392500,91600,1909400,M2,INDUS/G,,,
16947,59-4-0-2-TW,7726-87-2161-9998,COMM & IND,0,AC,0,0,0,0,122800,122800,0,0,0,0,119200,119200,B1,BUS/GEN,,,
16948,3-5-0-A-0,5892-78-9764,SNGL FAM SUB,12,AC,77600,0,77600,276900,2000,356500,76500,0,76500,247800,2000,326300,A1,AG/GEN,,,
16949,3-5-0-B-0,5892-78-7219,SNGL FAM SUB,10,AC,71800,0,71800,113900,1500,187200,69500,0,69500,94300,1500,165300,A1,AG/GEN,,,
16950,3-5-0-C-0,5892-77-6660,AG 20-100 AC,20.231,AC,93200,0,93200,383800,28000,505000,95800,0,95800,336000,26100,457900,A1,AG/GEN,,,
16951,3-5-0-D-0,5892-67-6888,AG 20-100 AC,34.6,AC,89300,0,89300,0,0,89300,86500,0,86500,0,0,86500,A1,AG/GEN,,,
16952,4-1-0-43-A2,6813-29-3435,SNGL FAM SUB,4.43,AC,58000,0,58000,0,0,58000,56700,0,56700,0,0,56700,A1,AG/GEN,,,
16953,18-13-0-1-0,6719-68-4461,SNGL FAM SUB,3.86,AC,56900,0,56900,202000,1100,260000,55200,0,55200,165400,1100,221700,A1,AG/GEN,,,
16954,18-13-0-3-0,6719-79-5406,SNGL FAM SUB,4.52,AC,60700,0,60700,191600,9300,261600,59100,0,59100,159400,700,219200,A1,AG/GEN,,,
16955,31-1-0-21-E,6768-66-0056,SNGL FAM SUB,2,AC,73400,0,73400,161400,4000,238800,65500,0,65500,125500,4000,195000,A2,AG/LTD,,,
16956,33-1-0-9-G,6798-46-2364,SNGL FAM SUB,3.341,AC,109400,0,109400,210600,1800,321800,97700,0,97700,170600,2000,270300,A2,AG/LTD,,,
16957,63-7-0-C-1B,7723-18-4066,SNGL FAM SUB,2.26,AC,199100,0,199100,1179500,0,1378600,173200,0,173200,987500,0,1160700,R1,RES/LTD,,,
16958,4-1-0-43-A1,6813-19-8559,SNGL FAM SUB,3.287,AC,51800,0,51800,0,0,51800,50800,0,50800,0,0,50800,A1,AG/GEN,,,
16959,18-13-0-2-0,6719-68-7685,SNGL FAM SUB,4.63,AC,61300,0,61300,171000,1200,233500,59800,0,59800,140100,1300,201200,A1,AG/GEN,,,
16961,31-1-0-81-A,6779-00-3390,SNGL FAM SUB,1.31,AC,52600,0,52600,0,0,52600,46900,0,46900,0,0,46900,A2,AG/LTD,,,
16962,44-1-0-14-F,6777-60-7733,SNGL FAM SUB,5.76,AC,135800,0,135800,313800,22500,472100,121100,0,121100,261300,22500,404900,A2,AG/LTD,,,
16964,41-1-0-13-0,6757-08-5299,COMM & IND,21.88,AC,409800,0,409800,31700,32500,474000,393700,0,393700,28300,32800,454800,M2,INDUS/G,,,
16965,32-1-0-26-A,6778-67-7962,SNGL FAM SUB,0.12,AC,1700,0,1700,0,0,1700,1500,0,1500,0,0,1500,B1,BUS/GEN,,,
16966,45-1-0-115-A,6797-88-2898,SNGL FAM SUB,4.5,AC,83400,0,83400,0,0,83400,74400,0,74400,0,0,74400,A2,AG/LTD,,,
16967,48-1-0-58-ATW,7738-30-9741-9998,COMM & IND,0,AC,0,0,0,0,144300,144300,0,0,0,0,143700,143700,M2,INDUS/G,,,
16968,58-32-3-50-A,7725-06-6484,Roads,0.399,AC,0,0,0,0,0,0,0,0,0,0,0,0,M1,INDUS/L,,,
16969,30-1-0-100-F,6768-17-9772,SNGL FAM SUB,10,AC,152200,0,152200,453400,16800,622400,143500,0,143500,368400,13800,525700,A2,AG/LTD,,,
16971,33-9-0-1-0,6798-73-4964,SNGL FAM SUB,4.795,AC,145300,0,145300,357300,0,502600,129600,0,129600,293000,0,422600,RR,RES/RUR,,,
16972,33-9-0-2-0,6798-73-0702,SNGL FAM SUB,5,AC,152800,0,152800,378200,25800,556800,136300,0,136300,310900,21700,468900,RR,RES/RUR,,,
16973,33-9-0-3-0,6798-63-5784,SNGL FAM SUB,4.504,AC,148800,0,148800,534500,0,683300,132700,0,132700,439900,0,572600,RR,RES/RUR,,,
16974,33-9-0-4-0,6798-64-4058,SNGL FAM SUB,5.278,AC,153300,0,153300,335800,0,489100,136700,0,136700,275600,0,412300,RR,RES/RUR,,,
16975,33-9-0-4-A,6798-64-6007,Cemetery,0.25,AC,100,0,100,0,0,100,100,0,100,0,0,100,RR,RES/RUR,,,
16976,33-9-0-5-0,6798-54-9154,SNGL FAM SUB,6.571,AC,158900,0,158900,407700,0,566600,141700,0,141700,335400,0,477100,RR,RES/RUR,,,
16977,33-9-0-6-0,6798-64-7303,SNGL FAM SUB,3.679,AC,135200,0,135200,357400,0,492600,120600,0,120600,293200,0,413800,RR,RES/RUR,,,
16978,33-9-0-7-0,6798-74-0335,SNGL FAM SUB,3.298,AC,128900,0,128900,375600,0,504500,115000,0,115000,308700,0,423700,RR,RES/RUR,,,
16979,33-9-0-8-0,6798-74-3454,SNGL FAM SUB,4.275,AC,136700,0,136700,417300,0,554000,121900,0,121900,341800,0,463700,RR,RES/RUR,,,
16980,33-9-0-9-0,6798-74-8525,SNGL FAM SUB,6.462,AC,155500,0,155500,345100,3600,504200,138700,0,138700,283800,2600,425100,RR,RES/RUR,,,
16981,33-9-0-10-0,6798-84-0382,SNGL FAM SUB,6.179,AC,159900,0,159900,440200,129400,729500,142500,0,142500,358100,94700,595300,RR,RES/RUR,,,
16982,5-1-0-19-A,6812-98-2938,SNGL FAM SUB,6,AC,63900,0,63900,15000,0,78900,62800,0,62800,17700,0,80500,A1,AG/GEN,,,
16983,16-1-0-58-A,6800-29-5900,AG 20-100 AC,20,AC,78700,0,78700,0,0,78700,76000,0,76000,0,0,76000,A1,AG/GEN,,,
16984,55-1-0-7-B,6786-15-3550,SNGL FAM SUB,2.4,AC,89400,0,89400,97000,1500,187900,79800,0,79800,74400,1500,155700,A2,AG/LTD,,,
16985,55-1-0-7-A,6786-15-7226,SNGL FAM SUB,3,AC,97700,0,97700,122600,3200,223500,87200,0,87200,94500,1400,183100,A2,AG/LTD,,,
16986,58-32-3-R-5A,7725-26-4307,Roads,0.038,AC,0,0,0,0,0,0,0,0,0,0,0,0,M1,INDUS/L,,,
16989,58-32-3-52-A,7725-07-8413,Roads,0.309,AC,0,0,0,0,0,0,0,0,0,0,0,0,M1,INDUS/L,,,
16990,59-3-3-W-4A,7725-57-1174,Roads,5.437,AC,0,0,0,0,0,0,0,0,0,0,0,0,M1,INDUS/L,,,
16992,59-3-2-W-7A,7725-48-8911,Roads,1.705,AC,0,0,0,0,0,0,0,0,0,0,0,0,M1,INDUS/L,,,
16993,62-37-0-A-0,6794-99-6917,Roads,2.025,AC,0,0,0,0,0,0,0,0,0,0,0,0,RR,RES/RUR,,,
16994,62-37-0-35-0,6794-98-8861,SNGL FAM SUB,10.536,AC,505400,0,505400,761200,56800,1323400,439700,0,439700,783200,47400,1270300,RR,RES/RUR,,,
16995,62-37-0-37-0,7705-00-6688,AG 20-100 AC,44.558,AC,1779400,0,1779400,1987900,210700,3978000,1547100,0,1547100,2040100,188100,3775300,RR,RES/RUR,,,
16997,62-37-0-38-0,6795-90-6557,AG 20-100 AC,26.129,AC,817100,0,817100,0,0,817100,711100,0,711100,0,0,711100,RR,RES/RUR,,,
16999,11-1-0-49-B2,6821-69-4198,SNGL FAM SUB,3.48,AC,56700,0,56700,273600,0,330300,56700,0,56700,223500,0,280200,A1,AG/GEN,,,
17000,18-10-0-4-A,6719-99-4065,SNGL FAM SUB,12.61,AC,102700,0,102700,0,0,102700,101900,0,101900,0,0,101900,A1,AG/GEN,,,
17001,31-11-0-1-A,6778-39-6884,SNGL FAM SUB,8.701,AC,151900,0,151900,416100,16500,584500,135800,0,135800,340300,14300,490400,RR,RES/RUR,,,
17002,44-1-0-61-A,6787-30-4165,SNGL FAM SUB,6.202,AC,138800,0,138800,352900,3000,494700,124000,0,124000,295700,3000,422700,A2,AG/LTD,,,
17006,9-1-0-69-B1,5892-71-4352,SNGL FAM SUB,2,AC,42400,0,42400,150600,8300,201300,41500,0,41500,119100,9100,169700,A1,AG/GEN,,,
17007,28-17-0-1-0,6729-82-2236,SNGL FAM SUB,3.395,AC,65900,0,65900,289100,41600,396600,63200,0,63200,242300,37000,342500,A1,AG/GEN,,,
17008,28-17-0-2-0,6729-72-8208,SNGL FAM SUB,3.639,AC,67500,0,67500,217300,2500,287300,64800,0,64800,179300,2500,246600,A1,AG/GEN,,,
17009,28-17-0-3-0,6729-72-4402,SNGL FAM SUB,4.891,AC,75800,0,75800,223200,35100,334100,73400,0,73400,185200,26400,285000,A1,AG/GEN,,,
17010,28-17-0-4-0,6729-72-5950,SNGL FAM SUB,3.862,AC,69000,0,69000,213200,3500,285700,66400,0,66400,175900,3500,245800,A1,AG/GEN,,,
17011,28-17-0-5-0,6729-72-9723,SNGL FAM SUB,3.563,AC,67000,0,67000,211300,2500,280800,64300,0,64300,174500,2500,241300,A1,AG/GEN,,,
17012,28-17-0-6-0,6729-82-3534,SNGL FAM SUB,3.356,AC,65600,0,65600,224400,3000,293000,62900,0,62900,187200,3000,253100,A1,AG/GEN,,,
17013,28-17-0-6-A,6729-82-2674,Cemetery,0,AC,100,0,100,0,0,100,100,0,100,0,0,100,A1,AG/GEN,,,
17018,28-17-0-7-0,6729-82-4705,SNGL FAM SUB,3.009,AC,63300,0,63300,337500,1200,402000,60600,0,60600,280300,1200,342100,A1,AG/GEN,,,
17019,63-37-1-8-T,7724-14-8976-9999,General Gov,0.282,AC,110700,0,110700,0,1785600,1896300,52700,0,52700,0,1341700,1394400,M1,INDUS/L,,,
17020,13-1-0-49-B,6841-36-6013,AG 20-100 AC,20,AC,112700,0,112700,0,0,112700,111800,0,111800,0,0,111800,A1,AG/GEN,,,
17021,17-1-0-88-B,6719-49-2367,AG 20-100 AC,50.31,AC,148500,123500,25000,0,0,148500,150900,127500,23400,0,0,150900,A1,AG/GEN,,,
17022,27-1-0-43-C,6718-79-7456,SNGL FAM SUB,3.162,AC,65600,0,65600,237700,32500,335800,64200,0,64200,238200,22200,324600,A1,AG/GEN,,,
17023,28-18-0-1-0,6729-95-9765,SNGL FAM SUB,3.622,AC,65000,0,65000,193100,2700,260800,63800,0,63800,161900,2900,228600,A1,AG/GEN,,,
17024,28-18-0-2-0,6729-95-3703,AG 20-100 AC,21.547,AC,154400,0,154400,0,0,154400,151500,0,151500,0,0,151500,A1,AG/GEN,,,
17025,28-18-0-3-0,6729-96-5116,SNGL FAM SUB,3.35,AC,63200,0,63200,198800,37900,299900,61900,0,61900,164500,32500,258900,A1,AG/GEN,,,
17026,28-18-0-4-0,6729-96-7197,SNGL FAM SUB,3.35,AC,63200,0,63200,205800,4500,273500,61900,0,61900,170400,4800,237100,A1,AG/GEN,,,
17027,28-18-0-5-0,6739-06-1225,SNGL FAM SUB,4.133,AC,68400,0,68400,203100,1000,272500,67600,0,67600,169900,1000,238500,A1,AG/GEN,,,
17028,39-12-0-1-0,6728-20-1657,SNGL FAM SUB,19.895,AC,104600,95400,9200,0,0,104600,103200,94700,8500,0,0,103200,A1,AG/GEN,,,
17029,39-12-0-2-0,6728-11-7396,SNGL FAM SUB,8.199,AC,64700,60900,3800,0,0,64700,63700,60200,3500,0,0,63700,A1,AG/GEN,,,
17030,39-12-0-3-0,6728-21-2492,SNGL FAM SUB,8.533,AC,81000,77100,3900,0,0,81000,79400,75800,3600,0,0,79400,A1,AG/GEN,,,
17031,39-12-0-4-0,6728-21-9294,SNGL FAM SUB,7.014,AC,75500,0,75500,0,0,75500,74100,0,74100,0,0,74100,A1,AG/GEN,,,
17032,43-1-0-47-A,6767-93-1997,SNGL FAM SUB,0.51,AC,7300,0,7300,0,0,7300,6600,0,6600,0,0,6600,A1,AG/GEN,,,
17034,44-27-0-B-0,6787-17-9348,Cmn Area/Open Spc,55.83,AC,0,0,0,0,0,0,0,0,0,0,0,0,RP,"RURAL,P",,,
17035,44-27-0-1-0,6787-19-4059,SNGL FAM SUB,2.043,AC,140000,0,140000,411800,600,552400,125000,0,125000,376200,700,501900,RP,"RURAL,P",,,
17036,44-27-0-2-0,6787-19-6288,SNGL FAM SUB,2.031,AC,140000,0,140000,387200,1700,528900,125000,0,125000,353000,1800,479800,RP,"RURAL,P",,,
17037,44-27-0-3-0,6787-19-8355,SNGL FAM SUB,2.018,AC,140000,0,140000,326100,0,466100,125000,0,125000,299500,0,424500,RP,"RURAL,P",,,
17038,44-27-0-4-0,6787-19-9558,SNGL FAM SUB,2.001,AC,140000,0,140000,389400,0,529400,125000,0,125000,358000,0,483000,RP,"RURAL,P",,,
17039,44-27-0-5-0,6787-29-2617,SNGL FAM SUB,2,AC,140000,0,140000,353200,0,493200,125000,0,125000,325600,0,450600,RP,"RURAL,P",,,
17040,44-27-0-6-0,6787-29-3417,SNGL FAM SUB,2,AC,140000,0,140000,365800,2200,508000,125000,0,125000,343500,2400,470900,RP,"RURAL,P",,,
17041,44-27-0-7-0,6787-29-3211,SNGL FAM SUB,2.002,AC,140000,0,140000,631900,2600,774500,125000,0,125000,575900,2700,703600,RP,"RURAL,P",,,
17042,44-27-0-8-0,6787-29-4142,SNGL FAM SUB,2.007,AC,140000,0,140000,586900,1700,728600,125000,0,125000,547800,1800,674600,RP,"RURAL,P",,,
17043,44-27-0-9-0,6787-28-5925,SNGL FAM SUB,2.045,AC,140000,0,140000,451700,0,591700,125000,0,125000,421600,0,546600,RP,"RURAL,P",,,
17044,44-27-0-10-0,6787-28-5772,SNGL FAM SUB,2.002,AC,140000,0,140000,330900,16500,487400,125000,0,125000,295200,0,420200,RP,"RURAL,P",,,
17045,44-27-0-11-0,6787-28-6510,SNGL FAM SUB,2.004,AC,140000,0,140000,416300,0,556300,125000,0,125000,381200,0,506200,RP,"RURAL,P",,,
17046,44-27-0-12-0,6787-28-7300,SNGL FAM SUB,2.152,AC,147000,0,147000,600000,1500,748500,131300,0,131300,549200,1500,682000,RP,"RURAL,P",,,
17052,44-27-0-18-0,6787-27-0994,SNGL FAM SUB,2.084,AC,140000,0,140000,280900,15000,435900,125000,0,125000,259700,14400,399100,RP,"RURAL,P",,,
17053,44-27-0-19-0,6787-27-0731,SNGL FAM SUB,2,AC,140000,0,140000,380000,29800,549800,125000,0,125000,348300,26000,499300,RP,"RURAL,P",,,
17054,44-27-0-20-0,6787-17-8645,SNGL FAM SUB,2.003,AC,140000,0,140000,605100,2100,747200,125000,0,125000,551600,2100,678700,RP,"RURAL,P",,,
17055,44-27-0-21-0,6787-17-4780,SNGL FAM SUB,2.001,AC,140000,0,140000,353400,0,493400,125000,0,125000,320300,0,445300,RP,"RURAL,P",,,
17056,44-27-0-22-0,6787-17-3960,SNGL FAM SUB,2.146,AC,140000,0,140000,428700,17900,586600,125000,0,125000,391800,17400,534200,RP,"RURAL,P",,,
17203,62-28-0-B-0,7705-61-2535,Cmn Area/Open Spc,4.815,AC,0,0,0,0,0,0,0,0,0,0,0,0,RR,RES/RUR,,,
17204,62-28-0-1-0,7705-61-3328,SNGL FAM SUB,4.644,AC,432000,0,432000,857400,31600,1321000,360000,0,360000,792800,30400,1183200,RR,RES/RUR,,,
17205,62-28-0-2-0,7705-61-5128,SNGL FAM SUB,4.999,AC,432000,0,432000,915600,73100,1420700,360000,0,360000,853900,69700,1283600,RR,RES/RUR,,,
17206,62-28-0-3-0,7705-60-7933,SNGL FAM SUB,4.548,AC,432000,0,432000,731900,51300,1215200,360000,0,360000,689500,48900,1098400,RR,RES/RUR,,,
17207,62-28-0-4-0,7705-60-7536,SNGL FAM SUB,3.325,AC,432000,0,432000,1372400,0,1804400,360000,0,360000,1327900,0,1687900,RR,RES/RUR,,,
17791,43-13-0-A-1,6767-73-3863,SNGL FAM SUB,2.2,AC,77800,0,77800,169100,0,246900,69400,0,69400,130200,0,199600,A2,AG/LTD,,,
17792,64-26-0-1-0,7733-58-1939,SNGL FAM SUB,1.379,AC,405000,0,405000,1578100,19800,2002900,369000,0,369000,1577100,17300,1963400,R1,RES/LTD,,,
17793,64-26-0-2-0,7733-59-4652,SNGL FAM SUB,1.907,AC,519800,0,519800,1811500,50900,2382200,473600,0,473600,1750800,49700,2274100,R1,RES/LTD,,,
17794,64-26-0-3-0,7733-59-4841,SNGL FAM SUB,2.174,AC,495000,0,495000,875400,0,1370400,451000,0,451000,863800,0,1314800,R1,RES/LTD,,,
17795,64-26-0-4-0,7734-50-4030,SNGL FAM SUB,2.143,AC,495000,0,495000,1393400,0,1888400,451000,0,451000,1358900,0,1809900,R1,RES/LTD,,,
17796,64-26-0-5-0,7734-50-4159,SNGL FAM SUB,2.184,AC,495000,0,495000,1449400,0,1944400,451000,0,451000,1432100,0,1883100,R1,RES/LTD,,,
17797,64-26-0-6-0,7734-50-4359,SNGL FAM SUB,2.24,AC,495000,0,495000,1475000,80800,2050800,451000,0,451000,1492100,75500,2018600,R1,RES/LTD,,,
17798,64-26-0-7-0,7734-50-4671,SNGL FAM SUB,2.234,AC,524700,0,524700,1377300,75600,1977600,478100,0,478100,1377400,70200,1925700,R1,RES/LTD,,,
17799,64-26-0-8-0,7734-50-4811,SNGL FAM SUB,1.691,AC,559400,0,559400,1224200,44900,1828500,509600,0,509600,1208600,42400,1760600,R1,RES/LTD,,,
17800,64-26-0-9-0,7734-51-3021,SNGL FAM SUB,1.488,AC,559400,0,559400,1014100,0,1573500,509600,0,509600,988600,0,1498200,R1,RES/LTD,,,
17801,64-26-0-10-0,7734-51-1178,SNGL FAM SUB,2.002,AC,524700,0,524700,1417400,62600,2004700,478100,0,478100,1438600,59500,1976200,R1,RES/LTD,,,
17802,64-26-0-11-0,7734-41-9136,SNGL FAM SUB,1.718,AC,450000,0,450000,1485600,68800,2004400,410000,0,410000,1443700,63700,1917400,R1,RES/LTD,,,
17803,64-26-0-13-0,7734-40-9796,SNGL FAM SUB,1.376,AC,450000,0,450000,1284200,1500,1735700,410000,0,410000,1234800,1300,1646100,R1,RES/LTD,,,
17804,64-26-0-14-0,7734-40-9692,SNGL FAM SUB,1.355,AC,450000,0,450000,1256900,4200,1711100,410000,0,410000,1234000,4300,1648300,R1,RES/LTD,,,
17805,64-26-0-15-0,7734-40-9487,SNGL FAM SUB,1.284,AC,450000,0,450000,1720100,83100,2253200,410000,0,410000,1688800,77000,2175800,R1,RES/LTD,,,
17806,64-26-0-16-0,7734-40-9373,SNGL FAM SUB,1.214,AC,450000,0,450000,1486300,42700,1979000,410000,0,410000,1450500,40100,1900600,R1,RES/LTD,,,
17807,64-26-0-17-0,7734-40-9168,SNGL FAM SUB,1.144,AC,450000,0,450000,1336100,173100,1959200,410000,0,410000,1301400,163100,1874500,R1,RES/LTD,,,
17808,64-26-0-18-0,7734-40-9052,SNGL FAM SUB,1.078,AC,450000,0,450000,1129800,2100,1581900,410000,0,410000,1104200,2200,1516400,R1,RES/LTD,,,
17809,64-26-0-19-0,7733-49-9857,SNGL FAM SUB,1.097,AC,450000,0,450000,0,0,450000,410000,0,410000,0,0,410000,R1,RES/LTD,,,
17810,64-26-0-20-0,7733-49-9781,SNGL FAM SUB,1.285,AC,450000,0,450000,1828800,135000,2413800,410000,0,410000,1738600,125500,2274100,R1,RES/LTD,,,
17811,64-26-0-21-0,7733-59-0505,SNGL FAM SUB,1.492,AC,450000,0,450000,1620200,0,2070200,410000,0,410000,1574200,0,1984200,R1,RES/LTD,,,
17812,64-26-0-22-0,7733-49-9399,SNGL FAM SUB,1.5,AC,450000,0,450000,1065000,0,1515000,410000,0,410000,1054300,0,1464300,R1,RES/LTD,,,
17813,64-26-0-23-0,7733-49-9232,SNGL FAM SUB,1.14,AC,450000,0,450000,1260700,127700,1838400,410000,0,410000,1235700,116100,1761800,R1,RES/LTD,,,
17814,64-26-R-1-0,7733-59-1820,Roads,3.377,AC,0,0,0,0,0,0,0,0,0,0,0,0,R1,RES/LTD,,,
17815,64-26-0-B-0,7733-59-3174,Cmn Area/Open Spc,7.048,AC,0,0,0,0,0,0,0,0,0,0,0,0,R1,RES/LTD,,,
18095,58-38-5-24-0,7715-68-7593,SNGL FAM URB,0.377,AC,133800,0,133800,512500,0,646300,131100,0,131100,520400,0,651500,RPUD,RES/PUD,,,
18096,58-38-5-25-0,7715-68-7435,SNGL FAM URB,0.452,AC,133800,0,133800,448700,0,582500,131100,0,131100,443800,0,574900,RPUD,RES/PUD,,,
18097,58-38-5-26-0,7715-68-6435,SNGL FAM URB,0.432,AC,133800,0,133800,505000,0,638800,131100,0,131100,498600,0,629700,RPUD,RES/PUD,,,
18098,58-38-5-27-0,7715-68-5440,SNGL FAM URB,0.388,AC,133800,0,133800,591300,0,725100,131100,0,131100,607600,0,738700,RPUD,RES/PUD,,,
18099,58-38-5-28-0,7715-68-4374,SNGL FAM URB,0.34,AC,133800,0,133800,432300,0,566100,131100,0,131100,444800,0,575900,RPUD,RES/PUD,,,
17057,44-27-0-23-0,6787-18-5047,SNGL FAM SUB,2.002,AC,140000,0,140000,455900,0,595900,125000,0,125000,417600,0,542600,RP,"RURAL,P",,,
17058,44-27-0-24-0,6787-18-6203,SNGL FAM SUB,2.001,AC,140000,0,140000,419200,27000,586200,125000,0,125000,381700,25100,531800,RP,"RURAL,P",,,
17059,44-27-0-25-0,6787-18-6472,SNGL FAM SUB,2.019,AC,140000,0,140000,353700,17500,511200,125000,0,125000,335000,15600,475600,RP,"RURAL,P",,,
17060,44-27-0-26-0,6787-18-8611,SNGL FAM SUB,2.008,AC,140000,0,140000,547100,0,687100,125000,0,125000,515400,0,640400,RP,"RURAL,P",,,
17061,44-27-0-27-0,6787-28-0785,SNGL FAM SUB,2.002,AC,140000,0,140000,415700,0,555700,125000,0,125000,382100,0,507100,RP,"RURAL,P",,,
17062,44-27-0-28-0,6787-18-9966,SNGL FAM SUB,2.004,AC,140000,0,140000,468000,2300,610300,125000,0,125000,428300,2100,555400,RP,"RURAL,P",,,
17063,44-27-0-29-0,6787-18-6841,SNGL FAM SUB,2.009,AC,140000,0,140000,539100,0,679100,125000,0,125000,491300,0,616300,RP,"RURAL,P",,,
17064,44-27-0-30-0,6787-18-3569,SNGL FAM SUB,2.007,AC,140000,0,140000,420800,58600,619400,125000,0,125000,382500,52200,559700,RP,"RURAL,P",,,
17065,44-27-0-31-0,6787-18-2319,SNGL FAM SUB,2.001,AC,140000,0,140000,502600,0,642600,125000,0,125000,467500,0,592500,RP,"RURAL,P",,,
17066,44-27-0-32-0,6787-18-1046,SNGL FAM SUB,2.018,AC,140000,0,140000,555100,20700,715800,125000,0,125000,505000,19400,649400,RP,"RURAL,P",,,
17067,44-27-0-33-0,6787-08-8084,SNGL FAM SUB,2,AC,140000,0,140000,558100,0,698100,125000,0,125000,521600,0,646600,RP,"RURAL,P",,,
17068,44-27-0-34-0,6787-08-7117,SNGL FAM SUB,2.002,AC,140000,0,140000,506600,0,646600,125000,0,125000,463700,0,588700,RP,"RURAL,P",,,
17069,44-27-0-35-0,6787-08-7472,SNGL FAM SUB,2,AC,140000,0,140000,408100,2100,550200,125000,0,125000,373200,2100,500300,RP,"RURAL,P",,,
17070,44-27-0-36-0,6787-08-8642,SNGL FAM SUB,2.015,AC,140000,0,140000,374300,1700,516000,125000,0,125000,341700,1700,468400,RP,"RURAL,P",,,
17071,44-27-0-37-0,6787-08-9749,SNGL FAM SUB,2.052,AC,140000,0,140000,393600,13300,546900,125000,0,125000,351400,11900,488300,RP,"RURAL,P",,,
17072,44-27-0-38-0,6787-18-1877,SNGL FAM SUB,2.067,AC,140000,0,140000,427000,10700,577700,125000,0,125000,387700,10400,523100,RP,"RURAL,P",,,
17073,48-1-0-67-D,7737-16-2572,COMM & IND,114.89,AC,2576400,0,2576400,0,0,2576400,2454000,0,2454000,0,0,2454000,M2,INDUS/G,,,
17074,48-1-0-67-E,7737-17-7890,COMM & IND,5.81,AC,386400,0,386400,0,0,386400,368200,0,368200,0,0,368200,M2,INDUS/G,,,
17075,48-1-0-69-C,7727-88-8884,COMM & IND,35.58,AC,1703800,0,1703800,75300,0,1779100,1623900,0,1623900,64300,0,1688200,M2,INDUS/G,,,
17076,48-17-4-1-0,7738-01-6515,SNGL FAM URB,0.27,AC,130000,0,130000,472600,0,602600,125000,0,125000,430800,0,555800,RPUD,RES/PUD,,,
17077,64-25-1-F-P3A,7734-13-7291,General Gov,0.02,AC,2700,0,2700,2000,0,4700,2600,0,2600,2000,0,4600,M1,INDUS/L,,,
17079,5-1-0-7-B,6813-86-3714,AG 20-100 AC,52.494,AC,195800,171600,24200,0,0,195800,192000,169700,22300,0,0,192000,A1,AG/GEN,,,
17080,5-5-0-G-0,6823-57-5251,SNGL FAM SUB,8.39,AC,73400,0,73400,165300,27800,266500,72100,0,72100,144300,21300,237700,A1,AG/GEN,,,
17081,7-1-0-6-A,6842-08-5001,AG 20-100 AC,36.726,AC,219500,157900,61600,0,78100,297600,214700,155700,59000,0,71300,286000,A1,AG/GEN,,,
17082,16-3-0-2-B1,5799-48-4670,SNGL FAM SUB,3.5,AC,45900,0,45900,0,0,45900,45500,0,45500,0,0,45500,A1,AG/GEN,,,
17083,16-3-0-2-B2,5799-58-0582,SNGL FAM SUB,4.608,AC,51800,0,51800,214600,1500,267900,50600,0,50600,186200,1500,238300,A1,AG/GEN,,,
17084,20-1-0-92-A1,6749-99-9036,SNGL FAM SUB,3,AC,73600,0,73600,260800,3700,338100,69700,0,69700,223300,2600,295600,A1,AG/GEN,,,
17085,31-1-0-24-C,6768-76-7887,SNGL FAM SUB,5,AC,101100,0,101100,203000,8700,312800,92700,0,92700,168100,6400,267200,A2,AG/LTD,,,
17086,31-2-0-2-C4,6769-41-4175,SNGL FAM SUB,8.339,AC,148700,144500,4200,0,0,148700,131400,127800,3600,0,0,131400,A2,AG/LTD,,,
17087,31-2-0-2-C3,6769-51-0814,SNGL FAM SUB,6.248,AC,121200,0,121200,343100,18400,482700,109700,0,109700,284000,16700,410400,A2,AG/LTD,,,
17088,45-1-0-18-A,6797-09-7413,SNGL FAM SUB,2.006,AC,86000,0,86000,116300,1700,204000,76800,0,76800,89900,1700,168400,A2,AG/LTD,,,
17089,56-1-0-39-B,6795-03-6633,SNGL FAM SUB,3.504,AC,192100,0,192100,1288800,98900,1579800,171400,0,171400,1104800,91600,1367800,A2,AG/LTD,,,
17090,52-1-0-1-C,6745-08-9561,AG 20-100 AC,76.106,AC,232900,195700,37200,0,0,232900,228300,195800,32500,0,0,228300,A1,AG/GEN,,,
17091,52-1-0-1-D,6745-28-2776,AG > 100 AC,115.93,AC,237700,180000,57700,0,0,237700,231900,182200,49700,0,0,231900,A1,AG/GEN,,,
17092,57-1-0-70-B1,7706-95-1134,SNGL FAM SUB,2,AC,237800,236800,1000,0,0,237800,206800,205900,900,0,0,206800,A2,AG/LTD,,,
17094,57-36-0-1-0,7716-15-2527,SNGL FAM SUB,2.002,AC,230000,0,230000,490300,0,720300,210000,0,210000,472900,0,682900,RP,"RURAL,P",,,
17095,57-36-0-2-0,7716-15-3345,SNGL FAM SUB,2.005,AC,230000,0,230000,602500,0,832500,210000,0,210000,577300,0,787300,RP,"RURAL,P",,,
17096,57-36-0-3-0,7716-15-4158,SNGL FAM SUB,2.078,AC,230000,0,230000,644600,43900,918500,210000,0,210000,606700,41100,857800,RP,"RURAL,P",,,
17097,57-36-0-4-0,7716-15-6054,SNGL FAM SUB,2,AC,230000,0,230000,434600,0,664600,210000,0,210000,422700,0,632700,RP,"RURAL,P",,,
17098,57-36-0-5-0,7716-14-8899,SNGL FAM SUB,2,AC,230000,0,230000,682100,0,912100,210000,0,210000,653000,0,863000,RP,"RURAL,P",,,
17099,57-36-0-6-0,7716-14-9517,SNGL FAM SUB,2,AC,230000,0,230000,569300,0,799300,210000,0,210000,551700,0,761700,RP,"RURAL,P",,,
17100,57-36-0-7-0,7716-24-0306,SNGL FAM SUB,2.002,AC,230000,0,230000,583000,11600,824600,210000,0,210000,560300,9900,780200,RP,"RURAL,P",,,
17101,57-36-0-8-0,7716-24-2258,SNGL FAM SUB,2.003,AC,230000,0,230000,429800,0,659800,210000,0,210000,416700,0,626700,RP,"RURAL,P",,,
17102,57-36-0-9-0,7716-24-4460,SNGL FAM SUB,2.002,AC,230000,0,230000,597400,0,827400,210000,0,210000,571400,0,781400,RP,"RURAL,P",,,
17103,57-36-0-10-0,7716-24-6561,SNGL FAM SUB,2,AC,230000,0,230000,495900,0,725900,210000,0,210000,479300,0,689300,RP,"RURAL,P",,,
17104,57-36-0-11-0,7716-24-7761,SNGL FAM SUB,2.001,AC,230000,0,230000,555800,0,785800,210000,0,210000,541200,0,751200,RP,"RURAL,P",,,
17105,57-36-0-12-0,7716-24-4962,SNGL FAM SUB,2.001,AC,230000,0,230000,502400,0,732400,210000,0,210000,482700,0,692700,RP,"RURAL,P",,,
17106,57-36-0-13-0,7716-24-2755,SNGL FAM SUB,2.001,AC,230000,0,230000,533200,0,763200,210000,0,210000,516100,0,726100,RP,"RURAL,P",,,
17107,57-36-0-14-0,7716-25-2029,SNGL FAM SUB,2,AC,230000,0,230000,583000,1400,814400,210000,0,210000,559400,1200,770600,RP,"RURAL,P",,,
17108,57-36-0-15-0,7716-25-0267,SNGL FAM SUB,2.003,AC,230000,0,230000,477500,800,708300,210000,0,210000,458800,800,669600,RP,"RURAL,P",,,
17109,57-36-0-16-0,7716-15-8442,SNGL FAM SUB,2.001,AC,230000,0,230000,537400,32800,800200,210000,0,210000,518600,30400,759000,RP,"RURAL,P",,,
17110,57-36-0-17-0,7716-15-6662,SNGL FAM SUB,2.003,AC,230000,0,230000,599100,1200,830300,210000,0,210000,577800,1300,789100,RP,"RURAL,P",,,
17111,57-36-0-18-0,7716-15-4779,SNGL FAM SUB,2.001,AC,230000,0,230000,509700,46100,785800,210000,0,210000,489900,43000,742900,RP,"RURAL,P",,,
17112,57-36-0-19-0,7716-15-2971,SNGL FAM SUB,2,AC,230000,0,230000,499100,0,729100,210000,0,210000,483300,0,693300,RP,"RURAL,P",,,
17113,17-3-0-1-C,6800-30-6568,SNGL FAM SUB,3.048,AC,50300,0,50300,89700,5000,145000,49300,0,49300,74300,5000,128600,A1,AG/GEN,,,
17116,11-16-0-20-0,6822-26-1246,SNGL FAM SUB,5.449,AC,76000,0,76000,654100,191500,921600,69000,0,69000,592600,194500,856100,RR,RES/RUR,,,
17117,11-16-0-21-0,6822-16-8189,SNGL FAM SUB,5.416,AC,76000,0,76000,0,0,76000,69000,0,69000,0,0,69000,RR,RES/RUR,,,
17118,11-16-0-22-0,6822-16-6086,SNGL FAM SUB,5.201,AC,76000,0,76000,310700,2400,389100,69000,0,69000,271300,2500,342800,RR,RES/RUR,,,
17119,11-16-0-23-0,6822-15-5930,SNGL FAM SUB,5.013,AC,76000,0,76000,428400,0,504400,69000,0,69000,354500,0,423500,RR,RES/RUR,,,
17120,11-16-0-24-0,6822-15-2676,SNGL FAM SUB,6.955,AC,76000,0,76000,400000,0,476000,72000,0,72000,346400,0,418400,RR,RES/RUR,,,
17121,11-16-0-25-0,6822-05-8577,SNGL FAM SUB,5.04,AC,76000,0,76000,496200,0,572200,69000,0,69000,425100,0,494100,RR,RES/RUR,,,
17122,11-16-0-26-0,6822-05-6800,SNGL FAM SUB,5.3,AC,76000,0,76000,0,0,76000,69000,0,69000,0,0,69000,RR,RES/RUR,,,
17123,11-16-0-27-0,6822-06-5178,SNGL FAM SUB,6.43,AC,76000,0,76000,0,0,76000,69000,0,69000,0,0,69000,RR,RES/RUR,,,
17124,11-16-0-28-0,6822-06-9456,SNGL FAM SUB,5.318,AC,76000,0,76000,333700,4100,413800,69000,0,69000,283100,4200,356300,RR,RES/RUR,,,
17125,11-16-0-29-0,6822-06-7921,SNGL FAM SUB,8,AC,76000,0,76000,392300,3100,471400,72000,0,72000,350900,3100,426000,RR,RES/RUR,,,
17126,11-16-0-30-0,6822-17-2110,SNGL FAM SUB,5.8,AC,76000,0,76000,424500,0,500500,69000,0,69000,367500,0,436500,RR,RES/RUR,,,
17127,11-16-0-31-0,6822-16-5798,SNGL FAM SUB,5.645,AC,76000,0,76000,544900,0,620900,69000,0,69000,507700,0,576700,RR,RES/RUR,,,
17128,13-1-0-50-B2,6841-46-1049,SNGL FAM SUB,3.166,AC,61200,0,61200,300600,0,361800,59100,0,59100,271500,0,330600,A1,AG/GEN,,,
17129,13-1-0-50-B3,6841-35-8488,SNGL FAM SUB,14.267,AC,91700,0,91700,279900,800,372400,88700,0,88700,243500,800,333000,A1,AG/GEN,,,
17130,16-1-0-75-A,6800-02-4400,SNGL FAM SUB,5.583,AC,59900,0,59900,739500,63600,863000,58600,0,58600,685600,53200,797400,A1,AG/GEN,,,
17131,51-1-0-56-0,6735-89-8053,AG 20-100 AC,40.707,AC,158600,139700,18900,0,0,158600,154700,137400,17300,0,0,154700,A1,AG/GEN,,,
17132,21-5-0-4-A,6850-52-2593,General Gov,0.2,AC,2500,0,2500,0,0,2500,2100,0,2100,0,0,2100,A2,AG/LTD,,,
17134,46-18-0-C-2,7708-00-1964,SNGL FAM SUB,6.05,AC,215600,0,215600,0,0,215600,192600,0,192600,0,0,192600,A2,AG/LTD,,,
17135,64-22-A-22-A,7734-20-4635,SNGL FAM SUB,2,AC,470000,0,470000,280600,0,750600,430000,0,430000,282300,0,712300,R1,RES/LTD,,,
17136,12-1-0-72-B,6831-62-0378,SNGL FAM SUB,3.45,AC,70300,0,70300,141700,1400,213400,63800,0,63800,109700,1500,175000,A1,AG/GEN,,,
17137,57-1-0-79-C1,7706-52-9629,SNGL FAM SUB,2.7,AC,154100,0,154100,0,1600,155700,154400,0,154400,0,0,154400,A2,AG/LTD,,,
17138,57-1-0-82-0,7705-23-0924,Roads,5.993,AC,0,0,0,0,0,0,0,0,0,0,0,0,RR,RES/RUR,,,
17139,62-1-0-2-0,7705-11-4681,Cmn Area/Open Spc,2.224,AC,0,0,0,0,0,0,0,0,0,0,0,0,RR,RES/RUR,,,
17140,26-16-0-4-0,6709-80-1474,SNGL FAM SUB,3,AC,51000,0,51000,341000,2400,394400,50000,0,50000,291500,2600,344100,RR,RES/RUR,,,
17141,26-16-0-1-0,6709-71-8105,SNGL FAM SUB,3,AC,52000,0,52000,335800,1000,388800,50000,0,50000,273900,1000,324900,RR,RES/RUR,,,
17142,26-16-0-2-0,6709-70-8856,SNGL FAM SUB,3,AC,52000,0,52000,342700,2200,396900,50000,0,50000,282200,2300,334500,RR,RES/RUR,,,
17143,26-16-0-3-0,6709-70-8641,SNGL FAM SUB,3,AC,52000,0,52000,301200,0,353200,50000,0,50000,245600,0,295600,RR,RES/RUR,,,
17144,26-17-0-1-0,6719-02-5871,AG 20-100 AC,27.666,AC,173700,0,173700,340700,4800,519200,171300,0,171300,276700,4800,452800,A1,AG/GEN,,,
17145,26-17-0-2-0,6719-02-8025,SNGL FAM SUB,11.516,AC,96800,0,96800,389000,1300,487100,95800,0,95800,325400,1200,422400,A1,AG/GEN,,,
17146,26-17-0-3-0,6719-01-0761,SNGL FAM SUB,12.629,AC,103900,0,103900,0,0,103900,102000,0,102000,0,0,102000,A1,AG/GEN,,,
17147,26-17-0-4-0,6709-92-7560,SNGL FAM SUB,10.897,AC,93500,0,93500,0,0,93500,92400,0,92400,0,0,92400,A1,AG/GEN,,,
17148,26-17-0-5-0,6709-93-8192,SNGL FAM SUB,7.962,AC,78500,0,78500,275500,3000,357000,76300,0,76300,223200,3300,302800,A1,AG/GEN,,,
17149,30-21-0-1-0,6768-29-4790,SNGL FAM SUB,8.48,AC,155400,151100,4300,0,3000,158400,144900,141300,3600,0,3000,147900,A2,AG/LTD,,,
17151,30-21-0-3-0,6769-20-4377,SNGL FAM SUB,15.21,AC,210200,202800,7400,0,4500,214700,190300,183800,6500,0,4500,194800,A2,AG/LTD,,,
17152,30-21-0-4-0,6768-29-9941,SNGL FAM SUB,5.42,AC,120900,118100,2800,0,0,120900,108100,105800,2300,0,0,108100,A2,AG/LTD,,,
17154,47-33-0-10-0,7727-49-3110,COMM & IND,4.849,AC,673800,0,673800,1604900,154100,2432800,641500,0,641500,1493100,124800,2259400,M2,INDUS/G,,,
17155,47-33-0-11-0,7727-39-9120,COMM & IND,1.526,AC,275700,0,275700,506700,61000,843400,262600,0,262600,476000,40400,779000,M2,INDUS/G,,,
17156,47-33-0-13-0,7727-38-7716,COMM & IND,3.409,AC,526400,0,526400,423100,23500,973000,501100,0,501100,394200,16000,911300,M2,INDUS/G,,,
17157,47-33-0-12-0,7727-39-5039,COMM & IND,5.03,AC,425700,0,425700,0,0,425700,405300,0,405300,0,0,405300,M2,INDUS/G,,,
17158,47-33-0-14-0,7727-38-9532,Cmn Area/Open Spc,2.16,AC,0,0,0,0,0,0,0,0,0,0,0,0,M2,INDUS/G,,,
17159,47-33-0-15-0,7727-48-0134,COMM & IND,1.503,AC,232100,0,232100,0,0,232100,220900,0,220900,0,0,220900,M2,INDUS/G,,,
17160,47-33-0-16-0,7727-48-1180,COMM & IND,3.414,AC,527100,0,527100,0,0,527100,501900,0,501900,0,0,501900,M2,INDUS/G,,,
17161,47-33-0-17-0,7727-48-4385,COMM & IND,3.175,AC,490200,0,490200,705000,65300,1260500,466700,0,466700,665600,44000,1176300,M2,INDUS/G,,,
17162,47-33-0-18-0,7727-48-6550,COMM & IND,2.506,AC,407600,0,407600,691000,86100,1184700,388200,0,388200,645600,88700,1122500,M2,INDUS/G,,,
17164,57-37-0-1-0,7705-73-5080,SNGL FAM SUB,3.458,AC,275000,0,275000,874900,0,1149900,250000,0,250000,810500,0,1060500,RR,RES/RUR,,,
17165,57-37-0-2-0,7705-72-8822,SNGL FAM SUB,3.392,AC,275000,0,275000,918300,0,1193300,250000,0,250000,839200,0,1089200,RR,RES/RUR,,,
17166,57-37-0-3-0,7705-82-1632,SNGL FAM SUB,5.4,AC,275000,0,275000,639700,46000,960700,250000,0,250000,585300,41500,876800,RR,RES/RUR,,,
17167,57-37-0-4-0,7705-82-4108,SNGL FAM SUB,6.2,AC,275000,0,275000,708000,0,983000,250000,0,250000,641800,0,891800,RR,RES/RUR,,,
17168,60-1-0-1-C,6774-97-4734,SNGL FAM SUB,1.071,AC,6200,0,6200,0,0,6200,5600,0,5600,0,0,5600,A2,AG/LTD,,,
17169,55-25-0-4-0,6786-62-8825,SNGL FAM SUB,2.65,AC,109800,0,109800,261100,34800,405700,98000,0,98000,214500,32300,344800,A2,AG/LTD,,,
17170,55-25-0-A-0,6786-63-5179,Roads,0.664,AC,0,0,0,0,0,0,0,0,0,0,0,0,A2,AG/LTD,,,
17171,55-25-0-B-0,6786-63-5122,Cmn Area/Open Spc,0.897,AC,0,0,0,0,0,0,0,0,0,0,0,0,A2,AG/LTD,,,
17172,55-25-0-1-0,6786-63-8336,SNGL FAM SUB,2.25,AC,103200,0,103200,491300,0,594500,92100,0,92100,403000,0,495100,A2,AG/LTD,,,
17173,55-25-0-2-0,6786-73-1245,SNGL FAM SUB,2.21,AC,102600,0,102600,410300,31900,544800,91500,0,91500,350000,26700,468200,A2,AG/LTD,,,
17174,55-25-0-3-0,6786-73-0014,SNGL FAM SUB,2,AC,99100,0,99100,360800,7700,467600,88500,0,88500,307500,5500,401500,A2,AG/LTD,,,
17175,48-1-0-8-C1,7728-60-9660,SNGL FAM SUB,2.92,AC,149300,0,149300,276200,700,426200,133300,0,133300,229200,700,363200,A2,AG/LTD,,,
17176,28-17-0-A-0,6729-82-4987,Roads,0.578,AC,0,0,0,0,0,0,0,0,0,0,0,0,A1,AG/GEN,,,
17177,28-1-0-71-E,6739-06-8235,SNGL FAM SUB,3,AC,60800,0,60800,378600,2400,441800,60300,0,60300,321300,0,381600,A1,AG/GEN,,,
17178,12-1-0-71-L,6831-52-0668,SNGL FAM SUB,3.597,AC,69300,0,69300,234400,6500,310200,65000,0,65000,210600,6500,282100,A1,AG/GEN,,,
17179,13-1-0-25-A2,6841-88-3755,SNGL FAM SUB,2.38,AC,56900,0,56900,195600,0,252500,55700,0,55700,170000,0,225700,A1,AG/GEN,,,
17180,42-1-0-90-A1,6767-06-6600,Academic-Private,9.41,AC,651700,0,651700,2256300,127100,3035100,591800,0,591800,2178300,122600,2892700,A2,AG/LTD,,,
17182,42-29-0-1-0,6758-80-6125,SNGL FAM SUB,2.56,AC,73100,0,73100,0,0,73100,68600,0,68600,0,0,68600,R1,RES/LTD,,,
17183,42-29-0-2-0,6758-80-5490,SNGL FAM SUB,2.57,AC,73200,0,73200,0,0,73200,68700,0,68700,0,0,68700,R1,RES/LTD,,,
17184,42-29-0-3-0,6758-80-7577,SNGL FAM SUB,2.57,AC,73200,0,73200,0,0,73200,68700,0,68700,0,0,68700,R1,RES/LTD,,,
17185,42-29-0-4-0,6758-90-1340,SNGL FAM SUB,2.96,AC,77800,0,77800,164400,0,242200,73400,0,73400,134400,100,207900,R1,RES/LTD,,,
17186,55-1-0-93-D,6785-66-2195,COMM & IND,0.33,AC,40000,0,40000,109900,0,149900,37100,0,37100,107600,0,144700,B1,BUS/GEN,,,
17188,9-1-0-69-C,5892-72-5006,SNGL FAM SUB,6,AC,56800,0,56800,148000,24000,228800,55500,0,55500,130100,22400,208000,A1,AG/GEN,,,
17189,9-1-0-69-D,5892-71-5725,SNGL FAM SUB,6,AC,56800,0,56800,0,0,56800,55500,0,55500,0,0,55500,A1,AG/GEN,,,
17190,46-1-0-118-G,7717-03-7731,SNGL FAM SUB,6,AC,184000,0,184000,460900,0,644900,164400,0,164400,403400,0,567800,A2,AG/LTD,,,
17192,63-1-0-161-A,7714-84-8579,COMM & IND,8.603,AC,228000,0,228000,1998700,108400,2335100,210800,0,210800,1912400,76800,2200000,A2,AG/LTD,,,
17193,47-20-0-B-1,7717-42-1056,SNGL FAM SUB,4.04,AC,183100,0,183100,497400,0,680500,163400,0,163400,430700,0,594100,A2,AG/LTD,,,
17194,50-1-0-5-A,6726-16-8844,SNGL FAM SUB,3.31,AC,52900,0,52900,0,0,52900,51900,0,51900,0,0,51900,A1,AG/GEN,,,
17195,50-1-0-5-B,6726-16-8453,SNGL FAM SUB,2.34,AC,46300,0,46300,131400,1000,178700,45400,0,45400,110800,1000,157200,A1,AG/GEN,,,
17196,7-1-0-6-B,6842-19-2319,SNGL FAM SUB,10,AC,101300,90000,11300,0,0,101300,98800,88300,10500,0,0,98800,A1,AG/GEN,,,
17197,18-1-0-6-F,6810-89-3754,SNGL FAM SUB,15.58,AC,120400,0,120400,340100,43600,504100,118200,0,118200,296900,42300,457400,A1,AG/GEN,,,
17198,29-1-0-50-B,6748-59-9677,SNGL FAM SUB,3,AC,73600,0,73600,203700,5000,282300,67500,0,67500,168500,5000,241000,A1,AG/GEN,,,
17199,29-1-0-50-C,6748-69-2790,SNGL FAM SUB,2,AC,64000,0,64000,130200,0,194200,58700,0,58700,99900,0,158600,A1,AG/GEN,,,
17200,40-1-0-15-B,6726-99-6376,SNGL FAM SUB,18.891,AC,146300,0,146300,0,0,146300,143600,0,143600,0,0,143600,A1,AG/GEN,,,
17201,63-1-0-114-F,7715-62-4196,SNGL FAM SUB,2.79,AC,138000,0,138000,0,0,138000,120000,0,120000,0,0,120000,A2,AG/LTD,,,
17202,62-28-0-A-0,7705-71-1391,Roads,5.535,AC,0,0,0,0,0,0,0,0,0,0,0,0,RR,RES/RUR,,,
17208,62-28-0-5-0,7705-60-6286,SNGL FAM SUB,3.407,AC,432000,0,432000,937300,38400,1407700,360000,0,360000,894500,32900,1287400,RR,RES/RUR,,,
17209,62-28-0-6-0,7704-69-7876,SNGL FAM SUB,4.795,AC,432000,0,432000,1019800,0,1451800,360000,0,360000,965100,0,1325100,RR,RES/RUR,,,
17210,62-28-0-7-0,7704-69-9574,SNGL FAM SUB,5.748,AC,432000,0,432000,1231300,0,1663300,360000,0,360000,1181700,0,1541700,RR,RES/RUR,,,
17211,62-28-0-8-0,7704-79-2988,SNGL FAM SUB,3.337,AC,432000,0,432000,1441000,76000,1949000,360000,0,360000,1430000,64300,1854300,RR,RES/RUR,,,
17212,62-28-0-9-0,7705-70-3349,SNGL FAM SUB,4.21,AC,432000,0,432000,0,0,432000,360000,0,360000,0,0,360000,RR,RES/RUR,,,
17213,62-28-0-10-0,7705-70-3718,SNGL FAM SUB,3.64,AC,432000,0,432000,739000,0,1171000,360000,0,360000,702000,0,1062000,RR,RES/RUR,,,
17214,62-28-0-11-0,7705-70-8700,SNGL FAM SUB,4.23,AC,432000,0,432000,0,0,432000,360000,0,360000,0,0,360000,RR,RES/RUR,,,
17215,62-28-0-12-0,7705-71-6195,SNGL FAM SUB,4.187,AC,432000,0,432000,1284600,5000,1721600,360000,0,360000,1221100,5200,1586300,RR,RES/RUR,,,
17216,62-28-0-13-0,7705-71-2208,SNGL FAM SUB,4.202,AC,432000,0,432000,1041700,49900,1523600,360000,0,360000,1004000,48500,1412500,RR,RES/RUR,,,
17217,62-28-0-14-0,7705-71-5564,SNGL FAM SUB,4.828,AC,432000,0,432000,1059900,0,1491900,360000,0,360000,1002000,0,1362000,RR,RES/RUR,,,
17218,62-28-0-15-0,7705-81-0287,SNGL FAM SUB,5.822,AC,453600,0,453600,1446100,1300,1901000,378000,0,378000,1367200,1400,1746600,RR,RES/RUR,,,
17219,62-28-0-16-0,7705-81-2667,SNGL FAM SUB,5.985,AC,432000,0,432000,832700,76200,1340900,360000,0,360000,786200,69700,1215900,RR,RES/RUR,,,
17220,62-28-0-17-0,7705-71-8939,SNGL FAM SUB,5.034,AC,432000,0,432000,1009900,0,1441900,360000,0,360000,950500,0,1310500,RR,RES/RUR,,,
17221,62-28-0-18-0,7705-72-5360,SNGL FAM SUB,4.752,AC,432000,0,432000,673800,0,1105800,360000,0,360000,638400,0,998400,RR,RES/RUR,,,
17222,62-28-0-19-0,7705-72-1697,SNGL FAM SUB,5.15,AC,432000,0,432000,795700,0,1227700,360000,0,360000,746400,0,1106400,RR,RES/RUR,,,
17223,62-28-0-20-0,7705-62-9369,SNGL FAM SUB,4.815,AC,432000,0,432000,804300,0,1236300,360000,0,360000,766800,0,1126800,RR,RES/RUR,,,
17224,62-28-0-21-0,7705-71-1949,SNGL FAM SUB,4.674,AC,432000,0,432000,1127500,35400,1594900,360000,0,360000,1090700,34500,1485200,RR,RES/RUR,,,
17225,62-28-0-22-0,7705-61-8750,SNGL FAM SUB,4.196,AC,432000,0,432000,682200,51000,1165200,360000,0,360000,650400,46600,1057000,RR,RES/RUR,,,
17227,11-3-0-3-A,6822-43-1383,SNGL FAM SUB,3.12,AC,50500,0,50500,418200,2500,471200,49600,0,49600,363900,2500,416000,A1,AG/GEN,,,
17228,46-1-0-79-E,7708-70-3856,SNGL FAM SUB,2.07,AC,116800,0,116800,402200,0,519000,104300,0,104300,349800,0,454100,A2,AG/LTD,,,
17230,42-30-A-B-1,6757-59-4391,Cmn Area/Open Spc,3.294,AC,0,0,0,0,0,0,0,0,0,0,0,0,R1,RES/LTD,,,
17231,42-30-A-1-0,6757-59-6846,SNGL FAM SUB,2.092,AC,92000,0,92000,421500,40900,554400,80000,0,80000,384700,38600,503300,R1,RES/LTD,,,
17232,42-30-A-2-0,6757-59-9908,SNGL FAM SUB,2.151,AC,92000,0,92000,409000,0,501000,80000,0,80000,376100,0,456100,R1,RES/LTD,,,
17233,42-30-A-3-0,6758-50-8259,SNGL FAM SUB,1.77,AC,92000,0,92000,318900,0,410900,80000,0,80000,280600,0,360600,R1,RES/LTD,,,
17234,42-30-A-4-0,6758-50-5294,SNGL FAM SUB,2.315,AC,92000,0,92000,403200,0,495200,80000,0,80000,369900,0,449900,R1,RES/LTD,,,
17235,42-30-A-5-0,6758-50-2187,SNGL FAM SUB,2.193,AC,92000,0,92000,392800,800,485600,80000,0,80000,359300,800,440100,R1,RES/LTD,,,
17236,42-30-A-6-0,6758-50-2306,SNGL FAM SUB,2.65,AC,92000,0,92000,315300,0,407300,80000,0,80000,277600,0,357600,R1,RES/LTD,,,
17237,42-30-A-7-0,6758-50-3632,SNGL FAM SUB,1.803,AC,110400,0,110400,497600,23600,631600,96000,0,96000,469200,21500,586700,R1,RES/LTD,,,
17238,42-30-A-8-0,6758-50-5629,SNGL FAM SUB,1.969,AC,110400,0,110400,442200,1000,553600,96000,0,96000,416900,1000,513900,R1,RES/LTD,,,
17239,42-30-A-9-0,6758-50-7689,SNGL FAM SUB,1.895,AC,110400,0,110400,436500,0,546900,96000,0,96000,408000,0,504000,R1,RES/LTD,,,
17240,42-30-A-10-0,6758-60-0632,SNGL FAM SUB,2.429,AC,110400,0,110400,400700,0,511100,96000,0,96000,375600,0,471600,R1,RES/LTD,,,
17241,42-30-A-11-0,6758-60-2400,SNGL FAM SUB,2.881,AC,92000,0,92000,454500,8700,555200,80000,0,80000,427600,7800,515400,R1,RES/LTD,,,
17242,42-30-A-12-0,6758-60-3007,SNGL FAM SUB,1.983,AC,92000,0,92000,391400,0,483400,80000,0,80000,364400,0,444400,R1,RES/LTD,,,
17243,42-30-A-13-0,6757-69-5957,SNGL FAM SUB,2.985,AC,92000,0,92000,456400,0,548400,80000,0,80000,427200,0,507200,R1,RES/LTD,,,
17244,42-30-A-14-0,6757-69-9820,SNGL FAM SUB,2.029,AC,92000,0,92000,378700,800,471500,80000,0,80000,346100,800,426900,R1,RES/LTD,,,
17245,42-30-A-16-0,6757-69-8225,SNGL FAM SUB,2.212,AC,92000,0,92000,339200,800,432000,80000,0,80000,310100,900,391000,R1,RES/LTD,,,
17246,42-30-A-17-0,6757-69-4295,SNGL FAM SUB,1.989,AC,92000,0,92000,319900,2500,414400,80000,0,80000,270400,0,350400,R1,RES/LTD,,,
17247,42-30-A-18-0,6757-69-3462,SNGL FAM SUB,2.06,AC,92000,0,92000,434500,0,526500,80000,0,80000,397200,0,477200,R1,RES/LTD,,,
17248,42-30-A-19-0,6757-69-4676,SNGL FAM SUB,1.672,AC,92000,0,92000,385000,800,477800,80000,0,80000,352200,900,433100,R1,RES/LTD,,,
17249,42-30-A-20-0,6757-69-1777,SNGL FAM SUB,1.596,AC,92000,0,92000,345900,0,437900,80000,0,80000,316400,0,396400,R1,RES/LTD,,,
17250,42-30-A-21-0,6757-69-0538,SNGL FAM SUB,2.39,AC,92000,0,92000,349000,28200,469200,80000,0,80000,320600,27200,427800,R1,RES/LTD,,,
17251,42-30-A-22-0,6757-59-8481,SNGL FAM SUB,3.051,AC,92000,0,92000,404000,0,496000,80000,0,80000,371600,0,451600,R1,RES/LTD,,,
17252,42-30-A-15-0,6757-69-8555,SNGL FAM SUB,1.568,AC,92000,0,92000,306500,2500,401000,80000,0,80000,270000,1700,351700,R1,RES/LTD,,,
17253,6-14-0-1-0,6832-48-0190,SNGL FAM SUB,11.46,AC,114700,0,114700,573100,35700,723500,112500,0,112500,539200,43700,695400,A1,AG/GEN,,,
17254,10-1-0-3-B,6802-75-8645,AG 20-100 AC,60.051,AC,249000,220500,28500,0,0,249000,240200,214600,25600,0,0,240200,A1,AG/GEN,,,
17255,12-28-0-2-0,6832-37-7676,SNGL FAM SUB,3.16,AC,74800,0,74800,0,0,74800,73400,0,73400,0,0,73400,A1,AG/GEN,,,
17256,12-28-0-3-0,6832-37-7376,SNGL FAM SUB,4.87,AC,87400,0,87400,0,0,87400,85700,0,85700,0,0,85700,A1,AG/GEN,,,
17257,12-28-0-4-0,6832-36-5894,SNGL FAM SUB,8.17,AC,101200,0,101200,0,0,101200,99200,0,99200,0,0,99200,A1,AG/GEN,,,
17258,12-28-0-5-0,6832-36-8533,SNGL FAM SUB,5.29,AC,76800,0,76800,0,0,76800,75300,0,75300,0,0,75300,A1,AG/GEN,,,
17259,12-28-0-6-0,6832-46-0325,SNGL FAM SUB,5.25,AC,76600,0,76600,0,0,76600,75000,0,75000,0,0,75000,A1,AG/GEN,,,
17260,33-1-0-9-H,6798-45-4717,SNGL FAM SUB,13.076,AC,211200,0,211200,684300,2700,898200,188700,0,188700,579100,2800,770600,RR,RES/RUR,,,
17261,33-1-0-9-I,6798-45-9813,SNGL FAM SUB,7.954,AC,166100,0,166100,666100,49400,881600,148100,0,148100,536100,45000,729200,RR,RES/RUR,,,
17262,39-13-0-1-0,6717-91-9944,AG 20-100 AC,26.166,AC,159700,143500,16200,0,0,159700,156200,141000,15200,0,0,156200,A1,AG/GEN,,,
17263,39-13-0-2-0,6727-01-4412,AG 20-100 AC,25.223,AC,155300,99800,55500,331100,18400,504800,152000,98700,53300,280300,15700,448000,A1,AG/GEN,,,
17264,39-13-0-3-0,6727-00-5615,AG 20-100 AC,22.211,AC,145900,131000,14900,0,0,145900,143200,129400,13800,0,0,143200,A1,AG/GEN,,,
17265,55-1-0-9-C,6786-10-1884,SNGL FAM SUB,5.578,AC,153200,0,153200,376800,43600,573600,131100,0,131100,315700,11000,457800,A2,AG/LTD,,,
17266,39-13-0-4-0,6727-10-4788,SNGL FAM SUB,7.426,AC,78000,0,78000,0,0,78000,76600,0,76600,0,0,76600,A1,AG/GEN,,,
17267,39-13-0-5-0,6727-10-5287,SNGL FAM SUB,5.361,AC,65400,0,65400,260400,1600,327400,64200,0,64200,230100,1700,296000,A1,AG/GEN,,,
17268,39-13-0-6-0,6726-19-5890,SNGL FAM SUB,5,AC,63200,0,63200,246600,6100,315900,62000,0,62000,218000,6200,286200,A1,AG/GEN,,,
17269,39-13-0-7-0,6726-19-6238,SNGL FAM SUB,5.008,AC,63200,0,63200,323100,500,386800,62000,0,62000,276900,500,339400,A1,AG/GEN,,,
17270,39-13-0-8-0,6726-09-8881,AG 20-100 AC,21.12,AC,136500,0,136500,0,0,136500,133500,0,133500,0,0,133500,A1,AG/GEN,,,
17271,43-34-0-A-0,6767-84-7523,Roads,0.742,AC,0,0,0,0,0,0,0,0,0,0,0,0,A2,AG/LTD,,,
17272,43-34-0-1-0,6767-84-8251,SNGL FAM SUB,5.287,AC,129800,0,129800,479500,4800,614100,118000,0,118000,459200,3400,580600,A2,AG/LTD,,,
17273,43-34-0-2-0,6767-83-7737,SNGL FAM SUB,6.443,AC,140800,0,140800,391100,11200,543100,128000,0,128000,342700,11700,482400,A2,AG/LTD,,,
17274,43-34-0-3-0,6767-84-1481,SNGL FAM SUB,5.605,AC,110000,0,110000,498600,40400,649000,100000,0,100000,441300,37800,579100,A2,AG/LTD,,,
17275,43-34-0-4-0,6767-84-3515,SNGL FAM SUB,4.253,AC,110000,0,110000,376100,0,486100,100000,0,100000,329300,0,429300,A2,AG/LTD,,,
17276,43-34-0-5-0,6767-84-4770,SNGL FAM SUB,3.552,AC,96800,0,96800,332300,11500,440600,88000,0,88000,293100,11500,392600,A2,AG/LTD,,,
17277,58-28-0-1-A,7716-30-6159,AG 20-100 AC,31.256,AC,945500,0,945500,5608100,1275600,7829200,876700,0,876700,3148100,3415300,7440100,A2,AG/LTD,,,
17278,64-1-0-74-C,7734-43-6270,General Gov,2.2,AC,298100,0,298100,4896700,33200,5228000,276100,0,276100,4563000,32600,4871700,B1,BUS/GEN,,,
17279,64-3-3-3-0,7724-83-0082,COMM & IND,0.526,AC,127300,0,127300,0,0,127300,125600,0,125600,0,0,125600,B1,BUS/GEN,,,
17280,47-1-0-42-B,7717-80-2081,COMM & IND,2,AC,115700,0,115700,200300,112100,428100,105200,0,105200,189000,79100,373300,A2,AG/LTD,,,
17281,59-1-0-38-A1,7726-86-9294,COMM & IND,1.852,AC,2016800,0,2016800,1074800,473200,3564800,1833500,0,1833500,1065300,301200,3200000,B1,BUS/GEN,,,
17282,59-1-0-38-A3,7726-86-4425,COMM & IND,2.399,AC,2375000,0,2375000,0,0,2375000,2159100,0,2159100,0,0,2159100,B1,BUS/GEN,,,
17284,17-13-0-1-0,6810-34-9967,SNGL FAM SUB,5,AC,63500,0,63500,255300,3400,322200,60000,0,60000,208500,4000,272500,A1,AG/GEN,,,
17285,17-13-0-2-0,6810-44-3874,SNGL FAM SUB,4.8,AC,62300,0,62300,322300,61900,446500,58900,0,58900,264400,57300,380600,A1,AG/GEN,,,
17286,17-13-0-3-0,6810-44-8766,SNGL FAM SUB,4.73,AC,61900,0,61900,336500,3900,402300,58500,0,58500,287100,3700,349300,A1,AG/GEN,,,
17287,17-13-0-4-0,6810-54-3684,SNGL FAM SUB,5,AC,63500,0,63500,315200,1800,380500,60000,0,60000,259400,1800,321200,A1,AG/GEN,,,
17288,30-1-0-102-A,6769-30-0544,SNGL FAM SUB,2.124,AC,74900,0,74900,246100,13100,334100,68600,0,68600,210600,11600,290800,A2,AG/LTD,,,
17289,57-1-0-70-A1,7716-05-3900,SNGL FAM SUB,4.5,AC,312900,310600,2300,0,0,312900,272000,270100,1900,0,0,272000,A2,AG/LTD,,,
17290,57-1-0-70-A2,7706-95-6888,SNGL FAM SUB,5,AC,328500,0,328500,0,0,328500,285600,283400,2200,0,0,285600,A2,AG/LTD,,,
17291,63-1-0-160-B,7714-95-2591,Roads,0.528,AC,0,0,0,0,0,0,0,0,0,0,0,0,A2,AG/LTD,,,
17292,43-1-0-70-A,6777-08-9996,SNGL FAM SUB,7.31,AC,149000,0,149000,0,6700,155700,133300,0,133300,0,6100,139400,A2,AG/LTD,,,
17293,47-1-0-42-C,7716-89-2045,COMM & IND,1.985,AC,1390700,0,1390700,1741300,95900,3227900,1264300,0,1264300,1647300,65900,2977500,B1,BUS/GEN,,,
17295,18-1-0-6-B1A,6810-88-3215,SNGL FAM SUB,0,AC,0,0,0,84900,300,85200,0,0,0,67800,300,68100,A1,AG/GEN,,,
17296,59-1-0-19-A1,7726-87-2160,TAXED -SCC,0,AC,0,0,0,0,0,0,0,0,0,0,0,0,M2,INDUS/G,,,
17297,17-1-0-88-C,6719-37-7948,SNGL FAM SUB,10,AC,89100,0,89100,124400,400,213900,87500,0,87500,97200,400,185100,A1,AG/GEN,,,
17298,31-11-0-6-A,6779-31-5566,SNGL FAM SUB,4.479,AC,114200,0,114200,0,0,114200,102100,0,102100,0,0,102100,RR,RES/RUR,,,
17299,34-1-0-4-A1,7708-34-1183,SNGL FAM SUB,2.343,AC,72300,0,72300,231200,0,303500,64600,0,64600,184500,0,249100,A2,AG/LTD,,,
17300,44-1-0-60-A,6786-36-5691,SNGL FAM SUB,15.657,AC,228500,0,228500,359400,0,587900,203800,0,203800,300300,0,504100,A2,AG/LTD,,,
17301,44-1-0-60-B,6786-37-8816,SNGL FAM SUB,3.048,AC,101000,0,101000,0,0,101000,90200,0,90200,0,0,90200,A2,AG/LTD,,,
17302,44-1-0-60-C,6786-38-9164,SNGL FAM SUB,3.502,AC,107900,0,107900,258100,1600,367600,96400,0,96400,218300,1600,316300,A2,AG/LTD,,,
17303,63-1-0-114-G,7715-62-1481,SNGL FAM SUB,3.43,AC,141000,0,141000,0,0,141000,122500,0,122500,0,0,122500,A2,AG/LTD,,,
17304,66-7-0-3-0,7723-16-2212,SNGL FAM SUB,4.622,AC,186300,0,186300,414200,0,600500,162000,0,162000,362100,0,524100,A2,AG/LTD,,,
17305,66-7-0-1-0,7723-17-9841,SNGL FAM SUB,1.6,AC,115000,0,115000,531300,0,646300,99900,0,99900,462600,0,562500,R1,RES/LTD,,,
17306,66-7-0-2-0,7723-17-7312,SNGL FAM SUB,3,AC,155600,0,155600,1085600,0,1241200,135200,0,135200,910000,0,1045200,A2R1,AG LTD/,,,
17307,58-1-0-112-ATW,7725-37-7775-9998,COMM & IND,0,AC,0,0,0,0,127600,127600,0,0,0,0,126300,126300,M1,INDUS/L,,,
17308,10-11-0-1-0,6802-86-1530,SNGL FAM SUB,3,AC,50200,0,50200,0,0,50200,49000,0,49000,0,0,49000,A1,AG/GEN,,,
17309,10-11-0-3-0,6802-86-3824,SNGL FAM SUB,3,AC,50200,0,50200,0,0,50200,49000,0,49000,0,0,49000,A1,AG/GEN,,,
17310,10-11-0-2-0,6802-86-2627,SNGL FAM SUB,3,AC,50200,0,50200,0,0,50200,49000,0,49000,0,0,49000,A1,AG/GEN,,,
17312,28-19-A-3-0,6738-03-0403,AG > 100 AC,186.133,AC,686800,590500,96300,0,8600,695400,670100,580700,89400,0,7900,678000,A1,AG/GEN,,,
17313,28-19-B-1-0,6738-44-5314,AG 20-100 AC,49.934,AC,265600,237700,27900,0,0,265600,259700,233700,26000,0,0,259700,A1,AG/GEN,,,
17314,28-19-B-2-0,6738-23-4144,AG 20-100 AC,62.12,AC,330500,272700,57800,0,0,330500,323000,267900,55100,0,0,323000,A1,AG/GEN,,,
17315,28-19-B-3-0,6738-32-9804,AG 20-100 AC,43.876,AC,233400,213200,20200,0,0,233400,228200,209600,18600,0,0,228200,A1,AG/GEN,,,
17316,40-6-B-4-0,6738-31-0962,AG 20-100 AC,22.339,AC,162500,152200,10300,0,0,162500,160900,151400,9500,0,0,160900,A1,AG/GEN,,,
17317,40-6-B-5-0,6738-10-4481,AG 20-100 AC,90.837,AC,434300,392400,41900,0,0,434300,426900,388300,38600,0,0,426900,A1,AG/GEN,,,
17318,40-6-B-6-0,6728-90-3655,AG > 100 AC,200,AC,153900,0,153900,497300,0,651200,144500,0,144500,437000,0,581500,A1,AG/GEN,,,
17319,28-19-0-A-0,6738-22-9889,Roads,6.019,AC,0,0,0,0,0,0,0,0,0,0,0,0,A1,AG/GEN,,,
17320,40-1-0-42-0,6738-20-7876,AG 20-100 AC,22.677,AC,165300,154800,10500,0,0,165300,162600,153000,9600,0,0,162600,A1,AG/GEN,,,
17321,16-1-0-39-D,5890-54-4735,SNGL FAM SUB,12.94,AC,66500,0,66500,0,0,66500,64900,0,64900,0,0,64900,A1,AG/GEN,,,
17322,16-1-0-39-E,5890-64-0215,SNGL FAM SUB,12.93,AC,68500,62400,6100,0,0,68500,67800,62300,5500,0,0,67800,A1,AG/GEN,,,
17323,58-1-0-10-B,7716-46-7000,SNGL FAM SUB,4.379,AC,156400,0,156400,0,0,156400,139800,0,139800,0,0,139800,A2,AG/LTD,,,
17324,58-34-1-1-0,7715-88-2431,SNGL FAM URB,0.894,AC,335000,0,335000,0,0,335000,272000,0,272000,0,0,272000,RPUD,RES/PUD,,,
17325,58-34-1-2-0,7715-88-0285,SNGL FAM URB,1.13,AC,335000,0,335000,0,0,335000,272000,0,272000,0,0,272000,RPUD,RES/PUD,,,
17326,58-34-1-3-0,7715-88-0003,SNGL FAM URB,1.042,AC,335000,0,335000,0,0,335000,272000,0,272000,0,0,272000,RPUD,RES/PUD,,,
17327,58-34-1-4-0,7715-77-9841,SNGL FAM URB,1.033,AC,335000,0,335000,0,0,335000,272000,0,272000,0,0,272000,RPUD,RES/PUD,,,
17328,58-34-1-5-0,7715-77-8589,SNGL FAM URB,1.033,AC,335000,0,335000,0,0,335000,272000,0,272000,0,0,272000,RPUD,RES/PUD,,,
17329,58-34-1-6-0,7715-77-8336,SNGL FAM URB,1.016,AC,335000,0,335000,0,0,335000,272000,0,272000,0,0,272000,RPUD,RES/PUD,,,
17330,58-34-1-7-0,7715-77-8116,SNGL FAM URB,1.54,AC,404500,0,404500,990700,0,1395200,386400,0,386400,956000,0,1342400,RPUD,RES/PUD,,,
17332,58-34-2-2-0,7715-76-7481,SNGL FAM URB,0.732,AC,198200,0,198200,1338600,0,1536800,198200,0,198200,1287700,0,1485900,RPUD,RES/PUD,,,
17333,58-34-2-3-0,7715-76-7289,SNGL FAM URB,0.562,AC,198200,0,198200,1228100,0,1426300,198200,0,198200,1304900,0,1503100,RPUD,RES/PUD,,,
17334,58-34-2-4-0,7715-76-8107,SNGL FAM URB,0.513,AC,198200,0,198200,0,0,198200,198200,0,198200,0,0,198200,RPUD,RES/PUD,,,
17335,58-34-2-5-0,7715-76-8007,SNGL FAM URB,0.501,AC,250300,0,250300,853700,0,1104000,250300,0,250300,840300,0,1090600,RPUD,RES/PUD,,,
17336,58-34-2-6-0,7715-75-8912,SNGL FAM URB,0.895,AC,413100,0,413100,1709300,37700,2160100,407200,0,407200,1650700,34400,2092300,RPUD,RES/PUD,,,
17337,58-34-2-7-0,7715-75-6893,SNGL FAM URB,0.863,AC,465800,0,465800,1326400,10300,1802500,459100,0,459100,1256400,8700,1724200,RPUD,RES/PUD,,,
17338,58-34-2-8-0,7715-75-5827,SNGL FAM URB,0.598,AC,437400,0,437400,926100,0,1363500,431100,0,431100,889900,0,1321000,RPUD,RES/PUD,,,
17339,58-34-2-9-0,7715-75-4949,SNGL FAM URB,0.635,AC,405000,0,405000,860300,0,1265300,399200,0,399200,850800,0,1250000,RPUD,RES/PUD,,,
17340,58-34-2-10-0,7715-76-4163,SNGL FAM URB,0.59,AC,250300,0,250300,915100,0,1165400,250300,0,250300,915500,0,1165800,RPUD,RES/PUD,,,
17341,58-34-2-11-0,7715-76-4284,SNGL FAM URB,0.647,AC,198200,0,198200,0,0,198200,198200,0,198200,0,0,198200,RPUD,RES/PUD,,,
17342,58-34-2-12-0,7715-76-4394,SNGL FAM URB,0.578,AC,198200,0,198200,943100,0,1141300,198200,0,198200,938300,0,1136500,RPUD,RES/PUD,,,
17343,58-34-2-13-0,7715-76-5419,SNGL FAM URB,0.703,AC,229500,0,229500,928900,0,1158400,229500,0,229500,935800,0,1165300,RPUD,RES/PUD,,,
17345,58-34-2-15-0,7715-76-5685,SNGL FAM URB,0.643,AC,229500,0,229500,0,0,229500,229500,0,229500,0,0,229500,RPUD,RES/PUD,,,
17346,58-34-3-1-0,7715-77-5080,SNGL FAM URB,1.092,AC,208600,0,208600,0,0,208600,208600,0,208600,0,0,208600,RPUD,RES/PUD,,,
17347,58-34-3-2-0,7715-76-4879,SNGL FAM URB,0.755,AC,208600,0,208600,1369400,0,1578000,208600,0,208600,1389300,0,1597900,RPUD,RES/PUD,,,
17348,58-34-3-3-0,7715-76-4707,SNGL FAM URB,0.742,AC,208600,0,208600,1038700,13500,1260800,208600,0,208600,1007000,12300,1227900,RPUD,RES/PUD,,,
17349,58-34-3-4-0,7715-76-3644,SNGL FAM URB,0.838,AC,208600,0,208600,1427400,0,1636000,208600,0,208600,1447700,0,1656300,RPUD,RES/PUD,,,
17350,58-34-3-5-0,7715-76-2498,SNGL FAM URB,0.821,AC,208600,0,208600,1167500,0,1376100,208600,0,208600,1172700,0,1381300,RPUD,RES/PUD,,,
17351,58-34-3-6-0,7715-76-2111,SNGL FAM URB,1.73,AC,506300,0,506300,1147300,8800,1662400,499000,0,499000,1122200,9000,1630200,RPUD,RES/PUD,,,
17352,58-34-3-7-0,7715-76-1249,SNGL FAM URB,0.874,AC,392900,0,392900,1104700,6800,1504400,387200,0,387200,1095400,7000,1489600,RPUD,RES/PUD,,,
17353,58-34-3-8-0,7715-66-9266,SNGL FAM URB,1.08,AC,465800,0,465800,799800,0,1265600,459100,0,459100,800400,0,1259500,RPUD,RES/PUD,,,
17354,58-34-3-9-0,7715-66-8379,SNGL FAM URB,0.969,AC,405000,0,405000,1344500,0,1749500,399200,0,399200,1332100,0,1731300,RPUD,RES/PUD,,,
17355,58-34-3-10-0,7715-66-6481,SNGL FAM URB,1.478,AC,465800,0,465800,1503900,0,1969700,459100,0,459100,1500000,0,1959100,RPUD,RES/PUD,,,
17356,58-34-3-11-0,7715-66-9641,SNGL FAM URB,0.86,AC,208600,0,208600,865100,27800,1101500,208600,0,208600,885200,27200,1121000,RPUD,RES/PUD,,,
17357,58-34-3-12-0,7715-76-0765,SNGL FAM URB,0.908,AC,208600,0,208600,0,0,208600,208600,0,208600,0,0,208600,RPUD,RES/PUD,,,
17358,58-34-3-13-0,7715-76-1848,SNGL FAM URB,0.89,AC,208600,0,208600,905800,0,1114400,208600,0,208600,906800,0,1115400,RPUD,RES/PUD,,,
17359,58-34-3-14-0,7715-77-2013,SNGL FAM URB,0.983,AC,208600,0,208600,1368800,13300,1590700,208600,0,208600,1379100,12000,1599700,RPUD,RES/PUD,,,
17360,58-34-3-15-0,7715-77-3127,SNGL FAM URB,1.134,AC,208600,0,208600,1652300,1500,1862400,208600,0,208600,1583900,1300,1793800,RPUD,RES/PUD,,,
17361,58-34-3-16-0,7715-77-4372,SNGL FAM URB,1.677,AC,229500,0,229500,1726700,5200,1961400,229500,0,229500,1724500,4800,1958800,RPUD,RES/PUD,,,
17362,58-34-3-17-0,7715-77-5562,SNGL FAM URB,1.201,AC,208600,0,208600,1042800,33100,1284500,208600,0,208600,1043100,32800,1284500,RPUD,RES/PUD,,,
17363,58-34-3-18-0,7715-77-6731,SNGL FAM URB,1.037,AC,208600,0,208600,1326700,53500,1588800,208600,0,208600,1341400,50600,1600600,RPUD,RES/PUD,,,
17364,58-34-3-19-0,7715-77-7901,SNGL FAM URB,0.995,AC,208600,0,208600,1254400,72200,1535200,208600,0,208600,1209700,66300,1484600,RPUD,RES/PUD,,,
17365,58-34-3-20-0,7715-78-7174,SNGL FAM URB,0.88,AC,208600,0,208600,0,0,208600,208600,0,208600,0,0,208600,RPUD,RES/PUD,,,
17366,58-34-3-21-0,7715-78-8352,SNGL FAM URB,0.714,AC,208600,0,208600,1227900,0,1436500,208600,0,208600,1193800,0,1402400,RPUD,RES/PUD,,,
17367,58-34-3-22-0,7715-78-9457,SNGL FAM URB,0.755,AC,208600,0,208600,0,0,208600,208600,0,208600,0,0,208600,RPUD,RES/PUD,,,
17368,58-34-3-23-0,7715-88-0650,SNGL FAM URB,0.944,AC,208600,0,208600,0,0,208600,208600,0,208600,0,0,208600,RPUD,RES/PUD,,,
17369,58-34-1-R-1,7715-76-8941,SNGL FAM URB,0.845,AC,351800,0,351800,980000,0,1331800,336000,0,336000,950900,0,1286900,RPUD,RES/PUD,,,
17370,58-34-2-R-1,7715-76-8640,Cmn Area/Open Spc,0.189,AC,0,0,0,0,0,0,0,0,0,0,0,0,RPUD,RES/PUD,,,
17377,58-34-1-A-0,7715-88-3520,Cmn Area/Open Spc,0.219,AC,0,0,0,0,0,0,0,0,0,0,0,0,RPUD,RES/PUD,,,
17378,58-34-2-A-0,7715-76-7567,Cmn Area/Open Spc,0.477,AC,0,0,0,0,0,0,0,0,0,0,0,0,RPUD,RES/PUD,,,
17379,58-34-2-B-0,7715-76-4595,Cmn Area/Open Spc,0.974,AC,0,0,0,0,0,0,0,0,0,0,0,0,RPUD,RES/PUD,,,
17380,58-34-3-A-0,7715-78-7033,Cmn Area/Open Spc,0.232,AC,0,0,0,0,0,0,0,0,0,0,0,0,RPUD,RES/PUD,,,
17381,58-34-3-B-0,7715-88-1638,Cmn Area/Open Spc,0.279,AC,0,0,0,0,0,0,0,0,0,0,0,0,RPUD,RES/PUD,,,
17382,58-34-3-C-0,7715-76-1179,Cmn Area/Open Spc,0.1,AC,0,0,0,0,0,0,0,0,0,0,0,0,RPUD,RES/PUD,,,
17383,10-1-0-43-D,6811-36-2427,AG 20-100 AC,25.4,AC,100700,0,100700,107700,200,208600,99000,0,99000,96300,200,195500,A1,AG/GEN,,,
17384,13-1-0-30-A,6852-01-3864,SNGL FAM SUB,4.46,AC,79500,0,79500,384500,0,464000,78000,0,78000,343800,0,421800,A1,AG/GEN,,,
17394,62-36-0-D-2,7714-17-5384,TAXED -SCC,0.263,AC,0,0,0,0,0,0,0,0,0,0,0,0,R1,RES/LTD,,,
17395,62-36-0-D-3,7714-07-8310,TAXED -SCC,0.549,AC,0,0,0,0,0,0,0,0,0,0,0,0,R1,RES/LTD,,,
17396,28-1-0-76-C,6739-26-0988,SNGL FAM SUB,2.415,AC,57400,0,57400,0,0,57400,54300,0,54300,0,0,54300,A1,AG/GEN,,,
17398,16-1-0-76-D,5890-81-3061,SNGL FAM SUB,7.42,AC,61900,0,61900,306200,5000,373100,60500,0,60500,275900,5000,341400,A1,AG/GEN,,,
17399,21-1-0-46-C,6850-63-3248,SNGL FAM SUB,2.79,AC,75800,0,75800,223900,1000,300700,68500,0,68500,185500,1000,255000,A2,AG/LTD,,,
17400,38-5-0-A-3,6707-98-8143,SNGL FAM SUB,5,AC,49500,0,49500,0,0,49500,48500,0,48500,0,0,48500,A1,AG/GEN,,,
17401,42-30-A-B-2,6757-58-4495,Cmn Area/Open Spc,0.47,AC,0,0,0,0,0,0,0,0,0,0,0,0,R1,RES/LTD,,,
17402,42-30-A-B-3,6757-68-3430,Cmn Area/Open Spc,1.2,AC,0,0,0,0,0,0,0,0,0,0,0,0,R1,RES/LTD,,,
17403,42-30-A-B-4,6757-69-4150,Cmn Area/Open Spc,4.337,AC,0,0,0,0,0,0,0,0,0,0,0,0,R1,RES/LTD,,,
17404,42-30-A-B-5,6758-60-6787,Cmn Area/Open Spc,4.355,AC,0,0,0,0,0,0,0,0,0,0,0,0,R1,RES/LTD,,,
17405,42-30-A-B-6,6758-40-9846,Cmn Area/Open Spc,6.019,AC,0,0,0,0,0,0,0,0,0,0,0,0,R1,RES/LTD,,,
17406,57-36-0-B-0,7716-25-0250,Cmn Area/Open Spc,43.038,AC,0,0,0,0,0,0,0,0,0,0,0,0,RP,"RURAL,P",,,
17408,63-38-0-C-1,7724-23-0803,Cmn Area/Open Spc,0.563,AC,0,0,0,0,0,0,0,0,0,0,0,0,R3,RES/GEN,,,
17409,63-38-0-C-2,7724-13-7944,Cmn Area/Open Spc,0.092,AC,0,0,0,0,0,0,0,0,0,0,0,0,R3,RES/GEN,,,
17410,63-38-0-C-3,7724-03-5732,Cmn Area/Open Spc,0.117,AC,0,0,0,0,0,0,0,0,0,0,0,0,R3,RES/GEN,,,
17411,63-38-0-C-4,7724-03-7605,Cmn Area/Open Spc,0.279,AC,0,0,0,0,0,0,0,0,0,0,0,0,R3,RES/GEN,,,
17412,63-38-0-C-5,7724-03-9628,Cmn Area/Open Spc,0.115,AC,0,0,0,0,0,0,0,0,0,0,0,0,R3,RES/GEN,,,
17413,63-38-0-C-6,7724-13-4800,Cmn Area/Open Spc,1.013,AC,0,0,0,0,0,0,0,0,0,0,0,0,R3,RES/GEN,,,
17414,63-38-0-C-7,7724-13-8634,Cmn Area/Open Spc,0.353,AC,0,0,0,0,0,0,0,0,0,0,0,0,R3,RES/GEN,,,
17415,63-38-0-C-8,7724-13-5968,Cmn Area/Open Spc,0.162,AC,0,0,0,0,0,0,0,0,0,0,0,0,R3,RES/GEN,,,
17416,63-38-0-C-9,7724-14-2142,Cmn Area/Open Spc,0.102,AC,0,0,0,0,0,0,0,0,0,0,0,0,R3,RES/GEN,,,
17417,63-38-0-1-0,7724-13-9930,SNGL FAM SUB,0.527,AC,115200,0,115200,623300,0,738500,111200,0,111200,615400,0,726600,R3,RES/GEN,,,
17418,63-38-0-2-0,7724-13-8966,SNGL FAM SUB,0.537,AC,128000,0,128000,502300,0,630300,117000,0,117000,496600,0,613600,R3,RES/GEN,,,
17419,63-38-0-3-0,7724-14-7083,SNGL FAM SUB,0.518,AC,128000,0,128000,465800,0,593800,117000,0,117000,461900,0,578900,R3,RES/GEN,,,
17420,63-38-0-4-0,7724-14-7029,SNGL FAM SUB,0.46,AC,128000,0,128000,523200,0,651200,117000,0,117000,521200,0,638200,R3,RES/GEN,,,
17421,63-38-0-5-0,7724-14-6155,SNGL FAM SUB,0.46,AC,128000,0,128000,622700,36600,787300,117000,0,117000,547400,34000,698400,R3,RES/GEN,,,
17422,63-38-0-6-0,7724-14-5291,SNGL FAM SUB,0.461,AC,128000,0,128000,541900,0,669900,117000,0,117000,541600,0,658600,R3,RES/GEN,,,
17423,63-38-0-7-0,7724-14-4256,SNGL FAM SUB,0.482,AC,128000,0,128000,507000,0,635000,117000,0,117000,502600,0,619600,R3,RES/GEN,,,
17424,63-38-0-8-0,7724-14-5324,SNGL FAM SUB,0.459,AC,128000,0,128000,569800,0,697800,117000,0,117000,564200,0,681200,R3,RES/GEN,,,
17425,63-38-0-9-0,7724-14-3513,SNGL FAM SUB,0.532,AC,170000,0,170000,513600,0,683600,155000,0,155000,499100,0,654100,R3,RES/GEN,,,
17426,63-38-0-10-0,7724-14-2456,SNGL FAM SUB,0.522,AC,170000,0,170000,410000,10700,590700,155000,0,155000,406300,9200,570500,R3,RES/GEN,,,
17427,63-38-0-11-0,7724-14-2400,SNGL FAM SUB,0.517,AC,170000,0,170000,537600,0,707600,155000,0,155000,533000,0,688000,R3,RES/GEN,,,
17428,63-38-0-12-0,7724-14-1344,SNGL FAM SUB,0.512,AC,170000,0,170000,508300,0,678300,155000,0,155000,507500,0,662500,R3,RES/GEN,,,
17429,63-38-0-13-0,7724-14-0298,SNGL FAM SUB,0.507,AC,170000,0,170000,514400,0,684400,155000,0,155000,512100,0,667100,R3,RES/GEN,,,
17430,63-38-0-14-0,7724-14-0232,SNGL FAM SUB,0.525,AC,170000,0,170000,638600,0,808600,155000,0,155000,633400,0,788400,R3,RES/GEN,,,
17431,63-38-0-15-0,7724-04-9186,SNGL FAM SUB,0.505,AC,170000,0,170000,807600,0,977600,155000,0,155000,796400,0,951400,R3,RES/GEN,,,
17432,63-38-0-16-0,7724-04-9130,SNGL FAM SUB,0.505,AC,170000,0,170000,618500,0,788500,155000,0,155000,600700,0,755700,R3,RES/GEN,,,
17433,63-38-0-17-0,7724-04-8073,SNGL FAM SUB,0.505,AC,170000,0,170000,523500,0,693500,155000,0,155000,519400,0,674400,R3,RES/GEN,,,
17434,63-38-0-18-0,7724-03-8927,SNGL FAM SUB,0.504,AC,170000,0,170000,637100,0,807100,155000,0,155000,634300,0,789300,R3,RES/GEN,,,
17435,63-38-0-19-0,7724-03-7962,SNGL FAM SUB,0.482,AC,170000,0,170000,595200,0,765200,155000,0,155000,580300,0,735300,R3,RES/GEN,,,
17436,63-38-0-20-0,7724-03-7806,SNGL FAM SUB,0.462,AC,170000,0,170000,552500,0,722500,155000,0,155000,545000,0,700000,R3,RES/GEN,,,
17437,63-38-0-21-0,7724-03-6709,SNGL FAM SUB,0.621,AC,170000,0,170000,624700,0,794700,155000,0,155000,610100,0,765100,R3,RES/GEN,,,
17438,63-38-0-22-0,7724-03-4686,SNGL FAM SUB,0.654,AC,170000,0,170000,660700,0,830700,155000,0,155000,655300,0,810300,R3,RES/GEN,,,
17439,63-38-0-23-0,7724-03-8750,SNGL FAM SUB,0.475,AC,128000,0,128000,488300,0,616300,117000,0,117000,485900,0,602900,R3,RES/GEN,,,
17440,63-38-0-24-0,7724-13-0608,SNGL FAM SUB,0.587,AC,128000,0,128000,502300,0,630300,117000,0,117000,498300,0,615300,R3,RES/GEN,,,
17441,63-38-0-25-0,7724-13-1720,SNGL FAM SUB,0.872,AC,134400,0,134400,464600,0,599000,122900,0,122900,460100,0,583000,R3,RES/GEN,,,
17442,63-38-0-26-0,7724-13-1778,SNGL FAM SUB,0.799,AC,134400,0,134400,515900,0,650300,122900,0,122900,515500,0,638400,R3,RES/GEN,,,
17443,63-38-0-27-0,7724-13-1950,SNGL FAM SUB,0.462,AC,128000,0,128000,495100,0,623100,117000,0,117000,492600,0,609600,R3,RES/GEN,,,
17444,63-38-0-28-0,7724-13-2905,SNGL FAM SUB,0.46,AC,128000,0,128000,563200,0,691200,117000,0,117000,555400,0,672400,R3,RES/GEN,,,
17445,63-38-0-29-0,7724-14-2061,SNGL FAM SUB,0.477,AC,128000,0,128000,501000,0,629000,117000,0,117000,494400,0,611400,R3,RES/GEN,,,
17446,63-38-0-30-0,7724-14-3114,SNGL FAM SUB,0.46,AC,128000,0,128000,596600,0,724600,117000,0,117000,591200,0,708200,R3,RES/GEN,,,
17447,63-38-0-31-0,7724-14-4006,SNGL FAM SUB,0.462,AC,128000,0,128000,433000,0,561000,117000,0,117000,424700,0,541700,R3,RES/GEN,,,
17448,63-38-0-32-0,7724-13-4956,SNGL FAM SUB,0.542,AC,128000,0,128000,439600,0,567600,117000,0,117000,436300,0,553300,R3,RES/GEN,,,
17449,63-38-0-33-0,7724-13-5857,SNGL FAM SUB,0.471,AC,128000,0,128000,576800,0,704800,117000,0,117000,571600,0,688600,R3,RES/GEN,,,
17450,63-38-0-34-0,7724-13-5742,SNGL FAM SUB,1.072,AC,134400,0,134400,658700,0,793100,122900,0,122900,658400,0,781300,R3,RES/GEN,,,
17451,63-38-0-35-0,7724-13-6679,SNGL FAM SUB,0.597,AC,128000,0,128000,542400,0,670400,117000,0,117000,537500,0,654500,R3,RES/GEN,,,
17452,63-38-0-36-0,7724-13-7643,SNGL FAM SUB,0.66,AC,128000,0,128000,457700,0,585700,117000,0,117000,442100,0,559100,R3,RES/GEN,,,
17453,47-1-0-59-A1A,7718-81-7302,TAXED -SCC,0,AC,0,0,0,0,0,0,0,0,0,0,0,0,A2,AG/LTD,,,
17454,12-29-0-1-0,6821-72-9266,SNGL FAM SUB,5,AC,64400,0,64400,0,0,64400,60300,0,60300,0,0,60300,A1,AG/GEN,,,
17455,12-29-0-2-0,6821-72-2255,SNGL FAM SUB,6,AC,56800,0,56800,0,0,56800,53100,0,53100,0,0,53100,A1,AG/GEN,,,
17456,12-29-0-3-0,6821-72-1966,AG 20-100 AC,26.816,AC,89600,0,89600,0,0,89600,82900,0,82900,0,0,82900,A1,AG/GEN,,,
17457,12-29-0-7-0,6821-82-1522,SNGL FAM SUB,5,AC,64400,0,64400,121400,0,185800,60300,0,60300,100100,0,160400,A1,AG/GEN,,,
17458,55-1-0-83-B,6785-75-4638,SNGL FAM SUB,2.506,AC,81800,0,81800,238800,0,320600,73000,0,73000,201300,0,274300,A2,AG/LTD,,,
17459,55-1-0-83-C,6785-75-1427,SNGL FAM SUB,3.187,AC,67700,0,67700,0,0,67700,60500,0,60500,0,0,60500,A2,AG/LTD,,,
17460,47-21-0-15-AT,7726-08-9914,General Gov,0.998,AC,355400,0,355400,2664000,0,3019400,323100,0,323100,1262500,0,1585600,B1,BUS/GEN,,,
17461,64-1-0-80-B,7733-58-5827,SNGL FAM SUB,2.63,AC,287800,0,287800,982600,18700,1289100,250200,0,250200,832700,18800,1101700,R1,RES/LTD,,,
17462,33-2-0-2-0,6798-06-7890,SNGL FAM SUB,3.57,AC,107100,0,107100,374100,2800,484000,95800,0,95800,315900,3000,414700,A2,AG/LTD,,,
17465,42-31-B-B-1,6758-72-0221,Cmn Area/Open Spc,0.851,AC,0,0,0,0,0,0,0,0,0,0,0,0,R1,RES/LTD,,,
17466,42-31-B-B-2,6758-70-2838,Cmn Area/Open Spc,1.933,AC,0,0,0,0,0,0,0,0,0,0,0,0,R1,RES/LTD,,,
17467,42-31-B-1-0,6758-72-0021,SNGL FAM SUB,2.55,AC,109200,0,109200,357400,8900,475500,94500,0,94500,326500,7100,428100,R1,RES/LTD,,,
17468,42-31-B-2-0,6758-71-0735,SNGL FAM SUB,2.018,AC,109200,0,109200,420100,0,529300,94500,0,94500,384300,0,478800,R1,RES/LTD,,,
17469,42-31-B-3-0,6758-61-9581,SNGL FAM SUB,2.024,AC,109200,0,109200,385800,1700,496700,94500,0,94500,352700,1700,448900,R1,RES/LTD,,,
17470,42-31-B-4-0,6758-61-9209,SNGL FAM SUB,2.491,AC,109200,0,109200,400900,0,510100,94500,0,94500,368000,0,462500,R1,RES/LTD,,,
17471,42-31-B-5-0,6758-61-8050,SNGL FAM SUB,3.313,AC,124800,0,124800,419900,70800,615500,108000,0,108000,385600,63900,557500,R1,RES/LTD,,,
17472,42-31-B-6-0,6758-60-5968,SNGL FAM SUB,2.324,AC,109200,0,109200,422200,2300,533700,94500,0,94500,387500,2600,484600,R1,RES/LTD,,,
17473,42-31-B-7-0,6758-61-2040,SNGL FAM SUB,2.359,AC,124800,0,124800,406100,0,530900,108000,0,108000,371400,0,479400,R1,RES/LTD,,,
17474,42-31-B-8-0,6758-61-2207,SNGL FAM SUB,2.858,AC,124800,0,124800,358900,0,483700,108000,0,108000,328300,0,436300,R1,RES/LTD,,,
17475,42-31-B-9-0,6758-61-5425,SNGL FAM SUB,2.815,AC,109200,0,109200,408600,1700,519500,94500,0,94500,374800,1800,471100,R1,RES/LTD,,,
17476,42-31-B-10-0,6758-61-5890,SNGL FAM SUB,3.296,AC,124800,0,124800,423600,30700,579100,108000,0,108000,387800,29000,524800,R1,RES/LTD,,,
17477,21-1-0-41-D,6850-40-9635,SNGL FAM SUB,4,AC,90100,0,90100,0,0,90100,81100,0,81100,0,0,81100,A2,AG/LTD,,,
17478,28-1-0-106-A,6738-75-8050,AG 20-100 AC,89.643,AC,41700,0,41700,0,0,41700,38100,0,38100,0,0,38100,A1,AG/GEN,,,
17479,18-1-0-2-AT,6811-71-7695-9999,AG > 100 AC,106.97,AC,375300,278600,96700,0,134100,509400,375600,288200,87400,0,114100,489700,A1,AG/GEN,,,
17481,17-1-0-39-D,6801-61-2321,SNGL FAM SUB,6.676,AC,64900,0,64900,232900,3500,301300,63500,0,63500,211200,3500,278200,A1,AG/GEN,,,
17482,32-1-0-77-B,6788-12-4953,AG 20-100 AC,29.457,AC,525100,0,525100,1845500,0,2370600,469900,0,469900,1601300,0,2071200,A2,AG/LTD,,,
17483,57-1-0-45-H,7715-14-5807,SNGL FAM SUB,2.01,AC,123000,0,123000,0,0,123000,107000,0,107000,0,0,107000,A2,AG/LTD,,,
17484,57-1-0-45-G,7715-13-7870,SNGL FAM SUB,5.58,AC,292400,0,292400,143400,500,436300,254200,0,254200,124100,500,378800,A2,AG/LTD,,,
17486,21-11-0-A-0,6850-14-9988,Cmn Area/Open Spc,0.616,AC,0,0,0,0,0,0,0,0,0,0,0,0,RR,RES/RUR,,,
17487,20-22-0-50-0,6850-04-2125,SNGL FAM SUB,3,AC,100000,0,100000,355300,0,455300,90000,0,90000,323800,0,413800,RR,RES/RUR,,,
17488,20-22-0-51-0,6850-03-3865,SNGL FAM SUB,3.004,AC,100000,0,100000,447700,1000,548700,90000,0,90000,401200,1000,492200,RR,RES/RUR,,,
17489,20-22-0-52-0,6850-03-3640,SNGL FAM SUB,3,AC,100000,0,100000,459600,0,559600,90000,0,90000,418800,0,508800,RR,RES/RUR,,,
17490,20-22-0-53-0,6850-03-4492,SNGL FAM SUB,3.874,AC,100000,0,100000,463100,2000,565100,90000,0,90000,417800,2000,509800,RR,RES/RUR,,,
17491,20-22-0-54-0,6850-03-3186,SNGL FAM SUB,3,AC,100000,0,100000,474500,2300,576800,90000,0,90000,430600,2300,522900,RR,RES/RUR,,,
17492,20-22-0-55-0,6850-02-4819,SNGL FAM SUB,3.048,AC,100000,0,100000,498500,5500,604000,90000,0,90000,452500,3800,546300,RR,RES/RUR,,,
17493,20-22-0-56-0,6850-03-7076,SNGL FAM SUB,3,AC,100000,0,100000,462800,0,562800,90000,0,90000,418900,0,508900,RR,RES/RUR,,,
17494,20-22-0-57-0,6850-13-0029,SNGL FAM SUB,3,AC,100000,0,100000,691100,6200,797300,90000,0,90000,625800,6300,722100,RR,RES/RUR,,,
17495,20-22-0-58-0,6850-13-2098,SNGL FAM SUB,3,AC,100000,0,100000,290100,14500,404600,90000,0,90000,265000,12400,367400,RR,RES/RUR,,,
17496,20-22-0-59-0,6850-13-5226,SNGL FAM SUB,3,AC,100000,0,100000,567500,23500,691000,90000,0,90000,515300,22800,628100,RR,RES/RUR,,,
17497,20-22-0-60-0,6850-13-6564,SNGL FAM SUB,3,AC,100000,0,100000,527600,0,627600,90000,0,90000,479900,0,569900,RR,RES/RUR,,,
17498,20-22-0-61-0,6850-13-3630,SNGL FAM SUB,3,AC,100000,0,100000,495100,26800,621900,90000,0,90000,449000,22800,561800,RR,RES/RUR,,,
17499,20-22-0-62-0,6850-13-0683,SNGL FAM SUB,3,AC,100000,0,100000,306700,27500,434200,90000,0,90000,280300,23700,394000,RR,RES/RUR,,,
17500,20-22-0-63-0,6850-03-8762,SNGL FAM SUB,3.063,AC,100000,0,100000,470500,2500,573000,90000,0,90000,427400,2500,519900,RR,RES/RUR,,,
17501,20-22-0-64-0,6850-04-6074,SNGL FAM SUB,3,AC,100000,0,100000,398100,3800,501900,90000,0,90000,387600,3600,481200,RR,RES/RUR,,,
17502,20-22-0-65-0,6850-04-3472,SNGL FAM SUB,3.041,AC,100000,0,100000,561300,0,661300,90000,0,90000,511600,0,601600,RR,RES/RUR,,,
17503,20-22-0-66-0,6850-04-2821,SNGL FAM SUB,5.268,AC,100000,0,100000,569500,0,669500,90000,0,90000,517100,0,607100,RR,RES/RUR,,,
17504,20-22-0-67-0,6850-04-7511,SNGL FAM SUB,3.002,AC,100000,0,100000,411300,21500,532800,90000,0,90000,384300,18100,492400,RR,RES/RUR,,,
17505,20-22-0-68-0,6850-04-9471,SNGL FAM SUB,3.025,AC,100000,0,100000,392100,27100,519200,90000,0,90000,360800,23400,474200,RR,RES/RUR,,,
17506,20-22-0-69-0,6850-14-1342,SNGL FAM SUB,3.132,AC,100000,0,100000,507600,0,607600,90000,0,90000,460600,0,550600,RR,RES/RUR,,,
17507,20-22-0-70-0,6850-14-3076,SNGL FAM SUB,3,AC,100000,0,100000,379400,0,479400,90000,0,90000,352500,0,442500,RR,RES/RUR,,,
17508,20-22-0-71-0,6850-13-7960,SNGL FAM SUB,3,AC,100000,0,100000,556700,0,656700,90000,0,90000,513800,0,603800,RR,RES/RUR,,,
17509,20-22-0-72-0,6850-14-7119,SNGL FAM SUB,3.11,AC,100000,0,100000,380500,41700,522200,90000,0,90000,344800,39300,474100,RR,RES/RUR,,,
17510,20-22-0-73-0,6850-14-6402,SNGL FAM SUB,3,AC,100000,0,100000,344100,18100,462200,90000,0,90000,317300,17100,424400,RR,RES/RUR,,,
17511,20-22-0-74-0,6850-14-5753,SNGL FAM SUB,5.999,AC,100000,0,100000,453500,0,553500,90000,0,90000,412800,0,502800,RR,RES/RUR,,,
17512,20-22-0-75-0,6850-15-4117,SNGL FAM SUB,9.125,AC,110000,0,110000,434700,0,544700,95000,0,95000,393800,0,488800,RR,RES/RUR,,,
17513,20-22-0-76-0,6850-15-3623,SNGL FAM SUB,5.277,AC,100000,0,100000,405100,1300,506400,90000,0,90000,367500,1000,458500,RR,RES/RUR,,,
17514,20-22-0-77-0,6850-15-4934,SNGL FAM SUB,5.063,AC,100000,0,100000,463300,0,563300,90000,0,90000,421500,0,511500,RR,RES/RUR,,,
17515,21-11-0-78-0,6850-16-8144,SNGL FAM SUB,5.626,AC,100000,0,100000,641200,0,741200,90000,0,90000,582300,0,672300,RR,RES/RUR,,,
17516,21-11-0-79-0,6850-26-1032,SNGL FAM SUB,6.193,AC,105000,0,105000,465700,0,570700,95000,0,95000,431700,0,526700,RR,RES/RUR,,,
17517,21-11-0-80-0,6850-25-2655,SNGL FAM SUB,7.127,AC,105000,0,105000,423200,73500,601700,95000,0,95000,384600,66600,546200,RR,RES/RUR,,,
17518,21-11-0-81-0,6850-25-5314,SNGL FAM SUB,7.258,AC,105000,0,105000,571200,20000,696200,95000,0,95000,516800,16800,628600,RR,RES/RUR,,,
17519,21-11-0-82-0,6850-24-6925,SNGL FAM SUB,12.574,AC,125000,0,125000,630100,23000,778100,114000,0,114000,585200,21600,720800,RR,RES/RUR,,,
17520,21-11-0-83-0,6850-24-1820,SNGL FAM SUB,3.058,AC,100000,0,100000,513300,0,613300,90000,0,90000,475400,0,565400,RR,RES/RUR,,,
17521,21-11-0-84-0,6850-24-2507,SNGL FAM SUB,3.14,AC,100000,0,100000,469900,21500,591400,90000,0,90000,425500,19800,535300,RR,RES/RUR,,,
17522,21-11-0-85-0,6850-24-2323,SNGL FAM SUB,3,AC,100000,0,100000,408400,1500,509900,90000,0,90000,372900,1500,464400,RR,RES/RUR,,,
17523,21-11-0-86-0,6850-24-6439,SNGL FAM SUB,3.123,AC,100000,0,100000,304800,53500,458300,90000,0,90000,282300,50100,422400,RR,RES/RUR,,,
17524,21-11-0-87-0,6850-24-8357,SNGL FAM SUB,4.321,AC,100000,0,100000,281100,24400,405500,90000,0,90000,255400,22700,368100,RR,RES/RUR,,,
17525,21-11-0-88-0,6850-24-3042,SNGL FAM SUB,3,AC,100000,0,100000,603400,12300,715700,90000,0,90000,547000,10400,647400,RR,RES/RUR,,,
17526,21-11-0-89-0,6850-23-1788,SNGL FAM SUB,3,AC,100000,0,100000,562600,9400,672000,90000,0,90000,522900,8300,621200,RR,RES/RUR,,,
17527,21-11-0-90-0,6850-13-9377,SNGL FAM SUB,3,AC,100000,0,100000,562000,0,662000,90000,0,90000,509400,0,599400,RR,RES/RUR,,,
17528,20-22-0-91-0,6850-12-3659,SNGL FAM SUB,3,AC,100000,0,100000,353200,1500,454700,90000,0,90000,325600,1500,417100,RR,RES/RUR,,,
17529,20-22-0-92-0,6850-12-0457,SNGL FAM SUB,3.014,AC,100000,0,100000,434800,32400,567200,90000,0,90000,403500,28100,521600,RR,RES/RUR,,,
17530,20-22-0-93-0,6850-02-8443,SNGL FAM SUB,3.345,AC,100000,0,100000,406600,34600,541200,90000,0,90000,375100,32800,497900,RR,RES/RUR,,,
17531,20-22-0-94-0,6850-02-6413,SNGL FAM SUB,3,AC,100000,0,100000,326700,0,426700,90000,0,90000,296900,0,386900,RR,RES/RUR,,,
17532,64-1-0-77-A1,7734-42-8236,General Gov,0,AC,0,0,0,0,10000,10000,0,0,0,0,10000,10000,A2,AG/LTD,,,
17533,16-1-0-86-A,6800-30-0046,SNGL FAM SUB,4.21,AC,56800,0,56800,0,0,56800,55700,0,55700,0,0,55700,A1,AG/GEN,,,
17534,16-1-0-86-B,6800-30-2442,SNGL FAM SUB,2.227,AC,45700,0,45700,236900,0,282600,44700,0,44700,204800,0,249500,A1,AG/GEN,,,
17535,16-1-0-86-C,6800-30-3616,SNGL FAM SUB,2.338,AC,46300,0,46300,237700,5100,289100,45400,0,45400,207700,5200,258300,A1,AG/GEN,,,
17536,16-1-0-86-D,6800-30-4838,SNGL FAM SUB,2.482,AC,47100,0,47100,255800,1000,303900,46200,0,46200,232400,1100,279700,A1,AG/GEN,,,
17537,64-4-2-A-0,7724-94-3415,Roads,0,AC,0,0,0,0,0,0,0,0,0,0,0,0,RN,RESIDEN,,,
17541,64-4-2-B-0,7724-94-5323,Roads,0,AC,0,0,0,0,0,0,0,0,0,0,0,0,RN,RESIDEN,,,
17542,64-3-3-A-0,7724-83-5678,Roads,0,AC,0,0,0,0,0,0,0,0,0,0,0,0,RN,RESIDEN,,,
17543,64-5-4-A-0,7734-04-3897,Roads,0,AC,0,0,0,0,0,0,0,0,0,0,0,0,RN,RESIDEN,,,
17544,58-1-0-72-TW,7716-92-9194-9998,TAXED -SCC,0,AC,0,0,0,0,0,0,0,0,0,0,0,0,A2,AG/LTD,,,
17545,43-35-0-1-0,6777-06-2819,SNGL FAM SUB,2.001,AC,140000,0,140000,458700,0,598700,125000,0,125000,418800,0,543800,RP,"RURAL,P",,,
17546,43-35-0-2-0,6777-06-4725,SNGL FAM SUB,2.001,AC,140000,0,140000,452700,37100,629800,125000,0,125000,414700,36300,576000,RP,"RURAL,P",,,
17547,43-35-0-3-0,6777-06-6633,SNGL FAM SUB,2.001,AC,140000,0,140000,476000,0,616000,125000,0,125000,436400,0,561400,RP,"RURAL,P",,,
17548,43-35-0-4-0,6777-06-8551,SNGL FAM SUB,2.001,AC,140000,0,140000,466600,2900,609500,125000,0,125000,427300,3200,555500,RP,"RURAL,P",,,
17549,43-35-0-5-0,6777-16-0378,SNGL FAM SUB,2,AC,140000,0,140000,389500,0,529500,125000,0,125000,355500,0,480500,RP,"RURAL,P",,,
17550,43-35-0-6-0,6777-16-4129,SNGL FAM SUB,2,AC,140000,0,140000,499600,0,639600,125000,0,125000,465600,0,590600,RP,"RURAL,P",,,
17551,43-35-0-7-0,6777-16-6163,SNGL FAM SUB,2,AC,140000,0,140000,547700,1700,689400,125000,0,125000,501700,1700,628400,RP,"RURAL,P",,,
17552,43-35-0-8-0,6777-16-9007,SNGL FAM SUB,2,AC,140000,0,140000,416900,2100,559000,125000,0,125000,381400,2200,508600,RP,"RURAL,P",,,
17553,43-35-0-9-0,6777-25-1958,SNGL FAM SUB,2,AC,140000,0,140000,489000,0,629000,125000,0,125000,446300,0,571300,RP,"RURAL,P",,,
17554,43-35-0-10-0,6777-26-4071,SNGL FAM SUB,2,AC,140000,0,140000,715500,0,855500,125000,0,125000,669900,0,794900,RP,"RURAL,P",,,
17555,43-35-0-11-0,6777-25-4843,SNGL FAM SUB,2,AC,140000,0,140000,368100,0,508100,125000,0,125000,343200,0,468200,RP,"RURAL,P",,,
17556,43-35-0-12-0,6777-25-4654,SNGL FAM SUB,2,AC,140000,0,140000,477900,0,617900,125000,0,125000,439300,0,564300,RP,"RURAL,P",,,
17557,43-35-0-13-0,6777-15-9497,SNGL FAM SUB,2,AC,140000,0,140000,449000,0,589000,125000,0,125000,408300,0,533300,RP,"RURAL,P",,,
17558,43-35-0-14-0,6777-15-8631,SNGL FAM SUB,2,AC,140000,0,140000,519800,0,659800,125000,0,125000,469500,0,594500,RP,"RURAL,P",,,
17559,43-35-0-15-0,6777-15-6647,SNGL FAM SUB,2,AC,140000,0,140000,470900,0,610900,125000,0,125000,430300,0,555300,RP,"RURAL,P",,,
17560,43-35-0-16-0,6777-15-4736,SNGL FAM SUB,2,AC,140000,0,140000,415000,25900,580900,125000,0,125000,380100,24700,529800,RP,"RURAL,P",,,
17561,43-35-0-17-0,6777-15-1886,SNGL FAM SUB,2,AC,140000,0,140000,586800,29100,755900,125000,0,125000,546000,27400,698400,RP,"RURAL,P",,,
17562,43-35-0-18-0,6777-06-9001,SNGL FAM SUB,2.001,AC,140000,0,140000,445100,0,585100,125000,0,125000,407400,0,532400,RP,"RURAL,P",,,
17563,43-35-0-19-0,6777-06-6184,SNGL FAM SUB,2.001,AC,140000,0,140000,451300,1500,592800,125000,0,125000,411700,1500,538200,RP,"RURAL,P",,,
17564,43-35-0-20-0,6777-06-4276,SNGL FAM SUB,2.001,AC,140000,0,140000,431200,0,571200,125000,0,125000,397500,0,522500,RP,"RURAL,P",,,
17565,43-35-0-21-0,6777-06-2359,SNGL FAM SUB,2.001,AC,140000,0,140000,429600,8200,577800,125000,0,125000,423000,0,548000,RP,"RURAL,P",,,
17566,43-35-0-22-0,6777-06-0542,SNGL FAM SUB,2,AC,140000,0,140000,509100,1700,650800,125000,0,125000,463100,1800,589900,RP,"RURAL,P",,,
17567,43-35-0-A-0,6767-87-8759,Cmn Area/Open Spc,2.539,AC,0,0,0,0,0,0,0,0,0,0,0,0,RP,"RURAL,P",,,
17568,43-35-0-B-0,6767-96-9704,Cmn Area/Open Spc,2.609,AC,0,0,0,0,0,0,0,0,0,0,0,0,RP,"RURAL,P",,,
17569,43-35-0-C-0,6777-25-8483,Cmn Area/Open Spc,45.808,AC,0,0,0,0,0,0,0,0,0,0,0,0,RP,"RURAL,P",,,
17571,9-11-0-7-C,5891-96-2925,SNGL FAM SUB,4.35,AC,50900,0,50900,121700,2200,174800,49700,0,49700,106600,1700,158000,A1,AG/GEN,,,
17572,31-1-0-45-F,6769-85-9103,SNGL FAM SUB,4.96,AC,107700,0,107700,0,0,107700,98300,0,98300,0,0,98300,A1,AG/GEN,,,
17573,9-1-0-59-A,5891-96-8228,SNGL FAM SUB,3,AC,46000,0,46000,129000,200,175200,45000,0,45000,114000,200,159200,A1,AG/GEN,,,
17574,42-1-0-122-0,6767-09-3012,COMM & IND,10.195,AC,1300700,0,1300700,4349000,527000,6176700,1250500,0,1250500,4379500,363400,5993400,B1,BUS/GEN,,,
17575,42-1-0-123-0,6757-98-9715,COMM & IND,1.384,AC,225500,0,225500,444800,76500,746800,216800,0,216800,448500,53300,718600,B1,BUS/GEN,,,
17576,42-1-0-124-0,6757-99-8141,COMM & IND,1.85,AC,301500,0,301500,634300,92600,1028400,289800,0,289800,581800,73100,944700,B1,BUS/GEN,,,
17578,45-1-0-3-B1,6798-00-2789,COMM & IND,0.309,AC,10700,0,10700,0,0,10700,10200,0,10200,0,0,10200,B1,BUS/GEN,,,
17580,21-1-0-56-G,6850-82-5552,SNGL FAM SUB,2,AC,66400,0,66400,115000,2000,183400,58200,0,58200,89200,1400,148800,A2,AG/LTD,,,
17581,5-10-0-1-B,6813-79-7863,SNGL FAM SUB,15.83,AC,90800,0,90800,207500,0,298300,89100,0,89100,182300,0,271400,A1,AG/GEN,,,
17582,9-1-0-70-0,5892-73-7732,SNGL FAM SUB,0.5,AC,26200,0,26200,210500,0,236700,29000,0,29000,187500,0,216500,A1,AG/GEN,,,
17583,9-1-0-11-B,5892-74-1326,SNGL FAM SUB,5,AC,42500,0,42500,0,0,42500,42400,0,42400,0,0,42400,A1,AG/GEN,,,
17584,31-1-0-66-ATW,6779-17-9387-9998,TAXED -SCC,0,AC,0,0,0,0,0,0,0,0,0,0,0,0,A2,AG/LTD,,,
17585,26-2-0-3-N2,6709-73-9011,SNGL FAM SUB,5,AC,63500,0,63500,182300,45700,291500,62000,0,62000,149200,38500,249700,RR,RES/RUR,,,
17586,56-1-0-45-G,6796-50-0524,AG 20-100 AC,29.465,AC,487900,474300,13600,0,0,487900,424300,411800,12500,0,0,424300,A2,AG/LTD,,,
17587,56-1-0-45-F,6795-29-7409,AG 20-100 AC,53.882,AC,773300,747700,25600,0,0,773300,673100,650100,23000,0,0,673100,A2,AG/LTD,,,
17588,12-1-0-4-A,6822-76-3160,SNGL FAM SUB,4.193,AC,58500,0,58500,0,0,58500,56800,0,56800,0,0,56800,A1,AG/GEN,,,
17589,17-1-0-52-A,6810-18-6237,SNGL FAM SUB,10,AC,89200,0,89200,256300,0,345500,83000,0,83000,230400,0,313400,A1,AG/GEN,,,
17590,59-3-2-94-0,7726-95-7530,General Gov,0.763,AC,300600,0,300600,474500,27000,802100,273300,0,273300,460000,27800,761100,B1,BUS/GEN,,,
17592,10-12-0-1-0,6812-02-1763,SNGL FAM SUB,14.776,AC,94600,0,94600,209100,2000,305700,90300,0,90300,190000,2000,282300,A1,AG/GEN,,,
17593,10-12-0-2-0,6812-03-6222,SNGL FAM SUB,10.397,AC,76800,71600,5200,0,11800,88600,70000,65600,4400,0,12300,82300,A1,AG/GEN,,,
17594,10-12-0-3-0,6812-12-1847,SNGL FAM SUB,10.397,AC,76800,0,76800,0,0,76800,75600,0,75600,0,0,75600,A1,AG/GEN,,,
17595,10-12-0-4-0,6812-11-6918,SNGL FAM SUB,9.68,AC,64000,0,64000,0,0,64000,62200,0,62200,0,0,62200,A1,AG/GEN,,,
17596,10-12-0-5-0,6812-02-8112,SNGL FAM SUB,10.397,AC,76800,71600,5200,0,0,76800,75600,71200,4400,0,0,75600,A1,AG/GEN,,,
17597,10-12-0-6-0,6812-01-2908,SNGL FAM SUB,10.397,AC,76800,0,76800,0,0,76800,75600,0,75600,0,0,75600,A1,AG/GEN,,,
17598,48-1-0-47-D,7727-66-6811,COMM & IND,129.025,AC,3120200,0,3120200,0,0,3120200,2972100,0,2972100,0,0,2972100,M2,INDUS/G,,,
17599,10-3-0-3-0,6812-21-0810,SNGL FAM SUB,0.092,AC,400,0,400,0,0,400,400,0,400,0,0,400,A1,AG/GEN,,,
17600,47-1-0-59-A1,7718-81-7354,SNGL FAM SUB,2,AC,13600,0,13600,0,0,13600,12200,0,12200,0,0,12200,A2,AG/LTD,,,
17601,13-1-0-10-0,6842-71-3640,AG 20-100 AC,21.52,AC,77300,0,77300,0,0,77300,75800,66700,9100,0,0,75800,A1,AG/GEN,,,
17602,18-1-0-26-B1,6729-07-3384,SNGL FAM SUB,3.474,AC,54700,0,54700,183800,10500,249000,51600,0,51600,150800,10500,212900,A1,AG/GEN,,,
17603,28-17-0-8-0,6729-83-6135,SNGL FAM SUB,4.007,AC,70000,0,70000,271800,73600,415400,68900,0,68900,227500,80500,376900,A1,AG/GEN,,,
17604,28-17-0-9-0,6729-83-3370,SNGL FAM SUB,2.726,AC,61700,0,61700,242200,6800,310700,59500,0,59500,203000,7100,269600,A1,AG/GEN,,,
17605,27-12-0-1-0,6729-73-1041,AG 20-100 AC,30.912,AC,167100,99700,67400,430300,55300,652700,162600,101000,61600,353700,47400,563700,A1,AG/GEN,,,
17606,27-12-0-2-0,6729-53-5510,AG 20-100 AC,36.386,AC,189600,171300,18300,0,0,189600,184500,168900,15600,0,0,184500,A1,AG/GEN,,,
17607,27-12-0-3-0,6729-33-0775,AG 20-100 AC,83.136,AC,302800,264300,38500,0,0,302800,282200,246800,35400,0,0,282200,A1,AG/GEN,,,
17608,27-12-0-4-0,6729-45-0651,AG 20-100 AC,76.277,AC,299200,212100,87100,202400,64200,565800,277700,189100,88600,197100,56000,530800,A1,AG/GEN,,,
17609,27-12-0-5-0,6729-55-5197,AG 20-100 AC,36.877,AC,191900,173800,18100,0,0,191900,183500,167700,15800,0,0,183500,A1,AG/GEN,,,
17610,27-12-0-6-0,6729-64-1479,AG 20-100 AC,25.322,AC,147800,135300,12500,0,0,147800,140300,129500,10800,0,0,140300,A1,AG/GEN,,,
17611,30-22-0-5-0,6758-68-9007,AG 20-100 AC,21.21,AC,160700,0,160700,459300,5300,625300,144900,0,144900,382300,4300,531500,A2,AG/LTD,,,
17612,30-22-0-4-0,6758-78-8100,AG 20-100 AC,21.524,AC,162100,0,162100,485500,126000,773600,146400,0,146400,405400,82900,634700,A2,AG/LTD,,,
17613,30-22-0-2-0,6758-87-3983,SNGL FAM SUB,5.865,AC,110300,0,110300,407900,13600,531800,100500,0,100500,338800,10900,450200,A2,AG/LTD,,,
17614,30-22-0-1-0,6758-98-2197,SNGL FAM SUB,10,AC,160300,0,160300,484000,34300,678600,143500,0,143500,410200,32400,586100,A2,AG/LTD,,,
17615,30-22-0-3-0,6758-88-7404,SNGL FAM SUB,3.41,AC,83200,0,83200,211400,0,294600,75000,0,75000,177700,0,252700,A2,AG/LTD,,,
17617,6-1-0-44-0,6832-17-1630,SNGL FAM SUB,4.18,AC,66200,0,66200,14500,4800,85500,64400,0,64400,15000,4100,83500,A1,AG/GEN,,,
17619,64-1-0-44-B,7724-93-9742,Other Religious,2.755,AC,180400,0,180400,430100,1400,611900,156900,0,156900,406100,0,563000,A2,AG/LTD,,,
17620,20-5-0-G-1,6840-07-7676,SNGL FAM SUB,5.35,AC,93800,0,93800,292300,3000,389100,86000,0,86000,243000,3000,332000,A1,AG/GEN,,,
17621,67-4-0-4-C,7733-06-0488,SNGL FAM SUB,3.877,AC,270200,0,270200,0,0,270200,234900,0,234900,0,0,234900,A2,AG/LTD,,,
17622,20-3-0-3-B,6840-35-4120,SNGL FAM SUB,2.001,AC,56800,0,56800,252300,9400,318500,53000,0,53000,214800,8400,276200,A1,AG/GEN,,,
17623,62-38-0-1-0,7704-84-2993,SNGL FAM URB,0.25,AC,126000,0,126000,434800,0,560800,115000,0,115000,409300,0,524300,RPUD,RES/PUD,,,
17624,62-38-0-2-0,7704-84-2939,SNGL FAM URB,0.3,AC,126000,0,126000,422100,500,548600,115000,0,115000,413100,500,528600,RPUD,RES/PUD,,,
17625,62-38-0-3-0,7704-85-1074,SNGL FAM URB,0.33,AC,126000,0,126000,344900,0,470900,115000,0,115000,326200,0,441200,RPUD,RES/PUD,,,
17626,62-38-0-4-0,7704-85-1018,SNGL FAM URB,0.33,AC,126000,0,126000,369200,0,495200,115000,0,115000,348700,0,463700,RPUD,RES/PUD,,,
17627,62-38-0-5-0,7704-85-0142,SNGL FAM URB,0.32,AC,126000,0,126000,329500,0,455500,115000,0,115000,312000,0,427000,RPUD,RES/PUD,,,
17628,62-38-0-6-0,7704-75-9176,SNGL FAM URB,0.29,AC,126000,0,126000,375400,0,501400,115000,0,115000,355000,0,470000,RPUD,RES/PUD,,,
17629,62-38-0-7-0,7704-75-9200,SNGL FAM URB,0.27,AC,126000,0,126000,348900,0,474900,115000,0,115000,330100,0,445100,RPUD,RES/PUD,,,
17630,62-38-0-8-0,7704-75-8243,SNGL FAM URB,0.25,AC,126000,0,126000,344400,0,470400,115000,0,115000,326000,0,441000,RPUD,RES/PUD,,,
17631,62-38-0-9-0,7704-75-7278,SNGL FAM URB,0.25,AC,126000,0,126000,346400,0,472400,115000,0,115000,337600,0,452600,RPUD,RES/PUD,,,
17632,62-38-0-10-0,7704-75-7302,SNGL FAM URB,0.26,AC,126000,0,126000,366500,0,492500,115000,0,115000,345400,0,460400,RPUD,RES/PUD,,,
17633,62-38-0-11-0,7704-75-6328,SNGL FAM URB,0.35,AC,126000,0,126000,345300,0,471300,115000,0,115000,326600,0,441600,RPUD,RES/PUD,,,
17634,62-38-0-12-0,7704-75-5457,SNGL FAM URB,0.5,AC,126000,0,126000,394000,0,520000,115000,0,115000,372500,0,487500,RPUD,RES/PUD,,,
17635,62-38-0-13-0,7704-75-4439,SNGL FAM URB,0.45,AC,126000,0,126000,379700,0,505700,115000,0,115000,358300,0,473300,RPUD,RES/PUD,,,
17636,62-38-0-14-0,7704-75-3507,SNGL FAM URB,0.42,AC,126000,0,126000,406200,0,532200,115000,0,115000,383900,0,498900,RPUD,RES/PUD,,,
17637,62-38-0-15-0,7704-75-3638,SNGL FAM URB,0.25,AC,126000,0,126000,360400,0,486400,115000,0,115000,339600,0,454600,RPUD,RES/PUD,,,
17638,62-38-0-16-0,7704-75-4731,SNGL FAM URB,0.58,AC,126000,0,126000,416900,0,542900,115000,0,115000,393000,0,508000,RPUD,RES/PUD,,,
17639,62-38-0-17-0,7704-75-7540,SNGL FAM URB,0.32,AC,126000,0,126000,385600,0,511600,115000,0,115000,363600,0,478600,RPUD,RES/PUD,,,
17640,62-38-0-18-0,7704-75-7558,SNGL FAM URB,0.22,AC,126000,0,126000,338200,0,464200,115000,0,115000,326300,0,441300,RPUD,RES/PUD,,,
17641,62-38-0-19-0,7704-75-7646,SNGL FAM URB,0.25,AC,126000,0,126000,509500,0,635500,115000,0,115000,483000,0,598000,RPUD,RES/PUD,,,
17642,62-38-0-20-0,7704-75-7745,SNGL FAM URB,0.26,AC,126000,0,126000,545100,0,671100,115000,0,115000,528200,0,643200,RPUD,RES/PUD,,,
17643,62-38-0-21-0,7704-75-8821,SNGL FAM URB,0.29,AC,126000,0,126000,501300,0,627300,115000,0,115000,490500,0,605500,RPUD,RES/PUD,,,
17644,62-38-0-22-0,7704-75-9718,SNGL FAM URB,0.27,AC,126000,0,126000,577200,0,703200,115000,0,115000,563700,0,678700,RPUD,RES/PUD,,,
17645,62-38-0-23-0,7704-75-9760,SNGL FAM URB,0.23,AC,126000,0,126000,442400,900,569300,115000,0,115000,415900,700,531600,RPUD,RES/PUD,,,
17646,62-38-0-24-0,7704-75-9643,SNGL FAM URB,0.26,AC,126000,0,126000,347500,0,473500,115000,0,115000,334100,0,449100,RPUD,RES/PUD,,,
17647,62-38-0-25-0,7704-75-9535,SNGL FAM URB,0.27,AC,126000,0,126000,354700,0,480700,115000,0,115000,327200,0,442200,RPUD,RES/PUD,,,
17648,62-38-0-26-0,7704-75-9427,SNGL FAM URB,0.25,AC,126000,0,126000,360900,0,486900,115000,0,115000,340400,0,455400,RPUD,RES/PUD,,,
17649,62-38-0-27-0,7704-75-8389,SNGL FAM URB,0.25,AC,126000,0,126000,365200,0,491200,115000,0,115000,346700,0,461700,RPUD,RES/PUD,,,
17650,62-38-0-28-0,7704-85-0322,SNGL FAM URB,0.25,AC,126000,0,126000,400300,0,526300,115000,0,115000,377500,0,492500,RPUD,RES/PUD,,,
17651,62-38-0-29-0,7704-85-0369,SNGL FAM URB,0.23,AC,126000,0,126000,365300,0,491300,115000,0,115000,345300,0,460300,RPUD,RES/PUD,,,
17652,62-38-0-30-0,7704-85-1405,SNGL FAM URB,0.25,AC,126000,0,126000,325600,0,451600,115000,0,115000,308500,0,423500,RPUD,RES/PUD,,,
17653,62-38-0-31-0,7704-85-1522,SNGL FAM URB,0.25,AC,126000,0,126000,349500,0,475500,115000,0,115000,330200,0,445200,RPUD,RES/PUD,,,
17654,62-38-0-32-0,7704-85-1641,SNGL FAM URB,0.25,AC,126000,0,126000,382200,0,508200,115000,0,115000,362200,0,477200,RPUD,RES/PUD,,,
17655,62-38-0-33-0,7704-85-2635,SNGL FAM URB,0.3,AC,126000,0,126000,378200,0,504200,115000,0,115000,358600,0,473600,RPUD,RES/PUD,,,
17656,62-38-0-34-0,7704-85-3529,SNGL FAM URB,0.28,AC,126000,0,126000,360000,0,486000,115000,0,115000,340400,0,455400,RPUD,RES/PUD,,,
17657,62-38-0-35-0,7704-85-3540,SNGL FAM URB,0.22,AC,126000,0,126000,320300,0,446300,115000,0,115000,308900,0,423900,RPUD,RES/PUD,,,
17658,62-38-0-36-0,7704-85-2494,SNGL FAM URB,0.24,AC,126000,0,126000,309100,0,435100,115000,0,115000,295000,0,410000,RPUD,RES/PUD,,,
17659,62-38-0-37-0,7704-85-2367,SNGL FAM URB,0.22,AC,126000,0,126000,366000,0,492000,115000,0,115000,341200,0,456200,RPUD,RES/PUD,,,
17660,62-38-0-38-0,7704-85-2321,SNGL FAM URB,0.24,AC,126000,0,126000,339300,0,465300,115000,0,115000,321200,0,436200,RPUD,RES/PUD,,,
17661,62-38-0-39-0,7704-85-1294,SNGL FAM URB,0.25,AC,126000,0,126000,375000,0,501000,115000,0,115000,355000,0,470000,RPUD,RES/PUD,,,
17662,62-38-0-40-0,7704-85-3125,SNGL FAM URB,0.24,AC,126000,0,126000,368700,0,494700,115000,0,115000,348300,0,463300,RPUD,RES/PUD,,,
17663,62-38-0-41-0,7704-85-3271,SNGL FAM URB,0.24,AC,126000,0,126000,379300,0,505300,115000,0,115000,357400,0,472400,RPUD,RES/PUD,,,
17664,62-38-0-42-0,7704-85-4217,SNGL FAM URB,0.28,AC,126000,0,126000,312600,0,438600,115000,0,115000,289000,0,404000,RPUD,RES/PUD,,,
17665,62-38-0-43-0,7704-85-4354,SNGL FAM URB,0.26,AC,126000,0,126000,365300,0,491300,115000,0,115000,345300,0,460300,RPUD,RES/PUD,,,
17666,62-38-0-44-0,7704-85-4471,SNGL FAM URB,0.25,AC,126000,0,126000,360400,0,486400,115000,0,115000,346800,0,461800,RPUD,RES/PUD,,,
17667,62-38-0-45-0,7704-85-5418,SNGL FAM URB,0.23,AC,126000,0,126000,371000,0,497000,115000,0,115000,351400,0,466400,RPUD,RES/PUD,,,
17668,62-38-0-46-0,7704-85-6419,SNGL FAM URB,0.26,AC,126000,0,126000,396800,0,522800,115000,0,115000,374500,0,489500,RPUD,RES/PUD,,,
17669,62-38-0-47-0,7704-85-6482,SNGL FAM URB,0.23,AC,126000,0,126000,350900,0,476900,115000,0,115000,332100,0,447100,RPUD,RES/PUD,,,
17670,62-38-0-48-0,7704-85-6373,SNGL FAM URB,0.24,AC,126000,0,126000,394900,0,520900,115000,0,115000,372700,0,487700,RPUD,RES/PUD,,,
17671,62-38-0-49-0,7704-85-6237,SNGL FAM URB,0.22,AC,126000,0,126000,370800,0,496800,115000,0,115000,351400,0,466400,RPUD,RES/PUD,,,
17672,62-38-0-50-0,7704-85-5291,SNGL FAM URB,0.22,AC,126000,0,126000,308000,0,434000,115000,0,115000,291400,0,406400,RPUD,RES/PUD,,,
17673,62-38-0-51-0,7704-85-5154,SNGL FAM URB,0.22,AC,126000,0,126000,334100,0,460100,115000,0,115000,316800,0,431800,RPUD,RES/PUD,,,
17674,62-38-0-52-0,7704-85-5019,SNGL FAM URB,0.23,AC,126000,0,126000,344100,0,470100,115000,0,115000,324900,0,439900,RPUD,RES/PUD,,,
17675,62-38-0-A-0,7704-85-2790,Cmn Area/Open Spc,6.96,AC,0,0,0,0,0,0,0,0,0,0,0,0,RPUD,RES/PUD,,,
17676,62-38-0-B-0,7704-75-6155,Cmn Area/Open Spc,10.06,AC,0,0,0,0,0,0,0,0,0,0,0,0,RPUD,RES/PUD,,,
17677,62-38-0-C-0,7704-84-4989,Cmn Area/Open Spc,0.46,AC,0,0,0,0,0,0,0,0,0,0,0,0,RPUD,RES/PUD,,,
17679,46-1-0-36-D,7707-42-3456,SNGL FAM SUB,3,AC,143400,0,143400,485000,44900,673300,128000,0,128000,435400,40400,603800,A2,AG/LTD,,,
17680,46-1-0-36-E,7707-32-9382,SNGL FAM SUB,2.19,AC,125400,0,125400,484100,3000,612500,112000,0,112000,426800,3000,541800,A2,AG/LTD,,,
17681,63-1-0-149-B,7714-99-1615,SNGL FAM SUB,6.709,AC,170700,0,170700,0,0,170700,148200,0,148200,0,0,148200,A2,AG/LTD,,,
17682,47-1-0-109-A,7727-27-2199,General Gov,0.23,AC,18200,0,18200,0,0,18200,16300,0,16300,0,0,16300,A2,AG/LTD,,,
17683,5-1-0-45-A,6823-17-5461,SNGL FAM SUB,4.145,AC,61300,0,61300,344900,3000,409200,60200,0,60200,301300,3000,364500,A2,AG/LTD,,,
17684,57-12-0-3-A,7706-04-1392,SNGL FAM SUB,6,AC,239900,0,239900,505900,0,745800,208800,0,208800,433700,0,642500,A2,AG/LTD,,,
17686,55-1-0-22-A,6785-17-5626,SNGL FAM SUB,4.52,AC,131300,0,131300,710100,51200,892600,117100,0,117100,580000,48100,745200,A2,AG/LTD,,,
17687,13-1-0-11-B,6841-79-0853,SNGL FAM SUB,5.14,AC,74600,0,74600,0,0,74600,73600,71400,2200,0,0,73600,A1,AG/GEN,,,
17688,13-1-0-11-A,6841-69-7983,SNGL FAM SUB,3.88,AC,67400,0,67400,178800,19200,265400,66300,0,66300,155000,18000,239300,A1,AG/GEN,,,
17689,16-1-0-53-D,5890-79-3085,SNGL FAM SUB,3.014,AC,46100,0,46100,257700,4600,308400,44000,0,44000,229500,5200,278700,A1,AG/GEN,,,
17690,16-1-0-53-C,5890-68-8996,SNGL FAM SUB,3.229,AC,46800,0,46800,226000,500,273300,45800,0,45800,200300,500,246600,A1,AG/GEN,,,
17691,45-1-0-98-A,6797-98-4525,SNGL FAM SUB,4.03,AC,113700,0,113700,206700,3300,323700,101700,0,101700,168000,3300,273000,A2,AG/LTD,,,
17692,58-35-0-2-C,7716-50-4689,SNGL FAM SUB,5.11,AC,319500,0,319500,826500,0,1146000,277600,0,277600,727300,0,1004900,A2,AG/LTD,,,
17693,58-35-0-2-B,7716-51-4158,SNGL FAM SUB,5.11,AC,431700,0,431700,0,0,431700,303100,0,303100,0,0,303100,A2,AG/LTD,,,
17694,58-35-0-2-A,7716-51-5604,SNGL FAM SUB,6.26,AC,359600,0,359600,0,0,359600,312600,0,312600,0,0,312600,A2,AG/LTD,,,
17695,58-35-0-2-A1,7716-51-6724,Cemetery,0,AC,100,0,100,0,0,100,100,0,100,0,0,100,A2,AG/LTD,,,
17696,29-1-0-22-A,6748-24-0380,AG 20-100 AC,21.445,AC,9900,0,9900,0,0,9900,9100,0,9100,0,0,9100,A1,AG/GEN,,,
17697,30-1-0-13-A,6759-42-6603,SNGL FAM SUB,3.026,AC,73800,0,73800,208400,24900,307100,70000,0,70000,172300,21500,263800,A2,AG/LTD,,,
17698,30-1-0-13-B,6759-42-3644,SNGL FAM SUB,2.422,AC,68100,0,68100,232700,4400,305200,64700,0,64700,198600,3100,266400,A2,AG/LTD,,,
17699,30-1-0-13-C,6759-32-9779,SNGL FAM SUB,8.449,AC,120700,0,120700,223200,4400,348300,111700,0,111700,183900,3100,298700,A1A2,AG GEN/,,,
17701,39-8-0-D-2,6727-24-2569,SNGL FAM SUB,10,AC,89200,0,89200,385000,1000,475200,87500,0,87500,329600,1000,418100,A1,AG/GEN,,,
17702,63-1-0-69-A,7714-52-7716,SNGL FAM SUB,5.68,AC,268800,265900,2900,0,0,268800,234000,231600,2400,0,0,234000,A2,AG/LTD,,,
17704,46-1-0-15-A,7707-25-9350,SNGL FAM SUB,3,AC,126400,0,126400,267500,0,393900,112900,0,112900,232500,0,345400,A2,AG/LTD,,,
17705,4-1-0-67-C,6813-33-7907,Cemetery,0,AC,100,0,100,0,0,100,100,0,100,0,0,100,A1,AG/GEN,,,
17706,18-11-0-4-A,6811-70-9439,Cemetery,0,AC,100,0,100,0,0,100,100,0,100,0,0,100,A1,AG/GEN,,,
17707,7-1-0-13-A,6842-58-3886,Cemetery,0,AC,100,0,100,0,0,100,100,0,100,0,0,100,A1,AG/GEN,,,
17708,62-15-0-G-1,7704-06-7683,AG 20-100 AC,26.7,AC,160200,0,160200,0,0,160200,106800,0,106800,0,0,106800,A2,AG/LTD,,,
17709,62-15-0-D-2,7704-16-6415,SNGL FAM SUB,7.9,AC,655000,0,655000,1473700,116400,2245100,601100,0,601100,1394200,112000,2107300,A2,AG/LTD,,,
17710,62-15-0-D-3,7704-37-0041,SNGL FAM SUB,10.317,AC,562100,0,562100,0,0,562100,518100,0,518100,0,0,518100,A2,AG/LTD,,,
17711,56-1-0-87-0,6795-93-1186,AG 20-100 AC,23.129,AC,674400,0,674400,961900,95700,1732000,586800,0,586800,992000,86800,1665600,RR,RES/RUR,,,
17712,33-1-0-18-A1,6798-83-2531,AG 20-100 AC,28.058,AC,443500,353000,90500,616600,9400,1069500,395400,315200,80200,545700,8800,949900,A2,AG/LTD,,,
17713,29-1-0-38-A,6758-13-9677,SNGL FAM SUB,0.36,AC,3600,3400,200,0,0,3600,3200,3000,200,0,0,3200,A2,AG/LTD,,,
17714,46-1-0-25-B,7707-14-2679,SNGL FAM SUB,0.201,AC,4600,0,4600,0,0,4600,4100,0,4100,0,0,4100,A2,AG/LTD,,,
17715,37-1-0-9-0,6706-39-6146,COMM & IND,0.25,AC,4200,0,4200,0,0,4200,4100,0,4100,0,0,4100,M2,INDUS/G,,,
17717,47-7-0-B-1,7717-69-7500,SNGL FAM SUB,5.02,AC,167300,0,167300,400400,23600,591300,149500,0,149500,348100,21400,519000,A2,AG/LTD,,,
17718,55-1-0-77-A,6786-60-4194,SNGL FAM SUB,2.292,AC,91400,0,91400,461900,13400,566700,81600,0,81600,365200,11100,457900,A2,AG/LTD,,,
17719,21-12-0-1-0,6850-41-7294,SNGL FAM SUB,2.789,AC,75800,0,75800,326000,0,401800,68500,0,68500,270000,0,338500,A2,AG/LTD,,,
17720,21-12-0-2-0,6850-51-1315,SNGL FAM SUB,2.395,AC,71200,0,71200,398500,3300,473000,64400,0,64400,331900,3500,399800,A2,AG/LTD,,,
17721,21-12-0-3-0,6850-51-3482,SNGL FAM SUB,2.427,AC,71500,0,71500,408700,0,480200,64700,0,64700,338700,0,403400,A2,AG/LTD,,,
17722,21-12-0-4-0,6850-51-6327,SNGL FAM SUB,2.852,AC,76600,0,76600,368700,46600,491900,69200,0,69200,306300,38500,414000,A2,AG/LTD,,,
17723,16-1-0-76-E,5890-81-7581,SNGL FAM SUB,11.367,AC,61800,25200,36600,10000,100,71900,59800,15700,44100,10000,100,69900,A1,AG/GEN,,,
17724,62-39-0-1-0,7705-81-4276,SNGL FAM SUB,6.38,AC,343200,0,343200,0,0,343200,312000,0,312000,0,0,312000,RR,RES/RUR,,,
17725,62-39-0-2-0,7705-91-0668,SNGL FAM SUB,5.28,AC,343200,0,343200,1634200,0,1977400,312000,0,312000,1571400,0,1883400,RR,RES/RUR,,,
17726,62-39-0-3-0,7705-81-9344,SNGL FAM SUB,3.525,AC,343200,0,343200,942300,0,1285500,312000,0,312000,886100,0,1198100,RR,RES/RUR,,,
17727,62-39-0-4-0,7705-80-5820,SNGL FAM SUB,9.393,AC,356900,0,356900,492700,3600,853200,324500,0,324500,511500,3100,839100,RR,RES/RUR,,,
17728,58-36-0-A-0,7715-58-4045,Cmn Area/Open Spc,1.397,AC,0,0,0,0,0,0,0,0,0,0,0,0,RPUD,RES/PUD,,,
17731,26-2-0-3-N3,6709-62-3474,AG 20-100 AC,22.71,AC,159300,96700,62600,497200,0,656500,156100,94800,61300,413800,0,569900,A1,AG/GEN,,,
17732,12-30-0-1-0,6832-93-1394,AG 20-100 AC,36.7,AC,287300,270400,16900,0,9900,297200,280700,265100,15600,0,8000,288700,A1,AG/GEN,,,
17733,12-30-0-2-0,6842-02-1740,AG 20-100 AC,40,AC,276700,165900,110800,341300,57900,675900,267800,160600,107200,335600,59500,662900,A1,AG/GEN,,,
17734,12-30-0-3-0,6832-91-5911,AG 20-100 AC,41.63,AC,332000,0,332000,235300,56300,623600,327600,257500,70100,144900,39200,511700,A1,AG/GEN,,,
17735,64-4-2-A-1,7724-94-4709,Roads,0,AC,0,0,0,0,0,0,0,0,0,0,0,0,RN,RESIDEN,,,
17736,44-28-0-1-0,6787-34-0125,SNGL FAM SUB,10.043,AC,214100,0,214100,0,0,214100,191100,0,191100,0,0,191100,RR,RES/RUR,,,
17737,44-28-0-2-0,6787-35-0461,AG 20-100 AC,20.192,AC,285400,0,285400,0,19500,304900,254600,0,254600,0,7000,261600,A2,AG/LTD,,,
17738,44-28-0-3-0,6787-34-9674,SNGL FAM SUB,2.029,AC,104900,0,104900,438800,8800,552500,93700,0,93700,361600,0,455300,A2,AG/LTD,,,
17739,44-28-0-4-0,6787-34-9385,SNGL FAM SUB,2.083,AC,105900,0,105900,379300,36000,521200,94500,0,94500,324000,30200,448700,A2,AG/LTD,,,
17740,44-28-0-5-0,6787-34-9115,SNGL FAM SUB,2.723,AC,117100,0,117100,361100,2900,481100,104600,0,104600,305200,0,409800,A2,AG/LTD,,,
17741,44-28-0-6-0,6787-34-6088,SNGL FAM SUB,2.019,AC,104700,0,104700,601900,63000,769600,93500,0,93500,511000,52900,657400,A2,AG/LTD,,,
17742,44-28-0-A-0,6787-34-5222,Roads,1.865,AC,0,0,0,0,0,0,0,0,0,0,0,0,A2,AG/LTD,,,
17743,44-28-0-2-A,6787-34-5752,Cemetery,0,AC,100,0,100,0,0,100,100,0,100,0,0,100,A2,AG/LTD,,,
17744,27-8-0-C-1,6729-06-9535,SNGL FAM SUB,3.57,AC,55200,0,55200,257000,23100,335300,53400,0,53400,212300,21800,287500,A1,AG/GEN,,,
17745,13-1-0-52-E,6841-27-4975,AG 20-100 AC,36.13,AC,234200,217500,16700,0,0,234200,229900,214500,15400,0,0,229900,A1,AG/GEN,,,
17746,1-1-0-2-A1,6805-91-3469,SNGL FAM SUB,6,AC,65200,0,65200,300400,24800,390400,64000,0,64000,261100,22300,347400,RR,RES/RUR,,,
17747,1-1-0-17-B,6814-08-5488,SNGL FAM SUB,15.44,AC,106000,0,106000,336500,33600,476100,104000,0,104000,302500,28600,435100,A1,AG/GEN,,,
17748,1-1-0-17-C,6814-07-8898,SNGL FAM SUB,14.306,AC,100800,0,100800,0,0,100800,98900,0,98900,0,0,98900,A1,AG/GEN,,,
17750,26-15-0-A-1,6708-86-3826,SNGL FAM SUB,4.25,AC,57000,0,57000,113800,0,170800,55900,0,55900,91000,0,146900,A1,AG/GEN,,,
17752,58-36-5-A-0,7715-78-2901,Cmn Area/Open Spc,1.66,AC,0,0,0,0,0,0,0,0,0,0,0,0,RPUD,RES/PUD,,,
17753,58-36-5-1-0,7715-78-1644,SNGL FAM URB,0.488,AC,133800,0,133800,590000,0,723800,131100,0,131100,598400,0,729500,RPUD,RES/PUD,,,
17754,58-36-5-2-0,7715-78-2724,SNGL FAM URB,0.642,AC,133800,0,133800,444100,0,577900,131100,0,131100,454200,0,585300,RPUD,RES/PUD,,,
17755,58-36-5-3-0,7715-78-2808,SNGL FAM URB,0.784,AC,133800,0,133800,565800,0,699600,131100,0,131100,570900,0,702000,RPUD,RES/PUD,,,
17756,58-36-5-4-0,7715-78-0944,SNGL FAM URB,0.591,AC,133800,0,133800,431500,0,565300,131100,0,131100,444600,0,575700,RPUD,RES/PUD,,,
17757,58-36-5-5-0,7715-68-9839,SNGL FAM URB,0.522,AC,133800,0,133800,618100,0,751900,131100,0,131100,632200,0,763300,RPUD,RES/PUD,,,
17758,58-36-5-6-0,7715-68-9707,SNGL FAM URB,0.532,AC,133800,0,133800,535200,0,669000,131100,0,131100,547100,0,678200,RPUD,RES/PUD,,,
17759,20-23-0-1-0,6840-16-2630,SNGL FAM SUB,4.164,AC,79900,0,79900,418200,2500,500600,76800,0,76800,362500,2600,441900,A1,AG/GEN,,,
17760,20-23-0-2-0,6840-06-9022,AG 20-100 AC,20.672,AC,113800,0,113800,473500,0,587300,109800,0,109800,426100,0,535900,A1,AG/GEN,,,
17761,20-23-0-3-0,6840-06-8647,SNGL FAM SUB,3.122,AC,71400,0,71400,379800,0,451200,68700,0,68700,341300,5200,415200,A1,AG/GEN,,,
17762,20-23-0-4-0,6840-16-1970,SNGL FAM SUB,2.502,AC,66300,0,66300,311500,30200,408000,63800,0,63800,277700,30800,372300,A1,AG/GEN,,,
17763,64-22-0-A-1,7733-07-9722,General Gov,0.648,AC,94000,0,94000,473800,0,567800,86000,0,86000,491400,0,577400,R1,RES/LTD,,,
17764,21-13-0-2-0,6769-09-8409,SNGL FAM SUB,13.6,AC,140900,0,140900,0,0,140900,128000,0,128000,0,0,128000,A2,AG/LTD,,,
17765,21-13-0-1-0,6860-10-0050,SNGL FAM SUB,13.6,AC,140900,134500,6400,0,0,140900,128000,122200,5800,0,0,128000,A2,AG/LTD,,,
17766,6-1-0-4-E2,6823-78-4410,SNGL FAM SUB,10,AC,72700,0,72700,157300,0,230000,71500,0,71500,135300,0,206800,RR,RES/RUR,,,
17767,42-32-C-23-0,6758-60-6273,SNGL FAM SUB,1.877,AC,92000,0,92000,394800,0,486800,80000,0,80000,361500,0,441500,R1,RES/LTD,,,
17768,42-32-C-24-0,6758-60-5315,SNGL FAM SUB,1.517,AC,92000,0,92000,460900,0,552900,80000,0,80000,421100,0,501100,R1,RES/LTD,,,
17769,42-32-C-25-0,6758-60-4680,SNGL FAM SUB,2.165,AC,92000,0,92000,402700,0,494700,80000,0,80000,378400,0,458400,R1,RES/LTD,,,
17770,42-32-C-26-0,6758-60-9579,SNGL FAM SUB,1.956,AC,92000,0,92000,423200,0,515200,80000,0,80000,395000,0,475000,R1,RES/LTD,,,
17771,42-32-C-27-0,6758-70-0472,SNGL FAM SUB,2.36,AC,92000,0,92000,378800,2300,473100,80000,0,80000,347300,2600,429900,R1,RES/LTD,,,
17772,42-32-C-28-0,6758-70-0120,SNGL FAM SUB,1.873,AC,92000,0,92000,333100,0,425100,80000,0,80000,304800,0,384800,R1,RES/LTD,,,
17773,42-32-D-29-0,6757-59-2571,SNGL FAM SUB,2.119,AC,92000,0,92000,437000,0,529000,80000,0,80000,398900,0,478900,R1,RES/LTD,,,
17774,42-32-D-30-0,6757-59-0524,SNGL FAM SUB,1.735,AC,92000,0,92000,481600,3200,576800,80000,0,80000,453200,2900,536100,R1,RES/LTD,,,
17775,42-32-D-31-0,6757-49-7548,SNGL FAM SUB,1.94,AC,92000,0,92000,442500,0,534500,80000,0,80000,410800,0,490800,R1,RES/LTD,,,
17776,42-32-D-32-0,6757-49-4686,SNGL FAM SUB,1.94,AC,92000,0,92000,438600,0,530600,80000,0,80000,400500,0,480500,R1,RES/LTD,,,
17777,42-32-D-33-0,6757-49-2764,SNGL FAM SUB,1.537,AC,92000,0,92000,370700,0,462700,80000,0,80000,339000,0,419000,R1,RES/LTD,,,
17778,42-32-D-34-0,6758-40-4014,SNGL FAM SUB,1.5,AC,92000,0,92000,386100,2100,480200,80000,0,80000,353800,2300,436100,R1,RES/LTD,,,
17779,42-32-D-35-0,6757-49-7906,SNGL FAM SUB,1.658,AC,92000,0,92000,426500,0,518500,80000,0,80000,356500,0,436500,R1,RES/LTD,,,
17780,42-32-D-36-0,6757-49-9924,SNGL FAM SUB,1.742,AC,92000,0,92000,418000,0,510000,80000,0,80000,381300,0,461300,R1,RES/LTD,,,
17781,42-32-D-37-0,6757-59-1933,SNGL FAM SUB,1.708,AC,92000,0,92000,396500,0,488500,80000,0,80000,362700,0,442700,R1,RES/LTD,,,
17782,42-32-D-38-0,6757-59-3877,SNGL FAM SUB,1.733,AC,92000,0,92000,454700,2400,549100,80000,0,80000,414300,2700,497000,R1,RES/LTD,,,
17783,42-32-C-B-1,6758-70-2219,Cmn Area/Open Spc,0.897,AC,0,0,0,0,0,0,0,0,0,0,0,0,R1,RES/LTD,,,
17784,42-32-D-B-1,6757-49-6402,Cmn Area/Open Spc,1.844,AC,0,0,0,0,0,0,0,0,0,0,0,0,R1,RES/LTD,,,
17785,32-1-0-70-F,6788-14-2320,AG 20-100 AC,54.763,AC,426300,0,426300,0,0,426300,380600,0,380600,0,0,380600,RR,RES/RUR,,,
17788,30-1-0-26-D,6758-28-4825,AG 20-100 AC,24,AC,228800,0,228800,343700,0,572500,217800,0,217800,281900,0,499700,A1A2,AG GEN/,,,
17789,43-1-0-65-C,6778-50-5351,SNGL FAM SUB,2.5,AC,91700,0,91700,528500,31300,651500,82000,0,82000,446900,25700,554600,A2,AG/LTD,,,
17790,63-34-0-2-A,7724-36-4703,COMM & IND,4.1,AC,775300,0,775300,3028500,200,3804000,738400,0,738400,3028500,100,3767000,M1,INDUS/L,,,
17816,64-26-0-A-0,7733-48-8861,Cmn Area/Open Spc,2.049,AC,0,0,0,0,0,0,0,0,0,0,0,0,R1,RES/LTD,,,
17817,64-26-0-12-0,7734-40-9922,SNGL FAM SUB,1.011,AC,450000,0,450000,1532300,33200,2015500,410000,0,410000,1536100,32200,1978300,R1,RES/LTD,,,
17818,29-21-0-2-0,6748-23-8542,SNGL FAM SUB,3.095,AC,74500,0,74500,357700,0,432200,70600,0,70600,297500,0,368100,A1,AG/GEN,,,
17819,29-21-0-1-0,6748-23-4596,SNGL FAM SUB,3.765,AC,80700,0,80700,350300,2000,433000,77300,0,77300,292500,2000,371800,A1,AG/GEN,,,
17820,29-21-0-3-0,6748-33-2590,SNGL FAM SUB,3.307,AC,76500,0,76500,0,0,76500,72700,0,72700,0,0,72700,A1,AG/GEN,,,
17821,20-5-0-G-1A,6840-07-1434,SNGL FAM SUB,5,AC,90800,0,90800,335000,60600,486400,83100,0,83100,279600,52700,415400,A1,AG/GEN,,,
17822,20-24-0-1-0,6840-70-1751,SNGL FAM SUB,2.231,AC,66000,0,66000,478900,3900,548800,63300,0,63300,394400,3800,461500,A2,AG/LTD,,,
17823,20-24-0-2-0,6840-70-2926,SNGL FAM SUB,2.257,AC,66300,0,66300,449500,7400,523200,63600,0,63600,370900,5900,440400,A2,AG/LTD,,,
17824,20-24-0-3-0,6840-71-2200,SNGL FAM SUB,2.234,AC,66000,0,66000,0,0,66000,63400,0,63400,0,0,63400,A2,AG/LTD,,,
17825,20-24-0-4-0,6840-71-1538,SNGL FAM SUB,4.465,AC,86300,0,86300,552400,0,638700,85900,0,85900,473900,0,559800,A2,AG/LTD,,,
17826,10-1-0-11-B,6801-44-1273,SNGL FAM SUB,5,AC,57200,0,57200,189800,8700,255700,56000,0,56000,164600,9600,230200,A1,AG/GEN,,,
17827,6-1-0-4-H2,6823-98-4651,SNGL FAM SUB,5.095,AC,59500,0,59500,434400,51500,545400,59500,0,59500,386200,48800,494500,RR,RES/RUR,,,
17828,10-13-0-1-0,6812-41-0963,SNGL FAM SUB,4,AC,52600,0,52600,163200,400,216200,51500,0,51500,142100,400,194000,A1,AG/GEN,,,
17829,10-13-0-2-0,6812-41-1673,SNGL FAM SUB,4.1,AC,53100,0,53100,0,0,53100,52000,0,52000,0,0,52000,A1,AG/GEN,,,
17830,10-13-0-3-0,6812-41-5356,SNGL FAM SUB,4.122,AC,53200,0,53200,368500,0,421700,52000,0,52000,320900,0,372900,A1,AG/GEN,,,
17831,10-13-0-4-0,6812-41-3117,SNGL FAM SUB,4.066,AC,52900,0,52900,0,0,52900,51800,0,51800,0,0,51800,A1,AG/GEN,,,
17832,10-13-0-5-0,6812-30-7962,AG 20-100 AC,21.251,AC,111300,98400,12900,0,0,111300,119000,106400,12600,0,0,119000,A1,AG/GEN,,,
17833,64-27-A-1-0,7733-07-6925,SNGL FAM URB,0.39,AC,210000,0,210000,678300,19100,907400,180000,0,180000,631100,17500,828600,RPUD,RES/PUD,,,
17834,64-27-A-2-0,7733-07-4996,SNGL FAM URB,0.434,AC,210000,0,210000,705500,0,915500,180000,0,180000,654900,0,834900,RPUD,RES/PUD,,,
17835,64-27-A-3-0,7733-08-4015,SNGL FAM URB,0.439,AC,210000,0,210000,714800,0,924800,180000,0,180000,668900,0,848900,RPUD,RES/PUD,,,
17836,64-27-A-4-0,7733-08-4139,SNGL FAM URB,0.504,AC,210000,0,210000,691400,73000,974400,180000,0,180000,644100,67900,892000,RPUD,RES/PUD,,,
17837,64-27-A-5-0,7733-08-5244,SNGL FAM URB,0.435,AC,210000,0,210000,646800,0,856800,180000,0,180000,605900,0,785900,RPUD,RES/PUD,,,
17838,64-27-A-6-0,7733-08-5445,SNGL FAM URB,0.421,AC,210000,0,210000,637600,0,847600,180000,0,180000,592800,0,772800,RPUD,RES/PUD,,,
17839,64-27-A-7-0,7733-08-4414,SNGL FAM URB,0.484,AC,210000,0,210000,654800,0,864800,180000,0,180000,612500,0,792500,RPUD,RES/PUD,,,
17840,64-27-A-8-0,7733-08-3556,SNGL FAM URB,0.422,AC,210000,0,210000,651400,0,861400,180000,0,180000,607200,0,787200,RPUD,RES/PUD,,,
17841,64-27-A-9-0,7733-08-4626,SNGL FAM URB,0.477,AC,210000,0,210000,680300,0,890300,180000,0,180000,634400,0,814400,RPUD,RES/PUD,,,
17842,64-27-A-10-0,7733-08-3853,SNGL FAM URB,0.376,AC,210000,0,210000,676500,0,886500,180000,0,180000,632000,0,812000,RPUD,RES/PUD,,,
17843,64-27-A-11-0,7733-08-2833,SNGL FAM URB,0.415,AC,210000,0,210000,693000,0,903000,180000,0,180000,648300,0,828300,RPUD,RES/PUD,,,
17844,64-27-A-12-0,7733-08-0717,SNGL FAM URB,0.733,AC,210000,0,210000,690200,0,900200,180000,0,180000,648100,0,828100,RPUD,RES/PUD,,,
17845,64-27-A-13-0,7723-98-9971,SNGL FAM URB,0.454,AC,210000,0,210000,734600,0,944600,180000,0,180000,685700,0,865700,RPUD,RES/PUD,,,
17846,64-27-A-14-0,7723-99-9082,SNGL FAM URB,0.331,AC,210000,0,210000,690500,0,900500,180000,0,180000,591600,0,771600,RPUD,RES/PUD,,,
17847,64-27-A-15-0,7723-99-9164,SNGL FAM URB,0.376,AC,210000,0,210000,667900,0,877900,180000,0,180000,621400,0,801400,RPUD,RES/PUD,,,
17848,64-27-A-16-0,7723-99-9266,SNGL FAM URB,0.429,AC,210000,0,210000,708800,0,918800,180000,0,180000,662100,0,842100,RPUD,RES/PUD,,,
17849,64-27-A-17-0,7723-99-9398,SNGL FAM URB,0.541,AC,210000,0,210000,691100,1600,902700,180000,0,180000,646100,1400,827500,RPUD,RES/PUD,,,
17850,64-27-A-18-0,7733-09-1404,SNGL FAM URB,0.477,AC,210000,0,210000,750500,0,960500,180000,0,180000,703100,0,883100,RPUD,RES/PUD,,,
17851,64-27-A-19-0,7733-09-2444,SNGL FAM URB,0.357,AC,210000,0,210000,763100,0,973100,180000,0,180000,716900,0,896900,RPUD,RES/PUD,,,
17852,64-27-A-20-0,7733-09-3452,SNGL FAM URB,0.377,AC,210000,0,210000,802900,41200,1054100,180000,0,180000,744700,39100,963800,RPUD,RES/PUD,,,
17853,64-27-A-21-0,7733-09-4470,SNGL FAM URB,0.435,AC,210000,0,210000,711700,43300,965000,180000,0,180000,662600,40300,882900,RPUD,RES/PUD,,,
17854,64-27-B-1-0,7733-09-3031,SNGL FAM URB,0.382,AC,210000,0,210000,694600,0,904600,180000,0,180000,649200,0,829200,RPUD,RES/PUD,,,
17855,64-27-B-2-0,7733-09-2022,SNGL FAM URB,0.421,AC,210000,0,210000,759400,0,969400,180000,0,180000,709600,0,889600,RPUD,RES/PUD,,,
17856,64-27-B-3-0,7733-09-1141,SNGL FAM URB,0.414,AC,210000,0,210000,713100,35200,958300,180000,0,180000,611100,32500,823600,RPUD,RES/PUD,,,
17857,64-27-B-4-0,7733-09-1253,SNGL FAM URB,0.402,AC,210000,0,210000,558700,0,768700,180000,0,180000,526600,0,706600,RPUD,RES/PUD,,,
17858,64-27-B-5-0,7733-09-2255,SNGL FAM URB,0.376,AC,210000,0,210000,607100,0,817100,180000,0,180000,570300,0,750300,RPUD,RES/PUD,,,
17859,64-27-B-6-0,7733-09-3254,SNGL FAM URB,0.339,AC,210000,0,210000,594900,0,804900,180000,0,180000,557100,0,737100,RPUD,RES/PUD,,,
17860,64-27-B-7-0,7733-09-4251,SNGL FAM URB,0.355,AC,210000,0,210000,571700,0,781700,180000,0,180000,536700,0,716700,RPUD,RES/PUD,,,
17861,64-27-C-1-0,7733-08-6755,SNGL FAM URB,0.519,AC,210000,0,210000,826700,0,1036700,180000,0,180000,759100,0,939100,RPUD,RES/PUD,,,
17862,64-27-C-2-0,7733-08-6887,SNGL FAM URB,0.383,AC,210000,0,210000,658300,0,868300,180000,0,180000,615700,0,795700,RPUD,RES/PUD,,,
17863,64-27-C-3-0,7733-08-6989,SNGL FAM URB,0.385,AC,210000,0,210000,727300,0,937300,180000,0,180000,681900,0,861900,RPUD,RES/PUD,,,
17864,64-27-C-4-0,7733-09-6150,SNGL FAM URB,0.44,AC,210000,0,210000,677800,39200,927000,180000,0,180000,631600,36900,848500,RPUD,RES/PUD,,,
17865,64-27-R-1-0,7733-08-4693,Roads,4.161,AC,0,0,0,0,0,0,0,0,0,0,0,0,RPUD,RES/PUD,,,
17866,64-27-0-A-0,7733-08-6100,Cmn Area/Open Spc,0.16,AC,0,0,0,0,0,0,0,0,0,0,0,0,RPUD,RES/PUD,,,
17867,64-27-0-B-0,7733-08-3403,Cmn Area/Open Spc,8.915,AC,0,0,0,0,0,0,0,0,0,0,0,0,RPUD,RES/PUD,,,
17868,64-27-0-C-0,7733-08-1923,Cmn Area/Open Spc,0.022,AC,0,0,0,0,0,0,0,0,0,0,0,0,RPUD,RES/PUD,,,
17869,64-27-0-D-0,7733-08-5913,Cmn Area/Open Spc,0.502,AC,0,0,0,0,0,0,0,0,0,0,0,0,RPUD,RES/PUD,,,
17870,64-27-0-E-0,7733-08-7564,Cmn Area/Open Spc,4.974,AC,0,0,0,0,0,0,0,0,0,0,0,0,RPUD,RES/PUD,,,
17871,64-27-0-F-0,7733-09-3191,Cmn Area/Open Spc,0.666,AC,0,0,0,0,0,0,0,0,0,0,0,0,RPUD,RES/PUD,,,
17872,9-13-0-1-0,5892-54-0777,SNGL FAM SUB,4.221,AC,50400,0,50400,448200,1500,500100,49300,0,49300,399600,1500,450400,A1,AG/GEN,,,
17873,9-13-0-2-0,5892-55-0259,SNGL FAM SUB,4.313,AC,50700,0,50700,342800,5500,399000,49600,0,49600,285900,9200,344700,A1,AG/GEN,,,
17874,9-13-0-3-0,5892-55-7230,AG 20-100 AC,20.363,AC,88300,0,88300,175900,0,264200,86400,0,86400,160700,0,247100,A1,AG/GEN,,,
17875,9-13-0-4-0,5892-54-5677,SNGL FAM SUB,4.285,AC,50600,0,50600,388100,2300,441000,49500,0,49500,337700,2500,389700,A1,AG/GEN,,,
17876,9-13-0-5-0,5892-54-4414,SNGL FAM SUB,3.94,AC,49400,0,49400,256400,73900,379700,48300,0,48300,223400,64400,336100,A1,AG/GEN,,,
17878,46-1-0-36-G,7707-42-1655,SNGL FAM SUB,2.86,AC,140300,0,140300,339500,0,479800,125200,0,125200,293300,0,418500,A2RR,AG& RUR,,,
17879,30-1-0-100-G,6768-17-6800,SNGL FAM SUB,8,AC,132100,0,132100,473500,33700,639300,122700,0,122700,391100,33700,547500,A2,AG/LTD,,,
17881,13-1-0-52-E1,6841-17-5474,AG 20-100 AC,58.06,AC,264200,237400,26800,0,0,264200,259000,234300,24700,0,0,259000,A1,AG/GEN,,,
17882,46-4-0-4-A,7708-33-1417,AG 20-100 AC,21.95,AC,331400,321300,10100,0,0,331400,296300,287000,9300,0,0,296300,A2,AG/LTD,,,
17883,45-23-0-C-0,6797-28-5229,Cmn Area/Open Spc,1.919,AC,0,0,0,0,0,0,0,0,0,0,0,0,R1,RES/LTD,,,
17884,45-23-0-A-0,6797-08-7768,Cmn Area/Open Spc,3.599,AC,0,0,0,0,0,0,0,0,0,0,0,0,R1,RES/LTD,,,
17885,45-23-0-B-0,6797-09-9299,Cmn Area/Open Spc,3.581,AC,0,0,0,0,0,0,0,0,0,0,0,0,R1,RES/LTD,,,
17886,45-23-0-D-0,6797-27-5735,Cmn Area/Open Spc,2.594,AC,0,0,0,0,0,0,0,0,0,0,0,0,R1,RES/LTD,,,
17887,45-23-0-E-0,6797-17-5528,Cmn Area/Open Spc,1.504,AC,0,0,0,0,0,0,0,0,0,0,0,0,R1,RES/LTD,,,
17888,45-23-0-F-0,6797-17-8879,Cmn Area/Open Spc,4.621,AC,0,0,0,0,0,0,0,0,0,0,0,0,R1,RES/LTD,,,
17890,45-23-0-1-0,6797-19-2241,SNGL FAM SUB,1.587,AC,129000,0,129000,488400,0,617400,115000,0,115000,445900,0,560900,R1,RES/LTD,,,
17891,45-23-0-2-0,6797-19-4112,SNGL FAM SUB,1.501,AC,129000,0,129000,694600,75400,899000,115000,0,115000,636900,67400,819300,R1,RES/LTD,,,
17892,45-23-0-3-0,6797-19-6004,SNGL FAM SUB,1.505,AC,129000,0,129000,523100,0,652100,115000,0,115000,477500,0,592500,R1,RES/LTD,,,
17893,45-23-0-4-0,6797-18-7989,SNGL FAM SUB,1.517,AC,129000,0,129000,493700,2000,624700,115000,0,115000,452900,0,567900,R1,RES/LTD,,,
17894,45-23-0-5-0,6797-18-9974,SNGL FAM SUB,1.504,AC,129000,0,129000,441100,0,570100,115000,0,115000,404900,0,519900,R1,RES/LTD,,,
17895,45-23-0-6-0,6797-28-1970,SNGL FAM SUB,1.5,AC,129000,0,129000,422100,0,551100,115000,0,115000,384800,0,499800,R1,RES/LTD,,,
17896,45-23-0-7-0,6797-28-4930,SNGL FAM SUB,1.5,AC,129000,0,129000,432000,12900,573900,115000,0,115000,392200,0,507200,R1,RES/LTD,,,
17897,45-23-0-8-0,6797-28-5704,SNGL FAM SUB,1.5,AC,129000,0,129000,509800,0,638800,115000,0,115000,465700,0,580700,R1,RES/LTD,,,
17898,45-23-0-9-0,6797-28-4583,SNGL FAM SUB,1.504,AC,129000,0,129000,431600,1600,562200,115000,0,115000,394200,1700,510900,R1,RES/LTD,,,
17899,45-23-0-10-0,6797-28-5034,SNGL FAM SUB,1.501,AC,129000,0,129000,515100,4500,648600,115000,0,115000,468900,3200,587100,R1,RES/LTD,,,
17900,45-23-0-11-0,6797-27-5367,SNGL FAM SUB,1.532,AC,129000,0,129000,479700,40700,649400,115000,0,115000,439600,34800,589400,R1,RES/LTD,,,
17901,45-23-0-12-0,6797-27-3380,SNGL FAM SUB,1.5,AC,129000,0,129000,448900,12700,590600,115000,0,115000,406600,11000,532600,R1,RES/LTD,,,
17902,45-23-0-13-0,6797-27-1278,SNGL FAM SUB,1.5,AC,129000,0,129000,407100,76700,612800,115000,0,115000,372700,65400,553100,R1,RES/LTD,,,
17903,45-23-0-14-0,6797-17-8384,SNGL FAM SUB,1.5,AC,129000,0,129000,371700,0,500700,115000,0,115000,339800,0,454800,R1,RES/LTD,,,
17904,45-23-0-15-0,6797-17-7405,SNGL FAM SUB,1.504,AC,129000,0,129000,425600,2900,557500,115000,0,115000,401300,2100,518400,R1,RES/LTD,,,
17905,45-23-0-16-0,6797-17-3742,SNGL FAM SUB,1.506,AC,129000,0,129000,413400,1000,543400,115000,0,115000,362800,0,477800,R1,RES/LTD,,,
17906,45-23-0-17-0,6797-17-1875,SNGL FAM SUB,1.501,AC,129000,0,129000,464300,2100,595400,115000,0,115000,415800,0,530800,R1,RES/LTD,,,
17907,45-23-0-18-0,6797-17-0908,SNGL FAM SUB,1.581,AC,129000,0,129000,434900,0,563900,115000,0,115000,396400,0,511400,R1,RES/LTD,,,
17908,45-23-0-19-0,6797-08-9203,SNGL FAM SUB,1.503,AC,129000,0,129000,537200,0,666200,115000,0,115000,503500,0,618500,R1,RES/LTD,,,
17909,45-23-0-20-0,6797-08-8447,SNGL FAM SUB,1.5,AC,129000,0,129000,584200,1000,714200,115000,0,115000,538900,900,654800,R1,RES/LTD,,,
17910,45-23-0-21-0,6797-18-2836,SNGL FAM SUB,1.518,AC,129000,0,129000,646800,0,775800,115000,0,115000,585600,0,700600,R1,RES/LTD,,,
17911,45-23-0-22-0,6797-18-2617,SNGL FAM SUB,1.505,AC,129000,0,129000,516400,46800,692200,115000,0,115000,471600,40600,627200,R1,RES/LTD,,,
17912,45-23-0-23-0,6797-18-1497,SNGL FAM SUB,1.5,AC,129000,0,129000,489300,0,618300,115000,0,115000,446500,0,561500,R1,RES/LTD,,,
17913,45-23-0-24-0,6797-18-2242,SNGL FAM SUB,1.507,AC,129000,0,129000,437000,3100,569100,115000,0,115000,412600,3400,531000,R1,RES/LTD,,,
17914,45-23-0-25-0,6797-18-4111,SNGL FAM SUB,1.5,AC,129000,0,129000,401700,2500,533200,115000,0,115000,363800,0,478800,R1,RES/LTD,,,
17915,45-23-0-26-0,6797-17-8689,SNGL FAM SUB,1.502,AC,129000,0,129000,576600,0,705600,115000,0,115000,538700,0,653700,R1,RES/LTD,,,
17916,45-23-0-27-0,6797-27-1630,SNGL FAM SUB,1.514,AC,129000,0,129000,389000,0,518000,115000,0,115000,357100,0,472100,R1,RES/LTD,,,
17917,45-23-0-28-0,6797-27-2800,SNGL FAM SUB,1.5,AC,129000,0,129000,461400,0,590400,115000,0,115000,428100,0,543100,R1,RES/LTD,,,
17918,45-23-0-29-0,6797-28-2206,SNGL FAM SUB,1.506,AC,129000,0,129000,451200,0,580200,115000,0,115000,424900,0,539900,R1,RES/LTD,,,
17919,45-23-0-30-0,6797-28-1583,SNGL FAM SUB,1.505,AC,129000,0,129000,0,0,129000,115000,0,115000,0,0,115000,R1,RES/LTD,,,
17920,45-23-0-31-0,6797-18-8684,SNGL FAM SUB,1.506,AC,129000,0,129000,481200,0,610200,115000,0,115000,447500,0,562500,R1,RES/LTD,,,
17921,45-23-0-32-0,6797-18-9403,SNGL FAM SUB,1.5,AC,129000,0,129000,422900,0,551900,115000,0,115000,384600,0,499600,R1,RES/LTD,,,
17922,45-23-0-33-0,6797-28-0105,SNGL FAM SUB,1.5,AC,129000,0,129000,480400,0,609400,115000,0,115000,414700,0,529700,R1,RES/LTD,,,
17923,45-23-0-34-0,6797-18-7153,SNGL FAM SUB,1.501,AC,129000,0,129000,450000,0,579000,115000,0,115000,415900,0,530900,R1,RES/LTD,,,
17924,45-23-0-35-0,6797-18-5279,SNGL FAM SUB,1.502,AC,129000,0,129000,458800,2400,590200,115000,0,115000,437900,0,552900,R1,RES/LTD,,,
17925,45-23-0-36-0,6797-18-5530,SNGL FAM SUB,1.559,AC,129000,0,129000,598300,0,727300,115000,0,115000,542900,0,657900,R1,RES/LTD,,,
17926,45-23-0-37-0,6797-18-5732,SNGL FAM SUB,1.509,AC,129000,0,129000,444400,0,573400,115000,0,115000,404700,0,519700,R1,RES/LTD,,,
17927,10-1-0-11-B1,6801-34-9439,SNGL FAM SUB,5,AC,57200,0,57200,171300,0,228500,56000,0,56000,149900,0,205900,A1,AG/GEN,,,
17928,16-1-0-53-E,5890-96-1476,AG 20-100 AC,75,AC,153900,119300,34600,0,0,153900,150000,118100,31900,0,0,150000,A1,AG/GEN,,,
17929,29-1-0-35-A,6748-54-3477,SNGL FAM SUB,2.294,AC,66900,0,66900,0,0,66900,61300,0,61300,0,0,61300,A1,AG/GEN,,,
17930,29-1-0-35-B,6748-55-4059,SNGL FAM SUB,17.169,AC,189400,165700,23700,0,0,189400,184100,161100,23000,0,0,184100,A1,AG/GEN,,,
17931,28-1-0-46-C1,6738-63-2516,AG 20-100 AC,29.433,AC,172600,159000,13600,0,0,172600,167800,155300,12500,0,0,167800,A1,AG/GEN,,,
17932,28-1-0-46-C2,6738-53-0124,AG 20-100 AC,21.116,AC,159300,144400,14900,0,0,159300,154500,140800,13700,0,0,154500,A1,AG/GEN,,,
17933,56-1-0-35-A,6785-93-2634,SNGL FAM SUB,2,AC,85900,0,85900,0,0,85900,76700,0,76700,0,0,76700,A2,AG/LTD,,,
17934,44-6-0-1-B,6787-52-2636,SNGL FAM SUB,2,AC,85900,0,85900,529200,5500,620600,76700,0,76700,455300,3800,535800,A2,AG/LTD,,,
17935,31-1-0-39-A,6769-80-8292,SNGL FAM SUB,15,AC,215400,0,215400,226800,1000,443200,193700,0,193700,190400,1000,385100,A2,AG/LTD,,,
17936,29-1-0-83-B,6749-75-5232,SNGL FAM SUB,2.26,AC,66500,0,66500,164400,0,230900,62400,0,62400,136800,0,199200,A1,AG/GEN,,,
17937,5-28-0-1-0,6813-98-8101,SNGL FAM SUB,6.559,AC,68100,0,68100,761800,62500,892400,66800,0,66800,696900,58100,821800,A1,AG/GEN,,,
17938,5-28-0-2-0,6813-97-7717,SNGL FAM SUB,3.302,AC,51400,0,51400,553900,0,605300,50500,0,50500,498600,0,549100,A1,AG/GEN,,,
17939,5-28-0-3-0,6813-97-5598,SNGL FAM SUB,3.056,AC,50200,0,50200,525400,8800,584400,49300,0,49300,471100,7400,527800,A1,AG/GEN,,,
17940,58-37-4-2-0,7715-78-4690,SNGL FAM URB,0.512,AC,165500,0,165500,772600,0,938100,165500,0,165500,762700,0,928200,RPUD,RES/PUD,,,
17941,58-37-4-3-0,7715-78-5726,SNGL FAM URB,0.674,AC,165500,0,165500,943600,0,1109100,165500,0,165500,922200,0,1087700,RPUD,RES/PUD,,,
17942,58-37-4-4-0,7715-78-6769,SNGL FAM URB,0.567,AC,165500,0,165500,649700,0,815200,165500,0,165500,641700,0,807200,RPUD,RES/PUD,,,
17943,58-37-4-5-0,7715-78-8712,SNGL FAM URB,0.777,AC,165500,0,165500,758900,0,924400,165500,0,165500,756000,0,921500,RPUD,RES/PUD,,,
17944,58-37-4-6-0,7715-78-7568,SNGL FAM URB,0.576,AC,165500,0,165500,724800,0,890300,165500,0,165500,715800,0,881300,RPUD,RES/PUD,,,
17945,58-37-4-7-0,7715-78-6487,SNGL FAM URB,0.499,AC,165500,0,165500,761400,55400,982300,165500,0,165500,776300,50200,992000,RPUD,RES/PUD,,,
17946,58-37-4-9-0,7715-78-5265,SNGL FAM URB,0.502,AC,165500,0,165500,664400,0,829900,165500,0,165500,670100,0,835600,RPUD,RES/PUD,,,
17947,58-37-4-10-0,7715-78-5114,SNGL FAM URB,0.544,AC,165500,0,165500,648600,7800,821900,165500,0,165500,660800,7000,833300,RPUD,RES/PUD,,,
17948,58-37-4-11-0,7715-78-4073,SNGL FAM URB,0.54,AC,165500,0,165500,630900,0,796400,165500,0,165500,642800,0,808300,RPUD,RES/PUD,,,
17949,58-37-4-12-0,7715-77-4941,SNGL FAM URB,0.501,AC,165500,0,165500,670400,0,835900,165500,0,165500,682700,0,848200,RPUD,RES/PUD,,,
17950,58-37-4-13-0,7715-77-4718,SNGL FAM URB,0.531,AC,165500,0,165500,761000,0,926500,165500,0,165500,760200,0,925700,RPUD,RES/PUD,,,
17951,58-37-4-14-0,7715-77-3647,SNGL FAM URB,0.509,AC,165500,0,165500,718200,0,883700,165500,0,165500,721600,0,887100,RPUD,RES/PUD,,,
17952,58-37-4-15-0,7715-77-1496,SNGL FAM URB,0.516,AC,165500,0,165500,873300,66000,1104800,165500,0,165500,861600,61500,1088600,RPUD,RES/PUD,,,
17953,58-37-4-16-0,7715-77-2576,SNGL FAM URB,0.496,AC,165500,0,165500,888200,1500,1055200,165500,0,165500,895000,1900,1062400,RPUD,RES/PUD,,,
17954,58-37-4-17-0,7715-77-0644,SNGL FAM URB,0.698,AC,165500,0,165500,738800,8100,912400,165500,0,165500,741900,7300,914700,RPUD,RES/PUD,,,
17955,58-37-4-18-0,7715-67-8783,SNGL FAM URB,0.716,AC,165500,0,165500,636600,61200,863300,165500,0,165500,634100,34400,834000,RPUD,RES/PUD,,,
17956,58-37-4-19-0,7715-67-9807,SNGL FAM URB,0.605,AC,165500,0,165500,729600,0,895100,165500,0,165500,735700,0,901200,RPUD,RES/PUD,,,
17957,58-37-4-20-0,7715-77-0944,SNGL FAM URB,0.56,AC,165500,0,165500,619200,0,784700,165500,0,165500,629500,0,795000,RPUD,RES/PUD,,,
17958,58-37-4-21-0,7715-77-1872,SNGL FAM URB,0.635,AC,165500,0,165500,696000,0,861500,165500,0,165500,684300,0,849800,RPUD,RES/PUD,,,
17959,58-37-4-22-0,7715-77-2906,SNGL FAM URB,0.598,AC,165500,0,165500,757600,2600,925700,165500,0,165500,756800,2600,924900,RPUD,RES/PUD,,,
17960,58-37-4-23-0,7715-78-2018,SNGL FAM URB,0.717,AC,165500,0,165500,664700,5600,835800,165500,0,165500,676000,5100,846600,RPUD,RES/PUD,,,
17961,58-37-4-24-0,7715-78-2271,SNGL FAM URB,0.599,AC,165500,0,165500,670300,0,835800,165500,0,165500,686600,0,852100,RPUD,RES/PUD,,,
17962,58-37-4-25-0,7715-78-3333,SNGL FAM URB,0.561,AC,165500,0,165500,789600,1500,956600,165500,0,165500,774600,1900,942000,RPUD,RES/PUD,,,
17963,58-37-4-8-0,7715-78-6326,SNGL FAM URB,0.505,AC,165500,0,165500,646400,65200,877100,165500,0,165500,654600,59000,879100,RPUD,RES/PUD,,,
17964,58-37-4-1-0,7715-78-4429,SNGL FAM URB,0.565,AC,165500,0,165500,722800,1500,889800,165500,0,165500,692400,1900,859800,RPUD,RES/PUD,,,
17966,42-11-A-1-A,6757-49-0112-0001,Non-Profit,4.683,AC,201100,0,201100,425500,59800,686400,193400,0,193400,428400,41200,663000,A2,AG/LTD,,,
17967,33-1-0-21-0,6798-04-4235,COMM & IND,69.9,AC,1840200,1806800,33400,0,0,1840200,1733100,1703300,29800,0,0,1733100,B1A2,BS AND,,,
17968,33-1-0-22-0,6788-84-1495,AG 20-100 AC,24.92,AC,197100,185600,11500,0,0,197100,175700,165100,10600,0,0,175700,A2,AG/LTD,,,
17969,58-37-4-A-0,7715-78-0163,Cmn Area/Open Spc,0.422,AC,0,0,0,0,0,0,0,0,0,0,0,0,RPUD,RES/PUD,,,
17970,58-37-4-B-0,7715-78-6435,Cmn Area/Open Spc,3.159,AC,0,0,0,0,0,0,0,0,0,0,0,0,RPUD,RES/PUD,,,
17971,42-1-0-30-F,6766-17-4168,SNGL FAM SUB,3.04,AC,21500,0,21500,0,0,21500,19200,0,19200,0,0,19200,A2,AG/LTD,,,
17972,9-1-0-34-B,5892-54-1142,SNGL FAM SUB,3.105,AC,46400,0,46400,235800,0,282200,45400,0,45400,0,0,45400,A1,AG/GEN,,,
17973,44-1-0-68-A,6786-68-2096-0001,COMM & IND,14.08,AC,328000,0,328000,297100,21800,646900,312500,0,312500,318800,21100,652400,B1,BUS/GEN,,,
17974,27-13-0-8-0,6728-08-9587,AG 20-100 AC,42.378,AC,227800,208300,19500,0,0,227800,223800,205800,18000,0,0,223800,A1,AG/GEN,,,
17975,27-13-0-7-0,6728-17-2882,AG 20-100 AC,21.166,AC,153500,143700,9800,0,0,153500,150800,141800,9000,0,0,150800,A1,AG/GEN,,,
17976,27-13-0-6-0,6728-17-4444,AG 20-100 AC,20.272,AC,148500,139200,9300,0,0,148500,145800,137200,8600,0,0,145800,A1,AG/GEN,,,
17977,27-13-0-5-0,6728-26-6840,AG 20-100 AC,40.066,AC,219600,197000,22600,0,36000,255600,214900,193800,21100,0,32200,247100,A1,AG/GEN,,,
17978,27-13-0-4-0,6728-37-0534,SNGL FAM SUB,8.638,AC,90500,0,90500,210300,21300,322100,88800,0,88800,184900,18900,292600,A1,AG/GEN,,,
17979,27-13-0-3-0,6728-37-5642,SNGL FAM SUB,8.084,AC,87100,0,87100,0,0,87100,85500,0,85500,0,0,85500,A1,AG/GEN,,,
17980,27-13-0-2-0,6728-38-1102,SNGL FAM SUB,8,AC,86600,0,86600,216000,22600,325200,85000,0,85000,190300,19900,295200,A1,AG/GEN,,,
17981,27-13-0-1-0,6728-28-4179,SNGL FAM SUB,11.196,AC,106100,0,106100,0,0,106100,104200,0,104200,0,0,104200,A1,AG/GEN,,,
17982,26-1-0-28-E,6718-09-8698,SNGL FAM SUB,6.9,AC,77700,0,77700,294800,0,372500,76400,0,76400,254100,0,330500,A1,AG/GEN,,,
17983,26-1-0-28-F,6708-97-0992,AG 20-100 AC,45.75,AC,175700,116300,59400,377100,0,552800,172300,115300,57000,335400,0,507700,A1,AG/GEN,,,
17984,29-1-0-94-A,6759-05-3979,SNGL FAM SUB,2,AC,64000,0,64000,290400,0,354400,59800,0,59800,237900,0,297700,A1,AG/GEN,,,
17985,16-1-0-77-A,5890-80-0819,SNGL FAM SUB,3,AC,46000,0,46000,116000,2500,164500,45000,0,45000,102300,2600,149900,A1,AG/GEN,,,
17986,51-1-0-56-A,6735-88-1583,SNGL FAM SUB,5.25,AC,64700,62100,2600,0,0,64700,63500,61200,2300,0,0,63500,A1,AG/GEN,,,
17987,51-1-0-56-B,6735-88-5435,SNGL FAM SUB,5.25,AC,64700,62100,2600,0,0,64700,63500,61200,2300,0,0,63500,A1,AG/GEN,,,
17990,62-40-0-1-0,7704-84-6973,SNGL FAM URB,0.29,AC,126000,0,126000,344700,0,470700,115000,0,115000,325600,0,440600,RPUD,RES/PUD,,,
17991,62-40-0-2-0,7704-84-7954,SNGL FAM URB,0.31,AC,126000,0,126000,329800,0,455800,115000,0,115000,312500,0,427500,RPUD,RES/PUD,,,
17992,62-40-0-3-0,7704-84-8945,SNGL FAM URB,0.29,AC,126000,0,126000,382100,0,508100,115000,0,115000,360900,0,475900,RPUD,RES/PUD,,,
17993,62-40-0-4-0,7704-84-9927,SNGL FAM URB,0.31,AC,126000,0,126000,387600,0,513600,115000,0,115000,366500,0,481500,RPUD,RES/PUD,,,
17994,62-40-0-5-0,7704-85-8161,SNGL FAM URB,0.25,AC,126000,0,126000,430800,0,556800,115000,0,115000,419900,0,534900,RPUD,RES/PUD,,,
17995,62-40-0-6-0,7704-85-8159,SNGL FAM URB,0.25,AC,126000,0,126000,329200,0,455200,115000,0,115000,311500,0,426500,RPUD,RES/PUD,,,
17996,62-40-0-7-0,7704-85-8277,SNGL FAM URB,0.26,AC,126000,0,126000,369100,0,495100,115000,0,115000,350600,0,465600,RPUD,RES/PUD,,,
17997,62-40-0-8-0,7704-85-8397,SNGL FAM URB,0.3,AC,126000,0,126000,368200,0,494200,115000,0,115000,348000,0,463000,RPUD,RES/PUD,,,
17998,62-40-0-9-0,7704-95-0346,SNGL FAM URB,0.32,AC,126000,0,126000,383600,0,509600,115000,0,115000,362300,0,477300,RPUD,RES/PUD,,,
17999,62-40-0-10-0,7704-95-0266,SNGL FAM URB,0.23,AC,126000,0,126000,340800,4400,471200,115000,0,115000,322900,3600,441500,RPUD,RES/PUD,,,
18000,62-40-0-11-0,7704-95-0149,SNGL FAM URB,0.25,AC,126000,0,126000,425100,0,551100,115000,0,115000,407200,0,522200,RPUD,RES/PUD,,,
18001,62-40-0-12-0,7704-95-0141,SNGL FAM URB,0.23,AC,126000,0,126000,460000,0,586000,115000,0,115000,440300,0,555300,RPUD,RES/PUD,,,
18002,62-40-0-13-0,7704-95-0063,SNGL FAM URB,0.23,AC,126000,0,126000,437300,0,563300,115000,0,115000,428200,0,543200,RPUD,RES/PUD,,,
18003,62-40-0-14-0,7704-94-0985,SNGL FAM URB,0.24,AC,126000,0,126000,423700,0,549700,115000,0,115000,405900,0,520900,RPUD,RES/PUD,,,
18004,62-40-0-15-0,7704-94-2943,SNGL FAM URB,0.23,AC,126000,0,126000,379500,0,505500,115000,0,115000,358800,0,473800,RPUD,RES/PUD,,,
18005,62-40-0-16-0,7704-95-2031,SNGL FAM URB,0.25,AC,126000,0,126000,371400,0,497400,115000,0,115000,351300,0,466300,RPUD,RES/PUD,,,
18006,62-40-0-17-0,7704-95-2110,SNGL FAM URB,0.29,AC,126000,0,126000,421800,0,547800,115000,0,115000,395900,0,510900,RPUD,RES/PUD,,,
18007,62-40-0-18-0,7704-95-1199,SNGL FAM URB,0.26,AC,126000,0,126000,427900,0,553900,115000,0,115000,415400,0,530400,RPUD,RES/PUD,,,
18008,62-40-0-19-0,7704-95-2267,SNGL FAM URB,0.28,AC,126000,0,126000,413800,0,539800,115000,0,115000,394200,0,509200,RPUD,RES/PUD,,,
18009,62-40-0-20-0,7704-95-3276,SNGL FAM URB,0.3,AC,126000,0,126000,478300,0,604300,115000,0,115000,466700,0,581700,RPUD,RES/PUD,,,
18010,62-40-0-21-0,7704-95-4106,SNGL FAM URB,0.26,AC,126000,0,126000,367400,0,493400,115000,0,115000,346900,0,461900,RPUD,RES/PUD,,,
18011,62-40-0-22-0,7704-95-4008,SNGL FAM URB,0.24,AC,126000,0,126000,333300,0,459300,115000,0,115000,315000,0,430000,RPUD,RES/PUD,,,
18012,62-40-0-23-0,7704-95-4000,SNGL FAM URB,0.23,AC,126000,0,126000,365200,0,491200,115000,0,115000,338200,0,453200,RPUD,RES/PUD,,,
18013,62-40-0-24-0,7704-94-4902,SNGL FAM URB,0.23,AC,126000,0,126000,375500,0,501500,115000,0,115000,355500,0,470500,RPUD,RES/PUD,,,
18014,62-40-0-25-0,7704-94-3875,SNGL FAM URB,0.22,AC,126000,0,126000,336200,0,462200,115000,0,115000,317600,0,432600,RPUD,RES/PUD,,,
18015,62-40-0-26-0,7704-94-4789,SNGL FAM URB,0.22,AC,126000,0,126000,473400,0,599400,115000,0,115000,462800,0,577800,RPUD,RES/PUD,,,
18016,62-40-0-27-0,7704-94-5766,SNGL FAM URB,0.26,AC,126000,0,126000,380300,0,506300,115000,0,115000,359200,0,474200,RPUD,RES/PUD,,,
18017,62-40-0-28-0,7704-94-5696,SNGL FAM URB,0.29,AC,126000,0,126000,354500,0,480500,115000,0,115000,334500,0,449500,RPUD,RES/PUD,,,
18018,62-40-0-29-0,7704-94-5519,SNGL FAM URB,0.24,AC,126000,0,126000,378300,0,504300,115000,0,115000,357500,0,472500,RPUD,RES/PUD,,,
18019,62-40-0-30-0,7704-94-4529,SNGL FAM URB,0.21,AC,126000,0,126000,348600,0,474600,115000,0,115000,329700,0,444700,RPUD,RES/PUD,,,
18020,62-40-0-31-0,7704-94-3675,SNGL FAM URB,0.22,AC,126000,0,126000,344500,0,470500,115000,0,115000,325800,0,440800,RPUD,RES/PUD,,,
18021,62-40-0-32-0,7704-94-3720,SNGL FAM URB,0.21,AC,126000,0,126000,359500,0,485500,115000,0,115000,340100,0,455100,RPUD,RES/PUD,,,
18022,62-40-0-33-0,7704-94-2764,SNGL FAM URB,0.21,AC,126000,0,126000,386800,0,512800,115000,0,115000,366700,0,481700,RPUD,RES/PUD,,,
18023,62-40-0-34-0,7704-94-2708,SNGL FAM URB,0.24,AC,126000,0,126000,391600,0,517600,115000,0,115000,370200,0,485200,RPUD,RES/PUD,,,
18024,62-40-0-35-0,7704-94-1821,SNGL FAM URB,0.24,AC,126000,0,126000,351400,0,477400,115000,0,115000,332000,0,447000,RPUD,RES/PUD,,,
18025,62-40-0-36-0,7704-94-0841,SNGL FAM URB,0.23,AC,126000,0,126000,354200,0,480200,115000,0,115000,335000,0,450000,RPUD,RES/PUD,,,
18026,62-40-0-37-0,7704-84-9769,SNGL FAM URB,0.22,AC,126000,0,126000,340500,0,466500,115000,0,115000,312000,0,427000,RPUD,RES/PUD,,,
18027,62-40-0-38-0,7704-84-8788,SNGL FAM URB,0.26,AC,126000,0,126000,355200,0,481200,115000,0,115000,335500,0,450500,RPUD,RES/PUD,,,
18028,62-40-0-39-0,7704-84-9696,SNGL FAM URB,0.31,AC,126000,0,126000,340000,0,466000,115000,0,115000,323000,0,438000,RPUD,RES/PUD,,,
18029,62-40-0-40-0,7704-94-1606,SNGL FAM URB,0.27,AC,126000,0,126000,472800,0,598800,115000,0,115000,448300,0,563300,RPUD,RES/PUD,,,
18030,62-40-0-41-0,7704-94-1567,SNGL FAM URB,0.29,AC,126000,0,126000,376300,0,502300,115000,0,115000,344000,0,459000,RPUD,RES/PUD,,,
18031,62-40-0-42-0,7704-94-1427,SNGL FAM URB,0.28,AC,126000,0,126000,372700,0,498700,115000,0,115000,353200,0,468200,RPUD,RES/PUD,,,
18032,62-40-0-43-0,7704-94-0424,SNGL FAM URB,0.29,AC,126000,0,126000,383800,0,509800,115000,0,115000,362700,0,477700,RPUD,RES/PUD,,,
18033,62-40-0-44-0,7704-84-9459,SNGL FAM URB,0.23,AC,126000,0,126000,368200,0,494200,115000,0,115000,348000,0,463000,RPUD,RES/PUD,,,
18034,62-40-0-45-0,7704-84-8583,SNGL FAM URB,0.25,AC,126000,0,126000,353900,0,479900,115000,0,115000,334800,0,449800,RPUD,RES/PUD,,,
18035,62-40-0-46-0,7704-84-8518,SNGL FAM URB,0.3,AC,126000,0,126000,329800,0,455800,115000,0,115000,312400,0,427400,RPUD,RES/PUD,,,
18036,62-40-0-47-0,7704-84-7664,SNGL FAM URB,0.3,AC,126000,0,126000,321100,0,447100,115000,0,115000,304400,0,419400,RPUD,RES/PUD,,,
18037,62-40-0-48-0,7704-84-7744,SNGL FAM URB,0.31,AC,126000,0,126000,365100,0,491100,115000,0,115000,345100,0,460100,RPUD,RES/PUD,,,
18038,62-40-0-49-0,7704-84-6741,SNGL FAM URB,0.4,AC,126000,0,126000,339200,0,465200,115000,0,115000,301200,0,416200,RPUD,RES/PUD,,,
18039,62-40-0-50-0,7704-84-5774,SNGL FAM URB,0.24,AC,126000,0,126000,388100,0,514100,115000,0,115000,365700,0,480700,RPUD,RES/PUD,,,
18041,62-40-0-A-0,7704-94-1865,Cmn Area/Open Spc,20.25,AC,0,0,0,0,0,0,0,0,0,0,0,0,RPUD,RES/PUD,,,
18042,28-1-0-78-C,6739-25-9696,SNGL FAM SUB,4,AC,67500,0,67500,84800,1500,153800,68100,0,68100,70800,1500,140400,A1,AG/GEN,,,
18043,50-10-0-1-0,6726-15-3585,SNGL FAM SUB,2.182,AC,45400,0,45400,0,0,45400,44500,0,44500,0,0,44500,A1,AG/GEN,,,
18044,50-10-0-2-0,6726-15-3950,SNGL FAM SUB,2.386,AC,46600,0,46600,270300,0,316900,45600,0,45600,233800,0,279400,A1,AG/GEN,,,
18045,56-1-0-88-0,6795-93-7942,AG 20-100 AC,27.543,AC,691900,0,691900,131400,0,823300,602100,0,602100,130100,0,732200,RR,RES/RUR,,,
18047,19-1-0-62-D,6830-81-0959,SNGL FAM SUB,2,AC,63800,0,63800,74600,4500,142900,58200,0,58200,63200,4500,125900,A1,AG/GEN,,,
18049,16-1-0-39-F,5890-53-8772,SNGL FAM SUB,4,AC,49600,9300,40300,98100,3600,151300,47000,7700,39300,81300,3700,132000,A1,AG/GEN,,,
18050,20-1-0-68-C1,6840-86-2736,SNGL FAM SUB,6.459,AC,80400,0,80400,419800,4500,504700,79700,0,79700,375300,3800,458800,A1,AG/GEN,,,
18051,58-39-4-A-0,7715-67-7806,Cmn Area/Open Spc,0.183,AC,0,0,0,0,0,0,0,0,0,0,0,0,RPUD,RES/PUD,,,
18052,58-39-4-B-0,7715-67-4844,Cmn Area/Open Spc,0.279,AC,0,0,0,0,0,0,0,0,0,0,0,0,RPUD,RES/PUD,,,
18053,58-39-4-C-0,7715-77-1113,Cmn Area/Open Spc,0.581,AC,0,0,0,0,0,0,0,0,0,0,0,0,RPUD,RES/PUD,,,
18055,58-39-4-1-0,7715-67-7726,SNGL FAM URB,0.599,AC,165500,0,165500,642600,0,808100,165500,0,165500,633300,0,798800,RPUD,RES/PUD,,,
18056,58-39-4-2-0,7715-67-7650,SNGL FAM URB,0.586,AC,165500,0,165500,822100,0,987600,165500,0,165500,824300,0,989800,RPUD,RES/PUD,,,
18057,58-39-4-3-0,7715-67-7476,SNGL FAM URB,0.591,AC,165500,0,165500,857000,0,1022500,165500,0,165500,821100,0,986600,RPUD,RES/PUD,,,
18058,58-39-4-4-0,7715-67-9543,SNGL FAM URB,0.633,AC,165500,0,165500,937700,0,1103200,165500,0,165500,898500,0,1064000,RPUD,RES/PUD,,,
18059,58-39-4-5-0,7715-77-1313,SNGL FAM URB,0.613,AC,165500,0,165500,798900,0,964400,165500,0,165500,814800,0,980300,RPUD,RES/PUD,,,
18060,58-39-4-6-0,7715-77-0129,SNGL FAM URB,1.031,AC,173800,0,173800,811700,0,985500,173800,0,173800,802200,0,976000,RPUD,RES/PUD,,,
18062,58-39-4-7-0,7715-67-8167,SNGL FAM URB,1.526,AC,173800,0,173800,1073900,1500,1249200,173800,0,173800,1030400,2000,1206200,RPUD,RES/PUD,,,
18063,58-39-4-8-0,7715-67-6073,SNGL FAM URB,0.606,AC,165500,0,165500,833800,5100,1004400,165500,0,165500,841000,4500,1011000,RPUD,RES/PUD,,,
18064,58-39-4-9-0,7715-67-6107,SNGL FAM URB,0.543,AC,165500,0,165500,816900,0,982400,165500,0,165500,788900,0,954400,RPUD,RES/PUD,,,
18065,58-39-4-10-0,7715-67-5372,SNGL FAM URB,0.522,AC,165500,0,165500,851100,0,1016600,165500,0,165500,835200,0,1000700,RPUD,RES/PUD,,,
18066,58-39-4-11-0,7715-67-5445,SNGL FAM URB,0.535,AC,165500,0,165500,765800,7900,939200,165500,0,165500,769500,6900,941900,RPUD,RES/PUD,,,
18067,58-39-4-12-0,7715-67-5518,SNGL FAM URB,0.541,AC,165500,0,165500,890200,0,1055700,165500,0,165500,870400,0,1035900,RPUD,RES/PUD,,,
18068,58-39-4-13-0,7715-67-4752,SNGL FAM URB,0.788,AC,165500,0,165500,820800,0,986300,165500,0,165500,781600,0,947100,RPUD,RES/PUD,,,
18069,58-38-5-A-0,7715-69-6057,Cmn Area/Open Spc,0.899,AC,0,0,0,0,0,0,0,0,0,0,0,0,RPUD,RES/PUD,,,
18070,58-38-5-B-0,7715-67-4973,Cmn Area/Open Spc,2.969,AC,0,0,0,0,0,0,0,0,0,0,0,0,RPUD,RES/PUD,,,
18072,58-38-5-1-0,7715-68-8915,SNGL FAM URB,0.671,AC,133800,0,133800,562800,0,696600,131100,0,131100,579300,0,710400,RPUD,RES/PUD,,,
18073,58-38-5-2-0,7715-68-7903,SNGL FAM URB,0.588,AC,133800,0,133800,585300,0,719100,131100,0,131100,601200,0,732300,RPUD,RES/PUD,,,
18074,58-38-5-3-0,7715-68-5973,SNGL FAM URB,0.558,AC,133800,0,133800,561100,0,694900,131100,0,131100,570700,0,701800,RPUD,RES/PUD,,,
18075,58-38-5-4-0,7715-68-4943,SNGL FAM URB,0.696,AC,133800,0,133800,529800,0,663600,131100,0,131100,538100,0,669200,RPUD,RES/PUD,,,
18076,58-38-5-5-0,7715-68-3884,SNGL FAM URB,0.53,AC,133800,0,133800,696700,0,830500,131100,0,131100,707900,0,839000,RPUD,RES/PUD,,,
18077,58-38-5-6-0,7715-68-3724,SNGL FAM URB,0.342,AC,133800,0,133800,572600,0,706400,131100,0,131100,577600,0,708700,RPUD,RES/PUD,,,
18078,58-38-5-7-0,7715-68-2658,SNGL FAM URB,0.35,AC,133800,0,133800,563700,0,697500,131100,0,131100,580300,0,711400,RPUD,RES/PUD,,,
18079,58-38-5-8-0,7715-68-1681,SNGL FAM URB,0.38,AC,133800,0,133800,517900,0,651700,131100,0,131100,533000,0,664100,RPUD,RES/PUD,,,
18080,58-38-5-9-0,7715-68-1524,SNGL FAM URB,0.38,AC,133800,0,133800,533600,0,667400,131100,0,131100,543000,0,674100,RPUD,RES/PUD,,,
18081,58-38-5-10-0,7715-68-0467,SNGL FAM URB,0.379,AC,133800,0,133800,490400,0,624200,131100,0,131100,504300,0,635400,RPUD,RES/PUD,,,
18082,58-38-5-11-0,7715-58-9471,SNGL FAM URB,0.432,AC,133800,0,133800,484800,0,618600,131100,0,131100,498700,0,629800,RPUD,RES/PUD,,,
18083,58-38-5-12-0,7715-58-9207,SNGL FAM URB,0.796,AC,140400,0,140400,542500,0,682900,137700,0,137700,559500,0,697200,RPUD,RES/PUD,,,
18084,58-38-5-13-0,7715-58-9175,SNGL FAM URB,0.938,AC,140400,0,140400,618400,0,758800,137700,0,137700,628200,0,765900,RPUD,RES/PUD,,,
18085,58-38-5-14-0,7715-68-1261,SNGL FAM URB,0.529,AC,140400,0,140400,652800,0,793200,137700,0,137700,658500,0,796200,RPUD,RES/PUD,,,
18086,58-38-5-15-0,7715-68-2312,SNGL FAM URB,0.328,AC,133800,0,133800,529200,0,663000,131100,0,131100,543700,0,674800,RPUD,RES/PUD,,,
18087,58-38-5-16-0,7715-68-2379,SNGL FAM URB,0.322,AC,133800,0,133800,512400,8800,655000,131100,0,131100,513100,9300,653500,RPUD,RES/PUD,,,
18088,58-38-5-17-0,7715-68-3445,SNGL FAM URB,0.352,AC,133800,0,133800,704500,8800,847100,131100,0,131100,713200,9300,853600,RPUD,RES/PUD,,,
18089,58-38-5-18-0,7715-68-4512,SNGL FAM URB,0.384,AC,133800,0,133800,576900,0,710700,131100,0,131100,588000,0,719100,RPUD,RES/PUD,,,
18090,58-38-5-19-0,7715-68-4588,SNGL FAM URB,0.415,AC,133800,0,133800,536500,0,670300,131100,0,131100,533200,0,664300,RPUD,RES/PUD,,,
18091,58-38-5-20-0,7715-68-5628,SNGL FAM URB,0.412,AC,133800,0,133800,486600,0,620400,131100,0,131100,499700,0,630800,RPUD,RES/PUD,,,
18092,58-38-5-21-0,7715-68-6639,SNGL FAM URB,0.414,AC,133800,0,133800,430400,0,564200,131100,0,131100,443600,0,574700,RPUD,RES/PUD,,,
18093,58-38-5-22-0,7715-68-7617,SNGL FAM URB,0.342,AC,133800,0,133800,524400,0,658200,131100,0,131100,538700,0,669800,RPUD,RES/PUD,,,
18094,58-38-5-23-0,7715-68-8652,SNGL FAM URB,0.373,AC,133800,0,133800,587900,0,721700,131100,0,131100,598000,0,729100,RPUD,RES/PUD,,,
18100,58-38-5-29-0,7715-68-3289,SNGL FAM URB,0.402,AC,133800,0,133800,593700,0,727500,131100,0,131100,601600,0,732700,RPUD,RES/PUD,,,
18101,58-38-5-30-0,7715-68-2187,SNGL FAM URB,0.721,AC,140400,0,140400,635400,0,775800,137700,0,137700,639000,0,776700,RPUD,RES/PUD,,,
18102,58-38-5-31-0,7715-68-3015,SNGL FAM URB,0.639,AC,140400,0,140400,612000,0,752400,137700,0,137700,624200,0,761900,RPUD,RES/PUD,,,
18103,58-38-5-32-0,7715-68-5026,SNGL FAM URB,0.418,AC,133800,0,133800,707600,0,841400,131100,0,131100,688200,0,819300,RPUD,RES/PUD,,,
18104,58-38-5-33-0,7715-68-5193,SNGL FAM URB,0.386,AC,133800,0,133800,733500,0,867300,131100,0,131100,739000,0,870100,RPUD,RES/PUD,,,
18105,58-38-5-34-0,7715-68-6250,SNGL FAM URB,0.371,AC,133800,0,133800,526200,0,660000,131100,0,131100,542600,0,673700,RPUD,RES/PUD,,,
18106,58-38-5-35-0,7715-68-7254,SNGL FAM URB,0.359,AC,133800,0,133800,588700,0,722500,131100,0,131100,570200,0,701300,RPUD,RES/PUD,,,
18107,58-38-5-36-0,7715-68-8256,SNGL FAM URB,0.465,AC,133800,0,133800,530400,0,664200,131100,0,131100,542800,0,673900,RPUD,RES/PUD,,,
18108,58-38-5-37-0,7715-68-9350,SNGL FAM URB,0.605,AC,133800,0,133800,411200,0,545000,131100,0,131100,424200,0,555300,RPUD,RES/PUD,,,
18109,58-38-5-38-0,7715-78-0560,SNGL FAM URB,0.548,AC,133800,0,133800,589000,8700,731500,131100,0,131100,584300,9200,724600,RPUD,RES/PUD,,,
18110,58-38-5-39-0,7715-78-0319,SNGL FAM URB,0.52,AC,133800,0,133800,616200,0,750000,131100,0,131100,632500,0,763600,RPUD,RES/PUD,,,
18111,43-1-0-51-A1,6767-97-7059,SNGL FAM SUB,3.099,AC,140000,0,140000,383400,0,523400,125000,0,125000,350600,0,475600,A2,AG/LTD,,,
18112,19-1-0-9-A,6820-89-3323,AG 20-100 AC,20,AC,108700,0,108700,140300,5500,254500,107900,0,107900,108800,5500,222200,A1,AG/GEN,,,
18113,18-6-0-10-A,6820-18-8391,SNGL FAM SUB,2.18,AC,47100,0,47100,276400,0,323500,44500,0,44500,228400,0,272900,A1,AG/GEN,,,
18114,31-3-0-A-1,6778-39-9449,SNGL FAM SUB,9.327,AC,143000,0,143000,98000,8700,249700,127800,0,127800,80900,8700,217400,A2,AG/LTD,,,
18115,56-1-0-52-A,6796-26-9516,SNGL FAM SUB,3.07,AC,116900,0,116900,0,0,116900,104200,0,104200,0,0,104200,A2,AG/LTD,,,
18116,6-15-0-1-0,6823-99-4150,SNGL FAM SUB,2.979,AC,59000,0,59000,502000,16500,577500,57800,0,57800,425700,23000,506500,A1,AG/GEN,,,
18117,6-15-0-2-0,6823-98-6983,SNGL FAM SUB,3.004,AC,59200,0,59200,473200,0,532400,58000,0,58000,401600,0,459600,A1,AG/GEN,,,
18118,6-15-0-3-0,6833-09-0215,SNGL FAM SUB,2.187,AC,52900,0,52900,499200,0,552100,51800,0,51800,423700,0,475500,A1,AG/GEN,,,
18119,6-15-0-4-0,6823-99-8412,SNGL FAM SUB,2.212,AC,53100,0,53100,422700,0,475800,52000,0,52000,360700,0,412700,A1,AG/GEN,,,
18120,6-15-0-5-0,6833-08-2665,AG 20-100 AC,21.006,AC,119000,0,119000,376200,13800,509000,116600,0,116600,321400,11500,449500,A1,AG/GEN,,,
18122,18-4-0-2-B1,6729-18-9563,SNGL FAM SUB,3.43,AC,54500,0,54500,11800,3600,69900,52600,0,52600,13300,4100,70000,A1,AG/GEN,,,
18123,18-4-0-2-B2,6729-08-8549,SNGL FAM SUB,3,AC,52000,0,52000,0,0,52000,49000,0,49000,0,0,49000,A1,AG/GEN,,,
18124,16-1-0-12-A1,5890-68-0588,SNGL FAM SUB,6.38,AC,58200,53300,4900,0,1400,59600,56800,52200,4600,0,1400,58200,A1,AG/GEN,,,
18125,38-1-0-13-B,6707-89-9539,SNGL FAM SUB,2.338,AC,45600,0,45600,0,0,45600,44700,0,44700,0,0,44700,A1,AG/GEN,,,
18271,42-34-F-44-0,6758-40-2453,SNGL FAM SUB,1.5,AC,92000,0,92000,391000,0,483000,80000,0,80000,356900,0,436900,R1,RES/LTD,,,
18272,42-34-F-45-0,6758-40-2271,SNGL FAM SUB,1.5,AC,92000,0,92000,412500,0,504500,80000,0,80000,377300,0,457300,R1,RES/LTD,,,
18273,42-34-F-46-0,6758-40-5323,SNGL FAM SUB,1.517,AC,92000,0,92000,374000,0,466000,80000,0,80000,341600,0,421600,R1,RES/LTD,,,
18274,42-34-F-47-0,6758-40-6621,SNGL FAM SUB,2.591,AC,105800,0,105800,397300,0,503100,92000,0,92000,365300,0,457300,R1,RES/LTD,,,
18275,42-34-F-48-0,6758-40-9512,SNGL FAM SUB,2.527,AC,105800,0,105800,432300,4100,542200,92000,0,92000,395500,2900,490400,R1,RES/LTD,,,
18276,42-34-F-49-0,6758-40-8234,SNGL FAM SUB,1.839,AC,92000,0,92000,424500,65300,581800,80000,0,80000,387900,62500,530400,R1,RES/LTD,,,
18278,42-34-F-C-1,6758-30-6047,Cmn Area/Open Spc,3.849,AC,0,0,0,0,0,0,0,0,0,0,0,0,R1,RES/LTD,,,
18279,42-34-F-C-2,6758-40-8668,Cmn Area/Open Spc,0.427,AC,0,0,0,0,0,0,0,0,0,0,0,0,R1,RES/LTD,,,
18280,20-5-0-F-1A,6840-07-1081,SNGL FAM SUB,10,AC,111200,0,111200,388400,4000,503600,101200,0,101200,323600,2900,427700,RR,RES/RUR,,,
18281,33-1-0-3-B1,6788-95-2758,SNGL FAM SUB,2.287,AC,41000,0,41000,0,0,41000,36500,0,36500,0,0,36500,A2,AG/LTD,,,
18283,32-1-0-80-0,6788-62-9948,SNGL FAM SUB,17.429,AC,267200,258800,8400,0,0,267200,238400,231000,7400,0,0,238400,A2,AG/LTD,,,
18284,5-24-0-B-1,6822-69-3018,SNGL FAM SUB,0.23,AC,900,0,900,0,0,900,900,0,900,0,0,900,A1,AG/GEN,,,
18285,58-1-0-64-A,7716-63-9540,SNGL FAM SUB,0.094,AC,1900,0,1900,0,0,1900,1700,0,1700,0,0,1700,A2,AG/LTD,,,
18286,57-39-0-A-0,7706-70-7363,Cmn Area/Open Spc,62.76,AC,0,0,0,0,0,0,0,0,0,0,0,0,RP,"RURAL,P",,,
18288,57-39-0-1-0,7706-80-7905,SNGL FAM SUB,2.06,AC,241500,0,241500,727100,0,968600,220500,0,220500,664600,0,885100,RP,"RURAL,P",,,
18126,38-1-0-13-C,6707-99-1181,SNGL FAM SUB,2.13,AC,45100,0,45100,0,0,45100,44200,0,44200,0,0,44200,A1,AG/GEN,,,
18129,29-1-0-21-C,6748-34-7587,SNGL FAM SUB,3.156,AC,15100,13600,1500,0,0,15100,13900,12600,1300,0,0,13900,A1,AG/GEN,,,
18130,42-33-E-A-1,6758-40-2960,Cmn Area/Open Spc,11.323,AC,0,0,0,0,0,0,0,0,0,0,0,0,R1,RES/LTD,,,
18132,42-33-E-11-0,6758-61-2825,SNGL FAM SUB,2.418,AC,109200,0,109200,378400,0,487600,94500,0,94500,345600,0,440100,R1,RES/LTD,,,
18133,42-33-E-12-0,6758-61-1557,SNGL FAM SUB,2.228,AC,109200,0,109200,408100,32600,549900,94500,0,94500,372700,28100,495300,R1,RES/LTD,,,
18134,42-33-E-13-0,6758-51-9365,SNGL FAM SUB,2.204,AC,109200,0,109200,436000,0,545200,94500,0,94500,408900,0,503400,R1,RES/LTD,,,
18135,42-33-E-14-0,6758-51-7284,SNGL FAM SUB,2.228,AC,124800,0,124800,446000,0,570800,108000,0,108000,420500,0,528500,R1,RES/LTD,,,
18136,42-33-E-15-0,6758-51-5225,SNGL FAM SUB,2.018,AC,124800,0,124800,506500,0,631300,108000,0,108000,478400,0,586400,R1,RES/LTD,,,
18137,42-33-E-16-0,6758-51-2274,SNGL FAM SUB,2.513,AC,124800,0,124800,468000,36800,629600,108000,0,108000,438100,33100,579200,R1,RES/LTD,,,
18138,42-33-E-17-0,6758-41-9294,SNGL FAM SUB,2.779,AC,124800,0,124800,577000,0,701800,108000,0,108000,541200,0,649200,R1,RES/LTD,,,
18139,42-33-E-18-0,6758-41-3186,SNGL FAM SUB,4.207,AC,130000,0,130000,345900,0,475900,112500,0,112500,316900,0,429400,R1,RES/LTD,,,
18140,42-33-E-19-0,6758-41-3479,SNGL FAM SUB,5.45,AC,130000,0,130000,517500,1000,648500,112500,0,112500,468100,800,581400,R1,RES/LTD,,,
18141,42-33-E-20-0,6758-41-5717,SNGL FAM SUB,5.036,AC,130000,0,130000,480400,1200,611600,112500,0,112500,439300,1300,553100,R1,RES/LTD,,,
18142,42-33-E-21-0,6758-41-9741,SNGL FAM SUB,3.054,AC,124800,0,124800,404700,59100,588600,108000,0,108000,369100,54400,531500,R1,RES/LTD,,,
18143,42-33-E-22-0,6758-51-2790,SNGL FAM SUB,3.02,AC,124800,0,124800,327600,109200,561600,108000,0,108000,299500,96300,503800,R1,RES/LTD,,,
18144,42-33-E-23-0,6758-51-6695,SNGL FAM SUB,3.103,AC,124800,0,124800,347500,500,472800,108000,0,108000,318100,500,426600,R1,RES/LTD,,,
18145,42-33-E-24-0,6758-51-8915,SNGL FAM SUB,3.035,AC,124800,0,124800,391900,1200,517900,108000,0,108000,357800,1300,467100,R1,RES/LTD,,,
18146,42-33-E-25-0,6758-62-1296,SNGL FAM SUB,3.311,AC,124800,0,124800,403100,0,527900,108000,0,108000,367600,0,475600,R1,RES/LTD,,,
18147,42-33-E-26-0,6758-62-5240,SNGL FAM SUB,3.1,AC,124800,0,124800,390600,34100,549500,108000,0,108000,357500,32300,497800,R1,RES/LTD,,,
18149,11-1-0-58-0,6821-23-1638,General Gov,11.387,AC,102300,0,102300,0,203700,306000,99100,0,99100,0,155100,254200,A1,AG/GEN,,,
18151,48-2-C-12-0,7726-57-8698,SNGL FAM SUB,0.585,AC,130000,0,130000,380300,0,510300,117000,0,117000,367600,0,484600,R1,RES/LTD,,,
18152,48-2-C-11-0,7726-57-9778,SNGL FAM SUB,0.56,AC,130000,0,130000,449400,0,579400,117000,0,117000,437900,0,554900,R1,RES/LTD,,,
18153,4-1-0-67-D,6813-34-1063,SNGL FAM SUB,8.859,AC,43300,0,43300,351400,0,394700,42300,0,42300,313700,0,356000,A1,AG/GEN,,,
18154,4-1-0-67-E,6813-33-3455,AG 20-100 AC,45.688,AC,21700,0,21700,0,0,21700,19500,0,19500,0,0,19500,A1,AG/GEN,,,
18155,39-1-0-100-0,6726-78-5227,SNGL FAM SUB,2.858,AC,49200,0,49200,190300,1800,241300,48200,0,48200,162900,1900,213000,A1,AG/GEN,,,
18156,31-1-0-69-B1,6779-32-0316,SNGL FAM SUB,10,AC,172100,0,172100,0,0,172100,153500,0,153500,0,0,153500,A2,AG/LTD,,,
18157,48-2-A-4-A,7726-67-5736,SNGL FAM SUB,0.551,AC,130000,0,130000,292900,0,422900,117000,0,117000,280400,0,397400,R1,RES/LTD,,,
18158,20-25-0-5-0,6840-26-0088,AG 20-100 AC,21.069,AC,115000,0,115000,370100,0,485100,111000,0,111000,340900,0,451900,A1,AG/GEN,,,
18159,20-25-0-6-0,6840-15-8643,SNGL FAM SUB,10.392,AC,96100,0,96100,377300,3100,476500,92600,0,92600,340200,3500,436300,A1,AG/GEN,,,
18160,20-25-0-7-0,6840-15-5356,SNGL FAM SUB,8.757,AC,97400,0,97400,297400,1500,396300,93900,0,93900,265100,1600,360600,A1,AG/GEN,,,
18161,20-25-0-8-0,6840-14-3780,AG 20-100 AC,21.842,AC,117400,0,117400,280600,21400,419400,113300,0,113300,251400,19800,384500,A1,AG/GEN,,,
18162,20-25-0-9-0,6840-25-2056,SNGL FAM SUB,7.011,AC,80900,0,80900,413600,11100,505600,78000,0,78000,376700,7900,462600,A1,AG/GEN,,,
18163,26-18-0-1-0,6708-75-4995,AG 20-100 AC,93.5,AC,191700,148600,43100,0,0,191700,187000,147300,39700,0,0,187000,A1,AG/GEN,,,
18164,26-18-0-2-0,6718-05-5984,AG 20-100 AC,59.516,AC,214300,186900,27400,0,0,214300,208300,183000,25300,0,0,208300,A1,AG/GEN,,,
18165,26-18-0-3-0,6708-95-8058,AG 20-100 AC,39.017,AC,140500,122500,18000,0,0,140500,136600,120000,16600,0,0,136600,A1,AG/GEN,,,
18166,17-1-0-9-C,6800-45-4500,AG 20-100 AC,37.575,AC,71800,54200,17600,0,66100,137900,68800,52800,16000,0,56600,125400,A1,AG/GEN,,,
18167,58-40-0-1-0,7716-72-3552,SNGL FAM SUB,13.406,AC,398700,0,398700,870500,70800,1340000,346600,0,346600,758400,59300,1164300,A2,AG/LTD,,,
18168,58-40-0-2-0,7716-72-6718,SNGL FAM SUB,5.811,AC,308900,0,308900,1053600,2200,1364700,268600,0,268600,918000,2000,1188600,A2,AG/LTD,,,
18169,58-40-0-3-0,7716-72-9808,SNGL FAM SUB,5.327,AC,295500,0,295500,1042800,18200,1356500,256900,0,256900,897300,15500,1169700,A2,AG/LTD,,,
18170,58-40-0-4-0,7716-83-0158,SNGL FAM SUB,5.274,AC,294100,0,294100,0,0,294100,255700,0,255700,0,0,255700,A2,AG/LTD,,,
18171,39-1-0-25-A,6717-93-6774,SNGL FAM SUB,10.288,AC,90800,0,90800,0,0,90800,89100,0,89100,0,0,89100,A1,AG/GEN,,,
18175,60-1-0-5-A,6784-27-1581,SNGL FAM SUB,11.569,AC,293800,11700,282100,1529100,0,1822900,262100,4100,258000,1301200,0,1563300,A2,AG/LTD,,,
18177,32-1-0-33-E,6778-66-5747,SNGL FAM SUB,3,AC,89100,0,89100,386900,0,476000,79600,0,79600,317300,0,396900,A2,AG/LTD,,,
18179,5-29-0-1-0,6823-52-2191,AG 20-100 AC,31.346,AC,137700,0,137700,0,0,137700,135000,0,135000,0,0,135000,A1,AG/GEN,,,
18180,5-29-0-2-0,6823-53-2051,AG 20-100 AC,22.391,AC,148500,0,148500,0,0,148500,146800,0,146800,0,0,146800,A1,AG/GEN,,,
18181,5-29-0-3-0,6823-43-7725,AG 20-100 AC,41.654,AC,214100,0,214100,0,0,214100,209900,0,209900,0,0,209900,A1,AG/GEN,,,
18182,5-29-0-4-0,6823-44-2398,SNGL FAM SUB,10,AC,77700,0,77700,0,0,77700,76200,0,76200,0,0,76200,A1,AG/GEN,,,
18183,38-11-0-1-0,6717-38-2585,SNGL FAM SUB,4.16,AC,51800,0,51800,0,0,51800,50600,0,50600,0,0,50600,A1,AG/GEN,,,
18184,38-11-0-2-0,6717-38-4902,SNGL FAM SUB,3,AC,47000,0,47000,212700,1700,261400,46000,0,46000,181500,1900,229400,A1,AG/GEN,,,
18185,38-11-0-3-0,6717-39-7221,SNGL FAM SUB,7.01,AC,63400,0,63400,0,0,63400,62000,0,62000,0,0,62000,A1,AG/GEN,,,
18186,38-11-0-4-0,6717-38-8887,SNGL FAM SUB,4.05,AC,51300,0,51300,0,0,51300,50200,0,50200,0,0,50200,A1,AG/GEN,,,
18187,38-11-0-5-0,6717-38-8418,SNGL FAM SUB,4.22,AC,52000,0,52000,0,0,52000,50900,0,50900,0,0,50900,A1,AG/GEN,,,
18188,38-11-0-6-0,6717-38-6276,SNGL FAM SUB,3.83,AC,50400,0,50400,211500,0,261900,49300,0,49300,180400,0,229700,A1,AG/GEN,,,
18189,39-1-0-63-D,6726-08-7898,SNGL FAM SUB,3,AC,50000,0,50000,243100,0,293100,49000,0,49000,220700,0,269700,A1,AG/GEN,,,
18190,39-1-0-63-E,6726-08-9579,SNGL FAM SUB,2.784,AC,48800,0,48800,294600,0,343400,47800,0,47800,247600,0,295400,A1,AG/GEN,,,
18191,39-1-0-63-F,6726-18-4472,SNGL FAM SUB,2.706,AC,48400,0,48400,236800,0,285200,47400,0,47400,199900,0,247300,A1,AG/GEN,,,
18192,40-8-0-A-0,6736-08-3444,SNGL FAM SUB,3.405,AC,60800,0,60800,0,0,60800,59600,0,59600,0,0,59600,A1,AG/GEN,,,
18193,42-1-0-30-G,6766-08-0327,SNGL FAM SUB,3.832,AC,102100,0,102100,520100,50700,672900,91200,0,91200,422100,47600,560900,A2,AG/LTD,,,
18194,56-1-0-46-A,6796-61-1010,AG 20-100 AC,22.183,AC,632000,0,632000,0,136300,768300,549000,0,549000,0,113600,662600,A2,AG/LTD,,,
18195,56-1-0-89-0,6796-82-8203,SNGL FAM SUB,3.44,AC,137900,0,137900,0,0,137900,119800,0,119800,0,0,119800,A2,AG/LTD,,,
18196,12-1-0-58-A,6832-53-7820,AG 20-100 AC,42.32,AC,223000,203500,19500,0,0,223000,215200,197200,18000,0,0,215200,A1,AG/GEN,,,
18197,43-11-0-2-A,6767-78-1143,SNGL FAM SUB,2.768,AC,95600,0,95600,0,0,95600,85400,0,85400,0,0,85400,A2,AG/LTD,,,
18198,58-1-0-9-B,7716-46-3190,SNGL FAM SUB,3,AC,133000,0,133000,0,0,133000,118800,0,118800,0,0,118800,A2,AG/LTD,,,
18199,6-13-0-4-A1,6833-42-5570-00A1,COMM & IND,0,AC,13700,0,13700,107400,4800,125900,13300,0,13300,107400,4600,125300,M2,INDUS/G,,,
18200,6-13-0-4-A2,6833-42-5570-00A2,COMM & IND,0,AC,13700,0,13700,107400,4800,125900,13300,0,13300,107400,4600,125300,M2,INDUS/G,,,
18201,6-13-0-4-A3,6833-42-5570-00A3,COMM & IND,0,AC,13700,0,13700,107400,4800,125900,13300,0,13300,107400,4600,125300,M2,INDUS/G,,,
18202,6-13-0-4-A4,6833-42-5570-00A4,COMM & IND,0,AC,13700,0,13700,107400,4800,125900,13300,0,13300,107400,4600,125300,M2,INDUS/G,,,
18203,6-13-0-4-A5,6833-42-5570-00A5,COMM & IND,0,AC,13700,0,13700,107400,4800,125900,13300,0,13300,107400,4600,125300,M2,INDUS/G,,,
18204,6-13-0-4-A6,6833-42-5570-00A6,COMM & IND,0,AC,13700,0,13700,140700,4800,159200,13300,0,13300,140700,4600,158600,M2,INDUS/G,,,
18205,6-13-0-4-B1,6833-42-5570-00B1,COMM & IND,0,AC,13700,0,13700,134400,6100,154200,13300,0,13300,134400,5900,153600,M2,INDUS/G,,,
18206,6-13-0-4-B2,6833-42-5570-00B2,COMM & IND,0,AC,13700,0,13700,111300,6000,131000,13300,0,13300,111300,5800,130400,M2,INDUS/G,,,
18207,6-13-0-4-B3,6833-42-5570-00B3,COMM & IND,0,AC,13700,0,13700,111300,6000,131000,13300,0,13300,111300,5800,130400,M2,INDUS/G,,,
18208,6-13-0-4-B4,6833-42-5570-00B4,COMM & IND,0,AC,13700,0,13700,111300,6000,131000,13300,0,13300,111300,5800,130400,M2,INDUS/G,,,
18209,6-13-0-4-B5,6833-42-5570-00B5,COMM & IND,0,AC,13700,0,13700,111300,6000,131000,13300,0,13300,111300,5800,130400,M2,INDUS/G,,,
18210,6-13-0-4-C,6833-42-5570-000C,COMM & IND,0,AC,13700,0,13700,0,0,13700,13300,0,13300,0,0,13300,M2,INDUS/G,,,
18211,6-13-0-4-D,6833-42-5570-000D,COMM & IND,0,AC,13700,0,13700,129500,0,143200,13300,0,13300,129500,0,142800,M2,INDUS/G,,,
18212,6-13-0-4-E,6833-42-5570-000E,COMM & IND,0,AC,13700,0,13700,129500,0,143200,13300,0,13300,129500,0,142800,M2,INDUS/G,,,
18213,6-13-0-4-F,6833-42-5570-000F,COMM & IND,0,AC,13700,0,13700,0,0,13700,13300,0,13300,0,0,13300,M2,INDUS/G,,,
18214,63-1-0-202-0,7723-37-8368,SNGL FAM SUB,2.019,AC,192200,0,192200,0,0,192200,167100,0,167100,0,0,167100,A2,AG/LTD,,,
18215,38-12-0-1-0,6718-01-5261,SNGL FAM SUB,4.053,AC,57400,0,57400,287700,3000,348100,56300,0,56300,244400,3000,303700,A1,AG/GEN,,,
18216,38-12-0-2-0,6718-01-7168,SNGL FAM SUB,2.741,AC,45500,0,45500,294100,47700,387300,44600,0,44600,252600,40100,337300,A1,AG/GEN,,,
18217,38-12-0-3-0,6718-01-9146,SNGL FAM SUB,2.285,AC,42700,0,42700,0,0,42700,41900,0,41900,0,0,41900,A1,AG/GEN,,,
18218,38-12-0-4-0,6718-11-2114,SNGL FAM SUB,2.241,AC,42500,0,42500,0,0,42500,41600,0,41600,0,0,41600,A1,AG/GEN,,,
18219,38-12-0-5-0,6718-10-5845,AG 20-100 AC,20.342,AC,127800,0,127800,0,0,127800,125000,0,125000,0,0,125000,A1,AG/GEN,,,
18220,32-1-0-33-C1,6778-66-0072,SNGL FAM SUB,3,AC,92900,0,92900,366100,16400,475400,83000,0,83000,301600,12700,397300,A2,AG/LTD,,,
18221,48-1-0-7-B,7728-81-3505,SNGL FAM SUB,3.817,AC,172800,0,172800,469200,3400,645400,154300,0,154300,404900,3400,562600,A2,AG/LTD,,,
18222,21-14-0-1-0,6850-55-1259,SNGL FAM SUB,3.384,AC,70600,0,70600,439300,0,509900,74300,0,74300,381900,0,456200,A1,AG/GEN,,,
18223,21-14-0-2-0,6850-55-4361,SNGL FAM SUB,2.526,AC,63100,0,63100,271700,1900,336700,67000,0,67000,233900,2000,302900,A1,AG/GEN,,,
18224,21-14-0-3-0,6850-55-7362,SNGL FAM SUB,2.635,AC,64100,0,64100,267700,2500,334300,67900,0,67900,236300,2500,306700,A1,AG/GEN,,,
18225,58-1-0-31-A1,7715-33-4682,SNGL FAM SUB,4.969,AC,219500,0,219500,660400,90700,970600,191000,0,191000,563300,82000,836300,A2,AG/LTD,,,
18226,46-1-0-49-B,7706-39-5596,SNGL FAM SUB,2,AC,107900,0,107900,412400,3000,523300,96300,0,96300,359300,3000,458600,A2,AG/LTD,,,
18227,63-14-0-B-1A,7714-83-4881,Roads,0.575,AC,0,0,0,0,0,0,0,0,0,0,0,0,A2,AG/LTD,,,
18228,38-1-0-41-B,6707-53-7044,SNGL FAM SUB,3,AC,50000,0,50000,238800,0,288800,49000,0,49000,211600,0,260600,A1,AG/GEN,,,
18231,46-40-0-1-0,7708-60-0989,SNGL FAM SUB,3.967,AC,158100,0,158100,109900,13900,281900,145100,0,145100,91800,10700,247600,A2,AG/LTD,,,
18232,46-40-0-2-0,7708-61-4239,AG 20-100 AC,20.904,AC,363100,0,363100,934000,57400,1354500,330100,0,330100,744400,53700,1128200,A2,AG/LTD,,,
18233,46-40-0-3-0,7708-62-3270,SNGL FAM SUB,3.351,AC,170000,0,170000,447000,26800,643800,156000,0,156000,385300,22600,563900,A2,AG/LTD,,,
18234,34-3-0-4-0,7708-62-3551,SNGL FAM SUB,3,AC,170000,0,170000,653300,0,823300,156000,0,156000,544800,0,700800,A2,AG/LTD,,,
18235,34-3-0-5-0,7708-62-3943,SNGL FAM SUB,3.875,AC,170000,0,170000,485200,19400,674600,156000,0,156000,407900,18500,582400,A2,AG/LTD,,,
18236,38-13-0-1-0,6706-68-6638,AG 20-100 AC,20.755,AC,139600,130000,9600,0,0,139600,136800,128000,8800,0,0,136800,A1,AG/GEN,,,
18237,38-13-0-2-0,6706-67-1970,SNGL FAM SUB,14.108,AC,105700,0,105700,0,0,105700,103500,0,103500,0,0,103500,A1,AG/GEN,,,
18238,38-13-0-3-0,6706-67-3148,AG 20-100 AC,20.254,AC,137000,127700,9300,0,0,137000,134300,125700,8600,0,0,134300,A1,AG/GEN,,,
18239,38-13-0-4-0,6706-67-9497,SNGL FAM SUB,14.876,AC,109600,0,109600,0,0,109600,107400,0,107400,0,0,107400,A1,AG/GEN,,,
18240,38-13-0-5-0,6706-78-6304,SNGL FAM SUB,18.192,AC,126500,113000,13500,0,0,126500,124000,111600,12400,0,0,124000,A1,AG/GEN,,,
18241,38-13-0-6-0,6706-77-9821,SNGL FAM SUB,16.569,AC,118200,105500,12700,0,0,118200,115800,104200,11600,0,0,115800,A1,AG/GEN,,,
18242,48-16-0-24-0,7727-59-6438,COMM & IND,2.3,AC,355100,0,355100,0,4000,359100,338100,0,338100,0,4000,342100,M2,INDUS/G,,,
18243,48-16-0-25-0,7727-59-7701,COMM & IND,2.75,AC,424600,0,424600,518700,61600,1004900,404300,0,404300,487300,45100,936700,M2,INDUS/G,,,
18244,48-16-0-26-0,7727-59-7965,COMM & IND,2.75,AC,424600,0,424600,1380900,100800,1906300,404300,0,404300,1303500,70300,1778100,M2,INDUS/G,,,
18245,48-16-0-27-0,7728-50-8117,COMM & IND,2.56,AC,395300,0,395300,386200,46500,828000,376300,0,376300,359700,30400,766400,M2,INDUS/G,,,
18246,48-16-0-28-0,7727-59-2680,COMM & IND,1.13,AC,174500,0,174500,323900,41100,539500,166100,0,166100,302300,27400,495800,M2,INDUS/G,,,
18247,48-16-0-29-0,7728-50-1091,COMM & IND,8.13,AC,1093500,0,1093500,1645800,1200,2740500,1041500,0,1041500,1507000,900,2549400,M2,INDUS/G,,,
18248,48-16-0-R-1,7727-59-4855,Roads,1.32,AC,0,0,0,0,0,0,0,0,0,0,0,0,M2,INDUS/G,,,
18251,32-17-0-4-0,6788-69-9120,SNGL FAM SUB,4,AC,107300,0,107300,495600,0,602900,95900,0,95900,417500,0,513400,A2,AG/LTD,,,
18252,32-17-0-5-0,6788-69-5191,SNGL FAM SUB,4.48,AC,114200,0,114200,348800,0,463000,102100,0,102100,287300,0,389400,A2,AG/LTD,,,
18253,32-17-0-6-0,6788-69-3033,SNGL FAM SUB,4.04,AC,107900,0,107900,413500,7100,528500,96400,0,96400,376200,5400,478000,A2,AG/LTD,,,
18254,32-17-0-7-0,6788-68-0985,SNGL FAM SUB,4.05,AC,108000,0,108000,585900,0,693900,96500,0,96500,489700,0,586200,A2,AG/LTD,,,
18255,32-17-0-8-0,6788-58-5858,AG 20-100 AC,20.06,AC,281400,272200,9200,0,0,281400,251600,243100,8500,0,0,251600,A2,AG/LTD,,,
18257,46-41-0-2-0,7717-08-3048,SNGL FAM SUB,3,AC,145000,0,145000,120200,11800,277000,131800,0,131800,102300,11800,245900,RR,RES/RUR,,,
18258,46-41-0-3-0,7707-98-9097,SNGL FAM SUB,3.001,AC,139600,0,139600,665300,0,804900,126900,0,126900,549000,0,675900,RR,RES/RUR,,,
18259,46-41-0-4-0,7707-98-8473,SNGL FAM SUB,4.4,AC,185600,0,185600,740900,0,926500,168600,0,168600,629800,0,798400,RR,RES/RUR,,,
18260,46-41-0-5-0,7717-08-3670,SNGL FAM SUB,3,AC,145000,0,145000,0,0,145000,131800,0,131800,0,0,131800,RR,RES/RUR,,,
18261,46-41-0-6-0,7717-08-6595,SNGL FAM SUB,3,AC,130600,0,130600,0,0,130600,131800,0,131800,0,0,131800,RR,RES/RUR,,,
18262,46-41-0-7-0,7717-08-8792,SNGL FAM SUB,3,AC,145000,0,145000,638200,0,783200,131800,0,131800,550800,0,682600,RR,RES/RUR,,,
18263,46-41-0-R-1,7717-08-3278,Roads,1.703,AC,0,0,0,0,0,0,0,0,0,0,0,0,RR,RES/RUR,,,
18264,5-1-0-72-A,6823-59-8070,SNGL FAM SUB,8.98,AC,76400,0,76400,0,4900,81300,75000,0,75000,0,5400,80400,A1,AG/GEN,,,
18265,3-1-0-1-B,6804-30-1346,SNGL FAM SUB,7,AC,70300,0,70300,0,0,70300,69000,0,69000,0,0,69000,A1,AG/GEN,,,
18266,42-34-F-39-0,6757-49-0903,SNGL FAM SUB,2.582,AC,92000,0,92000,468700,0,560700,80000,0,80000,433700,0,513700,R1,RES/LTD,,,
18267,42-34-F-40-0,6758-30-8156,SNGL FAM SUB,1.967,AC,92000,0,92000,370900,0,462900,80000,0,80000,349700,0,429700,R1,RES/LTD,,,
18268,42-34-F-41-0,6758-30-7339,SNGL FAM SUB,3.355,AC,105800,0,105800,432300,27500,565600,92000,0,92000,402400,25700,520100,R1,RES/LTD,,,
18269,42-34-F-42-0,6758-30-8664,SNGL FAM SUB,2.877,AC,87400,0,87400,486200,0,573600,76000,0,76000,451300,0,527300,R1,RES/LTD,,,
18270,42-34-F-43-0,6758-40-2646,SNGL FAM SUB,1.879,AC,92000,0,92000,413800,0,505800,80000,0,80000,385300,0,465300,R1,RES/LTD,,,
18289,57-39-0-2-0,7706-81-7238,SNGL FAM SUB,2.01,AC,241500,0,241500,740800,52300,1034600,220500,0,220500,671000,49100,940600,RP,"RURAL,P",,,
18290,57-39-0-3-0,7706-81-4391,SNGL FAM SUB,2.35,AC,241500,0,241500,677100,29300,947900,220500,0,220500,560400,27000,807900,RP,"RURAL,P",,,
18291,57-39-0-4-0,7706-81-3119,SNGL FAM SUB,2.24,AC,241500,0,241500,610100,42300,893900,220500,0,220500,554800,4500,779800,RP,"RURAL,P",,,
18292,57-39-0-5-0,7706-80-2933,SNGL FAM SUB,2.21,AC,241500,0,241500,1545900,17800,1805200,220500,0,220500,1374900,17200,1612600,RP,"RURAL,P",,,
18293,57-39-0-6-0,7706-81-0278,SNGL FAM SUB,2.68,AC,241500,0,241500,713400,39900,994800,220500,0,220500,645500,37600,903600,RP,"RURAL,P",,,
18294,57-39-0-7-0,7706-71-8347,SNGL FAM SUB,2.14,AC,241500,0,241500,932900,0,1174400,220500,0,220500,831000,0,1051500,RP,"RURAL,P",,,
18295,57-39-0-8-0,7706-71-5377,SNGL FAM SUB,2.13,AC,241500,0,241500,665100,0,906600,220500,0,220500,599400,0,819900,RP,"RURAL,P",,,
18296,57-39-0-9-0,7706-71-3397,SNGL FAM SUB,2.28,AC,241500,0,241500,929800,0,1171300,220500,0,220500,877700,0,1098200,RP,"RURAL,P",,,
18297,57-39-0-10-0,7706-71-1451,SNGL FAM SUB,2.19,AC,241500,0,241500,697200,0,938700,220500,0,220500,0,0,220500,RP,"RURAL,P",,,
18298,57-39-0-11-0,7706-61-9345,SNGL FAM SUB,2.07,AC,241500,0,241500,949900,0,1191400,220500,0,220500,899300,0,1119800,RP,"RURAL,P",,,
18299,57-39-0-12-0,7706-61-8150,SNGL FAM SUB,2.45,AC,241500,0,241500,0,0,241500,220500,0,220500,0,0,220500,RP,"RURAL,P",,,
18300,57-39-0-13-0,7706-60-8883,SNGL FAM SUB,2.89,AC,241500,0,241500,0,0,241500,220500,0,220500,0,0,220500,RP,"RURAL,P",,,
18301,57-39-0-14-0,7706-70-1880,SNGL FAM SUB,2,AC,241500,0,241500,636000,0,877500,220500,0,220500,583700,0,804200,RP,"RURAL,P",,,
18302,57-39-0-15-0,7706-70-4802,SNGL FAM SUB,2.28,AC,241500,0,241500,734400,0,975900,220500,0,220500,661000,0,881500,RP,"RURAL,P",,,
18303,57-39-0-16-0,7706-70-6828,SNGL FAM SUB,3.01,AC,241500,0,241500,1383100,0,1624600,220500,0,220500,1339100,0,1559600,RP,"RURAL,P",,,
18445,4-1-0-54-A1,6803-81-2122,AG 20-100 AC,27.61,AC,176300,123300,53000,528900,5000,710200,171100,121800,49300,496700,5000,672800,A1,AG/GEN,,,
18446,66-2-0-B-1,7713-96-9397,SNGL FAM SUB,8.284,AC,607300,0,607300,0,0,607300,528200,0,528200,0,0,528200,A2,AG/LTD,,,
18447,12-2-0-3-E,6821-84-7172,SNGL FAM SUB,16.066,AC,125200,70400,54800,353200,0,478400,117800,64700,53100,292000,0,409800,A1,AG/GEN,,,
18448,1-8-0-1-0,6814-29-2615,SNGL FAM SUB,10,AC,89900,0,89900,356100,5500,451500,88300,0,88300,309200,3800,401300,A1,AG/GEN,,,
18449,1-8-0-2-0,6814-29-5343,SNGL FAM SUB,10,AC,89900,0,89900,302700,0,392600,88300,0,88300,270300,0,358600,A1,AG/GEN,,,
18450,1-8-0-3-0,6814-38-0956,AG 20-100 AC,20.05,AC,148600,0,148600,189700,5500,343800,145800,0,145800,166800,5500,318100,A1,AG/GEN,,,
18451,1-8-0-4-0,6814-38-5208,AG 20-100 AC,20,AC,133300,0,133300,334600,21000,488900,130800,0,130800,290700,20600,442100,A1,AG/GEN,,,
18452,1-8-0-5-0,6814-37-8527,SNGL FAM SUB,10.81,AC,89700,0,89700,210300,58800,358800,88100,0,88100,185300,50700,324100,A1,AG/GEN,,,
18453,1-8-0-6-0,6814-47-1997,SNGL FAM SUB,10,AC,89900,0,89900,269800,19700,379400,88300,0,88300,244100,18400,350800,A1,AG/GEN,,,
18454,1-8-0-7-0,6814-39-5952,AG 20-100 AC,43.18,AC,193800,157200,36600,0,0,193800,190000,155700,34300,0,0,190000,A1,AG/GEN,,,
18603,13-12-0-C-4,6841-99-0631,Cemetery,0,AC,100,0,100,0,0,100,100,0,100,0,0,100,RR,RES/RUR,,,
18604,17-1-0-103-B,6810-55-6557,SNGL FAM SUB,10,AC,85100,0,85100,0,0,85100,83000,0,83000,0,0,83000,A1,AG/GEN,,,
18605,17-1-0-103-A,6810-46-9193,SNGL FAM SUB,5.32,AC,65200,0,65200,0,0,65200,63900,0,63900,0,0,63900,A1,AG/GEN,,,
18606,27-14-0-1-0,6729-05-3969,SNGL FAM SUB,10.575,AC,91900,0,91900,0,0,91900,90700,0,90700,0,0,90700,A1,AG/GEN,,,
18607,27-14-0-2-0,6719-95-3484,SNGL FAM SUB,16.765,AC,118400,0,118400,0,0,118400,115700,0,115700,0,0,115700,A1,AG/GEN,,,
18608,27-14-0-3-0,6729-05-1214,SNGL FAM SUB,14.023,AC,109900,0,109900,0,0,109900,109600,0,109600,0,0,109600,A1,AG/GEN,,,
18609,27-14-0-4-0,6719-94-5690,AG 20-100 AC,30.693,AC,173000,158900,14100,0,0,173000,174700,161700,13000,0,0,174700,A1,AG/GEN,,,
18610,13-1-0-46-AT,6841-63-5038-9999,SNGL FAM SUB,10,AC,177200,0,177200,0,0,177200,176200,0,176200,0,0,176200,A1,AG/GEN,,,
18611,64-1-0-85-0,7724-54-2170,COMM & IND,4.032,AC,325200,0,325200,0,0,325200,323600,0,323600,0,0,323600,M1,INDUS/L,,,
18614,58-44-0-1-0,7716-46-0526,SNGL FAM SUB,2.191,AC,166800,0,166800,846400,3000,1016200,145000,0,145000,718900,3200,867100,A2,AG/LTD,,,
18615,58-44-0-2-0,7716-46-1215,SNGL FAM SUB,2.505,AC,166800,0,166800,0,0,166800,145000,0,145000,0,0,145000,A2,AG/LTD,,,
18616,58-44-0-3-0,7716-45-0848,SNGL FAM SUB,2.159,AC,166800,0,166800,586800,0,753600,145000,0,145000,503800,0,648800,A2,AG/LTD,,,
18617,58-44-0-4-0,7716-35-8388,SNGL FAM SUB,6.139,AC,191800,0,191800,1253700,57600,1503100,166800,0,166800,1089600,52300,1308700,A2,AG/LTD,,,
18618,58-44-0-5-0,7716-35-4493,SNGL FAM SUB,3.28,AC,175100,0,175100,705400,0,880500,152300,0,152300,604900,0,757200,A2,AG/LTD,,,
18619,58-44-0-6-0,7716-35-6920,SNGL FAM SUB,2.155,AC,166800,0,166800,903800,0,1070600,145000,0,145000,764800,0,909800,A2,AG/LTD,,,
18304,57-39-0-17-0,7706-70-8714,SNGL FAM SUB,3.24,AC,241500,0,241500,0,0,241500,220500,0,220500,0,0,220500,RP,"RURAL,P",,,
18305,57-39-0-18-0,7706-80-0632,SNGL FAM SUB,2.6,AC,241500,0,241500,0,0,241500,220500,0,220500,0,0,220500,RP,"RURAL,P",,,
18306,57-39-0-19-0,7706-80-3408,SNGL FAM SUB,2.66,AC,241500,0,241500,699500,0,941000,220500,0,220500,631600,0,852100,RP,"RURAL,P",,,
18307,57-39-0-20-0,7706-80-4497,SNGL FAM SUB,2.66,AC,241500,0,241500,684200,0,925700,220500,0,220500,618100,0,838600,RP,"RURAL,P",,,
18308,57-39-0-21-0,7706-80-7481,SNGL FAM SUB,3.1,AC,241500,0,241500,1027900,0,1269400,220500,0,220500,913200,0,1133700,RP,"RURAL,P",,,
18309,57-39-0-22-0,7706-80-9535,SNGL FAM SUB,4.09,AC,241500,0,241500,517600,94500,853600,220500,0,220500,497600,84100,802200,RP,"RURAL,P",,,
18310,5-25-0-4-A,6822-57-7390,SNGL FAM SUB,7.818,AC,79800,0,79800,491400,31800,603000,79800,0,79800,409000,27800,516600,RR,RES/RUR,,,
18311,9-1-0-34-A,5892-53-5673,SNGL FAM SUB,5.108,AC,53600,0,53600,215600,0,269200,52400,0,52400,191700,0,244100,A1,AG/GEN,,,
18312,9-1-0-34-A1,5892-53-5873,SNGL FAM SUB,3.396,AC,47400,0,47400,208300,3700,259400,46400,0,46400,178400,4000,228800,A1,AG/GEN,,,
18313,9-1-0-34-A1A,5892-53-4971,Cemetery,0,AC,100,0,100,0,0,100,100,0,100,0,0,100,A1,AG/GEN,,,
18314,26-1-0-67-A,6719-05-8599,SNGL FAM SUB,5.376,AC,65400,0,65400,0,0,65400,64300,0,64300,0,0,64300,A1,AG/GEN,,,
18315,29-1-0-30-A,6748-43-8020,SNGL FAM SUB,3.005,AC,73600,0,73600,0,0,73600,68700,0,68700,0,0,68700,A1,AG/GEN,,,
18316,43-36-0-R-0,6767-87-0598,Roads,0.143,AC,0,0,0,0,0,0,0,0,0,0,0,0,RR,RES/RUR,,,
18317,43-36-0-1-0,6767-87-3599,SNGL FAM SUB,5.973,AC,138600,0,138600,566000,0,704600,123800,0,123800,494800,0,618600,RR,RES/RUR,,,
18318,43-36-0-2-0,6767-87-8326,SNGL FAM SUB,6.112,AC,154000,0,154000,479100,2600,635700,137500,0,137500,437300,2900,577700,RR,RES/RUR,,,
18319,43-36-0-3-0,6767-97-2109,SNGL FAM SUB,6.11,AC,154000,0,154000,0,0,154000,137500,0,137500,0,0,137500,RR,RES/RUR,,,
18320,43-36-0-4-0,6767-96-5823,SNGL FAM SUB,6.122,AC,154000,0,154000,523600,0,677600,137500,0,137500,478500,0,616000,RR,RES/RUR,,,
18321,12-1-0-36-B,6831-23-2380,SNGL FAM SUB,8.809,AC,84400,0,84400,0,0,84400,80100,0,80100,0,0,80100,A1,AG/GEN,,,
18322,11-1-0-23-D,6821-06-8929,AG 20-100 AC,61.377,AC,208100,177800,30300,0,0,208100,208700,182400,26300,0,0,208700,A1,AG/GEN,,,
18323,31-1-0-84-A1,6778-55-7435,SNGL FAM SUB,3.439,AC,99200,0,99200,292100,6100,397400,88700,0,88700,250300,3500,342500,A2,AG/LTD,,,
18324,38-7-0-C-2A,6717-08-4674,SNGL FAM SUB,2.68,AC,48200,0,48200,0,0,48200,47200,0,47200,0,0,47200,A1,AG/GEN,,,
18325,58-41-6-1-0,7715-58-7323,SNGL FAM URB,0.369,AC,133800,0,133800,677000,0,810800,131100,0,131100,683400,0,814500,RPUD,RES/PUD,,,
18326,58-41-6-2-0,7715-58-7472,SNGL FAM URB,0.348,AC,133800,0,133800,637500,0,771300,131100,0,131100,649400,0,780500,RPUD,RES/PUD,,,
18327,58-41-6-3-0,7715-58-8448,SNGL FAM URB,0.34,AC,133800,0,133800,651000,0,784800,131100,0,131100,660100,0,791200,RPUD,RES/PUD,,,
18328,58-41-6-4-0,7715-58-9505,SNGL FAM URB,0.332,AC,133800,0,133800,568500,0,702300,131100,0,131100,566800,0,697900,RPUD,RES/PUD,,,
18329,58-41-6-5-0,7715-58-9663,SNGL FAM URB,0.346,AC,133800,0,133800,608700,0,742500,131100,0,131100,607400,0,738500,RPUD,RES/PUD,,,
18330,58-41-6-6-0,7715-68-0730,SNGL FAM URB,0.342,AC,133800,0,133800,520200,9400,663400,131100,0,131100,521700,9700,662500,RPUD,RES/PUD,,,
18331,58-41-6-7-0,7715-68-1705,SNGL FAM URB,0.313,AC,133800,0,133800,559000,0,692800,131100,0,131100,553600,0,684700,RPUD,RES/PUD,,,
18332,58-41-6-8-0,7715-68-1882,SNGL FAM URB,0.44,AC,133800,0,133800,569200,0,703000,131100,0,131100,559900,0,691000,RPUD,RES/PUD,,,
18333,58-41-6-9-0,7715-68-2906,SNGL FAM URB,0.651,AC,133800,0,133800,649600,0,783400,131100,0,131100,658300,0,789400,RPUD,RES/PUD,,,
18334,58-41-6-10-0,7715-68-1909,SNGL FAM URB,0.47,AC,133800,0,133800,621800,0,755600,131100,0,131100,610200,0,741300,RPUD,RES/PUD,,,
18335,58-41-6-11-0,7715-59-9042,SNGL FAM URB,0.466,AC,133800,0,133800,624200,0,758000,131100,0,131100,611300,0,742400,RPUD,RES/PUD,,,
18336,58-41-6-12-0,7715-58-9910,SNGL FAM URB,0.364,AC,133800,0,133800,551700,0,685500,131100,0,131100,562300,0,693400,RPUD,RES/PUD,,,
18337,58-41-6-13-0,7715-58-8861,SNGL FAM URB,0.328,AC,133800,0,133800,409600,0,543400,131100,0,131100,417300,0,548400,RPUD,RES/PUD,,,
18338,58-41-6-14-0,7715-58-8704,SNGL FAM URB,0.308,AC,133800,0,133800,520200,0,654000,131100,0,131100,521700,0,652800,RPUD,RES/PUD,,,
18339,58-41-6-15-0,7715-58-7637,SNGL FAM URB,0.34,AC,133800,0,133800,605100,0,738900,131100,0,131100,584200,0,715300,RPUD,RES/PUD,,,
18340,58-41-6-16-0,7715-58-6789,SNGL FAM URB,0.391,AC,133800,0,133800,550200,0,684000,131100,0,131100,547800,0,678900,RPUD,RES/PUD,,,
18341,58-41-6-17-0,7715-58-6869,SNGL FAM URB,0.425,AC,133800,0,133800,606100,0,739900,131100,0,131100,596100,0,727200,RPUD,RES/PUD,,,
18342,58-41-6-18-0,7715-58-6979,SNGL FAM URB,0.384,AC,120400,0,120400,561900,0,682300,118000,0,118000,554600,0,672600,RPUD,RES/PUD,,,
18343,58-41-6-19-0,7715-59-6172,SNGL FAM URB,0.444,AC,133800,0,133800,636800,0,770600,131100,0,131100,608600,0,739700,RPUD,RES/PUD,,,
18344,58-41-6-20-0,7715-59-5156,SNGL FAM URB,0.502,AC,133800,0,133800,663500,0,797300,131100,0,131100,649700,0,780800,RPUD,RES/PUD,,,
18345,58-41-6-21-0,7715-59-4147,SNGL FAM URB,0.621,AC,140400,0,140400,469600,0,610000,137700,0,137700,473600,0,611300,RPUD,RES/PUD,,,
18346,58-41-6-22-0,7715-59-4042,SNGL FAM URB,0.339,AC,133800,0,133800,630700,0,764500,131100,0,131100,640600,0,771700,RPUD,RES/PUD,,,
18347,58-41-6-23-0,7715-58-4941,SNGL FAM URB,0.305,AC,133800,0,133800,593100,0,726900,131100,0,131100,596100,0,727200,RPUD,RES/PUD,,,
18348,58-41-6-24-0,7715-58-4861,SNGL FAM URB,0.325,AC,133800,0,133800,646100,0,779900,131100,0,131100,655500,0,786600,RPUD,RES/PUD,,,
18349,58-41-6-25-0,7715-58-4781,SNGL FAM URB,0.4,AC,133800,0,133800,704400,0,838200,131100,0,131100,711600,0,842700,RPUD,RES/PUD,,,
18350,58-41-6-26-0,7715-58-5622,SNGL FAM URB,0.43,AC,133800,0,133800,570300,0,704100,131100,0,131100,577800,0,708900,RPUD,RES/PUD,,,
18351,58-41-6-27-0,7715-58-6537,SNGL FAM URB,0.323,AC,133800,0,133800,573600,0,707400,131100,0,131100,572800,0,703900,RPUD,RES/PUD,,,
18352,58-41-6-28-0,7715-58-5469,SNGL FAM URB,0.423,AC,133800,0,133800,587000,0,720800,131100,0,131100,591400,0,722500,RPUD,RES/PUD,,,
18353,58-41-6-29-0,7715-58-3532,SNGL FAM URB,0.339,AC,133800,0,133800,657800,0,791600,131100,0,131100,642100,0,773200,RPUD,RES/PUD,,,
18354,58-41-6-30-0,7715-58-2535,SNGL FAM URB,0.345,AC,133800,0,133800,718600,0,852400,131100,0,131100,699900,0,831000,RPUD,RES/PUD,,,
18355,58-41-6-31-0,7715-58-2629,SNGL FAM URB,0.487,AC,133800,0,133800,654600,0,788400,131100,0,131100,635300,0,766400,RPUD,RES/PUD,,,
18356,58-41-6-32-0,7715-59-1146,SNGL FAM URB,0.879,AC,140400,0,140400,639800,0,780200,137700,0,137700,649500,0,787200,RPUD,RES/PUD,,,
18357,58-41-6-33-0,7715-59-0077,SNGL FAM URB,0.529,AC,133800,0,133800,580700,9600,724100,131100,0,131100,543400,9800,684300,RPUD,RES/PUD,,,
18358,58-41-6-34-0,7715-58-0962,SNGL FAM URB,0.332,AC,133800,0,133800,520700,0,654500,131100,0,131100,512800,0,643900,RPUD,RES/PUD,,,
18359,58-41-6-35-0,7715-58-0843,SNGL FAM URB,0.343,AC,133800,0,133800,658100,0,791900,131100,0,131100,629600,0,760700,RPUD,RES/PUD,,,
18360,58-41-6-36-0,7715-58-0723,SNGL FAM URB,0.363,AC,133800,0,133800,630700,0,764500,131100,0,131100,612500,0,743600,RPUD,RES/PUD,,,
18361,58-41-6-37-0,7715-58-0603,SNGL FAM URB,0.436,AC,133800,0,133800,550200,0,684000,131100,0,131100,547800,0,678900,RPUD,RES/PUD,,,
18362,58-41-6-38-0,7715-58-0572,SNGL FAM URB,0.376,AC,133800,0,133800,616700,0,750500,131100,0,131100,602600,0,733700,RPUD,RES/PUD,,,
18363,58-41-6-39-0,7715-48-9489,SNGL FAM URB,0.497,AC,133800,0,133800,734700,0,868500,131100,0,131100,727400,0,858500,RPUD,RES/PUD,,,
18364,58-41-6-40-0,7715-48-9366,SNGL FAM URB,0.524,AC,133800,0,133800,667900,0,801700,131100,0,131100,655400,0,786500,RPUD,RES/PUD,,,
18365,58-41-6-41-0,7715-48-9297,SNGL FAM URB,0.395,AC,133800,0,133800,671500,0,805300,131100,0,131100,640400,0,771500,RPUD,RES/PUD,,,
18366,58-41-6-42-0,7715-58-1253,SNGL FAM URB,0.5,AC,133800,0,133800,925000,10000,1068800,131100,0,131100,901100,10000,1042200,RPUD,RES/PUD,,,
18367,58-41-6-43-0,7715-58-2235,SNGL FAM URB,0.523,AC,133800,0,133800,687900,9100,830800,131100,0,131100,689600,9500,830200,RPUD,RES/PUD,,,
18368,58-41-6-44-0,7715-58-2347,SNGL FAM URB,0.362,AC,133800,0,133800,656800,0,790600,131100,0,131100,640200,0,771300,RPUD,RES/PUD,,,
18369,58-41-6-45-0,7715-58-3372,SNGL FAM URB,0.392,AC,133800,0,133800,595600,30700,760100,131100,0,131100,612600,28100,771800,RPUD,RES/PUD,,,
18370,58-41-6-46-0,7715-58-5321,SNGL FAM URB,0.393,AC,133800,0,133800,675500,0,809300,131100,0,131100,687200,0,818300,RPUD,RES/PUD,,,
18373,58-41-6-A-0,7715-59-5295,Cmn Area/Open Spc,7.141,AC,0,0,0,0,0,0,0,0,0,0,0,0,RPUD,RES/PUD,,,
18374,58-41-6-B-0,7715-58-4341,Cmn Area/Open Spc,0.148,AC,0,0,0,0,0,0,0,0,0,0,0,0,RPUD,RES/PUD,,,
18375,58-41-6-C-0,7715-58-5085,Cmn Area/Open Spc,0.037,AC,0,0,0,0,0,0,0,0,0,0,0,0,RPUD,RES/PUD,,,
18377,58-41-6-D-0,7715-59-8008,Cemetery,0.442,AC,100,0,100,0,0,100,100,0,100,0,0,100,RPUD,RES/PUD,,,
18378,20-6-0-6-A,6840-80-8938,SNGL FAM SUB,2.838,AC,71700,0,71700,413600,7900,493200,69000,0,69000,347200,7200,423400,A1,AG/GEN,,,
18379,20-6-0-6-B,6840-81-8255,SNGL FAM SUB,2.525,AC,68800,0,68800,473900,0,542700,65800,0,65800,411300,0,477100,A1,AG/GEN,,,
18380,39-1-0-39-A1,6717-93-6015,SNGL FAM SUB,2.13,AC,45100,0,45100,173100,0,218200,44200,0,44200,147000,0,191200,A1,AG/GEN,,,
18381,39-1-0-42-B,6727-02-6402,SNGL FAM SUB,2.055,AC,44700,0,44700,200700,0,245400,43800,0,43800,169700,0,213500,A1,AG/GEN,,,
18382,41-1-0-17-0,6748-20-7990,SNGL FAM SUB,0.375,AC,3100,0,3100,0,0,3100,3700,0,3700,0,0,3700,A1,AG/GEN,,,
18383,47-12-0-2-B1,7717-35-0808,SNGL FAM SUB,14.09,AC,391100,233600,157500,408800,0,799900,349200,208700,140500,367300,0,716500,A2,AG/LTD,,,
18384,51-1-0-8-C,6726-90-6960,SNGL FAM SUB,7,AC,72400,0,72400,199000,0,271400,71000,0,71000,173900,0,244900,A1,AG/GEN,,,
18385,51-1-0-8-D,6736-00-1781,SNGL FAM SUB,9.284,AC,85200,0,85200,0,0,85200,83600,0,83600,0,0,83600,A1,AG/GEN,,,
18386,53-1-0-3-C,6766-36-8266,SNGL FAM SUB,3,AC,95100,0,95100,266500,500,362100,85000,0,85000,227300,500,312800,A2,AG/LTD,,,
18388,58-1-0-60-A,7716-50-4311,SNGL FAM SUB,3,AC,317000,0,317000,0,0,317000,275600,0,275600,0,0,275600,A2,AG/LTD,,,
18389,58-1-0-60-B,7715-59-3960,SNGL FAM SUB,3,AC,317000,0,317000,879000,31200,1227200,275600,0,275600,786300,29200,1091100,A2,AG/LTD,,,
18390,58-1-0-60-C,7715-59-2670,SNGL FAM SUB,3,AC,317000,0,317000,873900,66200,1257100,275600,0,275600,770900,59800,1106300,A2,AG/LTD,,,
18391,5-5-0-B-1,6823-47-1000,SNGL FAM SUB,4.76,AC,58900,0,58900,281900,0,340800,57800,0,57800,254700,0,312500,A1,AG/GEN,,,
18392,17-1-0-41-A,6811-10-8207,SNGL FAM SUB,2.024,AC,46200,0,46200,335800,0,382000,43100,0,43100,291500,0,334600,A1,AG/GEN,,,
18393,15-1-0-40-A,5789-39-7275,SNGL FAM SUB,3,AC,46000,0,46000,215100,1000,262100,45000,0,45000,178100,1000,224100,A1,AG/GEN,,,
18394,15-1-0-40-B,5789-49-1095,SNGL FAM SUB,5.069,AC,53400,0,53400,0,0,53400,52200,0,52200,0,0,52200,A1,AG/GEN,,,
18395,38-1-0-54-A,6706-69-6795,SNGL FAM SUB,10,AC,89200,0,89200,362900,35100,487200,87500,0,87500,319500,28800,435800,A1,AG/GEN,,,
18396,30-23-G-A-0,6758-42-4797,Cmn Area/Open Spc,4.438,AC,0,0,0,0,0,0,0,0,0,0,0,0,R1,RES/LTD,,,
18398,30-23-G-27-0,6758-52-5026,SNGL FAM SUB,3.039,AC,124800,0,124800,419000,0,543800,108000,0,108000,382800,0,490800,R1,RES/LTD,,,
18399,30-23-G-28-0,6758-52-1151,SNGL FAM SUB,3.071,AC,124800,0,124800,408200,0,533000,108000,0,108000,374700,0,482700,R1,RES/LTD,,,
18400,30-23-G-29-0,6758-42-5096,SNGL FAM SUB,4.637,AC,130000,0,130000,521700,44700,696400,112500,0,112500,444400,42300,599200,R1,RES/LTD,,,
18401,30-23-G-30-0,6758-42-6305,SNGL FAM SUB,4.933,AC,130000,0,130000,530300,0,660300,112500,0,112500,497200,0,609700,R1,RES/LTD,,,
18402,30-23-G-31-0,6758-42-7631,SNGL FAM SUB,3.866,AC,130000,0,130000,463200,0,593200,112500,0,112500,433500,0,546000,R1,RES/LTD,,,
18403,30-23-G-32-0,6758-52-1595,SNGL FAM SUB,3.486,AC,124800,0,124800,355600,3200,483600,108000,0,108000,326000,2300,436300,R1,RES/LTD,,,
18404,30-23-G-33-0,6758-52-5457,SNGL FAM SUB,3.06,AC,124800,0,124800,428400,0,553200,108000,0,108000,391900,0,499900,R1,RES/LTD,,,
18405,30-23-G-34-0,6758-52-8376,SNGL FAM SUB,3.112,AC,124800,0,124800,514400,61100,700300,108000,0,108000,486100,57300,651400,R1,RES/LTD,,,
18406,20-1-0-98-0,6841-00-1280,SNGL FAM SUB,5,AC,83800,0,83800,447800,46300,577900,77900,0,77900,371100,39600,488600,RR,RES/RUR,,,
18407,57-1-0-36-B,7705-79-5848,Cemetery,0,AC,100,0,100,0,0,100,100,0,100,0,0,100,A2,AG/LTD,,,
18408,47-2-0-C-2,7717-87-7707,SNGL FAM SUB,17.245,AC,375200,0,375200,0,0,375200,335300,0,335300,0,0,335300,A2,AG/LTD,,,
18409,44-1-0-11-A,6777-72-8584,AG 20-100 AC,23.598,AC,295000,283000,12000,0,185600,480600,264300,254200,10100,0,160700,425000,A2,AG/LTD,,,
18410,43-1-0-75-B,6777-12-6796,AG 20-100 AC,70.566,AC,677100,644100,33000,0,0,677100,603300,573300,30000,0,0,603300,A2,AG/LTD,,,
18411,38-1-0-99-B,6707-87-9507,AG 20-100 AC,20,AC,126200,0,126200,402600,0,528800,123500,0,123500,352800,0,476300,A1,AG/GEN,,,
18413,38-1-0-99-D,6707-87-5762,Cemetery,0,AC,100,0,100,0,0,100,100,0,100,0,0,100,A1,AG/GEN,,,
18414,16-8-0-1-0,5799-59-7257,SNGL FAM SUB,8.241,AC,48700,0,48700,0,0,48700,47500,0,47500,0,0,47500,A1,AG/GEN,,,
18415,16-8-0-2-0,5890-40-0048,AG 20-100 AC,39.017,AC,114200,0,114200,0,0,114200,114000,0,114000,0,0,114000,A1,AG/GEN,,,
18416,16-8-0-3-0,5890-40-9286,SNGL FAM SUB,10.152,AC,68200,0,68200,303000,0,371200,70000,0,70000,276300,0,346300,A1,AG/GEN,,,
18417,16-8-0-4-0,5890-50-7508,AG 20-100 AC,20.66,AC,89100,0,89100,0,0,89100,99900,0,99900,0,0,99900,A1,AG/GEN,,,
18418,16-8-0-5-0,5799-59-9823,SNGL FAM SUB,9.503,,67800,0,67800,286400,0,354200,67800,0,67800,250000,0,317800,A1,AG/GEN,,,
18419,38-1-0-99-E,6707-76-8815,SNGL FAM SUB,10,AC,84200,0,84200,276300,0,360500,82600,0,82600,233500,0,316100,A1,AG/GEN,,,
18420,47-33-0-19-0,7727-47-4935,COMM & IND,3.273,AC,505400,0,505400,0,0,505400,481100,0,481100,0,0,481100,M2,INDUS/G,,,
18421,48-15-0-20-0,7727-58-4704,COMM & IND,2.059,AC,372100,0,372100,194800,21400,588300,354400,0,354400,179300,14900,548600,M2,INDUS/G,,,
18422,48-1-0-75-0,7738-02-7371,SNGL FAM SUB,1.91,AC,126800,0,126800,0,0,126800,113200,0,113200,0,0,113200,A2,AG/LTD,,,
18423,47-33-0-14-A,7727-38-9322,COMM & IND,1,AC,162000,0,162000,624400,33000,819400,162000,0,162000,583600,22700,768300,M2,INDUS/G,,,
18424,28-1-0-51-G,6738-26-4219,SNGL FAM SUB,2.4,AC,58200,0,58200,0,0,58200,57600,0,57600,0,0,57600,A1,AG/GEN,,,
18425,28-1-0-51-H,6738-26-1098,SNGL FAM SUB,2.43,AC,57600,0,57600,24500,0,82100,57100,0,57100,22100,0,79200,A1,AG/GEN,,,
18426,16-1-0-10-A,5890-59-9598,SNGL FAM SUB,4.25,AC,48000,0,48000,0,0,48000,47800,0,47800,0,0,47800,A1,AG/GEN,,,
18427,16-1-0-10-B,5890-69-1288,SNGL FAM SUB,2.109,AC,42800,0,42800,145300,0,188100,41300,0,41300,116600,0,157900,A1,AG/GEN,,,
18428,4-11-0-1-0,6803-55-7070,SNGL FAM SUB,4.308,AC,57700,0,57700,197700,15200,270600,56200,0,56200,174200,13200,243600,A1,AG/GEN,,,
18429,4-11-0-2-0,6803-54-9231,SNGL FAM SUB,3.242,AC,51600,0,51600,392700,40700,485000,50300,0,50300,347400,44900,442600,A1,AG/GEN,,,
18430,4-11-0-3-0,6803-53-9580,SNGL FAM SUB,8.135,AC,75600,0,75600,0,0,75600,73700,0,73700,0,0,73700,A1,AG/GEN,,,
18431,4-11-0-4-0,6803-53-2695,AG 20-100 AC,22.585,AC,149500,0,149500,175100,28800,353400,145900,0,145900,155700,30000,331600,A1,AG/GEN,,,
18432,4-11-0-5-0,6803-52-4347,AG 20-100 AC,42.307,AC,180900,0,180900,0,44300,225200,180900,0,180900,0,44300,225200,A1,AG/GEN,,,
18433,4-11-0-6-0,6803-42-4883,AG 20-100 AC,26.458,AC,184200,0,184200,0,0,184200,178000,0,178000,0,0,178000,A1,AG/GEN,,,
18434,5-10-0-3-A1,6813-89-1046,SNGL FAM SUB,7.564,AC,73200,0,73200,297800,12500,383500,71800,0,71800,270300,10500,352600,A1,AG/GEN,,,
18435,21-3-0-2-A,6860-01-2518,SNGL FAM SUB,2.78,AC,75700,0,75700,436500,0,512200,68400,0,68400,358900,0,427300,A2,AG/LTD,,,
18436,5-30-0-1-0,6813-73-7917,SNGL FAM SUB,4.073,AC,45500,0,45500,262200,0,307700,44700,0,44700,226400,0,271100,A1,AG/GEN,,,
18437,5-30-0-2-0,6813-74-3035,SNGL FAM SUB,2.49,AC,47300,0,47300,236800,2000,286100,46500,0,46500,209200,2000,257700,A1,AG/GEN,,,
18438,5-30-0-3-0,6813-74-2470,SNGL FAM SUB,3.212,AC,51000,0,51000,221200,1000,273200,50100,0,50100,190900,1000,242000,A1,AG/GEN,,,
18439,5-30-0-4-0,6813-74-6381,SNGL FAM SUB,2.417,AC,46900,0,46900,156800,0,203700,46100,0,46100,135700,0,181800,A1,AG/GEN,,,
18440,41-1-0-18-0,6748-11-7739,SNGL FAM SUB,5.109,AC,95200,0,95200,0,0,95200,91000,0,91000,0,0,91000,A1,AG/GEN,,,
18441,10-1-0-3-C,6802-76-4211,SNGL FAM SUB,3.991,AC,55800,53800,2000,0,13700,69500,54500,52800,1700,0,12400,66900,A1,AG/GEN,,,
18442,21-1-0-40-C,6759-49-5698,SNGL FAM SUB,5,AC,96400,0,96400,247100,0,343500,87500,0,87500,211100,0,298600,A2,AG/LTD,,,
18443,21-1-0-40-D,6759-59-0337,SNGL FAM SUB,4.809,AC,94500,0,94500,367400,30200,492100,85700,0,85700,306900,23200,415800,A2,AG/LTD,,,
18444,64-1-0-14-A,7724-52-7745,SNGL FAM SUB,1.727,AC,28000,0,28000,0,0,28000,24400,0,24400,0,0,24400,R3,RES/GEN,,,
18455,31-1-0-89-A1,6778-54-3406,SNGL FAM SUB,9.5,AC,166100,0,166100,0,0,166100,148200,0,148200,0,0,148200,A2,AG/LTD,,,
18456,44-1-0-19-E,6777-92-9210,SNGL FAM SUB,2.406,AC,89500,0,89500,208900,1000,299400,79900,0,79900,173600,1000,254500,A2,AG/LTD,,,
18458,44-1-0-37-A2,6787-19-1931,SNGL FAM SUB,19.393,AC,312900,0,312900,442700,61200,816800,279600,0,279600,377400,52800,709800,RR,RES/RUR,,,
18459,42-36-H-C-1,6757-58-3707,Cmn Area/Open Spc,0.615,AC,0,0,0,0,0,0,0,0,0,0,0,0,R1,RES/LTD,,,
18460,42-36-H-50-0,6757-58-5691,SNGL FAM SUB,1.31,AC,92000,0,92000,396500,0,488500,80000,0,80000,363400,0,443400,R1,RES/LTD,,,
18461,42-36-H-51-0,6757-58-4633,SNGL FAM SUB,1.071,AC,92000,0,92000,405200,0,497200,80000,0,80000,369100,0,449100,R1,RES/LTD,,,
18462,42-36-H-52-0,6757-58-4942,SNGL FAM SUB,1.286,AC,92000,0,92000,418600,0,510600,80000,0,80000,390200,0,470200,R1,RES/LTD,,,
18463,42-36-H-53-0,6757-58-6936,SNGL FAM SUB,1.518,AC,92000,0,92000,412700,0,504700,80000,0,80000,387700,0,467700,R1,RES/LTD,,,
18464,42-37-I-54-0,6757-68-0824,SNGL FAM SUB,1.377,AC,87400,0,87400,423700,0,511100,76000,0,76000,398100,0,474100,RO,RES/OF,,,
18465,42-37-I-55-0,6757-68-3829,SNGL FAM SUB,2.691,AC,87400,0,87400,366200,0,453600,76000,0,76000,343600,0,419600,RO,RES/OF,,,
18466,42-37-I-56-0,6757-68-7843,SNGL FAM SUB,3.791,AC,92000,0,92000,351400,34500,477900,80000,0,80000,322100,31700,433800,RO,RES/OF,,,
18467,42-37-I-57-0,6757-68-7531,SNGL FAM SUB,1.596,AC,92000,0,92000,0,0,92000,80000,0,80000,0,0,80000,RO,RES/OF,,,
18468,42-37-I-58-0,6757-68-4573,SNGL FAM SUB,1.169,AC,92000,0,92000,407700,0,499700,80000,0,80000,372200,0,452200,RO,RES/OF,,,
18469,42-37-I-59-0,6757-68-2524,SNGL FAM SUB,1.12,AC,92000,0,92000,410000,25600,527600,80000,0,80000,375000,22200,477200,RO,RES/OF,,,
18470,42-37-I-60-0,6757-58-9567,SNGL FAM SUB,1.382,AC,92000,0,92000,369600,0,461600,80000,0,80000,338500,0,418500,RO,RES/OF,,,
18471,58-42-0-1-0,7726-05-3958,SNGL FAM URB,0.306,AC,130000,0,130000,467100,0,597100,125000,0,125000,439900,0,564900,RPUD,RES/PUD,,,
18472,58-42-0-2-0,7726-06-3066,SNGL FAM URB,0.301,AC,130000,0,130000,334900,0,464900,125000,0,125000,323100,0,448100,RPUD,RES/PUD,,,
18473,58-42-0-3-0,7726-06-3184,SNGL FAM URB,0.248,AC,130000,0,130000,366100,0,496100,125000,0,125000,351700,0,476700,RPUD,RES/PUD,,,
18474,58-42-0-4-0,7726-06-4202,SNGL FAM URB,0.199,AC,130000,0,130000,322200,0,452200,125000,0,125000,306500,0,431500,RPUD,RES/PUD,,,
18475,58-42-0-5-0,7726-06-4310,SNGL FAM URB,0.204,AC,130000,0,130000,367200,0,497200,125000,0,125000,351300,0,476300,RPUD,RES/PUD,,,
18476,58-42-0-6-0,7726-06-4318,SNGL FAM URB,0.252,AC,130000,0,130000,353100,0,483100,125000,0,125000,332800,0,457800,RPUD,RES/PUD,,,
18477,58-42-0-7-0,7726-06-4407,SNGL FAM URB,0.342,AC,130000,0,130000,391800,0,521800,125000,0,125000,387100,0,512100,RPUD,RES/PUD,,,
18478,58-42-0-8-0,7726-06-3542,SNGL FAM URB,0.247,AC,130000,0,130000,353700,0,483700,125000,0,125000,340900,0,465900,RPUD,RES/PUD,,,
18479,58-42-0-9-0,7726-06-2554,SNGL FAM URB,0.217,AC,130000,0,130000,423800,0,553800,125000,0,125000,409400,0,534400,RPUD,RES/PUD,,,
18480,58-42-0-10-0,7726-06-1558,SNGL FAM URB,0.281,AC,130000,0,130000,470100,0,600100,125000,0,125000,466900,0,591900,RPUD,RES/PUD,,,
18481,58-42-0-11-0,7726-06-0690,SNGL FAM URB,0.289,AC,130000,0,130000,450300,0,580300,125000,0,125000,446700,0,571700,RPUD,RES/PUD,,,
18482,58-42-0-12-0,7726-06-0604,SNGL FAM URB,0.28,AC,130000,0,130000,396500,0,526500,125000,0,125000,379800,0,504800,RPUD,RES/PUD,,,
18483,58-42-0-13-0,7716-96-9620,SNGL FAM URB,0.266,AC,130000,0,130000,484900,0,614900,125000,0,125000,456400,0,581400,RPUD,RES/PUD,,,
18484,58-42-0-14-0,7716-96-8564,SNGL FAM URB,0.268,AC,130000,0,130000,374300,0,504300,125000,0,125000,359600,0,484600,RPUD,RES/PUD,,,
18485,58-42-0-15-0,7726-06-1061,SNGL FAM URB,0.187,AC,130000,0,130000,401500,0,531500,125000,0,125000,379400,0,504400,RPUD,RES/PUD,,,
18486,58-42-0-16-0,7726-06-1088,SNGL FAM URB,0.212,AC,130000,0,130000,354900,0,484900,125000,0,125000,345000,0,470000,RPUD,RES/PUD,,,
18487,58-42-0-17-0,7726-06-2105,SNGL FAM URB,0.211,AC,130000,0,130000,389600,0,519600,125000,0,125000,376200,0,501200,RPUD,RES/PUD,,,
18488,58-42-0-18-0,7726-06-2242,SNGL FAM URB,0.233,AC,130000,0,130000,356800,0,486800,125000,0,125000,344500,0,469500,RPUD,RES/PUD,,,
18489,58-42-0-19-0,7726-06-2350,SNGL FAM URB,0.252,AC,130000,0,130000,336800,0,466800,125000,0,125000,320300,0,445300,RPUD,RES/PUD,,,
18490,58-42-0-20-0,7726-06-2329,SNGL FAM URB,0.257,AC,130000,0,130000,334100,0,464100,125000,0,125000,319700,0,444700,RPUD,RES/PUD,,,
18491,58-42-0-21-0,7726-06-1420,SNGL FAM URB,0.234,AC,130000,0,130000,403200,0,533200,125000,0,125000,383100,0,508100,RPUD,RES/PUD,,,
18492,58-42-0-22-0,7726-06-0431,SNGL FAM URB,0.238,AC,130000,0,130000,453000,0,583000,125000,0,125000,432600,0,557600,RPUD,RES/PUD,,,
18493,58-42-0-23-0,7716-96-9440,SNGL FAM URB,0.243,AC,130000,0,130000,352500,0,482500,125000,0,125000,334500,0,459500,RPUD,RES/PUD,,,
18494,58-42-0-24-0,7716-96-8394,SNGL FAM URB,0.218,AC,130000,0,130000,384200,0,514200,125000,0,125000,367700,0,492700,RPUD,RES/PUD,,,
18495,58-42-0-25-0,7716-96-8261,SNGL FAM URB,0.242,AC,130000,0,130000,332000,0,462000,125000,0,125000,318800,0,443800,RPUD,RES/PUD,,,
18496,58-42-0-26-0,7716-96-8153,SNGL FAM URB,0.24,AC,130000,0,130000,358000,0,488000,125000,0,125000,344300,0,469300,RPUD,RES/PUD,,,
18497,58-42-0-27-0,7716-96-8045,SNGL FAM URB,0.239,AC,130000,0,130000,421400,0,551400,125000,0,125000,398600,0,523600,RPUD,RES/PUD,,,
18498,58-42-0-28-0,7716-95-7973,SNGL FAM URB,0.209,AC,130000,0,130000,307100,0,437100,125000,0,125000,290600,0,415600,RPUD,RES/PUD,,,
18499,58-42-0-29-0,7716-95-8931,SNGL FAM URB,0.221,AC,130000,0,130000,385200,0,515200,125000,0,125000,368200,0,493200,RPUD,RES/PUD,,,
18500,58-42-0-30-0,7716-95-9809,SNGL FAM URB,0.223,AC,130000,0,130000,326100,0,456100,125000,0,125000,313800,0,438800,RPUD,RES/PUD,,,
18501,58-42-0-31-0,7716-95-9878,SNGL FAM URB,0.238,AC,130000,0,130000,436900,0,566900,125000,0,125000,415300,0,540300,RPUD,RES/PUD,,,
18502,58-42-0-32-0,7726-05-0858,SNGL FAM URB,0.246,AC,130000,0,130000,405800,0,535800,125000,0,125000,386900,0,511900,RPUD,RES/PUD,,,
18503,58-42-0-33-0,7726-05-1838,SNGL FAM URB,0.222,AC,130000,0,130000,381600,0,511600,125000,0,125000,365900,0,490900,RPUD,RES/PUD,,,
18504,58-42-0-C-1,7726-06-1833,Cmn Area/Open Spc,5.7,AC,0,0,0,0,0,0,0,0,0,0,0,0,RPUD,RES/PUD,,,
18505,58-42-0-C-2,7716-96-9194,Cmn Area/Open Spc,2.34,AC,0,0,0,0,0,0,0,0,0,0,0,0,RPUD,RES/PUD,,,
18508,31-1-0-43-E1,6769-92-6154,SNGL FAM SUB,3.5,AC,101900,0,101900,0,0,101900,91000,0,91000,0,0,91000,A2,AG/LTD,,,
18509,26-1-0-50-A,6719-40-7469,SNGL FAM SUB,19.984,AC,145100,96600,48500,141400,1700,288200,142400,96300,46100,123400,1700,267500,A1,AG/GEN,,,
18521,47-34-B-10-0,7716-89-0353,COMM & IND,1.534,AC,675000,0,675000,0,0,675000,644300,0,644300,0,0,644300,B1,BUS/GEN,,,
18523,58-43-7-1-0,7715-67-1797,SNGL FAM URB,0.847,AC,252000,0,252000,1248500,0,1500500,247400,0,247400,1219300,0,1466700,RPUD,RES/PUD,,,
18524,58-43-7-2-0,7715-67-2692,SNGL FAM URB,0.873,AC,252000,0,252000,1311700,38200,1601900,247400,0,247400,1275400,32000,1554800,RPUD,RES/PUD,,,
18525,58-43-7-3-0,7715-67-3452,SNGL FAM URB,0.804,AC,252000,0,252000,1497300,1500,1750800,247400,0,247400,1445500,1900,1694800,RPUD,RES/PUD,,,
18526,58-43-7-4-0,7715-67-3292,SNGL FAM URB,0.841,AC,252000,0,252000,1042200,0,1294200,247400,0,247400,1032300,0,1279700,RPUD,RES/PUD,,,
18527,58-43-7-5-0,7715-67-4044,SNGL FAM URB,0.756,AC,252000,0,252000,1173800,0,1425800,247400,0,247400,1121800,0,1369200,RPUD,RES/PUD,,,
18528,58-43-7-6-0,7715-66-5818,SNGL FAM URB,0.604,AC,244400,0,244400,0,0,244400,240000,0,240000,0,0,240000,RPUD,RES/PUD,,,
18529,58-43-7-7-0,7715-66-7813,SNGL FAM URB,1.469,AC,256200,0,256200,998500,6000,1260700,251500,0,251500,948700,5400,1205600,RPUD,RES/PUD,,,
18530,58-43-7-8-0,7715-66-6644,SNGL FAM URB,0.848,AC,257000,0,257000,1383300,107100,1747400,252300,0,252300,1316800,100000,1669100,RPUD,RES/PUD,,,
18531,58-43-7-9-0,7715-66-4506,SNGL FAM URB,1.3,AC,465800,0,465800,1624300,59200,2149300,459100,0,459100,1564100,55600,2078800,RPUD,RES/PUD,,,
18532,58-43-7-10-0,7715-66-3702,SNGL FAM URB,0.8,AC,405000,0,405000,1450900,22000,1877900,399200,0,399200,1398600,22300,1820100,RPUD,RES/PUD,,,
18533,58-43-7-11-0,7715-66-2857,SNGL FAM URB,1,AC,405000,0,405000,1348800,56700,1810500,399200,0,399200,1315400,52500,1767100,RPUD,RES/PUD,,,
18534,58-43-7-12-0,7715-67-1062,SNGL FAM URB,0.9,AC,405000,0,405000,1841000,14200,2260200,399200,0,399200,1779200,14900,2193300,RPUD,RES/PUD,,,
18535,58-43-7-13-0,7715-67-1138,SNGL FAM URB,0.9,AC,405000,0,405000,1152100,0,1557100,399200,0,399200,1123300,0,1522500,RPUD,RES/PUD,,,
18536,58-43-7-14-0,7715-67-1302,SNGL FAM URB,0.8,AC,405000,0,405000,1483900,0,1888900,399200,0,399200,1510000,0,1909200,RPUD,RES/PUD,,,
18537,58-43-7-15-0,7715-67-0479,SNGL FAM URB,1,AC,405000,0,405000,1381600,0,1786600,399200,0,399200,1334900,0,1734100,RPUD,RES/PUD,,,
18538,58-43-7-16-0,7715-57-9672,SNGL FAM URB,0.9,AC,405000,0,405000,1376300,67500,1848800,399200,0,399200,1355000,63400,1817600,RPUD,RES/PUD,,,
18539,58-43-7-17-0,7715-57-8716,SNGL FAM URB,1.1,AC,396900,0,396900,1219800,10400,1627100,391200,0,391200,1165700,8600,1565500,RPUD,RES/PUD,,,
18540,58-43-7-C-1,7715-66-5424,Cmn Area/Open Spc,2.2,AC,0,0,0,0,0,0,0,0,0,0,0,0,RPUD,RES/PUD,,,
18541,58-43-7-C-2,7715-57-7913,Cmn Area/Open Spc,1.4,AC,0,0,0,0,0,0,0,0,0,0,0,0,RPUD,RES/PUD,,,
18543,13-6-0-5-A,6841-72-0433,SNGL FAM SUB,5.63,AC,83300,0,83300,0,0,83300,81800,0,81800,0,0,81800,A1,AG/GEN,,,
18544,63-39-0-1-0,7723-37-5151,SNGL FAM SUB,1.575,AC,356300,0,356300,0,0,356300,337300,0,337300,0,0,337300,R1,RES/LTD,,,
18545,63-39-0-2-0,7723-37-3178,SNGL FAM SUB,1.616,AC,356300,0,356300,0,0,356300,337300,0,337300,0,0,337300,R1,RES/LTD,,,
18546,63-39-0-3-0,7723-37-1285,SNGL FAM SUB,1.5569,AC,356300,0,356300,0,0,356300,337300,0,337300,0,0,337300,R1,RES/LTD,,,
18547,63-39-0-4-0,7723-27-9382,SNGL FAM SUB,1.7157,AC,320600,0,320600,0,0,320600,303500,0,303500,0,0,303500,R1,RES/LTD,,,
18548,66-8-0-5-0,7723-26-7872,SNGL FAM SUB,1.726,AC,337500,0,337500,0,0,337500,319500,0,319500,0,0,319500,R1,RES/LTD,,,
18549,66-8-0-6-0,7723-36-0658,SNGL FAM SUB,1.781,AC,375000,0,375000,0,0,375000,355000,0,355000,0,0,355000,R1,RES/LTD,,,
18550,66-8-0-7-0,7723-36-1867,SNGL FAM SUB,1.526,AC,375000,0,375000,0,0,375000,355000,0,355000,0,0,355000,R1,RES/LTD,,,
18551,66-8-0-8-0,7723-36-4719,SNGL FAM SUB,1.59,AC,375000,0,375000,812500,0,1187500,355000,0,355000,745700,0,1100700,R1,RES/LTD,,,
18552,66-8-0-9-0,7723-36-3526,SNGL FAM SUB,1.54,AC,375000,0,375000,0,0,375000,355000,0,355000,0,0,355000,R1,RES/LTD,,,
18553,66-8-0-10-0,7723-36-2321,SNGL FAM SUB,1.848,AC,375000,0,375000,0,0,375000,355000,0,355000,0,0,355000,R1,RES/LTD,,,
18554,66-8-0-11-0,7723-36-5023,SNGL FAM SUB,1.739,AC,356300,0,356300,0,0,356300,355000,0,355000,0,0,355000,R1,RES/LTD,,,
18555,66-8-0-12-0,7723-36-5284,SNGL FAM SUB,1.532,AC,375000,0,375000,0,0,375000,355000,0,355000,0,0,355000,R1,RES/LTD,,,
18556,66-8-0-13-0,7723-36-6438,SNGL FAM SUB,1.614,AC,375000,0,375000,0,0,375000,355000,0,355000,0,0,355000,R1,RES/LTD,,,
18557,66-8-0-14-0,7723-36-7752,SNGL FAM SUB,1.587,AC,375000,0,375000,0,0,375000,355000,0,355000,0,0,355000,R1,RES/LTD,,,
18558,66-8-0-15-0,7723-36-8986,SNGL FAM SUB,1.888,AC,356300,0,356300,0,0,356300,337300,0,337300,0,0,337300,R1,RES/LTD,,,
18559,66-8-0-A-0,7723-37-2070,Cmn Area/Open Spc,2.998,AC,0,0,0,0,0,0,0,0,0,0,0,0,R1,RES/LTD,,,
18560,66-8-0-B-0,7723-27-9050,Cmn Area/Open Spc,0.417,AC,0,0,0,0,0,0,0,0,0,0,0,0,R1,RES/LTD,,,
18561,63-39-0-A-0,7723-37-7174,Cmn Area/Open Spc,0.873,AC,0,0,0,0,0,0,0,0,0,0,0,0,R1,RES/LTD,,,
18562,47-1-0-42-A1,7716-79-9827,COMM & IND,5.253,AC,303900,0,303900,0,0,303900,276300,0,276300,0,0,276300,A2,AG/LTD,,,
18563,47-1-0-42-A2,7716-89-7863,COMM & IND,17.002,AC,825000,0,825000,0,0,825000,749900,0,749900,0,0,749900,A2,AG/LTD,,,
18564,17-1-0-1-B1,6801-30-5192,SNGL FAM SUB,7.772,AC,70000,0,70000,0,0,70000,65100,0,65100,0,0,65100,A1,AG/GEN,,,
18565,44-1-0-52-D1,6787-32-3711,SNGL FAM SUB,2.5,AC,90800,0,90800,260000,0,350800,81100,0,81100,219400,0,300500,A2,AG/LTD,,,
18566,57-1-0-81-B,7706-32-4748,SNGL FAM SUB,5,AC,262200,0,262200,0,0,262200,228000,225800,2200,0,0,228000,A2,AG/LTD,,,
18567,32-18-0-R-0,6778-95-7085,Roads,6.389,AC,0,0,0,0,0,0,0,0,0,0,0,0,RR,RES/RUR,,,
18568,32-18-0-1-0,6778-94-7741,SNGL FAM SUB,4.256,AC,112000,0,112000,0,0,112000,100000,0,100000,0,0,100000,RR,RES/RUR,,,
18569,32-18-0-2-0,6778-95-5400,SNGL FAM SUB,4.032,AC,112000,0,112000,416700,0,528700,100000,0,100000,380500,0,480500,RR,RES/RUR,,,
18570,32-18-0-3-0,6778-95-4856,SNGL FAM SUB,3.508,AC,112000,0,112000,429000,1200,542200,100000,0,100000,387400,0,487400,RR,RES/RUR,,,
18571,32-18-0-4-0,6778-97-6180,AG 20-100 AC,27.574,AC,234000,0,234000,865300,48000,1147300,115000,0,115000,805500,44300,964800,RR,RES/RUR,,,
18573,32-18-0-6-0,6778-96-9088,SNGL FAM SUB,8.555,AC,129000,0,129000,647900,0,776900,115000,0,115000,570400,0,685400,RR,RES/RUR,,,
18574,32-18-0-7-0,6788-05-0585,SNGL FAM SUB,6.633,AC,129000,0,129000,545100,52300,726400,115000,0,115000,500400,47500,662900,RR,RES/RUR,,,
18575,32-18-0-8-0,6788-04-1956,SNGL FAM SUB,8.419,AC,129000,0,129000,484500,10200,623700,115000,0,115000,435400,0,550400,RR,RES/RUR,,,
18576,32-18-0-9-0,6788-04-7220,SNGL FAM SUB,6.968,AC,129000,0,129000,749400,0,878400,115000,0,115000,695700,0,810700,RR,RES/RUR,,,
18577,32-18-0-10-0,6788-04-8457,SNGL FAM SUB,3.686,AC,112000,0,112000,383200,0,495200,100000,0,100000,346400,0,446400,RR,RES/RUR,,,
18578,32-18-0-11-0,6788-04-9656,SNGL FAM SUB,3.342,AC,112000,0,112000,738200,0,850200,100000,0,100000,685300,0,785300,RR,RES/RUR,,,
18579,32-18-0-12-0,6788-14-0846,SNGL FAM SUB,3.097,AC,112000,0,112000,443300,0,555300,100000,0,100000,401700,0,501700,RR,RES/RUR,,,
18580,32-18-0-13-0,6788-15-2167,SNGL FAM SUB,6.16,AC,129000,0,129000,620200,0,749200,115000,0,115000,576200,0,691200,RR,RES/RUR,,,
18581,32-18-0-24-0,6788-25-0389,SNGL FAM SUB,4.913,AC,129000,0,129000,456800,0,585800,115000,0,115000,410300,0,525300,RR,RES/RUR,,,
18582,32-18-0-25-0,6788-25-2382,SNGL FAM SUB,3.953,AC,112000,0,112000,361400,0,473400,100000,0,100000,326500,0,426500,RR,RES/RUR,,,
18583,32-18-0-26-0,6788-25-6463,SNGL FAM SUB,4.217,AC,112000,0,112000,542100,0,654100,100000,0,100000,463200,0,563200,RR,RES/RUR,,,
18584,32-18-0-27-0,6788-25-8243,SNGL FAM SUB,4.222,AC,112000,0,112000,0,0,112000,100000,0,100000,0,0,100000,RR,RES/RUR,,,
18585,32-18-0-28-0,6788-24-8902,SNGL FAM SUB,3.273,AC,112000,0,112000,406800,0,518800,100000,0,100000,366100,0,466100,RR,RES/RUR,,,
18586,32-18-0-29-0,6788-24-6597,SNGL FAM SUB,3.53,AC,112000,0,112000,451900,20100,584000,100000,0,100000,403700,18800,522500,RR,RES/RUR,,,
18587,32-18-0-30-0,6788-24-3771,SNGL FAM SUB,3.715,AC,112000,0,112000,631800,26100,769900,100000,0,100000,544600,0,644600,RR,RES/RUR,,,
18588,32-18-0-31-0,6788-24-0739,SNGL FAM SUB,3.5,AC,112000,0,112000,0,0,112000,100000,0,100000,0,0,100000,RR,RES/RUR,,,
18589,32-18-0-32-0,6788-14-7925,SNGL FAM SUB,4.016,AC,112000,0,112000,652800,0,764800,100000,0,100000,597000,0,697000,RR,RES/RUR,,,
18590,32-18-0-33-0,6788-14-5525,SNGL FAM SUB,3.034,AC,112000,0,112000,609800,3100,724900,100000,0,100000,552800,0,652800,RR,RES/RUR,,,
18591,32-18-0-34-0,6788-14-8454,SNGL FAM SUB,3.034,AC,112000,0,112000,510800,0,622800,100000,0,100000,470100,0,570100,RR,RES/RUR,,,
18592,32-18-0-35-0,6788-24-1383,SNGL FAM SUB,3.604,AC,112000,0,112000,574000,3500,689500,100000,0,100000,538100,3900,642000,RR,RES/RUR,,,
18593,32-18-0-36-0,6788-24-2170,SNGL FAM SUB,4.108,AC,112000,0,112000,529900,0,641900,100000,0,100000,476800,0,576800,RR,RES/RUR,,,
18594,32-18-0-37-0,6788-23-1768,SNGL FAM SUB,6.223,AC,129000,0,129000,478900,700,608600,115000,0,115000,437800,700,553500,RR,RES/RUR,,,
18595,32-18-0-38-0,6788-13-7914,SNGL FAM SUB,5.199,AC,129000,0,129000,0,0,129000,115000,0,115000,0,0,115000,RR,RES/RUR,,,
18596,32-18-0-39-0,6788-14-2180,SNGL FAM SUB,3.274,AC,112000,0,112000,754900,0,866900,100000,0,100000,686800,0,786800,RR,RES/RUR,,,
18597,18-1-0-44-A,6810-74-6477,SNGL FAM SUB,0.759,AC,2300,0,2300,0,0,2300,2300,0,2300,0,0,2300,A1,AG/GEN,,,
18598,59-1-0-38-A2,7726-86-6397,COMM & IND,2.31,AC,2286900,0,2286900,711500,0,2998400,2079000,0,2079000,651900,0,2730900,M2,INDUS/G,,,
18599,18-1-0-3-A,6811-90-6748,SNGL FAM SUB,3.23,AC,53300,0,53300,242300,8700,304300,51400,0,51400,203900,7900,263200,A1,AG/GEN,,,
18600,47-33-0-11-B,7727-49-0273,COMM & IND,1.013,AC,173900,0,173900,0,0,173900,165600,0,165600,0,0,165600,M2,INDUS/G,,,
18601,47-33-0-11-C,7727-48-0977,COMM & IND,1.01,AC,182500,0,182500,502300,29100,713900,173800,0,173800,473600,18200,665600,M2,INDUS/G,,,
18602,13-12-0-C-3,6841-99-0425,SNGL FAM SUB,5,AC,53600,0,53600,0,0,53600,52600,0,52600,0,0,52600,RR,RES/RUR,,,
18620,58-44-0-7-0,7716-36-7256,SNGL FAM SUB,2.753,AC,166800,0,166800,797900,0,964700,145000,0,145000,686200,0,831200,A2,AG/LTD,,,
18621,58-44-0-A-0,7716-37-8340,Cmn Area/Open Spc,0.114,AC,0,0,0,0,0,0,0,0,0,0,0,0,A2,AG/LTD,,,
18622,58-44-0-R-0,7716-36-9021,Roads,2.078,AC,0,0,0,0,0,0,0,0,0,0,0,0,A2,AG/LTD,,,
18623,26-19-A-1-0,6718-37-2666,AG 20-100 AC,20.25,AC,127400,118100,9300,0,0,127400,124600,116000,8600,0,0,124600,A1,AG/GEN,,,
18624,26-19-A-2-0,6718-36-8723,AG 20-100 AC,40.356,AC,219800,201200,18600,0,0,219800,215100,197900,17200,0,0,215100,A1,AG/GEN,,,
18625,26-19-A-3-0,6718-26-7727,AG 20-100 AC,21.072,AC,131100,121400,9700,0,0,131100,128300,119300,9000,0,0,128300,A1,AG/GEN,,,
18626,26-19-A-4-0,6718-25-7482,AG 20-100 AC,40.059,AC,218500,200000,18500,0,0,218500,213800,196800,17000,0,0,213800,A1,AG/GEN,,,
18627,26-19-B-5-0,6718-45-0032,AG 20-100 AC,40.085,AC,218600,200100,18500,0,0,218600,213900,196900,17000,0,0,213900,A1,AG/GEN,,,
18628,26-19-B-6-0,6718-54-2118,AG 20-100 AC,40.014,AC,218300,199900,18400,0,0,218300,213600,196600,17000,0,0,213600,A1,AG/GEN,,,
18629,26-19-B-7-0,6718-53-2440,AG 20-100 AC,40.001,AC,218200,199800,18400,0,0,218200,213500,196500,17000,0,0,213500,A1,AG/GEN,,,
18962,28-1-0-84-B,6739-32-6473,SNGL FAM SUB,7.42,AC,71600,0,71600,0,0,71600,70700,0,70700,0,0,70700,A1,AG/GEN,,,
18963,40-1-0-15-C,6736-07-9716,SNGL FAM SUB,15.944,AC,127600,0,127600,482500,0,610100,125200,0,125200,392000,0,517200,A1,AG/GEN,,,
18964,40-1-0-15-D,6736-08-5729,SNGL FAM SUB,17.906,AC,149200,0,149200,463100,1200,613500,146600,0,146600,395700,1300,543600,A1,AG/GEN,,,
18965,7-1-0-6-C,6842-09-7232,SNGL FAM SUB,8.672,AC,92300,88200,4100,0,0,92300,89900,86200,3700,0,0,89900,A1,AG/GEN,,,
18966,21-5-0-1-A,6850-32-4823,SNGL FAM SUB,3.464,AC,100000,0,100000,0,0,100000,90000,0,90000,0,0,90000,A2,AG/LTD,,,
18967,32-1-0-77-C,6788-12-8283,AG 20-100 AC,68.685,AC,952000,0,952000,0,0,952000,851000,0,851000,0,0,851000,A2,AG/LTD,,,
18968,38-1-0-99-F,6707-77-8583,SNGL FAM SUB,5,AC,61200,0,61200,142100,600,203900,60000,0,60000,122900,600,183500,A1,AG/GEN,,,
18969,11-1-0-41-A1,6821-46-8936,AG 20-100 AC,33,AC,130200,114200,16000,0,0,130200,126000,111900,14100,0,0,126000,A1,AG/GEN,,,
18974,27-1-0-76-C,6728-45-8879,SNGL FAM SUB,4.382,AC,57700,0,57700,10800,500,69000,56600,0,56600,10400,500,67500,A1,AG/GEN,,,
18975,51-1-0-46-B,6736-46-4195,AG 20-100 AC,23.416,AC,147000,92400,54600,301400,1000,449400,143900,91400,52500,259900,0,403800,A1,AG/GEN,,,
18976,43-37-A-1-0,6767-64-0333,SNGL FAM SUB,1.812,AC,88000,0,88000,238600,900,327500,80000,0,80000,218900,900,299800,R1,RES/LTD,,,
18977,43-37-A-2-0,6767-64-1621,SNGL FAM SUB,2.438,AC,88000,0,88000,278100,0,366100,80000,0,80000,251700,0,331700,R1,RES/LTD,,,
18978,43-37-A-3-0,6767-54-9758,SNGL FAM SUB,2.172,AC,88000,0,88000,252500,0,340500,80000,0,80000,232900,0,312900,R1,RES/LTD,,,
18979,43-37-A-4-0,6767-54-7437,SNGL FAM SUB,1.636,AC,88000,0,88000,204800,2400,295200,80000,0,80000,186600,2600,269200,R1,RES/LTD,,,
18980,43-37-A-5-0,6767-54-5522,SNGL FAM SUB,1.531,AC,88000,0,88000,274900,0,362900,80000,0,80000,252400,0,332400,R1,RES/LTD,,,
18981,43-37-A-6-0,6767-54-7705,SNGL FAM SUB,1.755,AC,88000,0,88000,247600,0,335600,80000,0,80000,227900,0,307900,R1,RES/LTD,,,
18982,43-37-A-7-0,6767-55-7054,SNGL FAM SUB,1.943,AC,88000,0,88000,514200,16200,618400,80000,0,80000,471300,14000,565300,R1,RES/LTD,,,
18983,43-37-A-8-0,6767-55-6378,SNGL FAM SUB,1.869,AC,88000,0,88000,252200,0,340200,80000,0,80000,231300,0,311300,R1,RES/LTD,,,
18984,43-37-A-9-0,6767-55-4414,SNGL FAM SUB,2.313,AC,88000,0,88000,301100,0,389100,80000,0,80000,276800,0,356800,R1,RES/LTD,,,
18985,43-37-A-10-0,6767-55-3152,SNGL FAM SUB,1.501,AC,88000,0,88000,312700,0,400700,80000,0,80000,287800,0,367800,R1,RES/LTD,,,
18986,43-37-A-11-0,6767-54-3834,SNGL FAM SUB,1.741,AC,88000,0,88000,278000,0,366000,80000,0,80000,255300,0,335300,R1,RES/LTD,,,
18987,43-37-A-12-0,6767-54-2630,SNGL FAM SUB,1.862,AC,88000,0,88000,384800,33100,505900,80000,0,80000,353600,30900,464500,R1,RES/LTD,,,
18988,43-37-A-13-0,6767-44-8588,SNGL FAM SUB,1.606,AC,88000,0,88000,242900,7500,338400,80000,0,80000,221400,7500,308900,R1,RES/LTD,,,
18989,43-37-A-14-0,6767-44-6528,SNGL FAM SUB,1.86,AC,88000,0,88000,328700,7500,424200,80000,0,80000,301300,7500,388800,R1,RES/LTD,,,
18990,43-37-B-1-0,6767-54-8075,SNGL FAM SUB,1.871,AC,88000,0,88000,213800,700,302500,80000,0,80000,195700,700,276400,R1,RES/LTD,,,
18991,43-37-B-2-0,6767-53-8807,SNGL FAM SUB,1.834,AC,88000,0,88000,241600,0,329600,80000,0,80000,221400,0,301400,R1,RES/LTD,,,
18992,43-37-B-3-0,6767-53-6596,SNGL FAM SUB,3.687,AC,92400,0,92400,275400,0,367800,84000,0,84000,252800,0,336800,R1,RES/LTD,,,
18993,43-37-B-4-0,6767-53-3706,SNGL FAM SUB,3.291,AC,92400,0,92400,244300,0,336700,84000,0,84000,228900,0,312900,R1,RES/LTD,,,
18994,43-37-B-5-0,6767-53-3968,SNGL FAM SUB,1.501,AC,88000,0,88000,298500,1800,388300,80000,0,80000,273800,1900,355700,R1,RES/LTD,,,
18995,43-37-B-6-0,6767-54-5116,SNGL FAM SUB,1.605,AC,88000,0,88000,232300,0,320300,80000,0,80000,212500,0,292500,R1,RES/LTD,,,
18630,26-19-B-8-0,6718-33-2173,AG 20-100 AC,40,AC,218200,199800,18400,0,0,218200,213500,196500,17000,0,0,213500,A1,AG/GEN,,,
18631,26-19-B-9-0,6718-24-7001,AG 20-100 AC,40.002,AC,218200,199800,18400,0,0,218200,213500,196500,17000,0,0,213500,A1,AG/GEN,,,
18632,26-19-A-R-0,6718-27-0351,Roads,1.661,AC,0,0,0,0,0,0,0,0,0,0,0,0,A1,AG/GEN,,,
18633,26-19-B-R-0,6718-24-4530,Roads,4.381,AC,0,0,0,0,0,0,0,0,0,0,0,0,A1,AG/GEN,,,
18634,63-1-0-191-A1,7723-19-9318,AG 20-100 AC,55,AC,1721500,1696100,25400,0,0,1721500,1496000,1472600,23400,0,0,1496000,A2R1,AG LTD/,,,
18635,21-9-0-G-0,6860-02-0071,Cmn Area/Open Spc,0.8,AC,0,0,0,0,0,0,0,0,0,0,0,0,RR,RES/RUR,,,
18636,21-9-0-H-0,6860-01-1973,Cmn Area/Open Spc,1.14,AC,0,0,0,0,0,0,0,0,0,0,0,0,RR,RES/RUR,,,
18637,38-14-0-1-0,6707-65-7231,SNGL FAM SUB,3.547,AC,53100,0,53100,223300,2500,278900,52000,0,52000,196400,2200,250600,A1,AG/GEN,,,
18638,38-14-0-2-0,6707-65-4218,SNGL FAM SUB,2.087,AC,44900,0,44900,188800,0,233700,44000,0,44000,160600,0,204600,A1,AG/GEN,,,
18639,38-14-0-3-0,6707-65-5428,SNGL FAM SUB,2.045,AC,44700,0,44700,310200,3600,358500,43700,0,43700,268400,3700,315800,A1,AG/GEN,,,
18644,5-31-0-A-0,6813-92-8665,Cmn Area/Open Spc,22.129,AC,0,0,0,0,0,0,0,0,0,0,0,0,A1,AG/GEN,,,
18645,5-31-0-B-0,6813-82-7739,Cemetery,0.008,AC,100,0,100,0,0,100,100,0,100,0,0,100,A1,AG/GEN,,,
18646,5-31-0-1-0,6813-82-5965,SNGL FAM SUB,4.011,AC,55100,0,55100,230000,1000,286100,54100,0,54100,201400,1000,256500,A1,AG/GEN,,,
18647,5-31-0-2-0,6813-82-7617,SNGL FAM SUB,2,AC,44800,0,44800,0,0,44800,44000,0,44000,0,0,44000,A1,AG/GEN,,,
18648,5-31-0-3-0,6813-92-1552,SNGL FAM SUB,2,AC,44800,0,44800,486500,0,531300,44000,0,44000,412700,10000,466700,A1,AG/GEN,,,
18649,26-20-0-1-0,6718-03-9677,SNGL FAM SUB,3.575,AC,53200,0,53200,0,0,53200,52200,0,52200,0,0,52200,A1,AG/GEN,,,
18650,26-20-0-2-0,6718-13-0132,AG 20-100 AC,20.696,AC,97100,0,97100,0,0,97100,95000,0,95000,0,0,95000,A1,AG/GEN,,,
18651,26-20-0-3-0,6718-12-6716,AG 20-100 AC,21.002,AC,98100,0,98100,0,0,98100,96000,0,96000,0,0,96000,A1,AG/GEN,,,
18652,26-20-0-4-0,6718-22-6073,SNGL FAM SUB,7.207,AC,63900,0,63900,0,0,63900,62600,0,62600,0,0,62600,A1,AG/GEN,,,
18653,26-20-0-5-0,6718-22-7483,SNGL FAM SUB,7.184,AC,63700,0,63700,354200,29400,447300,62500,0,62500,300200,26200,388900,A1,AG/GEN,,,
18654,26-20-0-6-0,6718-22-2842,SNGL FAM SUB,5.487,AC,56500,0,56500,0,0,56500,55400,0,55400,0,0,55400,A1,AG/GEN,,,
18655,32-1-0-11-D,6779-75-2151,SNGL FAM SUB,7.67,AC,131500,0,131500,422200,0,553700,117200,0,117200,360700,0,477900,A2,AG/LTD,,,
18656,43-1-0-88-G,6777-00-5123,SNGL FAM SUB,4,AC,113300,0,113300,445300,0,558600,101300,0,101300,384100,0,485400,A2,AG/LTD,,,
18657,46-1-0-118-B1,7717-04-4568,SNGL FAM SUB,2.001,AC,165000,0,165000,355300,32100,552400,150000,0,150000,302600,27200,479800,A2,AG/LTD,,,
18658,46-1-0-118-B3,7717-04-4256,SNGL FAM SUB,2.001,AC,160100,0,160100,0,0,160100,145500,0,145500,0,0,145500,A2,AG/LTD,,,
18659,4-12-0-1-0,6814-32-1514,SNGL FAM SUB,3.53,AC,52600,0,52600,426500,0,479100,51700,0,51700,382600,0,434300,A1,AG/GEN,,,
18660,4-12-0-2-0,6814-22-8294,SNGL FAM SUB,3.53,AC,52600,0,52600,207100,200,259900,51700,0,51700,181900,200,233800,A1,AG/GEN,,,
18661,4-12-0-3-0,6814-22-7000,SNGL FAM SUB,3.53,AC,52600,0,52600,0,0,52600,51700,0,51700,0,0,51700,A1,AG/GEN,,,
18662,4-12-0-4-0,6814-21-5729,SNGL FAM SUB,3.53,AC,52600,0,52600,212800,0,265400,51700,0,51700,196200,0,247900,A1,AG/GEN,,,
18663,12-1-0-16-C,6822-72-8293,Cemetery,0,AC,100,0,100,0,0,100,100,0,100,0,0,100,A1,AG/GEN,,,
18664,18-1-0-22-B,6810-40-2567,AG 20-100 AC,30,AC,108600,94500,14100,0,0,108600,105000,92200,12800,0,0,105000,A1,AG/GEN,,,
18665,18-1-0-22-C,6719-59-6380,AG 20-100 AC,30,AC,164200,80200,84000,392500,43400,600100,168500,85600,82900,330500,36800,535800,A1,AG/GEN,,,
18666,17-1-0-100-A,6810-44-3224,AG 20-100 AC,21.737,AC,112900,82800,30100,0,38700,151600,110600,86000,24600,0,36000,146600,A1,AG/GEN,,,
18667,17-1-0-100-B,6810-54-3081,AG 20-100 AC,20.137,AC,109600,100300,9300,0,0,109600,95400,86800,8600,0,0,95400,A1,AG/GEN,,,
18668,31-31-0-1-0,6769-53-7233,SNGL FAM SUB,2.134,AC,96000,0,96000,334600,2500,433100,92000,0,92000,308400,1800,402200,A2,AG/LTD,,,
18669,31-31-0-2-0,6769-53-5251,SNGL FAM SUB,2.211,AC,96000,0,96000,385200,900,482100,92000,0,92000,351600,1000,444600,A2,AG/LTD,,,
18670,31-31-0-3-0,6769-43-8393,AG 20-100 AC,21.172,AC,178100,168300,9800,0,0,178100,169000,160000,9000,0,0,169000,A2,AG/LTD,,,
18671,31-31-0-4-0,6769-53-5626,SNGL FAM SUB,2.155,AC,96000,0,96000,447000,4600,547600,92000,0,92000,410100,3200,505300,A2,AG/LTD,,,
18672,31-31-0-5-0,6769-53-7669,SNGL FAM SUB,2.112,AC,96000,0,96000,359100,1000,456100,92000,0,92000,325400,1100,418500,A2,AG/LTD,,,
18673,44-1-0-10-G,6787-44-6670,SNGL FAM SUB,8.39,AC,167600,0,167600,597400,29100,794100,149800,0,149800,494000,24500,668300,A2,AG/LTD,,,
18675,27-1-0-19-A,6718-64-8977,SNGL FAM SUB,14.395,AC,87700,81100,6600,0,0,87700,86000,79900,6100,0,0,86000,A1,AG/GEN,,,
18676,30-1-0-28-C,6758-38-2110,SNGL FAM SUB,2.515,AC,69000,0,69000,0,0,69000,65700,0,65700,0,0,65700,A2,AG/LTD,,,
18677,30-1-0-28-B,6758-28-8218,SNGL FAM SUB,2.725,AC,57500,0,57500,0,0,57500,54500,0,54500,0,0,54500,A2,AG/LTD,,,
18678,13-24-0-14-0,6842-84-4522,SNGL FAM SUB,3.806,AC,71100,0,71100,302600,2400,376100,69700,0,69700,257500,2500,329700,A1,AG/GEN,,,
18679,45-21-0-4-B,6797-99-2385,SNGL FAM SUB,2.355,AC,79100,0,79100,361500,0,440600,70700,0,70700,295400,0,366100,A2,AG/LTD,,,
18680,13-1-0-39-B1,6841-94-3225,SNGL FAM SUB,3.144,AC,63500,0,63500,277800,0,341300,57200,0,57200,267000,0,324200,A1,AG/GEN,,,
18681,47-35-0-1-0,7718-81-1561,SNGL FAM SUB,2.04,AC,141500,0,141500,50800,1500,193800,126300,0,126300,52400,1500,180200,A2,AG/LTD,,,
18682,47-35-0-2-0,7718-71-9395,SNGL FAM SUB,4.12,AC,176800,0,176800,115100,0,291900,157900,0,157900,98400,0,256300,A2,AG/LTD,,,
18683,47-35-0-3-0,7718-71-8144,SNGL FAM SUB,4.01,AC,175000,0,175000,186600,0,361600,156300,0,156300,158400,0,314700,A2,AG/LTD,,,
18684,47-35-0-4-0,7718-71-5001,SNGL FAM SUB,7.18,AC,228900,0,228900,0,0,228900,204400,0,204400,0,0,204400,A2,AG/LTD,,,
18685,46-13-0-9-B,7717-06-3494,SNGL FAM SUB,2.67,AC,120800,0,120800,0,0,120800,107900,0,107900,0,0,107900,A2,AG/LTD,,,
18686,30-1-0-115-A1,6759-64-0848,SNGL FAM SUB,4.308,AC,77700,0,77700,245400,27800,350900,70500,0,70500,203400,24800,298700,A2,AG/LTD,,,
18687,63-4-0-A-0,7714-96-5920,Roads,2.2,AC,0,0,0,0,0,0,0,0,0,0,0,0,A2,AG/LTD,,,
18689,5-1-0-36-D1,6813-86-7085,SNGL FAM SUB,10,AC,77000,0,77000,325800,6400,409200,75600,0,75600,285700,5600,366900,A1,AG/GEN,,,
18690,18-14-0-R-0,6821-60-5546,Roads,6.428,AC,0,0,0,0,0,0,0,0,0,0,0,0,A1,AG/GEN,,,
18691,18-14-0-1-0,6820-67-6577,AG 20-100 AC,40.869,AC,151200,0,151200,462100,0,613300,143600,0,143600,372700,0,516300,A1,AG/GEN,,,
18692,18-14-0-2-0,6820-68-4817,SNGL FAM SUB,5.608,AC,73600,0,73600,0,0,73600,71600,0,71600,0,0,71600,A1,AG/GEN,,,
18693,18-14-0-3-0,6820-69-3197,SNGL FAM SUB,5.951,AC,75300,0,75300,373500,0,448800,73200,0,73200,313500,0,386700,A1,AG/GEN,,,
18694,18-14-0-4-0,6820-69-3489,SNGL FAM SUB,6.524,AC,78500,0,78500,384000,33000,495500,75900,0,75900,323700,28200,427800,A1,AG/GEN,,,
18695,18-14-0-5-0,6820-69-3822,SNGL FAM SUB,6.44,AC,78000,0,78000,0,0,78000,75500,0,75500,0,0,75500,A1,AG/GEN,,,
18696,18-14-0-6-0,6821-60-2186,SNGL FAM SUB,5.736,AC,74200,0,74200,538800,0,613000,72200,0,72200,466000,0,538200,A1,AG/GEN,,,
18697,18-14-0-7-0,6821-60-2513,SNGL FAM SUB,5.058,AC,70800,0,70800,582800,0,653600,69000,0,69000,493000,0,562000,A1,AG/GEN,,,
18698,18-14-0-8-0,6821-50-9607,SNGL FAM SUB,5.006,AC,70600,0,70600,506300,3300,580200,68700,0,68700,428600,3600,500900,A1,AG/GEN,,,
18699,18-14-0-9-0,6821-50-4725,SNGL FAM SUB,5.532,AC,73200,0,73200,0,0,73200,71200,0,71200,0,0,71200,A1,AG/GEN,,,
18700,18-14-0-10-0,6821-40-8833,AG 20-100 AC,25.056,AC,115800,0,115800,0,0,115800,106400,0,106400,0,0,106400,A1,AG/GEN,,,
18701,18-14-0-11-0,6821-60-5877,AG 20-100 AC,24.609,AC,114700,49800,64900,549000,0,663700,105400,45500,59900,475600,0,581000,A1,AG/GEN,,,
18702,18-14-0-12-0,6820-79-1418,AG 20-100 AC,20.001,AC,105200,96000,9200,0,0,105200,94600,86100,8500,0,0,94600,A1,AG/GEN,,,
18703,18-14-0-13-0,6820-78-4368,AG 20-100 AC,20.744,AC,105400,0,105400,364600,0,470000,96300,87500,8800,0,0,96300,A1,AG/GEN,,,
18704,18-14-0-14-0,6820-77-8682,AG 20-100 AC,41.132,AC,151700,130600,21100,0,0,151700,144200,124700,19500,0,0,144200,A1,AG/GEN,,,
18705,18-14-0-15-0,6820-76-9577,AG 20-100 AC,42,AC,152900,131400,21500,0,0,152900,146300,126500,19800,0,0,146300,A1,AG/GEN,,,
18706,13-24-0-1-0,6852-04-4315,SNGL FAM SUB,3,AC,53300,0,53300,0,0,53300,52300,0,52300,0,0,52300,A1,AG/GEN,,,
18707,13-24-0-2-0,6842-94-8776,SNGL FAM SUB,3,AC,59300,0,59300,306900,0,366200,58100,0,58100,259600,0,317700,A1,AG/GEN,,,
18708,13-24-0-3-0,6842-95-4010,SNGL FAM SUB,3.664,AC,59300,0,59300,342600,0,401900,58100,0,58100,289800,0,347900,A1,AG/GEN,,,
18709,13-24-0-4-0,6842-85-9151,SNGL FAM SUB,7.608,AC,77000,0,77000,308000,0,385000,75500,0,75500,261100,0,336600,A1,AG/GEN,,,
18710,13-24-0-5-0,6842-85-5079,SNGL FAM SUB,3.243,AC,59300,0,59300,302900,0,362200,58100,0,58100,257500,0,315600,A1,AG/GEN,,,
18711,13-24-0-6-0,6842-85-2354,SNGL FAM SUB,2.088,AC,59300,0,59300,345100,0,404400,58100,0,58100,292100,0,350200,A1,AG/GEN,,,
18712,13-24-0-7-0,6842-85-0404,SNGL FAM SUB,2.877,AC,59300,0,59300,0,0,59300,58100,0,58100,0,0,58100,A1,AG/GEN,,,
18713,13-24-0-8-0,6842-75-8165,SNGL FAM SUB,3.119,AC,59300,0,59300,344400,0,403700,58100,0,58100,289800,0,347900,A1,AG/GEN,,,
18714,13-24-0-9-0,6842-84-0932,SNGL FAM SUB,2.09,AC,59300,0,59300,316800,0,376100,58100,0,58100,268200,0,326300,A1,AG/GEN,,,
18715,13-24-0-10-0,6842-74-7852,SNGL FAM SUB,3.194,AC,59300,0,59300,306100,0,365400,58100,0,58100,260000,0,318100,A1,AG/GEN,,,
18716,13-24-0-11-0,6842-74-6622,SNGL FAM SUB,2.98,AC,59300,0,59300,329100,0,388400,58100,0,58100,277400,0,335500,A1,AG/GEN,,,
18717,13-24-0-12-0,6842-74-9206,SNGL FAM SUB,4.072,AC,59300,0,59300,335700,0,395000,58100,0,58100,284400,0,342500,A1,AG/GEN,,,
18718,13-24-0-13-0,6842-84-3198,SNGL FAM SUB,6.746,AC,96300,0,96300,0,0,96300,95200,0,95200,0,0,95200,A1,AG/GEN,,,
18719,13-24-0-15-0,6842-84-5701,SNGL FAM SUB,2.907,AC,71100,0,71100,323600,0,394700,69700,0,69700,273500,0,343200,A1,AG/GEN,,,
18720,13-24-0-16-0,6842-84-9548,SNGL FAM SUB,2.833,AC,77000,0,77000,509400,0,586400,75500,0,75500,458200,0,533700,A1,AG/GEN,,,
18721,13-24-0-17-0,6842-94-3589,SNGL FAM SUB,3.98,AC,71100,0,71100,0,0,71100,69700,0,69700,0,0,69700,A1,AG/GEN,,,
18722,13-24-0-18-0,6842-94-6381,SNGL FAM SUB,5.872,AC,77000,0,77000,378700,4800,460500,76800,0,76800,313300,4900,395000,A1,AG/GEN,,,
18723,13-24-0-19-0,6842-94-2211,SNGL FAM SUB,3.17,AC,71100,0,71100,490300,0,561400,69700,0,69700,424800,0,494500,A1,AG/GEN,,,
18724,13-24-0-20-0,6842-84-8138,SNGL FAM SUB,4.435,AC,84700,0,84700,366300,0,451000,83100,0,83100,313300,0,396400,A1,AG/GEN,,,
18725,13-24-0-21-0,6842-83-3727,SNGL FAM SUB,3.949,AC,59300,0,59300,298700,0,358000,58100,0,58100,245900,0,304000,A1,AG/GEN,,,
18726,13-24-0-22-0,6842-83-8736,SNGL FAM SUB,3.894,AC,59300,0,59300,308300,0,367600,58100,0,58100,261700,0,319800,A1,AG/GEN,,,
18727,13-24-0-23-0,6842-93-1764,SNGL FAM SUB,3.837,AC,59300,0,59300,312900,1000,373200,58100,0,58100,266500,1000,325600,A1,AG/GEN,,,
18728,13-24-0-24-0,6842-93-7851,SNGL FAM SUB,5.477,AC,65200,0,65200,370600,0,435800,63900,0,63900,312900,0,376800,A1,AG/GEN,,,
18729,13-24-0-25-0,6852-04-0076,SNGL FAM SUB,3.478,AC,59300,0,59300,293200,22100,374600,58100,0,58100,254500,21100,333700,A1,AG/GEN,,,
18730,13-24-0-26-0,6852-03-3914,SNGL FAM SUB,4.472,AC,61900,0,61900,304300,0,366200,60700,0,60700,257700,0,318400,A1,AG/GEN,,,
18731,13-24-0-R-0,6842-93-2965,Roads,5.441,AC,0,0,0,0,0,0,0,0,0,0,0,0,A1,AG/GEN,,,
18732,32-18-0-23-0,6788-15-7621,SNGL FAM SUB,9.202,AC,129000,0,129000,502700,0,631700,115000,0,115000,461400,0,576400,RR,RES/RUR,,,
18733,9-1-0-46-C,5891-39-4766,SNGL FAM SUB,4.176,AC,35200,0,35200,371100,20900,427200,34500,0,34500,323200,16400,374100,A1,AG/GEN,,,
18734,12-2-0-3-B1,6821-94-4255,SNGL FAM SUB,2,AC,47600,0,47600,259000,0,306600,47800,0,47800,213300,0,261100,A1,AG/GEN,,,
18735,30-1-0-98-A,6768-16-0894,AG 20-100 AC,66.95,AC,635900,602600,33300,0,0,635900,598800,570100,28700,0,0,598800,A2,AG/LTD,,,
18736,5-1-0-44-A,6823-17-5896,SNGL FAM SUB,4.506,AC,63400,0,63400,0,0,63400,65100,0,65100,0,0,65100,A1,AG/GEN,,,
18737,58-45-0-1-0,7716-96-8409,SNGL FAM URB,0.246,AC,130000,0,130000,420400,0,550400,125000,0,125000,421400,0,546400,RPUD,RES/PUD,,,
18738,58-45-0-2-0,7716-96-7441,SNGL FAM URB,0.264,AC,130000,0,130000,320600,0,450600,125000,0,125000,308000,0,433000,RPUD,RES/PUD,,,
18739,58-45-0-3-0,7716-96-7310,SNGL FAM URB,0.232,AC,130000,0,130000,424300,0,554300,125000,0,125000,417800,0,542800,RPUD,RES/PUD,,,
18740,58-45-0-4-0,7716-96-7202,SNGL FAM URB,0.23,AC,130000,0,130000,476900,0,606900,125000,0,125000,451100,0,576100,RPUD,RES/PUD,,,
18741,58-45-0-5-0,7716-96-6194,SNGL FAM URB,0.239,AC,130000,0,130000,447600,0,577600,125000,0,125000,431400,0,556400,RPUD,RES/PUD,,,
18742,58-45-0-6-0,7716-96-6075,SNGL FAM URB,0.245,AC,130000,0,130000,459300,0,589300,125000,0,125000,458800,0,583800,RPUD,RES/PUD,,,
18743,58-45-0-7-0,7716-95-6927,SNGL FAM URB,0.249,AC,130000,0,130000,454900,0,584900,125000,0,125000,442000,0,567000,RPUD,RES/PUD,,,
18744,58-45-0-8-0,7716-95-5963,SNGL FAM URB,0.229,AC,130000,0,130000,414500,0,544500,125000,0,125000,413100,0,538100,RPUD,RES/PUD,,,
18745,58-45-0-9-0,7716-95-5808,SNGL FAM URB,0.229,AC,130000,0,130000,421900,0,551900,125000,0,125000,419200,0,544200,RPUD,RES/PUD,,,
18746,58-45-0-10-0,7716-95-4833,SNGL FAM URB,0.229,AC,130000,0,130000,417800,0,547800,125000,0,125000,410700,0,535700,RPUD,RES/PUD,,,
18747,58-45-0-11-0,7716-95-3779,SNGL FAM URB,0.229,AC,130000,0,130000,452200,0,582200,125000,0,125000,433100,0,558100,RPUD,RES/PUD,,,
18748,58-45-0-12-0,7716-95-4697,SNGL FAM URB,0.229,AC,130000,0,130000,330500,0,460500,125000,0,125000,319900,0,444900,RPUD,RES/PUD,,,
18749,58-45-0-13-0,7716-95-5751,SNGL FAM URB,0.229,AC,130000,0,130000,410200,0,540200,125000,0,125000,391500,0,516500,RPUD,RES/PUD,,,
18750,58-45-0-14-0,7716-95-6840,SNGL FAM URB,0.288,AC,130000,0,130000,400100,1600,531700,125000,0,125000,386500,1300,512800,RPUD,RES/PUD,,,
18751,58-45-0-15-0,7716-95-7727,SNGL FAM URB,0.228,AC,130000,0,130000,282500,0,412500,125000,0,125000,275200,0,400200,RPUD,RES/PUD,,,
18752,58-45-0-16-0,7716-95-7795,SNGL FAM URB,0.227,AC,130000,0,130000,409900,0,539900,125000,0,125000,391800,0,516800,RPUD,RES/PUD,,,
18753,58-45-0-17-0,7716-95-8752,SNGL FAM URB,0.227,AC,130000,0,130000,333800,0,463800,125000,0,125000,319700,0,444700,RPUD,RES/PUD,,,
18754,58-45-0-18-0,7716-95-9731,SNGL FAM URB,0.226,AC,130000,0,130000,404800,0,534800,125000,0,125000,386100,0,511100,RPUD,RES/PUD,,,
18755,58-45-0-19-0,7726-05-0700,SNGL FAM URB,0.216,AC,130000,0,130000,426600,0,556600,125000,0,125000,404400,0,529400,RPUD,RES/PUD,,,
18756,58-45-0-20-0,7726-05-0780,SNGL FAM URB,0.207,AC,130000,0,130000,396400,19100,545500,125000,0,125000,386900,17000,528900,RPUD,RES/PUD,,,
18757,58-45-0-21-0,7726-05-1760,SNGL FAM URB,0.244,AC,130000,0,130000,321400,0,451400,125000,0,125000,306500,0,431500,RPUD,RES/PUD,,,
18758,58-45-0-A-0,7716-95-8621,Cmn Area/Open Spc,2.26,AC,0,0,0,0,0,0,0,0,0,0,0,0,RPUD,RES/PUD,,,
18759,58-45-0-B-0,7716-96-4073,Cmn Area/Open Spc,3.6,AC,0,0,0,0,0,0,0,0,0,0,0,0,RPUD,RES/PUD,,,
18761,17-1-0-18-TW,6709-88-5855-9998,COMM & IND,0,AC,0,0,0,0,134000,134000,0,0,0,0,134000,134000,A1,AG/GEN,,,
18762,42-1-0-117-A,6766-28-3400,SNGL FAM SUB,0.274,AC,900,0,900,0,0,900,800,0,800,0,0,800,A2,AG/LTD,,,
18763,47-33-0-14-A1,7727-38-9532-0001,COMM & IND,0,AC,177500,0,177500,681500,26700,885700,177500,0,177500,636700,18400,832600,M2,INDUS/G,,,
18764,47-33-0-14-C,7727-38-9532-0002,COMM & IND,0,AC,177500,0,177500,666400,33400,877300,177500,0,177500,622800,23000,823300,M2,INDUS/G,,,
18765,47-33-0-14-D,7727-38-9532-0003,COMM & IND,0,AC,82000,0,82000,294800,13400,390200,82000,0,82000,275900,9200,367100,M2,INDUS/G,,,
18766,16-1-0-51-B,5890-56-8722,SNGL FAM SUB,5.861,AC,56300,50400,5900,0,5000,61300,55000,0,55000,0,0,55000,A1,AG/GEN,,,
18767,63-14-A-3-A,7714-84-3325-0001,MultiFamily,0,,132600,0,132600,313200,23300,469100,130000,0,130000,306300,20700,457000,R3,RES/GEN,,,
18768,63-14-A-3-B,7714-84-3325-0002,MultiFamily,0,AC,132600,0,132600,271400,0,404000,130000,0,130000,263800,0,393800,R3,RES/GEN,,,
18769,63-14-A-3-C,7714-84-3325-0003,MultiFamily,0,AC,132600,0,132600,277900,40600,451100,130000,0,130000,270100,34100,434200,R3,RES/GEN,,,
18770,63-14-A-3-D,7714-84-3325-0004,MultiFamily,0,AC,132600,0,132600,307500,20800,460900,130000,0,130000,297400,20700,448100,R3,RES/GEN,,,
18771,4-1-0-62-A,6812-39-8630,SNGL FAM SUB,3.644,AC,53200,0,53200,0,0,53200,52200,0,52200,0,0,52200,A1,AG/GEN,,,
18772,4-1-0-27-A,6803-64-3108,SNGL FAM SUB,13.895,AC,109000,101900,7100,0,0,109000,108900,102900,6000,0,0,108900,A1,AG/GEN,,,
18773,9-1-0-41-A,5892-30-6855,SNGL FAM SUB,3.072,AC,46300,0,46300,246700,0,293000,45300,0,45300,218500,0,263800,A1,AG/GEN,,,
18774,47-20-0-C-1,7717-42-7385,SNGL FAM SUB,3,AC,172100,0,172100,289400,0,461500,153600,0,153600,247100,0,400700,A2,AG/LTD,,,
18775,43-1-0-74-B,6777-58-5962,SNGL FAM SUB,3,AC,98900,0,98900,233100,500,332500,88400,0,88400,189100,500,278000,A2,AG/LTD,,,
18776,48-10-0-B-3,7728-50-3486,COMM & IND,1.61,AC,266500,0,266500,692200,65300,1024000,253700,0,253700,647400,44900,946000,M2,INDUS/G,,,
18777,48-10-0-B-2,7728-50-1531,COMM & IND,1.16,AC,192000,0,192000,692200,65300,949500,182800,0,182800,647400,44900,875100,M2,INDUS/G,,,
18778,13-9-0-6-A,6841-64-6224,SNGL FAM SUB,2,AC,58600,0,58600,231200,1400,291200,57500,0,57500,196000,1500,255000,A1,AG/GEN,,,
18779,47-1-0-39-B,7717-61-6722,Cemetery,0,AC,100,0,100,0,0,100,100,0,100,0,0,100,A2,AG/LTD,,,
18780,55-20-0-4-0,6785-44-2999,SNGL FAM SUB,3.18,AC,118700,0,118700,427600,0,546300,105800,0,105800,362700,0,468500,A2,AG/LTD,,,
18781,42-1-0-30-H,6756-97-9365,Parks & Rec,29,AC,84100,0,84100,0,0,84100,79800,0,79800,0,0,79800,A2,AG/LTD,,,
18782,45-1-0-38-A,6786-89-3418,AG 20-100 AC,30,AC,601400,0,601400,1454800,260800,2317000,537400,0,537400,1203500,239100,1980000,A2,AG/LTD,,,
18783,4-13-0-1-0,6803-65-8712,SNGL FAM SUB,10,AC,90100,0,90100,137800,0,227900,87500,0,87500,117500,0,205000,A1,AG/GEN,,,
18784,4-13-0-2-0,6803-65-5250,AG 20-100 AC,21.1,AC,152200,0,152200,212600,46700,411500,148600,0,148600,185700,41400,375700,A1,AG/GEN,,,
18785,4-13-0-3-0,6803-64-8624,SNGL FAM SUB,10.05,AC,90400,0,90400,218600,3000,312000,87800,0,87800,193800,3000,284600,A1,AG/GEN,,,
18786,4-13-0-4-0,6803-64-9186,SNGL FAM SUB,10.07,AC,90500,0,90500,181600,6900,279000,87900,0,87900,158200,6600,252700,A1,AG/GEN,,,
18787,20-26-0-1-0,6840-43-5618,SNGL FAM SUB,6.415,AC,76700,0,76700,428100,0,504800,73700,0,73700,382100,0,455800,A1,AG/GEN,,,
18788,20-26-0-2-0,6840-43-6590,SNGL FAM SUB,2.662,AC,69700,0,69700,272900,0,342600,67000,0,67000,248700,0,315700,A1,AG/GEN,,,
18789,20-26-0-3-0,6840-43-9640,SNGL FAM SUB,5.345,AC,76700,0,76700,412700,0,489400,73700,0,73700,368900,0,442600,A1,AG/GEN,,,
18790,20-26-0-4-0,6840-53-2319,SNGL FAM SUB,3.412,AC,69700,0,69700,292600,4500,366800,67000,0,67000,263900,4000,334900,A1,AG/GEN,,,
18791,20-26-0-5-0,6840-53-6426,SNGL FAM SUB,3.658,AC,69700,0,69700,0,0,69700,67000,0,67000,0,0,67000,A1,AG/GEN,,,
18792,20-26-0-6-0,6840-53-9578,SNGL FAM SUB,3.128,AC,69700,0,69700,0,0,69700,67000,0,67000,0,0,67000,A1,AG/GEN,,,
18793,20-26-0-7-0,6840-63-2553,SNGL FAM SUB,7.142,AC,83600,0,83600,464200,39700,587500,80400,0,80400,424900,35700,541000,A1,AG/GEN,,,
18794,20-26-0-8-0,6840-62-1691,AG 20-100 AC,24.727,AC,186600,174500,12100,0,0,186600,179700,169100,10600,0,0,179700,A1,AG/GEN,,,
18795,20-26-0-9-0,6840-53-7021,SNGL FAM SUB,4,AC,76700,0,76700,308500,1600,386800,73700,0,73700,275100,1700,350500,A1,AG/GEN,,,
18796,20-26-0-10-0,6840-52-1377,AG 20-100 AC,20.765,AC,175400,0,175400,0,0,175400,161100,0,161100,0,0,161100,A1,AG/GEN,,,
18797,20-26-0-11-0,6840-52-1953,SNGL FAM SUB,3.453,AC,69700,0,69700,664500,13500,747700,67000,0,67000,596600,11400,675000,A1,AG/GEN,,,
18798,20-26-0-12-0,6840-42-8966,SNGL FAM SUB,4.1,AC,69700,0,69700,289700,0,359400,67000,0,67000,261700,0,328700,A1,AG/GEN,,,
18799,20-26-0-13-0,6840-42-4778,SNGL FAM SUB,4.494,AC,76700,0,76700,510300,0,587000,73700,0,73700,451800,0,525500,A1,AG/GEN,,,
18800,20-26-0-14-0,6840-42-2984,SNGL FAM SUB,2.864,AC,69700,0,69700,373800,0,443500,67000,0,67000,330300,0,397300,A1,AG/GEN,,,
18802,20-18-0-1-A,6840-12-6534,SNGL FAM SUB,5.16,AC,78400,0,78400,311100,1500,391000,71500,0,71500,224300,1500,297300,A1,AG/GEN,,,
18803,63-1-0-172-B,7724-31-1765,AG 20-100 AC,24.772,AC,2222800,2211400,11400,0,0,2222800,1933000,1922500,10500,0,0,1933000,A2,AG/LTD,,,
18804,30-1-0-87-A,6758-92-5221,COMM & IND,1.5,AC,115800,0,115800,215200,26200,357200,112400,0,112400,215200,25400,353000,BN,BUS/NHD,,,
18805,57-1-0-83-0,7705-14-2278,Cmn Area/Open Spc,22.305,AC,0,0,0,0,0,0,0,0,0,0,0,0,RR,RES/RUR,,,
18806,10-7-0-C-1,6801-72-0499,SNGL FAM SUB,3.01,AC,46100,44600,1500,0,0,46100,46000,44700,1300,0,0,46000,A1,AG/GEN,,,
18807,20-5-0-C-1,6840-17-4189,SNGL FAM SUB,2.01,AC,63900,0,63900,98300,2000,164200,59400,0,59400,79300,2000,140700,A1,AG/GEN,,,
18808,42-11-0-3-TW,6758-70-7265-9998,COMM & IND,0,AC,0,0,0,0,148800,148800,0,0,0,0,146400,146400,A1,AG/GEN,,,
18809,64-28-D-1-0,7724-90-6370,SNGL FAM URB,0.392,AC,210000,0,210000,552800,4700,767500,180000,0,180000,514100,4300,698400,RPUD,RES/PUD,,,
18810,64-28-D-2-0,7724-90-7109,SNGL FAM URB,0.381,AC,210000,0,210000,530200,0,740200,180000,0,180000,496600,0,676600,RPUD,RES/PUD,,,
18811,64-28-D-3-0,7724-90-7079,SNGL FAM URB,0.383,AC,210000,0,210000,563200,0,773200,180000,0,180000,525500,0,705500,RPUD,RES/PUD,,,
18812,64-28-D-4-0,7723-99-8949,SNGL FAM URB,0.474,AC,210000,0,210000,643200,1500,854700,180000,0,180000,623900,1200,805100,RPUD,RES/PUD,,,
18813,64-28-D-5-0,7723-99-9937,SNGL FAM URB,0.453,AC,210000,0,210000,650900,0,860900,180000,0,180000,609800,0,789800,RPUD,RES/PUD,,,
18814,64-28-D-6-0,7733-09-0975,SNGL FAM URB,0.355,AC,210000,0,210000,509400,0,719400,180000,0,180000,483100,0,663100,RPUD,RES/PUD,,,
18815,64-28-D-7-0,7733-09-1996,SNGL FAM URB,0.396,AC,210000,0,210000,504900,0,714900,180000,0,180000,475700,0,655700,RPUD,RES/PUD,,,
18816,64-28-D-8-0,7733-09-3928,SNGL FAM URB,0.427,AC,210000,0,210000,456500,0,666500,180000,0,180000,431600,0,611600,RPUD,RES/PUD,,,
18817,64-28-E-1-0,7724-90-8361,SNGL FAM URB,0.308,AC,210000,0,210000,578200,1500,789700,180000,0,180000,541000,1200,722200,RPUD,RES/PUD,,,
18818,64-28-E-2-0,7724-90-8281,SNGL FAM URB,0.308,AC,210000,0,210000,635400,0,845400,180000,0,180000,595100,0,775100,RPUD,RES/PUD,,,
18819,64-28-E-3-0,7724-90-9165,SNGL FAM URB,0.339,AC,210000,0,210000,461000,0,671000,180000,0,180000,431600,0,611600,RPUD,RES/PUD,,,
18820,64-28-E-4-0,7734-00-0174,SNGL FAM URB,0.358,AC,210000,0,210000,490300,0,700300,180000,0,180000,459000,0,639000,RPUD,RES/PUD,,,
18821,64-28-E-5-0,7734-00-1193,SNGL FAM URB,0.362,AC,210000,0,210000,508400,0,718400,180000,0,180000,475000,0,655000,RPUD,RES/PUD,,,
18822,64-28-F-1-0,7734-00-1435,SNGL FAM URB,0.395,AC,210000,0,210000,577300,0,787300,180000,0,180000,539200,0,719200,RPUD,RES/PUD,,,
18823,64-28-F-2-0,7734-00-1576,SNGL FAM URB,0.343,AC,210000,0,210000,664500,0,874500,180000,0,180000,617900,0,797900,RPUD,RES/PUD,,,
18824,64-28-F-3-0,7734-00-1962,SNGL FAM URB,0.376,AC,210000,0,210000,460700,0,670700,180000,0,180000,439400,0,619400,RPUD,RES/PUD,,,
18825,64-28-F-4-0,7734-01-1053,SNGL FAM URB,0.414,AC,210000,0,210000,621900,0,831900,180000,0,180000,575500,0,755500,RPUD,RES/PUD,,,
18826,64-28-F-5-0,7734-01-1241,SNGL FAM URB,0.334,AC,210000,0,210000,644800,59700,914500,180000,0,180000,602000,55600,837600,RPUD,RES/PUD,,,
18827,64-28-F-6-0,7734-01-0240,SNGL FAM URB,0.353,AC,210000,0,210000,561800,0,771800,180000,0,180000,528200,0,708200,RPUD,RES/PUD,,,
18828,64-28-F-7-0,7724-91-9139,SNGL FAM URB,0.392,AC,210000,0,210000,672300,0,882300,180000,0,180000,638600,0,818600,RPUD,RES/PUD,,,
18829,64-28-F-8-0,7724-91-8107,SNGL FAM URB,0.428,AC,210000,0,210000,452200,33500,695700,180000,0,180000,430500,30900,641400,RPUD,RES/PUD,,,
18830,64-28-F-9-0,7724-91-7222,SNGL FAM URB,0.493,AC,210000,0,210000,500800,0,710800,180000,0,180000,471300,0,651300,RPUD,RES/PUD,,,
18831,64-28-F-10-0,7724-91-7410,SNGL FAM URB,0.537,AC,210000,0,210000,478100,0,688100,180000,0,180000,454700,0,634700,RPUD,RES/PUD,,,
18832,64-28-F-11-0,7724-91-8402,SNGL FAM URB,0.435,AC,210000,0,210000,645100,0,855100,180000,0,180000,617000,0,797000,RPUD,RES/PUD,,,
18833,64-28-F-12-0,7724-91-9430,SNGL FAM URB,0.428,AC,210000,0,210000,652800,0,862800,180000,0,180000,608500,0,788500,RPUD,RES/PUD,,,
18834,64-28-F-13-0,7734-01-0440,SNGL FAM URB,0.413,AC,210000,0,210000,485800,0,695800,180000,0,180000,457100,0,637100,RPUD,RES/PUD,,,
18835,64-28-F-14-0,7734-01-1359,SNGL FAM URB,0.382,AC,210000,0,210000,549700,0,759700,180000,0,180000,518300,0,698300,RPUD,RES/PUD,,,
18836,64-28-F-15-0,7734-01-2359,SNGL FAM URB,0.351,AC,210000,0,210000,448900,0,658900,180000,0,180000,423800,0,603800,RPUD,RES/PUD,,,
18837,64-28-F-16-0,7734-01-3379,SNGL FAM URB,0.348,AC,210000,0,210000,561000,0,771000,180000,0,180000,521900,0,701900,RPUD,RES/PUD,,,
18838,64-28-F-17-0,7734-01-4386,SNGL FAM URB,0.385,AC,210000,0,210000,598200,36600,844800,180000,0,180000,552700,34100,766800,RPUD,RES/PUD,,,
18839,64-28-F-18-0,7734-01-5385,SNGL FAM URB,0.441,AC,210000,0,210000,550100,12700,772800,180000,0,180000,513400,10900,704300,RPUD,RES/PUD,,,
18840,64-28-F-19-0,7734-01-3270,SNGL FAM URB,0.43,AC,210000,0,210000,583000,0,793000,180000,0,180000,548100,0,728100,RPUD,RES/PUD,,,
18841,64-28-F-20-0,7734-01-3054,SNGL FAM URB,0.369,AC,210000,0,210000,879200,15400,1104600,180000,0,180000,831700,13100,1024800,RPUD,RES/PUD,,,
18842,64-28-F-21-0,7734-00-3953,SNGL FAM URB,0.336,AC,210000,0,210000,635800,0,845800,180000,0,180000,612600,0,792600,RPUD,RES/PUD,,,
18843,64-28-F-22-0,7734-00-3753,SNGL FAM URB,0.394,AC,210000,0,210000,614700,0,824700,180000,0,180000,576600,0,756600,RPUD,RES/PUD,,,
18844,64-28-F-23-0,7734-00-3651,SNGL FAM URB,0.378,AC,210000,0,210000,503400,0,713400,180000,0,180000,480500,0,660500,RPUD,RES/PUD,,,
18845,64-28-F-24-0,7734-00-3449,SNGL FAM URB,0.398,AC,210000,0,210000,481200,0,691200,180000,0,180000,452100,0,632100,RPUD,RES/PUD,,,
18846,64-28-F-25-0,7734-00-3316,SNGL FAM URB,0.412,AC,210000,0,210000,544400,0,754400,180000,0,180000,511300,0,691300,RPUD,RES/PUD,,,
18847,64-28-F-26-0,7734-00-4164,SNGL FAM URB,0.398,AC,210000,0,210000,596100,5600,811700,180000,0,180000,548200,5100,733300,RPUD,RES/PUD,,,
18848,64-28-F-27-0,7734-00-4295,SNGL FAM URB,0.379,AC,210000,0,210000,585100,0,795100,180000,0,180000,547300,0,727300,RPUD,RES/PUD,,,
18849,64-28-F-28-0,7734-00-5316,SNGL FAM URB,0.31,AC,210000,0,210000,650800,0,860800,180000,0,180000,600500,0,780500,RPUD,RES/PUD,,,
18850,64-28-F-29-0,7734-00-5426,SNGL FAM URB,0.324,AC,210000,0,210000,559300,0,769300,180000,0,180000,517100,0,697100,RPUD,RES/PUD,,,
18851,64-28-F-30-0,7734-00-5538,SNGL FAM URB,0.341,AC,210000,0,210000,634000,0,844000,180000,0,180000,580600,0,760600,RPUD,RES/PUD,,,
18852,64-28-F-31-0,7734-00-5639,SNGL FAM URB,0.35,AC,210000,0,210000,658400,0,868400,180000,0,180000,627800,0,807800,RPUD,RES/PUD,,,
18853,64-28-F-32-0,7734-00-5830,SNGL FAM URB,0.333,AC,210000,0,210000,748900,0,958900,180000,0,180000,703400,0,883400,RPUD,RES/PUD,,,
18854,64-28-F-33-0,7734-00-5951,SNGL FAM URB,0.334,AC,210000,0,210000,777000,0,987000,180000,0,180000,706600,0,886600,RPUD,RES/PUD,,,
18855,64-28-F-34-0,7734-01-5072,SNGL FAM URB,0.374,AC,210000,0,210000,649600,0,859600,180000,0,180000,598200,0,778200,RPUD,RES/PUD,,,
18856,64-28-F-35-0,7734-01-6131,SNGL FAM URB,0.539,AC,210000,0,210000,725000,0,935000,180000,0,180000,704300,0,884300,RPUD,RES/PUD,,,
18857,64-28-F-36-0,7734-00-7910,SNGL FAM URB,0.339,AC,210000,0,210000,618100,25000,853100,180000,0,180000,571100,23700,774800,RPUD,RES/PUD,,,
18858,64-28-F-37-0,7734-00-7717,SNGL FAM URB,0.335,AC,210000,0,210000,617900,0,827900,180000,0,180000,575200,0,755200,RPUD,RES/PUD,,,
18859,64-28-F-38-0,7734-00-7616,SNGL FAM URB,0.331,AC,210000,0,210000,881400,0,1091400,180000,0,180000,816800,0,996800,RPUD,RES/PUD,,,
18860,64-28-F-39-0,7734-00-7505,SNGL FAM URB,0.332,AC,210000,0,210000,628500,0,838500,180000,0,180000,588100,0,768100,RPUD,RES/PUD,,,
18861,64-28-F-40-0,7734-00-6494,SNGL FAM URB,0.372,AC,210000,0,210000,512300,0,722300,180000,0,180000,479100,0,659100,RPUD,RES/PUD,,,
18862,64-28-F-41-0,7734-00-6393,SNGL FAM URB,0.389,AC,210000,0,210000,741200,0,951200,180000,0,180000,689800,0,869800,RPUD,RES/PUD,,,
18863,64-28-F-42-0,7734-00-6292,SNGL FAM URB,0.447,AC,210000,0,210000,732300,0,942300,180000,0,180000,683900,0,863900,RPUD,RES/PUD,,,
18864,64-28-F-43-0,7734-00-6170,SNGL FAM URB,0.412,AC,210000,0,210000,829100,0,1039100,180000,0,180000,769300,0,949300,RPUD,RES/PUD,,,
18865,64-28-F-44-0,7734-00-5081,SNGL FAM URB,0.4,AC,210000,0,210000,587000,0,797000,180000,0,180000,547700,0,727700,RPUD,RES/PUD,,,
18866,64-28-0-C-0,7734-00-0470,Cmn Area/Open Spc,7.306,AC,0,0,0,0,0,0,0,0,0,0,0,0,RPUD,RES/PUD,,,
18867,64-28-0-A-0,7723-99-9816,Cmn Area/Open Spc,0.767,AC,0,0,0,0,0,0,0,0,0,0,0,0,RPUD,RES/PUD,,,
18868,64-28-0-B-0,7734-00-0238,Cmn Area/Open Spc,15.133,AC,0,0,0,0,0,0,0,0,0,0,0,0,RPUD,RES/PUD,,,
18869,64-28-0-R-0,7734-00-0015,Roads,5.852,AC,0,0,0,0,0,0,0,0,0,0,0,0,RPUD,RES/PUD,,,
18870,10-14-0-1-0,6802-91-0353,SNGL FAM SUB,12.754,AC,93500,44700,48800,123400,2000,218900,90900,43800,47100,107200,2000,200100,A1,AG/GEN,,,
18871,10-14-0-2-0,6812-01-2550,SNGL FAM SUB,18.271,AC,100800,0,100800,0,0,100800,98400,0,98400,0,0,98400,A1,AG/GEN,,,
18872,10-14-0-3-0,6812-01-3042,SNGL FAM SUB,18.271,AC,100800,0,100800,0,0,100800,98400,0,98400,0,0,98400,A1,AG/GEN,,,
18873,10-14-0-4-0,6802-90-8526,SNGL FAM SUB,17.046,AC,97800,0,97800,0,0,97800,94200,0,94200,0,0,94200,A1,AG/GEN,,,
18874,26-1-0-50-B,6719-40-0485,SNGL FAM SUB,4.736,AC,59700,0,59700,243700,1400,304800,58500,0,58500,209600,1500,269600,A1,AG/GEN,,,
18875,26-1-0-50-B1,6719-40-3809,SNGL FAM SUB,3.264,AC,52600,0,52600,243700,1400,297700,51600,0,51600,209600,1500,262700,A1,AG/GEN,,,
18876,29-5-0-2-A1,6749-65-6376,SNGL FAM SUB,2.3,AC,66900,0,66900,0,0,66900,62800,0,62800,0,0,62800,A1,AG/GEN,,,
18877,29-5-0-2-A2,6749-65-5505,SNGL FAM SUB,2.32,AC,67100,0,67100,0,0,67100,63000,0,63000,0,0,63000,A1,AG/GEN,,,
18878,29-5-0-2-A3,6749-65-1743,SNGL FAM SUB,5.394,AC,95000,0,95000,0,0,95000,91200,0,91200,0,0,91200,A1,AG/GEN,,,
18879,31-11-0-5-A,6779-31-7212,SNGL FAM SUB,5.29,AC,125900,0,125900,418300,0,544200,112500,0,112500,339100,0,451600,RR,RES/RUR,,,
18880,38-15-0-1-0,6717-09-8547,SNGL FAM SUB,2.971,AC,49800,0,49800,218000,0,267800,48800,0,48800,191500,0,240300,A1,AG/GEN,,,
18881,38-15-0-2-0,6717-09-9805,SNGL FAM SUB,2.698,AC,48300,0,48300,233700,0,282000,47300,0,47300,205800,0,253100,A1,AG/GEN,,,
18882,38-15-0-3-0,6718-00-9147,SNGL FAM SUB,2.319,AC,46200,0,46200,220700,0,266900,45300,0,45300,191300,0,236600,A1,AG/GEN,,,
18883,38-15-0-4-0,6718-10-0550,SNGL FAM SUB,4.033,AC,55800,0,55800,189900,3400,249100,54700,0,54700,162900,3800,221400,A1,AG/GEN,,,
18884,46-1-0-76-D4,7707-32-4154,SNGL FAM SUB,3.65,AC,132900,0,132900,239200,1500,373600,122800,0,122800,212500,1500,336800,A2,AG/LTD,,,
18885,59-1-0-6-B,7726-67-5414,COMM & IND,5.191,AC,1227200,0,1227200,0,0,1227200,1115700,0,1115700,0,0,1115700,R3,RES/GEN,,,
18886,46-1-0-73-E,7707-63-6070,SNGL FAM SUB,5.164,AC,191400,0,191400,498000,43700,733100,170800,0,170800,421700,41800,634300,A2RR,AG& RUR,,,
18887,55-1-0-93-F,6785-65-2999,COMM & IND,0.392,AC,7300,0,7300,0,0,7300,6800,0,6800,0,0,6800,B1,BUS/GEN,,,
18888,55-1-0-93-G,6785-66-5137,COMM & IND,0.129,AC,9600,0,9600,0,0,9600,8900,0,8900,0,0,8900,B1,BUS/GEN,,,
18889,5-32-0-1-0,6823-46-3892,SNGL FAM SUB,3.655,AC,58100,0,58100,115000,4000,177100,56900,0,56900,91200,4000,152100,A1,AG/GEN,,,
18890,5-32-0-2-0,6823-47-6178,SNGL FAM SUB,3.661,AC,58100,0,58100,197600,27800,283500,57000,0,57000,169900,25700,252600,A1,AG/GEN,,,
18891,5-32-0-3-0,6823-47-9556,SNGL FAM SUB,3.571,AC,57600,0,57600,271900,18100,347600,56500,0,56500,236900,15600,309000,A1,AG/GEN,,,
18892,5-32-0-4-0,6823-57-2935,SNGL FAM SUB,3.601,AC,57800,0,57800,0,0,57800,56600,0,56600,0,0,56600,A1,AG/GEN,,,
18893,4-1-0-26-A1,6803-73-0372,SNGL FAM SUB,7.43,AC,75500,33400,42100,268300,4000,347800,70200,29400,40800,241300,4000,315500,A1,AG/GEN,,,
18894,39-1-0-42-B1,6727-02-6871,SNGL FAM SUB,3.567,AC,53200,0,53200,215400,0,268600,52100,0,52100,182600,0,234700,A1,AG/GEN,,,
18895,31-1-0-71-B,6779-10-2277,SNGL FAM SUB,4,AC,113300,111500,1800,0,0,113300,101300,99600,1700,0,0,101300,A2,AG/LTD,,,
18896,31-1-0-66-BT,6779-27-0414-9999,SNGL FAM SUB,2.93,AC,117900,0,117900,0,0,117900,116000,0,116000,0,0,116000,A2,AG/LTD,,,
18898,19-1-0-46-C,6831-71-5368,SNGL FAM SUB,5.189,AC,92400,36300,56100,210700,8000,311100,84700,33000,51700,177100,8000,269800,A1,AG/GEN,,,
18899,10-1-0-12-A,6801-23-4207,SNGL FAM SUB,15.552,AC,69700,0,69700,0,0,69700,67100,0,67100,0,0,67100,A1,AG/GEN,,,
18900,46-1-0-25-F,7707-13-3672,SNGL FAM SUB,2.951,AC,142300,0,142300,0,0,142300,127000,0,127000,0,0,127000,A2,AG/LTD,,,
18901,46-1-0-25-G,7707-13-3837,SNGL FAM SUB,2.951,AC,142300,0,142300,261300,1000,404600,127000,0,127000,223500,1000,351500,A2,AG/LTD,,,
18902,45-1-0-58-A1,6797-07-9706,SNGL FAM SUB,2.53,AC,99800,0,99800,0,0,99800,89200,0,89200,0,0,89200,A2,AG/LTD,,,
18903,45-1-0-58-A2,6797-17-1590,SNGL FAM SUB,2,AC,91800,0,91800,304000,0,395800,82000,0,82000,252600,0,334600,A2,AG/LTD,,,
18904,48-15-0-2-A,7727-58-2083,COMM & IND,2.498,AC,451400,0,451400,0,0,451400,429900,0,429900,0,0,429900,M2,INDUS/G,,,
18905,26-15-0-D-2,6708-97-6025,SNGL FAM SUB,5,AC,61200,0,61200,0,0,61200,60000,0,60000,0,0,60000,A1,AG/GEN,,,
18906,30-1-0-100-H,6768-17-0348,SNGL FAM SUB,6.727,AC,119000,0,119000,342900,0,461900,112500,0,112500,283400,0,395900,RR,RES/RUR,,,
18907,18-15-0-1-0,6810-76-5844,SNGL FAM SUB,3.817,AC,50600,0,50600,0,0,50600,45000,0,45000,0,0,45000,A1,AG/GEN,,,
18908,18-15-0-2-0,6810-76-6598,SNGL FAM SUB,2.417,AC,48500,0,48500,284000,0,332500,44400,0,44400,233300,0,277700,A1,AG/GEN,,,
18909,18-15-0-3-0,6810-76-7491,SNGL FAM SUB,2.551,AC,49300,0,49300,265000,0,314300,45000,0,45000,211600,0,256600,A1,AG/GEN,,,
18910,18-15-0-4-0,6810-76-8293,SNGL FAM SUB,3.115,AC,52700,0,52700,248600,0,301300,47500,0,47500,199200,0,246700,A1,AG/GEN,,,
18954,46-1-0-4-A,7707-59-1724,AG > 100 AC,222.206,AC,3351100,3091000,260100,180600,1500,3533200,2994900,2768200,226700,151500,1500,3147900,A2,AG/LTD,,,
18960,27-1-0-30-B,6728-33-2333,SNGL FAM SUB,2,AC,44900,0,44900,150500,17800,213200,44000,0,44000,128600,17000,189600,A1,AG/GEN,,,
18961,6-1-0-19-A1,6823-71-6403,COMM & IND,0.09,AC,4200,0,4200,0,3500,7700,4100,0,4100,0,3500,7600,B1,BUS/GEN,,,
18996,43-37-B-7-0,6767-54-2294,SNGL FAM SUB,2.062,AC,88000,0,88000,243400,0,331400,80000,0,80000,223100,0,303100,R1,RES/LTD,,,
18997,43-37-B-8-0,6767-44-9265,SNGL FAM SUB,1.809,AC,88000,0,88000,282300,0,370300,80000,0,80000,258300,0,338300,R1,RES/LTD,,,
18998,43-37-B-9-0,6767-44-6295,SNGL FAM SUB,1.612,AC,88000,0,88000,287300,2900,378200,80000,0,80000,264600,2900,347500,R1,RES/LTD,,,
18999,43-37-B-10-0,6767-44-8050,SNGL FAM SUB,2.657,AC,88000,0,88000,350800,0,438800,80000,0,80000,318800,0,398800,R1,RES/LTD,,,
19000,43-37-B-11-0,6767-43-8797,SNGL FAM SUB,2.641,AC,88000,0,88000,342700,0,430700,80000,0,80000,311200,0,391200,R1,RES/LTD,,,
19001,43-37-B-12-0,6767-43-8388,SNGL FAM SUB,1.829,AC,88000,0,88000,382600,0,470600,80000,0,80000,348300,0,428300,R1,RES/LTD,,,
19002,43-37-B-13-0,6767-43-9154,SNGL FAM SUB,2.26,AC,88000,0,88000,356200,0,444200,80000,0,80000,327000,0,407000,R1,RES/LTD,,,
19003,43-37-B-14-0,6767-42-8849,SNGL FAM SUB,3.738,AC,92400,0,92400,399000,23300,514700,84000,0,84000,358100,21700,463800,R1,RES/LTD,,,
19004,43-37-B-15-0,6767-43-4076,SNGL FAM SUB,1.769,AC,88000,0,88000,277300,5200,370500,80000,0,80000,254500,5000,339500,R1,RES/LTD,,,
19005,43-37-B-16-0,6767-43-4330,SNGL FAM SUB,1.943,AC,88000,0,88000,275700,0,363700,80000,0,80000,250700,0,330700,R1,RES/LTD,,,
19006,43-37-B-17-0,6767-43-4539,SNGL FAM SUB,1.866,AC,88000,0,88000,294800,0,382800,80000,0,80000,268200,0,348200,R1,RES/LTD,,,
19007,43-37-B-18-0,6767-43-4800,SNGL FAM SUB,1.691,AC,88000,0,88000,388200,0,476200,80000,0,80000,351500,0,431500,R1,RES/LTD,,,
19008,43-37-B-19-0,6767-44-3070,SNGL FAM SUB,1.522,AC,88000,0,88000,338600,31900,458500,80000,0,80000,309600,30300,419900,R1,RES/LTD,,,
19009,43-37-B-20-0,6767-44-3262,SNGL FAM SUB,1.585,AC,88000,0,88000,289500,200,377700,80000,0,80000,266900,200,347100,R1,RES/LTD,,,
19010,43-37-B-21-0,6767-44-0084,SNGL FAM SUB,1.519,AC,88000,0,88000,249700,0,337700,80000,0,80000,230000,0,310000,R1,RES/LTD,,,
19011,43-37-B-22-0,6767-43-1703,SNGL FAM SUB,1.825,AC,88000,0,88000,274000,0,362000,80000,0,80000,250900,0,330900,R1,RES/LTD,,,
19012,43-37-B-23-0,6767-33-8688,SNGL FAM SUB,1.641,AC,88000,0,88000,256200,0,344200,80000,0,80000,236500,0,316500,R1,RES/LTD,,,
19013,43-37-B-24-0,6767-33-7867,SNGL FAM SUB,1.527,AC,88000,0,88000,264600,0,352600,80000,0,80000,243000,0,323000,R1,RES/LTD,,,
19014,43-37-B-A-0,6767-42-5536,Cmn Area/Open Spc,19.528,AC,0,0,0,0,0,0,0,0,0,0,0,0,R1,RES/LTD,,,
19015,43-37-B-B-0,6767-43-9517,Cmn Area/Open Spc,1.067,AC,0,0,0,0,0,0,0,0,0,0,0,0,R1,RES/LTD,,,
19016,43-37-B-C-0,6767-54-6241,Cmn Area/Open Spc,0.345,AC,0,0,0,0,0,0,0,0,0,0,0,0,R1,RES/LTD,,,
19017,43-37-C-1-0,6767-44-3545,SNGL FAM SUB,1.979,AC,88000,0,88000,356200,0,444200,80000,0,80000,323200,0,403200,R1,RES/LTD,,,
19018,43-37-C-2-0,6767-44-1428,SNGL FAM SUB,1.957,AC,88000,0,88000,270000,0,358000,80000,0,80000,247300,0,327300,R1,RES/LTD,,,
19019,43-37-C-3-0,6767-34-9444,SNGL FAM SUB,2.481,AC,88000,0,88000,246400,12500,346900,80000,0,80000,224900,8800,313700,R1,RES/LTD,,,
19020,43-37-C-4-0,6767-34-7362,SNGL FAM SUB,2.102,AC,88000,0,88000,323400,0,411400,80000,0,80000,296100,0,376100,R1,RES/LTD,,,
19021,43-37-C-5-0,6767-34-5258,SNGL FAM SUB,2.501,AC,88000,0,88000,351600,0,439600,80000,0,80000,320200,0,400200,R1,RES/LTD,,,
19022,43-37-C-A-0,6767-34-5643,Cmn Area/Open Spc,2.462,AC,0,0,0,0,0,0,0,0,0,0,0,0,R1,RES/LTD,,,
19023,43-37-0-R-0,6767-44-1275,Roads,2.758,AC,0,0,0,0,0,0,0,0,0,0,0,0,R1,RES/LTD,,,
19024,9-1-0-77-G,5892-96-1725,SNGL FAM SUB,2,AC,42400,0,42400,289800,1100,333300,41000,0,41000,162300,100,203400,A1,AG/GEN,,,
19025,51-1-0-52-A,6736-52-2888,SNGL FAM SUB,2,AC,38600,0,38600,204400,1400,244400,37800,0,37800,174500,1500,213800,A1,AG/GEN,,,
19026,32-1-0-33-G,6778-66-0436,SNGL FAM SUB,7.649,AC,131300,0,131300,372900,0,504200,117000,0,117000,304900,0,421900,A2,AG/LTD,,,
19027,39-1-0-48-C3,6716-99-9999,SNGL FAM SUB,19.535,AC,124100,104600,19500,0,0,124100,121400,102800,18600,0,0,121400,RR,RES/RUR,,,
19028,39-1-0-48-C4,6717-90-2889,AG 20-100 AC,20.484,AC,128400,0,128400,251200,0,379600,125700,0,125700,222700,0,348400,RR,RES/RUR,,,
19029,13-1-0-1-D1,6842-40-1004,SNGL FAM SUB,17.74,AC,37900,29700,8200,0,0,37900,37500,30000,7500,0,0,37500,A1,AG/GEN,,,
19030,19-1-0-54-D2,6830-56-1490,SNGL FAM SUB,11.008,AC,115200,110100,5100,0,0,115200,112000,107300,4700,0,0,112000,A1,AG/GEN,,,
19031,19-1-0-54-D3,6830-56-9113,SNGL FAM SUB,16.933,AC,146500,138700,7800,0,0,146500,140700,133500,7200,0,0,140700,A1,AG/GEN,,,
19032,19-1-0-54-D4,6830-54-5904,SNGL FAM SUB,11.333,AC,132600,127100,5500,0,0,132600,125300,120500,4800,0,0,125300,A1,AG/GEN,,,
19033,6-1-0-51-A,6832-19-4559,SNGL FAM SUB,4.284,AC,53700,0,53700,0,0,53700,52200,0,52200,0,0,52200,A1,AG/GEN,,,
19034,6-1-0-21-B,6833-01-4708,COMM & IND,10.08,AC,420900,0,420900,241600,218000,880500,408800,0,408800,230000,219900,858700,B1,BUS/GEN,,,
19036,20-27-0-1-0,6840-55-9815,AG 20-100 AC,51.36,AC,331400,289700,41700,0,100000,431400,318400,296500,21900,0,100000,418400,A1,AG/GEN,,,
19037,20-27-0-2-0,6840-56-7702,SNGL FAM SUB,15,AC,133600,115500,18100,0,0,133600,126700,108700,18000,0,0,126700,A1,AG/GEN,,,
19038,20-27-0-3-0,6840-46-7605,AG 20-100 AC,31.68,AC,202800,188200,14600,0,0,202800,196400,182900,13500,0,0,196400,A1,AG/GEN,,,
19039,20-27-0-4-0,6840-45-6796,SNGL FAM SUB,10.38,AC,127400,122600,4800,0,0,127400,118400,114000,4400,0,0,118400,A1,AG/GEN,,,
19040,20-27-0-5-0,6840-46-1080,SNGL FAM SUB,10,AC,125400,120800,4600,0,0,125400,124600,120300,4300,0,0,124600,A1,AG/GEN,,,
19041,20-1-0-47-A,6840-48-5031,SNGL FAM SUB,1.35,AC,4900,0,4900,0,0,4900,4200,0,4200,0,0,4200,A1,AG/GEN,,,
19042,20-1-0-47-B,6840-47-9896,SNGL FAM SUB,0.06,AC,600,0,600,0,0,600,400,0,400,0,0,400,A1,AG/GEN,,,
19043,46-35-0-G-1,7717-18-8589,SNGL FAM SUB,3,AC,136800,135300,1500,0,0,136800,122100,120800,1300,0,0,122100,A2,AG/LTD,,,
19044,21-1-0-15-E,6850-53-3383,Cemetery,0,AC,100,0,100,0,0,100,100,0,100,0,0,100,A2,AG/LTD,,,
19045,47-1-0-53-B,7717-88-8720,SNGL FAM SUB,13.41,AC,307600,0,307600,0,0,307600,274900,0,274900,0,0,274900,A2,AG/LTD,,,
19046,58-46-0-1-0,7716-95-7447,SNGL FAM URB,0.21,AC,130000,0,130000,396500,0,526500,125000,0,125000,374000,0,499000,RPUD,RES/PUD,,,
19047,58-46-0-2-0,7716-95-6474,SNGL FAM URB,0.21,AC,130000,0,130000,404400,0,534400,125000,0,125000,392500,0,517500,RPUD,RES/PUD,,,
19048,58-46-0-3-0,7716-95-6410,SNGL FAM URB,0.23,AC,130000,0,130000,339900,0,469900,125000,0,125000,323900,0,448900,RPUD,RES/PUD,,,
19049,58-46-0-4-0,7716-95-5328,SNGL FAM URB,0.31,AC,130000,0,130000,370300,0,500300,125000,0,125000,358200,0,483200,RPUD,RES/PUD,,,
19050,58-46-0-5-0,7716-95-4430,SNGL FAM URB,0.31,AC,130000,0,130000,446000,0,576000,125000,0,125000,427800,0,552800,RPUD,RES/PUD,,,
19051,58-46-0-6-0,7716-95-4510,SNGL FAM URB,0.26,AC,130000,0,130000,385000,0,515000,125000,0,125000,370400,0,495400,RPUD,RES/PUD,,,
19052,58-46-0-7-0,7716-95-4610,SNGL FAM URB,0.29,AC,130000,0,130000,364900,0,494900,125000,0,125000,355200,0,480200,RPUD,RES/PUD,,,
19053,58-46-0-8-0,7716-95-2763,SNGL FAM URB,0.27,AC,130000,0,130000,367800,0,497800,125000,0,125000,354200,0,479200,RPUD,RES/PUD,,,
19054,58-46-0-9-0,7716-95-2645,SNGL FAM URB,0.27,AC,130000,0,130000,378900,0,508900,125000,0,125000,358400,0,483400,RPUD,RES/PUD,,,
19055,58-46-0-10-0,7716-95-2538,SNGL FAM URB,0.24,AC,130000,0,130000,346700,0,476700,125000,0,125000,332000,0,457000,RPUD,RES/PUD,,,
19056,58-46-0-11-0,7716-95-2530,SNGL FAM URB,0.23,AC,130000,0,130000,398800,0,528800,125000,0,125000,382300,0,507300,RPUD,RES/PUD,,,
19057,58-46-0-12-0,7716-95-2452,SNGL FAM URB,0.23,AC,130000,0,130000,381200,0,511200,125000,0,125000,366600,0,491600,RPUD,RES/PUD,,,
19058,58-46-0-13-0,7716-95-2364,SNGL FAM URB,0.26,AC,130000,0,130000,343300,0,473300,125000,0,125000,331600,0,456600,RPUD,RES/PUD,,,
19059,58-46-0-14-0,7716-95-2265,SNGL FAM URB,0.24,AC,130000,0,130000,334400,0,464400,125000,0,125000,319500,0,444500,RPUD,RES/PUD,,,
19060,58-46-0-15-0,7716-95-2185,SNGL FAM URB,0.34,AC,130000,0,130000,389200,0,519200,125000,0,125000,372500,0,497500,RPUD,RES/PUD,,,
19061,58-46-0-16-0,7716-95-3167,SNGL FAM URB,0.26,AC,130000,0,130000,325300,0,455300,125000,0,125000,311300,0,436300,RPUD,RES/PUD,,,
19062,58-46-0-17-0,7716-95-4159,SNGL FAM URB,0.24,AC,130000,0,130000,447000,0,577000,125000,0,125000,424200,0,549200,RPUD,RES/PUD,,,
19063,58-46-0-18-0,7716-95-5221,SNGL FAM URB,0.24,AC,130000,0,130000,344000,0,474000,125000,0,125000,332000,0,457000,RPUD,RES/PUD,,,
19064,58-46-0-19-0,7716-95-6213,SNGL FAM URB,0.23,AC,130000,0,130000,357400,0,487400,125000,0,125000,339300,0,464300,RPUD,RES/PUD,,,
19065,58-46-0-20-0,7716-95-6295,SNGL FAM URB,0.25,AC,130000,0,130000,291000,0,421000,125000,0,125000,282000,0,407000,RPUD,RES/PUD,,,
19066,58-46-0-21-0,7716-95-7350,SNGL FAM URB,0.3,AC,130000,0,130000,370500,0,500500,125000,0,125000,357600,0,482600,RPUD,RES/PUD,,,
19068,58-46-0-A-0,7716-95-6114,Cmn Area/Open Spc,2.1,AC,0,0,0,0,0,0,0,0,0,0,0,0,RPUD,RES/PUD,,,
19069,12-1-0-47-B,6831-45-0658,SNGL FAM SUB,2.1,AC,47500,0,47500,218700,800,267000,45800,0,45800,180500,800,227100,A1,AG/GEN,,,
19070,30-1-0-100-I,6768-17-2719,SNGL FAM SUB,7.334,AC,125200,0,125200,0,0,125200,115800,0,115800,0,0,115800,RR,RES/RUR,,,
19071,16-1-0-77-A1,5890-80-1484,SNGL FAM SUB,10,AC,62300,0,62300,0,500,62800,60500,0,60500,0,500,61000,A1,AG/GEN,,,
19072,29-1-0-95-A,6759-06-0055,SNGL FAM SUB,9.54,AC,129500,0,129500,0,0,129500,130200,0,130200,0,0,130200,A1,AG/GEN,,,
19073,18-1-0-22-D,6810-51-4811,AG > 100 AC,274.662,AC,622900,494900,128000,0,28100,651000,604300,487400,116900,0,26200,630500,A1,AG/GEN,,,
19074,58-17-0-A-2,7716-53-9057,SNGL FAM SUB,3,AC,167700,0,167700,354400,0,522100,145900,0,145900,309500,0,455400,A2,AG/LTD,,,
19075,1-1-0-22-K,6804-66-5307,SNGL FAM SUB,6.02,AC,65300,0,65300,221800,18500,305600,64100,0,64100,195900,16600,276600,A1,AG/GEN,,,
19076,51-1-0-55-A1,6736-73-3939,AG > 100 AC,152.675,AC,389300,318900,70400,0,0,389300,381700,316800,64900,0,0,381700,A1,AG/GEN,,,
19077,10-12-0-4-A,6812-11-2925,SNGL FAM SUB,4.84,AC,56500,0,56500,313300,37300,407100,53400,0,53400,285300,30900,369600,A1,AG/GEN,,,
19078,12-1-0-43-B,6831-24-7886,SNGL FAM SUB,7,AC,74100,0,74100,117500,3400,195000,70700,0,70700,91400,3400,165500,A1,AG/GEN,,,
19079,26-1-0-69-B,6719-25-7585,SNGL FAM SUB,3.018,AC,52100,0,52100,248400,22500,323000,50100,0,50100,223500,18400,292000,A1,AG/GEN,,,
19080,26-1-0-69-A,6719-25-5457,SNGL FAM SUB,5.11,AC,64100,0,64100,0,0,64100,62700,0,62700,0,0,62700,A1,AG/GEN,,,
19081,51-1-0-55-C,6736-90-2376,AG 20-100 AC,84.328,AC,258000,219100,38900,0,0,258000,253000,217200,35800,0,0,253000,A1,AG/GEN,,,
19082,5-1-0-24-B,6812-99-2400,SNGL FAM SUB,2,AC,44800,0,44800,0,0,44800,44000,0,44000,0,0,44000,A1,AG/GEN,,,
19083,47-12-0-2-B2,7717-16-3289,SNGL FAM SUB,2,AC,120300,0,120300,401800,60300,582400,107500,0,107500,342300,52800,502600,A2,AG/LTD,,,
19084,31-2-0-2-B1,6769-30-9136,SNGL FAM SUB,7.649,AC,135500,0,135500,0,2300,137800,120900,0,120900,0,2300,123200,A2,AG/LTD,,,
19085,28-1-0-81-A,6739-34-9342,SNGL FAM SUB,3,AC,60800,0,60800,0,0,60800,60300,0,60300,0,0,60300,A1,AG/GEN,,,
19086,4-1-0-6-F2,6803-55-8998,SNGL FAM SUB,8,AC,76700,0,76700,0,84200,160900,73000,0,73000,0,80000,153000,A1,AG/GEN,,,
19088,12-1-0-59-C1,6832-41-3950,SNGL FAM SUB,4,AC,62800,0,62800,239500,2800,305100,61200,0,61200,206700,1900,269800,A1,AG/GEN,,,
19089,2-1-0-1-B,6814-59-9010,SNGL FAM SUB,8.02,AC,64100,60400,3700,0,0,64100,63000,59600,3400,0,0,63000,A1,AG/GEN,,,
19090,42-1-0-59-A2,6757-85-8148,SNGL FAM SUB,3.922,,137300,0,137300,0,0,137300,90700,0,90700,0,0,90700,R3,RES/GEN,,,
19091,33-1-0-11-A1,6798-22-9960,AG 20-100 AC,36.13,,442800,426100,16700,0,0,442800,408500,393100,15400,0,0,408500,B1A2,BS AND,,,
19092,56-1-0-64-A,6796-53-0471,SNGL FAM SUB,3.54,,160200,0,160200,270300,4000,434500,139300,0,139300,230300,4000,373600,A2,AG/LTD,,,
19093,18-1-0-65-B1,6820-63-3518,SNGL FAM SUB,3.532,,55000,0,55000,352800,52300,460100,51900,0,51900,297100,49200,398200,A1,AG/GEN,,,
19094,17-6-0-A-1,6810-24-9682,SNGL FAM SUB,2.31,,47900,0,47900,479300,0,527200,45200,0,45200,403000,0,448200,A1,AG/GEN,,,
19095,58-47-0-1-0,7726-05-3761,SNGL FAM URB,0.28,,130000,0,130000,388100,0,518100,125000,0,125000,371400,0,496400,RPUD,RES/PUD,,,
19096,58-47-0-2-0,7726-05-3652,SNGL FAM URB,0.26,,130000,0,130000,334900,0,464900,125000,0,125000,322200,0,447200,RPUD,RES/PUD,,,
19097,58-47-0-3-0,7726-05-3544,SNGL FAM URB,0.29,,130000,0,130000,375800,0,505800,125000,0,125000,362800,0,487800,RPUD,RES/PUD,,,
19098,58-47-0-4-0,7726-05-3426,SNGL FAM URB,0.36,,130000,0,130000,334800,0,464800,125000,0,125000,323700,0,448700,RPUD,RES/PUD,,,
19099,58-47-0-5-0,7726-05-2480,SNGL FAM URB,0.3,,130000,0,130000,338900,0,468900,125000,0,125000,319600,0,444600,RPUD,RES/PUD,,,
19100,58-47-0-6-0,7726-05-2308,SNGL FAM URB,0.26,,130000,0,130000,442300,0,572300,125000,0,125000,416000,0,541000,RPUD,RES/PUD,,,
19101,58-47-0-7-0,7726-05-0375,SNGL FAM URB,0.27,,130000,0,130000,411100,0,541100,125000,0,125000,393800,0,518800,RPUD,RES/PUD,,,
19102,58-47-0-8-0,7716-95-9384,SNGL FAM URB,0.3,,130000,0,130000,398700,0,528700,125000,0,125000,379200,0,504200,RPUD,RES/PUD,,,
19103,58-47-0-9-0,7716-95-9302,SNGL FAM URB,0.31,,130000,0,130000,467700,0,597700,125000,0,125000,442000,0,567000,RPUD,RES/PUD,,,
19104,58-47-0-10-0,7716-95-8330,SNGL FAM URB,0.3,,130000,0,130000,432000,0,562000,125000,0,125000,406800,0,531800,RPUD,RES/PUD,,,
19105,58-47-0-11-0,7716-95-8419,SNGL FAM URB,0.21,,130000,0,130000,395100,0,525100,125000,0,125000,364700,0,489700,RPUD,RES/PUD,,,
19106,58-47-0-12-0,7716-95-8591,SNGL FAM URB,0.22,,130000,0,130000,403500,0,533500,125000,0,125000,383400,0,508400,RPUD,RES/PUD,,,
19107,58-47-0-13-0,7716-95-9562,SNGL FAM URB,0.22,,130000,0,130000,386700,0,516700,125000,0,125000,360300,0,485300,RPUD,RES/PUD,,,
19108,58-47-0-14-0,7726-05-0543,SNGL FAM URB,0.21,,130000,0,130000,426800,0,556800,125000,0,125000,417100,0,542100,RPUD,RES/PUD,,,
19109,58-47-0-15-0,7726-05-1534,SNGL FAM URB,0.25,,130000,0,130000,408100,0,538100,125000,0,125000,388000,0,513000,RPUD,RES/PUD,,,
19110,58-47-0-16-0,7726-05-1589,SNGL FAM URB,0.21,,130000,0,130000,341500,0,471500,125000,0,125000,326300,0,451300,RPUD,RES/PUD,,,
19111,10-1-0-25-E,6801-86-2781,AG 20-100 AC,25.523,,127500,106500,21000,0,0,127500,123800,108300,15500,0,0,123800,A1,AG/GEN,,,
19112,58-47-0-A-0,7726-05-3354,Cmn Area/Open Spc,1.34,,0,0,0,0,0,0,0,0,0,0,0,0,RPUD,RES/PUD,,,
19113,25-1-0-3-C,5799-61-5826,SNGL FAM SUB,5.244,,58300,17300,41000,111600,8600,178500,57100,17300,39800,95900,7800,160800,A1,AG/GEN,,,
19114,58-31-0-4-B,7715-76-9733,SNGL FAM URB,1.455,,460600,0,460600,565900,0,1026500,440000,0,440000,558500,0,998500,RPUD,RES/PUD,,,
19115,18-4-0-4-H1,6820-20-5424,SNGL FAM SUB,5.301,,65100,0,65100,319000,0,384100,63800,0,63800,266100,0,329900,A1,AG/GEN,,,
19116,32-1-0-17-A,6779-73-7457,SNGL FAM SUB,4,,107300,0,107300,0,0,107300,95900,0,95900,0,0,95900,A2,AG/LTD,,,
19117,32-1-0-17-B,6779-73-9882,SNGL FAM SUB,3.716,,103200,0,103200,400900,0,504100,92200,0,92200,327600,0,419800,A2,AG/LTD,,,
19118,63-14-A-4-R,7714-83-7584,Roads,0.952,,0,0,0,0,0,0,0,0,0,0,0,0,A2,AG/LTD,,,
19119,26-1-0-5-C,6709-75-2734,SNGL FAM SUB,11.65,,94500,0,94500,153400,1000,248900,91300,0,91300,127300,1000,219600,A1,AG/GEN,,,
19120,42-38-0-3-0,6767-34-1269,SNGL FAM SUB,11.088,,149500,0,149500,587800,0,737300,138700,0,138700,544800,0,683500,R1,RES/LTD,,,
19121,42-38-0-2-0,6767-33-1554,SNGL FAM SUB,11.65,,156500,0,156500,332800,0,489300,145300,0,145300,302200,0,447500,R1,RES/LTD,,,
19122,42-38-0-1-0,6767-33-1186,SNGL FAM SUB,11.92,,116900,0,116900,0,0,116900,108600,0,108600,0,0,108600,R1,RES/LTD,,,
19123,42-38-0-R-0,6767-33-5931,Roads,0.295,,0,0,0,0,0,0,0,0,0,0,0,0,R1,RES/LTD,,,
19124,26-15-0-D-3A,6718-06-0986,Cemetery,0,,100,0,100,0,0,100,100,0,100,0,0,100,A1,AG/GEN,,,
19125,26-15-0-D-3,6718-06-2967,SNGL FAM SUB,5,,61200,0,61200,224100,800,286100,60000,0,60000,191700,800,252500,A1,AG/GEN,,,
19126,64-1-0-86-0,7724-52-2049,SNGL FAM SUB,8.1,,165200,101600,63600,0,0,165200,143400,88100,55300,0,0,143400,ROA2,RESIDEN,,,
19127,63-1-0-203-0,7723-39-2143,SNGL FAM SUB,14.084,,287300,280800,6500,0,0,287300,249300,243300,6000,0,0,249300,A2,AG/LTD,,,
19128,44-20-0-5-B1,6787-41-1738,SNGL FAM SUB,3,,76600,0,76600,0,0,76600,68400,0,68400,0,0,68400,A2,AG/LTD,,,
19129,10-1-0-36-A2,6812-43-3899,SNGL FAM SUB,8.432,,73700,0,73700,327600,0,401300,72400,0,72400,277800,0,350200,A1,AG/GEN,,,
19130,10-1-0-36-A1,6812-54-1427,SNGL FAM SUB,9.364,,78100,0,78100,0,0,78100,76600,0,76600,0,0,76600,A1,AG/GEN,,,
19131,10-1-0-28-B1,6812-30-0998,AG 20-100 AC,20.725,,73800,63900,9900,0,0,73800,72500,63600,8900,0,0,72500,A1,AG/GEN,,,
19132,47-12-0-2-B3,7717-26-7106,SNGL FAM SUB,14,,389200,0,389200,0,37600,426800,347500,0,347500,0,35000,382500,A2,AG/LTD,,,
19133,48-1-0-56-A,7738-21-5725,COMM & IND,3.98,AC,468400,0,468400,1645500,448500,2562400,446200,0,446200,1713100,276200,2435500,B1,BUS/GEN,,,
19134,26-1-0-5-C1,6709-75-3396,Cemetery,0,,100,0,100,0,0,100,100,0,100,0,0,100,A1,AG/GEN,,,
19135,27-1-0-69-B,6728-67-2756,Cemetery,0,,100,0,100,0,0,100,100,0,100,0,0,100,A1,AG/GEN,,,
19136,45-1-0-91-A1,6797-86-6714,SNGL FAM SUB,4.508,,132100,0,132100,50800,0,182900,118000,0,118000,43200,0,161200,A2,AG/LTD,,,
19137,16-1-0-64-A,6800-15-5841,SNGL FAM SUB,2,,43400,0,43400,92800,500,136700,42500,0,42500,80600,500,123600,A1,AG/GEN,,,
19138,40-3-0-A-2,6737-29-3390,AG 20-100 AC,28.895,,200300,187000,13300,0,0,200300,195000,182700,12300,0,0,195000,A1,AG/GEN,,,
19139,42-1-0-78-TW,6767-08-6689-9998,General Gov,0,,0,0,0,0,122800,122800,0,0,0,0,120000,120000,A2,AG/LTD,,,
19140,63-40-0-1-0,7714-49-1598,SNGL FAM SUB,5.016,,275000,0,275000,637300,0,912300,250000,0,250000,588300,0,838300,RR,RES/RUR,,,
19141,63-40-0-2-0,7715-30-9075,SNGL FAM SUB,5.249,,275000,0,275000,633000,47700,955700,250000,0,250000,583800,44500,878300,RR,RES/RUR,,,
19142,63-40-0-3-0,7715-30-6202,SNGL FAM SUB,5.254,,275000,0,275000,1263800,88800,1627600,250000,0,250000,1152800,81100,1483900,RR,RES/RUR,,,
19143,63-40-0-4-0,7715-30-3119,SNGL FAM SUB,5.107,,275000,0,275000,773100,0,1048100,250000,0,250000,708400,0,958400,RR,RES/RUR,,,
19144,63-40-0-5-0,7714-39-3629,SNGL FAM SUB,5.736,,275000,0,275000,592900,0,867900,250000,0,250000,551600,0,801600,RR,RES/RUR,,,
19145,63-40-0-6-0,7714-39-6446,SNGL FAM SUB,5.082,,275000,0,275000,629800,107100,1011900,250000,0,250000,575300,91900,917200,RR,RES/RUR,,,
19146,63-40-0-7-0,7714-38-9917,SNGL FAM SUB,5.655,,275000,0,275000,634900,26800,936700,250000,0,250000,583700,22600,856300,RR,RES/RUR,,,
19147,63-40-0-8-0,7714-48-3683,SNGL FAM SUB,5.074,,275000,0,275000,912400,13900,1201300,250000,0,250000,852000,11800,1113800,RR,RES/RUR,,,
19148,63-40-0-A-0,7714-49-2282,Cmn Area/Open Spc,8.313,,0,0,0,0,0,0,0,0,0,0,0,0,RR,RES/RUR,,,
19149,63-40-0-B-0,7714-48-0488,Cmn Area/Open Spc,8.261,,0,0,0,0,0,0,0,0,0,0,0,0,RR,RES/RUR,,,
19150,63-40-0-C-0,7714-29-7567,Cmn Area/Open Spc,2.707,,0,0,0,0,0,0,0,0,0,0,0,0,RR,RES/RUR,,,
19151,63-40-0-R-0,7714-39-6204,Roads,3.858,,0,0,0,0,0,0,0,0,0,0,0,0,RR,RES/RUR,,,
19152,45-17-0-F-1,6796-59-5169,SNGL FAM SUB,5.523,,157300,0,157300,0,0,157300,140300,0,140300,0,0,140300,A2,AG/LTD,,,
19153,27-1-0-70-B1,6729-51-9164,Cemetery,0,,100,0,100,0,0,100,100,0,100,0,0,100,A1,AG/GEN,,,
19154,32-1-0-31-A1,6778-57-8956,SNGL FAM SUB,3,,92900,0,92900,0,0,92900,83000,0,83000,0,0,83000,A2,AG/LTD,,,
19156,38-1-0-37-C,6707-64-0758,Cemetery,0,,100,0,100,0,0,100,100,0,100,0,0,100,A1,AG/GEN,,,
19157,63-14-0-A-5,7714-74-9308,MultiFamily,0.51,,33200,0,33200,0,0,33200,32500,0,32500,0,0,32500,R3,RES/GEN,,,
19158,55-1-0-64-A1,6786-64-4984,SNGL FAM SUB,4.73,,131600,0,131600,0,0,131600,117400,0,117400,0,0,117400,A2,AG/LTD,,,
19159,55-1-0-64-A3,6786-55-7100,SNGL FAM SUB,4.73,,119400,0,119400,0,0,119400,106700,0,106700,0,0,106700,A2,AG/LTD,,,
19160,55-1-0-64-A4,6786-54-3922,SNGL FAM SUB,4.73,,119400,0,119400,0,0,119400,106700,0,106700,0,0,106700,A2,AG/LTD,,,
19161,18-1-0-6-B2,6810-87-1810,SNGL FAM SUB,3.684,,55900,0,55900,216200,2000,274100,54100,0,54100,178400,0,232500,A1,AG/GEN,,,
19162,40-1-0-32-A,6737-57-4485,AG > 100 AC,220.983,,815400,713500,101900,0,0,815400,795500,701600,93900,0,0,795500,A1,AG/GEN,,,
19163,48-1-0-7-C,7728-81-6694,SNGL FAM SUB,2,,127200,0,127200,256400,2000,385600,113600,0,113600,216200,2000,331800,A2,AG/LTD,,,
19164,6-13-0-41-B,6833-52-1445,COMM & IND,3.671,,154200,0,154200,0,0,154200,149800,0,149800,0,0,149800,M2,INDUS/G,,,
19165,6-13-0-41-A2,6833-42-8175-0002,COMM & IND,1,,39900,0,39900,205600,71100,316600,38800,0,38800,206000,70400,315200,M2,INDUS/G,,,
19166,6-13-0-41-A3,6833-42-8175-0003,COMM & IND,1,,39900,0,39900,209500,71900,321300,38800,0,38800,210200,70400,319400,M2,INDUS/G,,,
19167,12-1-0-6-C,6822-85-3749,SNGL FAM SUB,11.861,,100100,89100,11000,14900,3100,118100,97600,87500,10100,12800,2600,113000,A1,AG/GEN,,,
19168,33-1-0-5-B,6798-25-1732,SNGL FAM SUB,15,,263300,186100,77200,88700,36800,388800,173300,106800,66500,73900,28600,275800,A2,AG/LTD,,,
19169,48-1-0-73-E,7737-03-0545,COMM & IND,70.18,,1390600,0,1390600,0,0,1390600,945500,0,945500,0,0,945500,M2A2,INDUSTR,,,
19170,5-1-0-21-B,6822-08-4998,SNGL FAM SUB,5.61,,63200,0,63200,0,0,63200,62100,0,62100,0,0,62100,A1,AG/GEN,,,
19171,47-1-0-43-P4,7726-08-5884,COMM & IND,2.632,,985200,0,985200,1433400,138600,2557200,895600,0,895600,1360000,102300,2357900,B1,BUS/GEN,,,
19172,47-12-0-1-B1,7717-24-3303,AG 20-100 AC,20.3,,633000,504400,128600,336500,67200,1036700,564700,450300,114400,283700,63200,911600,A2,AG/LTD,,,
19173,63-1-0-109-A,7715-42-0121,Cemetery,0,,100,0,100,0,0,100,100,0,100,0,0,100,A2,AG/LTD,,,
19174,57-18-0-2-A,7715-03-1005,Cemetery,0,,100,0,100,0,0,100,100,0,100,0,0,100,A2,AG/LTD,,,
19175,31-1-0-85-B,6778-48-7104,AG 20-100 AC,30.066,,292500,278600,13900,0,0,292500,260700,247900,12800,0,0,260700,A2,AG/LTD,,,
19176,13-1-0-36-F,6851-17-4398,AG 20-100 AC,77.059,,430700,349700,81000,17600,2500,450800,422200,345800,76400,15100,2500,439800,A1,AG/GEN,,,
19177,28-1-0-86-A,6739-23-8461,Cemetery,0.5,AC,100,0,100,0,0,100,100,0,100,0,0,100,A1,AG/GEN,,,
19178,46-1-0-16-E,7707-25-2046,SNGL FAM SUB,12.46,,323600,0,323600,0,0,323600,289000,0,289000,0,0,289000,A2,AG/LTD,,,
19179,47-36-0-1-0,7716-78-4017,SNGL FAM URB,0.366,,120000,0,120000,419600,0,539600,115000,0,115000,389200,0,504200,RPUD,RES/PUD,,,
19180,47-36-0-2-0,7716-78-3168,SNGL FAM URB,0.314,,120000,0,120000,417400,0,537400,115000,0,115000,405100,0,520100,RPUD,RES/PUD,,,
19181,47-36-0-3-0,7716-78-2149,SNGL FAM URB,0.214,,120000,0,120000,374100,0,494100,115000,0,115000,360600,0,475600,RPUD,RES/PUD,,,
19182,47-36-0-4-0,7716-78-1193,SNGL FAM URB,0.241,,120000,0,120000,417500,0,537500,115000,0,115000,400200,0,515200,RPUD,RES/PUD,,,
19183,47-36-0-5-0,7716-78-2015,SNGL FAM URB,0.179,,120000,0,120000,423800,0,543800,115000,0,115000,391300,0,506300,RPUD,RES/PUD,,,
19184,47-36-0-6-0,7716-77-2938,SNGL FAM URB,0.178,,120000,0,120000,423600,0,543600,115000,0,115000,392600,0,507600,RPUD,RES/PUD,,,
19185,47-36-0-7-0,7716-77-2951,SNGL FAM URB,0.178,,120000,0,120000,442300,0,562300,115000,0,115000,367000,0,482000,RPUD,RES/PUD,,,
19186,47-36-0-8-0,7716-77-2875,SNGL FAM URB,0.178,,120000,0,120000,322400,0,442400,115000,0,115000,317800,0,432800,RPUD,RES/PUD,,,
19187,47-36-0-9-0,7716-77-2798,SNGL FAM URB,0.178,,120000,0,120000,402100,0,522100,115000,0,115000,309700,0,424700,RPUD,RES/PUD,,,
19188,47-36-0-10-0,7716-77-3721,SNGL FAM URB,0.183,,120000,0,120000,379200,0,499200,115000,0,115000,366000,0,481000,RPUD,RES/PUD,,,
19189,47-36-0-11-0,7716-77-3644,SNGL FAM URB,0.183,,120000,0,120000,360700,0,480700,115000,0,115000,353500,0,468500,RPUD,RES/PUD,,,
19190,47-36-0-12-0,7716-77-3568,SNGL FAM URB,0.183,,120000,0,120000,431400,0,551400,115000,0,115000,397000,0,512000,RPUD,RES/PUD,,,
19191,47-36-0-13-0,7716-77-3581,SNGL FAM URB,0.183,,120000,0,120000,361500,0,481500,115000,0,115000,347500,0,462500,RPUD,RES/PUD,,,
19192,47-36-0-41-0,7716-77-5517,SNGL FAM URB,0.211,,120000,0,120000,420200,0,540200,115000,0,115000,406100,0,521100,RPUD,RES/PUD,,,
19193,47-36-0-42-0,7716-77-5598,SNGL FAM URB,0.183,,120000,0,120000,350100,0,470100,115000,0,115000,336800,0,451800,RPUD,RES/PUD,,,
19194,47-36-0-43-0,7716-77-6661,SNGL FAM URB,0.194,,120000,0,120000,386400,0,506400,115000,0,115000,375700,0,490700,RPUD,RES/PUD,,,
19195,47-36-0-44-0,7716-77-6761,SNGL FAM URB,0.264,,120000,0,120000,495600,0,615600,115000,0,115000,463500,0,578500,RPUD,RES/PUD,,,
19196,47-36-0-45-0,7716-77-6739,SNGL FAM URB,0.268,,120000,0,120000,448300,0,568300,115000,0,115000,435900,0,550900,RPUD,RES/PUD,,,
19197,47-36-0-46-0,7716-77-5738,SNGL FAM URB,0.297,,120000,0,120000,405300,0,525300,115000,0,115000,392500,0,507500,RPUD,RES/PUD,,,
19198,47-36-0-47-0,7716-77-4754,SNGL FAM URB,0.249,,120000,0,120000,373900,0,493900,115000,0,115000,360200,0,475200,RPUD,RES/PUD,,,
19199,47-36-0-48-0,7716-77-4828,SNGL FAM URB,0.226,,120000,0,120000,458800,0,578800,115000,0,115000,443100,0,558100,RPUD,RES/PUD,,,
19200,47-36-0-49-0,7716-77-5922,SNGL FAM URB,0.321,,120000,0,120000,459800,1600,581400,115000,0,115000,439500,1300,555800,RPUD,RES/PUD,,,
19201,47-36-0-A-0,7716-77-2595,Cmn Area/Open Spc,1,,0,0,0,0,0,0,0,0,0,0,0,0,RPUD,RES/PUD,,,
19202,47-36-0-B-0,7716-77-8710,Cmn Area/Open Spc,1.54,,0,0,0,0,0,0,0,0,0,0,0,0,RPUD,RES/PUD,,,
19204,63-32-0-B-1,7723-09-8028,SNGL FAM SUB,1.67,,182000,0,182000,794000,0,976000,158300,0,158300,704700,0,863000,R1,RES/LTD,,,
19205,47-33-0-18-A,7727-48-3631,COMM & IND,1.212,,219000,0,219000,713500,69000,1001500,208800,0,208800,666500,50000,925300,M2,INDUS/G,,,
19206,33-10-0-1-0,6798-84-6677,SNGL FAM SUB,10,,199700,194600,5100,0,0,199700,178700,174400,4300,0,0,178700,A2,AG/LTD,,,
19207,33-10-0-2-0,6798-85-6371,SNGL FAM SUB,10,,199700,194600,5100,0,0,199700,178700,174400,4300,0,0,178700,A2,AG/LTD,,,
19208,33-10-0-3-0,6798-95-2150,SNGL FAM SUB,10,,199700,194600,5100,0,0,199700,178700,174400,4300,0,0,178700,A2,AG/LTD,,,
19209,10-1-0-31-C1,6812-25-5780,SNGL FAM SUB,13.023,,95000,0,95000,0,0,95000,93200,0,93200,0,0,93200,A1,AG/GEN,,,
19210,63-1-0-102-A,7715-40-4502,Cemetery,0,,100,0,100,0,0,100,100,0,100,0,0,100,A2,AG/LTD,,,
19211,30-1-0-112-C,6759-63-5625,SNGL FAM SUB,3.13,,79800,0,79800,243700,5100,328600,71000,0,71000,200000,3600,274600,A2,AG/LTD,,,
19212,32-1-0-33-C2,6778-66-3060,SNGL FAM SUB,9.649,,162700,0,162700,260900,0,423600,145400,0,145400,210700,0,356100,A2,AG/LTD,,,
19213,47-1-0-43-P5,7716-98-7671,COMM & IND,0.993,,676500,0,676500,565900,30800,1273200,594300,0,594300,537000,20900,1152200,B1,BUS/GEN,,,
19214,47-37-0-14-0,7716-77-4404,SNGL FAM URB,0.183,,120000,0,120000,397300,0,517300,115000,0,115000,388900,0,503900,RPUD,RES/PUD,,,
19215,47-37-0-15-0,7716-77-4327,SNGL FAM URB,0.183,,120000,0,120000,400000,0,520000,115000,0,115000,384500,0,499500,RPUD,RES/PUD,,,
19216,47-37-0-16-0,7716-77-4340,SNGL FAM URB,0.183,,120000,0,120000,379600,0,499600,115000,0,115000,369700,0,484700,RPUD,RES/PUD,,,
19217,47-37-0-17-0,7716-77-4263,SNGL FAM URB,0.183,,120000,0,120000,461200,0,581200,115000,0,115000,438500,0,553500,RPUD,RES/PUD,,,
19218,47-37-0-18-0,7716-77-4186,SNGL FAM URB,0.183,,120000,0,120000,436000,0,556000,115000,0,115000,408600,0,523600,RPUD,RES/PUD,,,
19219,47-37-0-19-0,7716-77-5009,SNGL FAM URB,0.183,,120000,0,120000,342100,0,462100,115000,0,115000,336700,0,451700,RPUD,RES/PUD,,,
19220,47-37-0-20-0,7716-77-5032,SNGL FAM URB,0.183,,120000,0,120000,426500,0,546500,115000,0,115000,403500,0,518500,RPUD,RES/PUD,,,
19221,47-37-0-21-0,7716-76-5955,SNGL FAM URB,0.197,,120000,0,120000,345300,0,465300,115000,0,115000,339700,0,454700,RPUD,RES/PUD,,,
19222,47-37-0-40-0,7716-77-5458,SNGL FAM URB,0.17,,120000,0,120000,348700,0,468700,115000,0,115000,334500,0,449500,RPUD,RES/PUD,,,
19223,47-37-0-39-0,7716-77-5471,SNGL FAM URB,0.17,,120000,0,120000,395000,0,515000,115000,0,115000,380200,0,495200,RPUD,RES/PUD,,,
19224,47-37-0-38-0,7716-77-5395,SNGL FAM URB,0.17,,120000,0,120000,421700,0,541700,115000,0,115000,402800,0,517800,RPUD,RES/PUD,,,
19225,47-37-0-22-0,7716-77-7000,SNGL FAM URB,0.237,,120000,0,120000,420300,0,540300,115000,0,115000,406100,0,521100,RPUD,RES/PUD,,,
19226,47-37-0-23-0,7716-77-7083,SNGL FAM URB,0.182,,120000,0,120000,356700,0,476700,115000,0,115000,345900,0,460900,RPUD,RES/PUD,,,
19227,47-37-0-24-0,7716-77-8055,SNGL FAM URB,0.182,,120000,0,120000,410200,0,530200,115000,0,115000,399800,0,514800,RPUD,RES/PUD,,,
19228,47-37-0-25-0,7716-77-9027,SNGL FAM URB,0.177,,120000,0,120000,369800,0,489800,115000,0,115000,359400,0,474400,RPUD,RES/PUD,,,
19229,47-37-0-26-0,7716-77-9099,SNGL FAM URB,0.177,,120000,0,120000,393000,0,513000,115000,0,115000,383000,0,498000,RPUD,RES/PUD,,,
19230,47-37-0-27-0,7716-87-0151,SNGL FAM URB,0.177,,120000,0,120000,395600,0,515600,115000,0,115000,335100,0,450100,RPUD,RES/PUD,,,
19231,47-37-0-28-0,7716-87-1133,SNGL FAM URB,0.24,,120000,0,120000,431800,0,551800,115000,0,115000,414500,0,529500,RPUD,RES/PUD,,,
19232,47-37-0-37-0,7716-77-6137,SNGL FAM URB,0.232,,120000,0,120000,492500,0,612500,115000,0,115000,468900,0,583900,RPUD,RES/PUD,,,
19233,47-37-0-36-0,7716-77-7109,SNGL FAM URB,0.235,,120000,0,120000,422400,0,542400,115000,0,115000,408300,0,523300,RPUD,RES/PUD,,,
19234,47-37-0-35-0,7716-77-7261,SNGL FAM URB,0.235,,120000,0,120000,396900,0,516900,115000,0,115000,382200,0,497200,RPUD,RES/PUD,,,
19235,47-37-0-34-0,7716-77-8233,SNGL FAM URB,0.235,,120000,0,120000,460000,0,580000,115000,0,115000,442100,0,557100,RPUD,RES/PUD,,,
19236,47-37-0-33-0,7716-77-9205,SNGL FAM URB,0.235,,120000,0,120000,482400,0,602400,115000,0,115000,495700,0,610700,RPUD,RES/PUD,,,
19237,47-37-0-32-0,7716-77-9267,SNGL FAM URB,0.235,,120000,0,120000,421400,0,541400,115000,0,115000,401100,0,516100,RPUD,RES/PUD,,,
19238,47-37-0-31-0,7716-87-0239,SNGL FAM URB,0.235,,120000,0,120000,447400,0,567400,115000,0,115000,423500,0,538500,RPUD,RES/PUD,,,
19239,47-37-0-30-0,7716-87-1301,SNGL FAM URB,0.237,,120000,0,120000,460100,0,580100,115000,0,115000,444200,0,559200,RPUD,RES/PUD,,,
19240,47-37-0-29-0,7716-87-1372,SNGL FAM URB,0.27,,120000,0,120000,477400,0,597400,115000,0,115000,453400,0,568400,RPUD,RES/PUD,,,
19241,47-37-0-D-0,7716-77-4117,Cmn Area/Open Spc,0.483,,0,0,0,0,0,0,0,0,0,0,0,0,RPUD,RES/PUD,,,
19242,47-37-0-C-0,7716-77-8466,Cmn Area/Open Spc,3.7,,0,0,0,0,0,0,0,0,0,0,0,0,RPUD,RES/PUD,,,
19243,56-1-0-78-B,6796-72-2208,AG 20-100 AC,56.993,,1262700,1126000,136700,186000,242400,1691100,1096400,978100,118300,163000,206900,1466300,A2,AG/LTD,,,
19244,45-6-0-1-A1,6797-30-9146,SNGL FAM SUB,5.19,,148900,0,148900,633400,0,782300,132900,0,132900,530600,0,663500,A2,AG/LTD,,,
19245,59-3-2-90-A,7726-84-4399,COMM & IND,19.89,,9012200,0,9012200,0,72569700,81581900,8905700,0,8905700,0,62393300,71299000,M1,INDUS/L,,,
19246,22-1-0-9-A2,6769-78-9492,SNGL FAM SUB,3.5897,,92300,0,92300,342000,2000,436300,86200,0,86200,285100,2000,373300,A2,AG/LTD,,,
19248,58-2-0-R-0,7726-36-1803,Roads,2.25,,0,0,0,0,0,0,0,0,0,0,0,0,RN,RESIDEN,,,
19249,62-15-0-D-2A,7704-26-1048,SNGL FAM SUB,9.6,,545400,0,545400,2319200,189100,3053700,502500,0,502500,2103900,162800,2769200,A2,AG/LTD,,,
19251,63-14-A-4-R1,7714-74-5237,Roads,1.311,,0,0,0,0,0,0,0,0,0,0,0,0,A2R3,AGRIC.R,,,
19254,31-1-0-25-R,6768-83-8658,Roads,0.6,,0,0,0,0,0,0,0,0,0,0,0,0,A2,AG/LTD,,,
19255,43-1-0-6-B1,6767-47-0213,SNGL FAM SUB,3,,100300,0,100300,404200,0,504500,89600,0,89600,331700,0,421300,A2,AG/LTD,,,
19256,67-1-0-10-A,7723-66-4561,SNGL FAM SUB,1.328,,191400,0,191400,645100,0,836500,166400,0,166400,545100,0,711500,R1,RES/LTD,,,
19257,67-1-0-10-B,7723-66-4269,SNGL FAM SUB,1.186,,191400,0,191400,648500,0,839900,166400,0,166400,544500,0,710900,R1,RES/LTD,,,
19258,67-1-0-10-C,7723-66-2301,SNGL FAM SUB,1.193,,191400,0,191400,668800,0,860200,166400,0,166400,560700,0,727100,R1,RES/LTD,,,
19259,46-1-0-61-R,7717-20-8261,Roads,0.01,,0,0,0,0,0,0,0,0,0,0,0,0,A2,AG/LTD,,,
19260,47-1-0-14-R,7717-30-2140,Roads,0.44,,0,0,0,0,0,0,0,0,0,0,0,0,A2,AG/LTD,,,
19261,47-1-0-78-R,7716-78-6531,Roads,0.45,,0,0,0,0,0,0,0,0,0,0,0,0,B1,BUS/GEN,,,
19262,18-1-0-7-A,6810-79-4333,SNGL FAM SUB,3.76,,54300,0,54300,169900,2600,226800,53200,0,53200,146400,2800,202400,A1,AG/GEN,,,
19263,47-12-0-B-1A,7717-16-9611,SNGL FAM SUB,2,,127600,0,127600,174400,49000,351000,113900,0,113900,144400,39600,297900,A2,AG/LTD,,,
19264,54-3-0-K-3,6776-16-8533,SNGL FAM SUB,10,,167300,0,167300,797800,61000,1026100,149000,0,149000,654900,56700,860600,A2,AG/LTD,,,
19265,31-1-0-90-C,6778-44-5073,SNGL FAM SUB,6.918,,142200,138900,3300,0,2000,144200,127000,124100,2900,0,2000,129000,A2,AG/LTD,,,
19268,47-1-0-43-P6,7726-08-4473,COMM & IND,1.506,,1116600,0,1116600,936000,149600,2202200,1061200,0,1061200,888600,101800,2051600,B1,BUS/GEN,,,
19269,13-1-0-1-P1,6842-11-0913,AG 20-100 AC,29,,197700,0,197700,306600,70400,574700,193700,0,193700,274200,55400,523300,A1,AG/GEN,,,
19270,31-1-0-75-E,6779-42-5892,SNGL FAM SUB,2.352,,76500,0,76500,126200,3000,205700,68200,0,68200,96500,3000,167700,A2,AG/LTD,,,
19271,26-18-0-1-A,6708-75-0678,Cemetery,0,,100,0,100,0,0,100,100,0,100,0,0,100,A1,AG/GEN,,,
19272,43-1-0-88-H,6777-10-5267,AG 20-100 AC,62.75,,715400,685800,29600,0,0,715400,640100,613400,26700,0,0,640100,A2,AG/LTD,,,
19273,47-38-0-50-0,7716-76-5889,SNGL FAM URB,0.194,,120000,0,120000,369000,0,489000,115000,0,115000,351100,0,466100,RPUD,RES/PUD,,,
19274,47-38-0-51-0,7716-76-6845,SNGL FAM URB,0.179,,120000,0,120000,423300,0,543300,115000,0,115000,398700,0,513700,RPUD,RES/PUD,,,
19275,47-38-0-52-0,7716-76-7800,SNGL FAM URB,0.179,,120000,0,120000,413100,0,533100,115000,0,115000,353800,0,468800,RPUD,RES/PUD,,,
19276,47-38-0-53-0,7716-76-7756,SNGL FAM URB,0.176,,120000,0,120000,512300,0,632300,115000,0,115000,487300,0,602300,RPUD,RES/PUD,,,
19277,47-38-0-54-0,7716-76-8701,SNGL FAM URB,0.179,,120000,0,120000,378000,0,498000,115000,0,115000,360900,0,475900,RPUD,RES/PUD,,,
19278,47-38-0-55-0,7716-76-8657,SNGL FAM URB,0.179,,120000,0,120000,431100,0,551100,115000,0,115000,411800,0,526800,RPUD,RES/PUD,,,
19279,47-38-0-56-0,7716-76-9612,SNGL FAM URB,0.187,,120000,0,120000,389600,0,509600,115000,0,115000,373900,0,488900,RPUD,RES/PUD,,,
19280,47-38-0-57-0,7716-86-0508,SNGL FAM URB,0.315,,120000,0,120000,383000,0,503000,115000,0,115000,360800,0,475800,RPUD,RES/PUD,,,
19281,47-38-0-58-0,7716-76-9570,SNGL FAM URB,0.25,,120000,0,120000,510100,0,630100,115000,0,115000,482000,0,597000,RPUD,RES/PUD,,,
19282,47-38-0-59-0,7716-76-9464,SNGL FAM URB,0.241,,120000,0,120000,406400,0,526400,115000,0,115000,384800,0,499800,RPUD,RES/PUD,,,
19283,47-38-0-60-0,7716-76-9357,SNGL FAM URB,0.231,,120000,0,120000,415200,0,535200,115000,0,115000,397900,0,512900,RPUD,RES/PUD,,,
19284,47-38-0-61-0,7716-76-9009,SNGL FAM URB,0.23,,120000,0,120000,385200,0,505200,115000,0,115000,366400,0,481400,RPUD,RES/PUD,,,
19285,47-38-0-62-0,7716-76-8091,SNGL FAM URB,0.217,,120000,0,120000,489400,0,609400,115000,0,115000,488600,0,603600,RPUD,RES/PUD,,,
19430,43-38-A-7-0,6777-58-2531,SNGL FAM SUB,2.918,,150000,0,150000,501700,33700,685400,140000,0,140000,457100,27300,624400,RP,"RURAL,P",,,
19431,43-38-A-8-0,6777-58-1895,SNGL FAM SUB,3.069,,150000,0,150000,855800,0,1005800,140000,0,140000,777800,0,917800,RP,"RURAL,P",,,
19432,43-38-A-9-0,6777-48-8882,SNGL FAM SUB,2.156,,150000,0,150000,676500,49800,876300,140000,0,140000,618200,0,758200,RP,"RURAL,P",,,
19433,43-38-A-10-0,6777-48-6780,SNGL FAM SUB,3.276,,150000,0,150000,667200,0,817200,140000,0,140000,602500,0,742500,RP,"RURAL,P",,,
19434,43-38-A-11-0,6777-48-4653,SNGL FAM SUB,2.42,,150000,0,150000,685000,19200,854200,140000,0,140000,620100,16600,776700,RP,"RURAL,P",,,
19435,43-38-A-12-0,6777-48-1664,SNGL FAM SUB,2.011,,150000,0,150000,678800,0,828800,140000,0,140000,618900,0,758900,RP,"RURAL,P",,,
19436,43-38-A-13-0,6777-38-8379,SNGL FAM SUB,2.386,,157500,0,157500,604100,0,761600,147000,0,147000,557000,0,704000,RP,"RURAL,P",,,
19437,43-38-A-14-0,6777-48-1144,SNGL FAM SUB,2.855,,172500,0,172500,871000,74500,1118000,161000,0,161000,795600,63800,1020400,RP,"RURAL,P",,,
19438,43-38-A-15-0,6777-47-1769,SNGL FAM SUB,3.169,,187500,0,187500,682800,2400,872700,175000,0,175000,618000,0,793000,RP,"RURAL,P",,,
19439,43-38-B-1-0,6777-47-5130,SNGL FAM SUB,2.119,,172500,0,172500,579200,0,751700,161000,0,161000,548100,0,709100,RP,"RURAL,P",,,
19600,59-3-2-90-D,7726-85-6810,COMM & IND,7.374,,7498300,0,7498300,0,0,7498300,6816600,0,6816600,0,0,6816600,B1,BUS/GEN,,,
19601,45-1-0-91-A2,6797-87-8113,SNGL FAM SUB,2,,91800,0,91800,161000,0,252800,82000,0,82000,130200,0,212200,A2,AG/LTD,,,
19602,38-1-0-39-A1,6707-43-6877,Cemetery,0.0001,,100,0,100,0,0,100,100,0,100,0,0,100,A1,AG/GEN,,,
19603,50-1-0-22-A,6726-60-5590,SNGL FAM SUB,0.94,,3400,0,3400,0,0,3400,3300,0,3300,0,0,3300,A1,AG/GEN,,,
19604,50-1-0-17-A,6726-50-7088,SNGL FAM SUB,0.469,,1700,0,1700,0,0,1700,1600,0,1600,0,0,1600,A1,AG/GEN,,,
19605,12-1-0-73-C,6831-62-6752,Cemetery,0.0001,,100,0,100,0,0,100,100,0,100,0,0,100,A1,AG/GEN,,,
19607,17-1-0-86-H,6719-27-0748,SNGL FAM SUB,8,,62900,0,62900,242100,3700,308700,62500,0,62500,202900,4000,269400,A1,AG/GEN,,,
19608,17-1-0-86-I,6719-18-4239,SNGL FAM SUB,8.345,,64400,60100,4300,0,0,64400,63700,60100,3600,0,0,63700,A1,AG/GEN,,,
19610,33-1-0-3-F1,6798-05-6159,SNGL FAM SUB,0.00001,,0,0,0,37700,200,37900,0,0,0,31600,200,31800,A2,AG/LTD,,,
19611,33-1-0-3-D1,6798-05-3335,SNGL FAM SUB,0,,0,0,0,91500,700,92200,0,0,0,75300,700,76000,A2,AG/LTD,,,
19612,42-1-0-18-A,6757-72-3050,SNGL FAM SUB,2.218,,76200,0,76200,471000,1200,548400,65700,0,65700,391200,1300,458200,A2,AG/LTD,,,
19614,18-1-0-22-D1,6719-69-7695,AG 20-100 AC,20,AC,138400,0,138400,486600,0,625000,138000,0,138000,400100,0,538100,A1,AG/GEN,,,
19615,42-1-0-60-B1,6757-76-2707,SNGL FAM SUB,16.14,,207300,199900,7400,0,0,207300,186000,179100,6900,0,0,186000,A2,AG/LTD,,,
19616,45-1-0-74-A,6796-68-0221,SNGL FAM SUB,2.35,,119700,24100,95600,55000,0,174700,104100,21000,83100,46900,0,151000,A2,AG/LTD,,,
19617,58-41-0-B-0,7715-45-8998,General Gov,0.36,,35200,0,35200,0,18500,53700,34500,0,34500,0,18900,53400,RPUD,RES/PUD,,,
19902,58-48-8-57-0,7715-46-6570,SNGL FAM URB,0.5,,154900,0,154900,800200,0,955100,151800,0,151800,769200,0,921000,RPUD,RES/PUD,,,
19903,58-48-8-58-0,7715-46-7339,SNGL FAM URB,0.523,,154900,0,154900,667000,0,821900,151800,0,151800,640600,0,792400,RPUD,RES/PUD,,,
19904,58-48-8-59-0,7715-46-7273,SNGL FAM URB,0.407,,154900,0,154900,0,0,154900,151800,0,151800,0,0,151800,RPUD,RES/PUD,,,
19905,58-48-8-60-0,7715-46-6271,SNGL FAM URB,0.353,,154900,0,154900,0,0,154900,151800,0,151800,0,0,151800,RPUD,RES/PUD,,,
19906,58-48-8-61-0,7715-46-5260,SNGL FAM URB,0.445,,154900,0,154900,877700,13200,1045800,151800,0,151800,815600,0,967400,RPUD,RES/PUD,,,
19907,58-48-8-62-0,7715-46-4155,SNGL FAM URB,0.474,,154900,0,154900,867300,0,1022200,151800,0,151800,829700,0,981500,RPUD,RES/PUD,,,
19908,58-48-8-63-0,7715-45-4969,SNGL FAM URB,0.459,,154900,0,154900,830200,12900,998000,151800,0,151800,801500,11400,964700,RPUD,RES/PUD,,,
19909,58-48-8-64-0,7715-45-5952,SNGL FAM URB,0.607,,154900,0,154900,843800,0,998700,151800,0,151800,807200,0,959000,RPUD,RES/PUD,,,
19910,58-48-8-65-0,7715-45-6989,SNGL FAM URB,0.404,,154900,0,154900,825300,0,980200,151800,0,151800,786800,0,938600,RPUD,RES/PUD,,,
19911,58-48-8-66-0,7715-46-7093,SNGL FAM URB,0.462,,154900,0,154900,628500,0,783400,151800,0,151800,601500,0,753300,RPUD,RES/PUD,,,
19286,47-38-0-63-0,7716-75-8983,SNGL FAM URB,0.183,,120000,0,120000,415700,0,535700,115000,0,115000,392300,0,507300,RPUD,RES/PUD,,,
19287,47-38-0-64-0,7716-75-8300,SNGL FAM URB,0.221,,120000,0,120000,643500,1500,765000,115000,0,115000,598100,2900,716000,RPUD,RES/PUD,,,
19288,47-38-0-65-0,7716-75-8289,SNGL FAM URB,0.289,,120000,0,120000,449600,0,569600,115000,0,115000,425100,0,540100,RPUD,RES/PUD,,,
19289,47-38-0-66-0,7716-75-9430,SNGL FAM URB,0.256,,120000,0,120000,439600,0,559600,115000,0,115000,414500,0,529500,RPUD,RES/PUD,,,
19290,47-38-0-67-0,7716-75-9428,SNGL FAM URB,0.266,,120000,0,120000,733000,1500,854500,115000,0,115000,672600,2000,789600,RPUD,RES/PUD,,,
19291,47-38-0-68-0,7716-75-9545,SNGL FAM URB,0.25,,120000,0,120000,391100,0,511100,115000,0,115000,371000,0,486000,RPUD,RES/PUD,,,
19292,47-38-0-69-0,7716-75-9662,SNGL FAM URB,0.225,,120000,0,120000,457900,0,577900,115000,0,115000,428800,0,543800,RPUD,RES/PUD,,,
19293,47-38-0-70-0,7716-75-9688,SNGL FAM URB,0.202,,120000,0,120000,613700,0,733700,115000,0,115000,573600,0,688600,RPUD,RES/PUD,,,
19294,47-38-0-71-0,7716-85-0705,SNGL FAM URB,0.187,,120000,0,120000,456600,0,576600,115000,0,115000,427200,0,542200,RPUD,RES/PUD,,,
19295,47-38-0-72-0,7716-85-0812,SNGL FAM URB,0.18,,120000,0,120000,475000,0,595000,115000,0,115000,444600,0,559600,RPUD,RES/PUD,,,
19296,47-38-0-73-0,7716-85-0839,SNGL FAM URB,0.178,,120000,0,120000,521400,0,641400,115000,0,115000,481000,0,596000,RPUD,RES/PUD,,,
19297,47-38-0-74-0,7716-85-0946,SNGL FAM URB,0.178,,120000,0,120000,472000,0,592000,115000,0,115000,440400,0,555400,RPUD,RES/PUD,,,
19298,47-38-0-75-0,7716-86-0063,SNGL FAM URB,0.178,,120000,0,120000,400500,0,520500,115000,0,115000,382000,0,497000,RPUD,RES/PUD,,,
19299,47-38-0-76-0,7716-86-1204,SNGL FAM URB,0.196,,120000,0,120000,425900,0,545900,115000,0,115000,401300,0,516300,RPUD,RES/PUD,,,
19300,47-38-0-77-0,7716-86-1321,SNGL FAM URB,0.178,,120000,0,120000,417700,0,537700,115000,0,115000,391100,0,506100,RPUD,RES/PUD,,,
19301,47-38-0-78-0,7716-86-1339,SNGL FAM URB,0.19,,120000,0,120000,421800,0,541800,115000,0,115000,404900,0,519900,RPUD,RES/PUD,,,
19302,47-38-0-79-0,7716-86-1456,SNGL FAM URB,0.178,,120000,0,120000,384700,0,504700,115000,0,115000,367800,0,482800,RPUD,RES/PUD,,,
19303,47-38-0-80-0,7716-86-1563,SNGL FAM URB,0.19,,120000,0,120000,423200,0,543200,115000,0,115000,458300,0,573300,RPUD,RES/PUD,,,
19304,47-38-0-81-0,7716-86-1680,SNGL FAM URB,0.178,,120000,0,120000,477600,0,597600,115000,0,115000,448400,0,563400,RPUD,RES/PUD,,,
19305,47-38-0-82-0,7716-86-1697,SNGL FAM URB,0.196,,120000,0,120000,447700,0,567700,115000,0,115000,421900,0,536900,RPUD,RES/PUD,,,
19306,47-38-0-83-0,7716-86-2714,SNGL FAM URB,0.196,,120000,0,120000,469500,0,589500,115000,0,115000,444400,0,559400,RPUD,RES/PUD,,,
19307,47-38-0-84-0,7716-86-2822,SNGL FAM URB,0.178,,120000,0,120000,432500,0,552500,115000,0,115000,404800,0,519800,RPUD,RES/PUD,,,
19308,47-38-0-85-0,7716-86-2849,SNGL FAM URB,0.178,,120000,0,120000,538700,0,658700,115000,0,115000,493500,0,608500,RPUD,RES/PUD,,,
19309,47-38-0-86-0,7716-86-2956,SNGL FAM URB,0.196,,120000,0,120000,460200,0,580200,115000,0,115000,432400,0,547400,RPUD,RES/PUD,,,
19310,47-38-0-87-0,7716-87-2073,SNGL FAM URB,0.183,,120000,0,120000,432300,0,552300,115000,0,115000,405000,0,520000,RPUD,RES/PUD,,,
19311,47-38-0-88-0,7716-87-3680,SNGL FAM URB,0.266,,120000,0,120000,454900,0,574900,115000,0,115000,430100,0,545100,RPUD,RES/PUD,,,
19312,47-38-0-89-0,7716-87-4609,SNGL FAM URB,0.2,,120000,0,120000,490200,0,610200,115000,0,115000,455300,0,570300,RPUD,RES/PUD,,,
19313,47-38-0-90-0,7716-87-4718,SNGL FAM URB,0.319,,120000,0,120000,486500,0,606500,115000,0,115000,496600,0,611600,RPUD,RES/PUD,,,
19314,47-38-0-91-0,7716-87-3864,SNGL FAM URB,0.258,,120000,0,120000,478800,0,598800,115000,0,115000,448700,0,563700,RPUD,RES/PUD,,,
19315,47-38-0-92-0,7716-87-2715,SNGL FAM URB,0.274,,120000,0,120000,507300,0,627300,115000,0,115000,476900,0,591900,RPUD,RES/PUD,,,
19316,47-38-0-93-0,7716-87-2636,SNGL FAM URB,0.258,,120000,0,120000,507300,0,627300,115000,0,115000,472900,0,587900,RPUD,RES/PUD,,,
19317,47-38-0-94-0,7716-87-2517,SNGL FAM URB,0.259,,120000,0,120000,512700,0,632700,115000,0,115000,482000,0,597000,RPUD,RES/PUD,,,
19318,47-38-0-95-0,7716-87-1012,SNGL FAM URB,0.258,,120000,0,120000,452400,0,572400,115000,0,115000,423700,0,538700,RPUD,RES/PUD,,,
19319,47-38-0-96-0,7716-86-0983,SNGL FAM URB,0.177,,120000,0,120000,413900,0,533900,115000,0,115000,396900,0,511900,RPUD,RES/PUD,,,
19320,47-38-0-97-0,7716-86-0877,SNGL FAM URB,0.177,,120000,0,120000,405700,0,525700,115000,0,115000,384800,0,499800,RPUD,RES/PUD,,,
19321,47-38-0-98-0,7716-86-0850,SNGL FAM URB,0.177,,120000,0,120000,487400,0,607400,115000,0,115000,452000,0,567000,RPUD,RES/PUD,,,
19322,47-38-0-99-0,7716-86-0743,SNGL FAM URB,0.189,,120000,0,120000,403500,0,523500,115000,0,115000,381800,0,496800,RPUD,RES/PUD,,,
19323,47-38-0-100-0,7716-76-9759,SNGL FAM URB,0.28,,120000,0,120000,475200,0,595200,115000,0,115000,457300,0,572300,RPUD,RES/PUD,,,
19324,47-38-0-101-0,7716-76-8876,SNGL FAM URB,0.202,,120000,0,120000,537700,0,657700,115000,0,115000,503500,0,618500,RPUD,RES/PUD,,,
19325,47-38-0-102-0,7716-76-8902,SNGL FAM URB,0.293,,120000,0,120000,383900,0,503900,115000,0,115000,366200,0,481200,RPUD,RES/PUD,,,
19326,47-38-0-E-0,7716-75-7243,Cmn Area/Open Spc,7.9,,0,0,0,0,0,0,0,0,0,0,0,0,RPUD,RES/PUD,,,
19327,47-38-0-F-0,7716-87-1779,Cmn Area/Open Spc,0.074,,0,0,0,0,0,0,0,0,0,0,0,0,RPUD,RES/PUD,,,
19328,47-38-0-G-0,7716-76-9965,Cmn Area/Open Spc,0.567,,0,0,0,0,0,0,0,0,0,0,0,0,RPUD,RES/PUD,,,
19329,47-38-0-H-0,7716-87-1496,Cmn Area/Open Spc,0.386,,0,0,0,0,0,0,0,0,0,0,0,0,RPUD,RES/PUD,,,
19330,47-38-0-R-0,7716-86-0104,Roads,3.64,,0,0,0,0,0,0,0,0,0,0,0,0,RPUD,RES/PUD,,,
19331,58-1-0-2-A,7716-26-5798,SNGL FAM SUB,12.42,,293100,286800,6300,0,35000,328100,262000,256700,5300,0,30800,292800,A2,AG/LTD,,,
19332,63-11-0-C-0,7714-46-7490,SNGL FAM SUB,3.132,,172500,0,172500,0,0,172500,150000,0,150000,0,0,150000,A2,AG/LTD,,,
19333,59-3-2-90-B,7726-85-1105,COMM & IND,6.051,,2741700,0,2741700,22536000,0,25277700,2492600,0,2492600,22536000,0,25028600,M1,INDUS/L,,,
19334,12-1-0-61-E,6832-60-3498,SNGL FAM SUB,3,,56600,0,56600,365500,1500,423600,55000,0,55000,316000,1500,372500,A1,AG/GEN,,,
19335,27-1-0-19-B,6718-65-6985,SNGL FAM SUB,2.331,,46300,0,46300,148800,0,195100,45300,0,45300,125900,0,171200,A1,AG/GEN,,,
19336,47-1-0-43-P7,7726-08-2428,COMM & IND,1.16,,826900,0,826900,648000,91000,1565900,751700,0,751700,616700,62600,1431000,B1,BUS/GEN,,,
19337,16-2-0-A-2,5890-46-9798,SNGL FAM SUB,4,,49600,0,49600,218300,0,267900,48500,0,48500,188800,0,237300,A1,AG/GEN,,,
19338,45-9-0-A-1,6798-00-7201,Cemetery,0.0001,,100,0,100,0,0,100,100,0,100,0,0,100,A2,AG/LTD,,,
19339,55-1-0-93-CTW,6785-64-9920-9998,COMM & IND,0,,0,0,0,0,153200,153200,0,0,0,0,151000,151000,A2,AG/LTD,,,
19340,63-14-B-2-A,7714-83-4894,Roads,0.171,,0,0,0,0,0,0,0,0,0,0,0,0,A2,AG/LTD,,,
19342,51-6-0-B-3,6735-87-7095,AG 20-100 AC,56.293,,265500,191500,74000,441200,21200,727900,259200,189300,69900,396600,18500,674300,A1,AG/GEN,,,
19343,41-1-0-4-A,6747-49-9571,SNGL FAM SUB,2.091,,66200,0,66200,826400,0,892600,62000,0,62000,776600,0,838600,A1,AG/GEN,,,
19346,20-1-0-66-C,6840-87-7594,SNGL FAM SUB,2.86,,56100,54800,1300,0,0,56100,53900,52700,1200,0,0,53900,A1,AG/GEN,,,
19347,20-1-0-66-B,6840-87-5795,SNGL FAM SUB,5.08,,75800,73500,2300,0,0,75800,73300,71100,2200,0,0,73300,A1,AG/GEN,,,
19349,48-1-0-56-B,7738-21-7319,COMM & IND,1.713,,212900,0,212900,0,0,212900,202800,0,202800,0,0,202800,B1,BUS/GEN,,,
19350,48-1-0-56-C,7738-21-4224,COMM & IND,5.82,,719300,0,719300,0,0,719300,652400,0,652400,0,0,652400,B1,BUS/GEN,,,
19351,51-6-B-3-R,6735-88-8095,Roads,0.707,,0,0,0,0,0,0,0,0,0,0,0,0,A1,AG/GEN,,,
19352,51-1-0-44-A,6726-95-7626,SNGL FAM SUB,5,,63200,0,63200,190000,100,253300,62000,0,62000,163700,100,225800,A1,AG/GEN,,,
19353,17-1-0-44-B1,6811-41-5699,SNGL FAM SUB,9.258,,85000,42100,42900,6500,0,91500,75200,33600,41600,8000,0,83200,A1,AG/GEN,,,
19355,46-35-0-G-2,7717-18-5851,SNGL FAM SUB,3,,136800,0,136800,205400,1100,343300,122100,0,122100,171000,0,293100,A2,AG/LTD,,,
19356,46-35-0-G-3,7717-19-6004,SNGL FAM SUB,2,,114600,0,114600,215000,1200,330800,102300,0,102300,181500,1200,285000,A2,AG/LTD,,,
19357,44-1-0-10-H,6777-74-6538,AG > 100 AC,123.894,,1260400,1058500,201900,0,75600,1336000,1120100,939000,181100,0,75600,1195700,A1RP,AG GEN,,,
19358,48-6-0-1-B,7738-01-5972,General Gov,0.06,,1400,0,1400,0,0,1400,1300,0,1300,0,0,1300,B1,BUS/GEN,,,
19359,48-6-0-1-A,7738-02-9158,General Gov,0.23,,5400,0,5400,0,0,5400,5200,0,5200,0,0,5200,B1,BUS/GEN,,,
19360,48-1-0-69-B1,7738-01-4950,Roads,0.53,,0,0,0,0,0,0,0,0,0,0,0,0,A2,AG/LTD,,,
19361,26-1-0-52-A,6719-51-1449,Cemetery,0.0001,,100,0,100,0,0,100,100,0,100,0,0,100,A1,AG/GEN,,,
19362,25-1-0-1-A,5799-21-9954,AG 20-100 AC,56.4,,141000,112200,28800,0,0,141000,141000,116700,24300,0,0,141000,A1,AG/GEN,,,
19363,25-1-0-2-A,5799-20-7259,AG 20-100 AC,77.2,,193000,153600,39400,0,0,193000,193000,159800,33200,0,0,193000,A1,AG/GEN,,,
19364,12-1-0-13-A,6832-07-7020,SNGL FAM SUB,4.404,,57900,0,57900,290900,4000,352800,56000,0,56000,250800,4000,310800,A1,AG/GEN,,,
19365,58-48-8-1-0,7715-57-4626,SNGL FAM URB,0.81,,372600,0,372600,973300,13600,1359500,367300,0,367300,923000,13100,1303400,RPUD,RES/PUD,,,
19366,58-48-8-2-0,7715-57-4552,SNGL FAM URB,0.56,,380700,0,380700,980400,0,1361100,375200,0,375200,925100,0,1300300,RPUD,RES/PUD,,,
19367,58-48-8-3-0,7715-57-4440,SNGL FAM URB,0.45,,380700,0,380700,1001400,9900,1392000,375200,0,375200,949200,10000,1334400,RPUD,RES/PUD,,,
19368,58-48-8-4-0,7715-57-4320,SNGL FAM URB,0.45,,380700,0,380700,1317400,0,1698100,375200,0,375200,1318400,0,1693600,RPUD,RES/PUD,,,
19369,58-48-8-5-0,7715-57-4271,SNGL FAM URB,0.46,,380700,0,380700,845400,0,1226100,375200,0,375200,812600,0,1187800,RPUD,RES/PUD,,,
19370,58-48-8-6-0,7715-57-5153,SNGL FAM URB,0.59,,380700,0,380700,1177800,0,1558500,375200,0,375200,1146000,0,1521200,RPUD,RES/PUD,,,
19371,58-48-8-7-0,7715-57-6004,SNGL FAM URB,0.7,,380700,0,380700,924500,0,1305200,375200,0,375200,869800,0,1245000,RPUD,RES/PUD,,,
19372,58-48-8-8-0,7715-56-6932,SNGL FAM URB,0.67,,380700,0,380700,966400,0,1347100,375200,0,375200,925600,0,1300800,RPUD,RES/PUD,,,
19373,58-48-8-9-0,7715-56-6811,SNGL FAM URB,0.55,,380700,0,380700,1165200,0,1545900,375200,0,375200,1145800,0,1521000,RPUD,RES/PUD,,,
19374,58-48-8-10-0,7715-56-5791,SNGL FAM URB,0.44,,380700,0,380700,1126100,9800,1516600,375200,0,375200,1098700,9900,1483800,RPUD,RES/PUD,,,
19375,58-48-8-11-0,7715-56-6611,SNGL FAM URB,0.45,,380700,0,380700,961800,0,1342500,375200,0,375200,943300,0,1318500,RPUD,RES/PUD,,,
19376,58-48-8-12-0,7715-56-6551,SNGL FAM URB,0.58,,380700,0,380700,865400,0,1246100,375200,0,375200,819900,0,1195100,RPUD,RES/PUD,,,
19377,58-48-8-13-0,7715-56-6378,SNGL FAM URB,0.92,,401000,0,401000,1243200,0,1644200,395200,0,395200,1214100,0,1609300,RPUD,RES/PUD,,,
19378,58-48-8-14-0,7715-56-5294,SNGL FAM URB,1.06,,401000,0,401000,1256600,0,1657600,395200,0,395200,1224500,0,1619700,RPUD,RES/PUD,,,
19379,58-48-8-15-0,7715-56-4203,SNGL FAM URB,0.7,,368600,0,368600,913300,0,1281900,363300,0,363300,869400,0,1232700,RPUD,RES/PUD,,,
19380,58-48-8-16-0,7715-56-3304,SNGL FAM URB,0.596,,176000,0,176000,855600,0,1031600,172500,0,172500,820700,0,993200,RPUD,RES/PUD,,,
19381,58-48-8-17-0,7715-56-3457,SNGL FAM URB,0.553,,176000,0,176000,804800,0,980800,172500,0,172500,761100,0,933600,RPUD,RES/PUD,,,
19382,58-48-8-18-0,7715-56-3567,SNGL FAM URB,0.524,,176000,0,176000,766700,0,942700,172500,0,172500,744100,0,916600,RPUD,RES/PUD,,,
19383,58-48-8-19-0,7715-56-1488,SNGL FAM URB,0.889,,162600,0,162600,1147200,0,1309800,159400,0,159400,1077400,0,1236800,RPUD,RES/PUD,,,
19384,58-48-8-20-0,7715-56-1600,SNGL FAM URB,0.483,,154900,0,154900,1068800,0,1223700,151800,0,151800,1018400,0,1170200,RPUD,RES/PUD,,,
19385,58-48-8-21-0,7715-56-0730,SNGL FAM URB,0.362,,154900,0,154900,606300,0,761200,151800,0,151800,589900,0,741700,RPUD,RES/PUD,,,
19386,58-48-8-22-0,7715-46-9779,SNGL FAM URB,0.369,,154900,0,154900,732700,0,887600,151800,0,151800,708600,0,860400,RPUD,RES/PUD,,,
19387,58-48-8-23-0,7715-46-9827,SNGL FAM URB,0.353,,154900,0,154900,663100,0,818000,151800,0,151800,638300,0,790100,RPUD,RES/PUD,,,
19388,58-48-8-24-0,7715-46-8977,SNGL FAM URB,0.426,,154900,0,154900,848500,0,1003400,151800,0,151800,807500,0,959300,RPUD,RES/PUD,,,
19389,58-48-8-25-0,7715-47-7074,SNGL FAM URB,0.466,,154900,0,154900,950500,0,1105400,151800,0,151800,855600,0,1007400,RPUD,RES/PUD,,,
19390,58-48-8-26-0,7715-47-8292,SNGL FAM URB,0.773,,162600,0,162600,960400,1600,1124600,159400,0,159400,927000,1300,1087700,RPUD,RES/PUD,,,
19391,58-48-8-27-0,7715-57-0115,SNGL FAM URB,0.552,,154900,0,154900,816800,0,971700,151800,0,151800,776500,0,928300,RPUD,RES/PUD,,,
19392,58-48-8-28-0,7715-57-0075,SNGL FAM URB,0.433,,154900,0,154900,707200,0,862100,151800,0,151800,682600,0,834400,RPUD,RES/PUD,,,
19393,58-48-8-29-0,7715-56-1926,SNGL FAM URB,0.39,,154900,0,154900,707400,0,862300,151800,0,151800,673000,0,824800,RPUD,RES/PUD,,,
19394,58-48-8-30-0,7715-56-1875,SNGL FAM URB,0.498,,154900,0,154900,868400,0,1023300,151800,0,151800,843900,0,995700,RPUD,RES/PUD,,,
19395,58-48-8-31-0,7715-56-3794,SNGL FAM URB,0.285,,154900,0,154900,697500,0,852400,151800,0,151800,672200,0,824000,RPUD,RES/PUD,,,
19396,58-48-8-32-0,7715-56-3864,SNGL FAM URB,0.452,,176000,0,176000,811300,0,987300,172500,0,172500,772300,0,944800,RPUD,RES/PUD,,,
19397,58-48-8-33-0,7715-56-3956,SNGL FAM URB,0.444,,176000,0,176000,899100,0,1075100,172500,0,172500,864700,0,1037200,RPUD,RES/PUD,,,
19398,58-48-8-34-0,7715-57-2095,SNGL FAM URB,0.39,,176000,0,176000,882500,9800,1068300,172500,0,172500,852600,9900,1035000,RPUD,RES/PUD,,,
19399,58-48-8-35-0,7715-57-2154,SNGL FAM URB,0.394,,176000,0,176000,751200,0,927200,172500,0,172500,724100,0,896600,RPUD,RES/PUD,,,
19400,58-48-8-36-0,7715-57-1293,SNGL FAM URB,0.471,,176000,0,176000,886700,0,1062700,172500,0,172500,854200,0,1026700,RPUD,RES/PUD,,,
19401,58-48-8-37-0,7715-57-1398,SNGL FAM URB,0.701,,176000,0,176000,757200,0,933200,172500,0,172500,745900,0,918400,RPUD,RES/PUD,,,
19402,58-48-8-38-0,7715-47-9429,SNGL FAM URB,0.419,,140800,0,140800,593700,0,734500,138000,0,138000,571600,0,709600,RPUD,RES/PUD,,,
19403,58-48-8-39-0,7715-47-9589,SNGL FAM URB,0.416,,140800,0,140800,591900,0,732700,138000,0,138000,580400,0,718400,RPUD,RES/PUD,,,
19404,58-48-8-40-0,7715-57-0617,SNGL FAM URB,0.39,,140800,0,140800,604000,0,744800,138000,0,138000,582400,0,720400,RPUD,RES/PUD,,,
19405,58-48-8-41-0,7715-57-1733,SNGL FAM URB,0.437,,140800,0,140800,700800,0,841600,138000,0,138000,668000,0,806000,RPUD,RES/PUD,,,
19406,58-48-8-42-0,7715-57-1825,SNGL FAM URB,0.475,,140800,0,140800,725900,0,866700,138000,0,138000,698100,0,836100,RPUD,RES/PUD,,,
19407,58-48-8-43-0,7715-57-0903,SNGL FAM URB,0.511,,140800,0,140800,703100,0,843900,138000,0,138000,667600,0,805600,RPUD,RES/PUD,,,
19408,58-48-8-44-0,7715-47-8980,SNGL FAM URB,0.528,,140800,0,140800,752000,0,892800,138000,0,138000,747800,0,885800,RPUD,RES/PUD,,,
19409,58-48-8-45-0,7715-47-8811,SNGL FAM URB,0.473,,140800,0,140800,664000,0,804800,138000,0,138000,645500,0,783500,RPUD,RES/PUD,,,
19410,58-48-8-46-0,7715-47-7780,SNGL FAM URB,0.364,,140800,0,140800,824800,0,965600,138000,0,138000,786700,0,924700,RPUD,RES/PUD,,,
19411,58-48-8-47-0,7715-47-7651,SNGL FAM URB,0.358,,140800,0,140800,580300,0,721100,138000,0,138000,560500,0,698500,RPUD,RES/PUD,,,
19412,58-48-8-48-0,7715-47-7523,SNGL FAM URB,0.346,,140800,0,140800,852500,0,993300,138000,0,138000,0,0,138000,RPUD,RES/PUD,,,
19413,58-48-8-49-0,7715-47-6226,SNGL FAM URB,0.477,,140800,0,140800,682400,0,823200,138000,0,138000,650800,0,788800,RPUD,RES/PUD,,,
19414,58-48-8-A-0,7715-48-8121,Cmn Area/Open Spc,6.286,,0,0,0,0,0,0,0,0,0,0,0,0,RPUD,RES/PUD,,,
19415,58-48-8-B-0,7715-47-6101,Cmn Area/Open Spc,0.829,,0,0,0,0,0,0,0,0,0,0,0,0,RPUD,RES/PUD,,,
19416,58-48-8-C-0,7715-57-0334,Cmn Area/Open Spc,1,,0,0,0,0,0,0,0,0,0,0,0,0,RPUD,RES/PUD,,,
19417,58-48-8-D-0,7715-46-8827,Cmn Area/Open Spc,0.48,,0,0,0,0,0,0,0,0,0,0,0,0,RPUD,RES/PUD,,,
19418,58-48-8-R-0,7715-47-9778,Roads,4.139,,0,0,0,0,0,0,0,0,0,0,0,0,RPUD,RES/PUD,,,
19419,44-6-0-1-TW,6787-52-7315-9998,COMM & IND,0,,0,0,0,0,151900,151900,0,0,0,0,149600,149600,A2,AG/LTD,,,
19420,26-1-0-12-A1,6709-86-8435,Cemetery,0,,100,0,100,0,0,100,100,0,100,0,0,100,A1,AG/GEN,,,
19421,42-1-0-76-C,6768-01-9386,SNGL FAM SUB,4.844,,99400,0,99400,378700,0,478100,89900,0,89900,324500,0,414400,A2,AG/LTD,,,
19424,43-38-A-1-0,6777-57-1012,SNGL FAM SUB,2.301,,150000,0,150000,694000,28300,872300,140000,0,140000,630800,24400,795200,RP,"RURAL,P",,,
19425,43-38-A-2-0,6777-47-9204,SNGL FAM SUB,2.068,,150000,0,150000,737200,3100,890300,140000,0,140000,684600,0,824600,RP,"RURAL,P",,,
19426,43-38-A-3-0,6777-47-7419,SNGL FAM SUB,2.747,,150000,0,150000,637200,0,787200,140000,0,140000,594500,0,734500,RP,"RURAL,P",,,
19427,43-38-A-4-0,6777-47-5850,SNGL FAM SUB,2.623,,150000,0,150000,617800,0,767800,140000,0,140000,562700,0,702700,RP,"RURAL,P",,,
19428,43-38-A-5-0,6777-48-5157,SNGL FAM SUB,2.845,,150000,0,150000,743600,3000,896600,140000,0,140000,693800,0,833800,RP,"RURAL,P",,,
19429,43-38-A-6-0,6777-48-9227,SNGL FAM SUB,3.248,,150000,0,150000,1026500,67700,1244200,140000,0,140000,942900,69400,1152300,RP,"RURAL,P",,,
19440,43-38-B-2-0,6777-46-6899,SNGL FAM SUB,2.257,,150000,0,150000,609400,47900,807300,140000,0,140000,560900,40500,741400,RP,"RURAL,P",,,
19441,43-38-B-3-0,6777-46-8741,SNGL FAM SUB,2.379,,150000,0,150000,673700,2500,826200,140000,0,140000,603600,0,743600,RP,"RURAL,P",,,
19442,43-38-B-4-0,6777-46-9582,SNGL FAM SUB,2.261,,150000,0,150000,575400,0,725400,140000,0,140000,534500,0,674500,RP,"RURAL,P",,,
19443,43-38-B-5-0,6777-56-1364,SNGL FAM SUB,2.598,,150000,0,150000,670000,14500,834500,140000,0,140000,616000,12300,768300,RP,"RURAL,P",,,
19444,43-38-A-A-0,6777-68-0046,Cmn Area/Open Spc,1.407,,0,0,0,0,0,0,0,0,0,0,0,0,RP,"RURAL,P",,,
19445,43-38-A-B-0,6777-57-4899,Cmn Area/Open Spc,37.301,,0,0,0,0,0,0,0,0,0,0,0,0,RP,"RURAL,P",,,
19446,43-38-A-C-0,6777-56-5981,Cmn Area/Open Spc,7.166,,0,0,0,0,0,0,0,0,0,0,0,0,RP,"RURAL,P",,,
19447,43-38-A-D-0,6777-46-6392,Cmn Area/Open Spc,9.574,,0,0,0,0,0,0,0,0,0,0,0,0,RP,"RURAL,P",,,
19448,43-38-A-E-0,6777-37-7663,Cmn Area/Open Spc,32.848,,0,0,0,0,0,0,0,0,0,0,0,0,RP,"RURAL,P",,,
19449,43-38-A-R-0,6777-57-7242,Roads,7.432,,0,0,0,0,0,0,0,0,0,0,0,0,RP,"RURAL,P",,,
19450,43-38-A-R-1,6777-68-1760,Roads,2.083,,0,0,0,0,0,0,0,0,0,0,0,0,RP,"RURAL,P",,,
19451,43-38-A-R-2,6777-46-2818,Roads,1.69,,0,0,0,0,0,0,0,0,0,0,0,0,RP,"RURAL,P",,,
19453,20-1-0-69-B,6840-76-1100,AG 20-100 AC,26.422,,231800,160200,71600,188800,10700,431300,227300,157700,69600,168000,10800,406100,A1,AG/GEN,,,
19455,64-1-0-53-A,7724-92-0565,Roads,0.064,,0,0,0,0,0,0,0,0,0,0,0,0,B1,BUS/GEN,,,
19457,48-17-0-1-0,7738-20-6819,SNGL FAM URB,0.14,,130000,0,130000,364800,0,494800,125000,0,125000,343100,0,468100,RPUD,RES/PUD,,,
19458,48-17-0-2-0,7738-20-6863,SNGL FAM URB,0.21,,130000,0,130000,371400,0,501400,125000,0,125000,353100,0,478100,RPUD,RES/PUD,,,
19459,48-17-0-3-0,7738-20-6736,SNGL FAM URB,0.22,,130000,0,130000,350200,0,480200,125000,0,125000,337600,0,462600,RPUD,RES/PUD,,,
19460,48-17-0-4-0,7738-20-6649,SNGL FAM URB,0.17,,130000,0,130000,345700,0,475700,125000,0,125000,326200,0,451200,RPUD,RES/PUD,,,
19461,48-17-0-5-0,7738-20-6631,SNGL FAM URB,0.18,,130000,0,130000,421600,0,551600,125000,0,125000,397900,0,522900,RPUD,RES/PUD,,,
19462,48-17-0-6-0,7738-20-6522,SNGL FAM URB,0.26,,130000,0,130000,430700,0,560700,125000,0,125000,415300,0,540300,RPUD,RES/PUD,,,
19463,48-17-0-7-0,7738-20-5486,SNGL FAM URB,0.26,,130000,0,130000,524100,0,654100,125000,0,125000,492200,0,617200,RPUD,RES/PUD,,,
19464,48-17-0-8-0,7738-20-5422,SNGL FAM URB,0.24,,130000,0,130000,388200,0,518200,125000,0,125000,413200,0,538200,RPUD,RES/PUD,,,
19465,48-17-0-9-0,7738-20-4359,SNGL FAM URB,0.22,,130000,0,130000,377600,0,507600,125000,0,125000,360300,0,485300,RPUD,RES/PUD,,,
19466,48-17-0-10-0,7738-20-3378,SNGL FAM URB,0.21,,130000,0,130000,529400,0,659400,125000,0,125000,494500,0,619500,RPUD,RES/PUD,,,
19467,48-17-0-11-0,7738-20-2399,SNGL FAM URB,0.21,,130000,0,130000,395300,0,525300,125000,0,125000,375600,0,500600,RPUD,RES/PUD,,,
19468,48-17-0-12-0,7738-20-2422,SNGL FAM URB,0.21,,130000,0,130000,482900,0,612900,125000,0,125000,449300,0,574300,RPUD,RES/PUD,,,
19469,48-17-0-13-0,7738-20-1456,SNGL FAM URB,0.22,,130000,0,130000,396700,0,526700,125000,0,125000,377100,0,502100,RPUD,RES/PUD,,,
19470,48-17-0-14-0,7738-20-1512,SNGL FAM URB,0.23,,130000,0,130000,503100,0,633100,125000,0,125000,499000,0,624000,RPUD,RES/PUD,,,
19471,48-17-0-15-0,7738-20-0579,SNGL FAM URB,0.23,,130000,0,130000,398800,0,528800,125000,0,125000,395200,0,520200,RPUD,RES/PUD,,,
19472,48-17-0-16-0,7738-20-0666,SNGL FAM URB,0.22,,130000,0,130000,463900,0,593900,125000,0,125000,453100,0,578100,RPUD,RES/PUD,,,
19473,48-17-0-17-0,7738-20-0783,SNGL FAM URB,0.2,,130000,0,130000,440000,0,570000,125000,0,125000,425200,0,550200,RPUD,RES/PUD,,,
19474,48-17-0-18-0,7738-20-1800,SNGL FAM URB,0.21,,130000,0,130000,411200,0,541200,125000,0,125000,407700,0,532700,RPUD,RES/PUD,,,
19475,48-17-0-19-0,7738-20-1827,SNGL FAM URB,0.2,,130000,0,130000,482400,0,612400,125000,0,125000,468800,0,593800,RPUD,RES/PUD,,,
19476,48-17-0-20-0,7738-20-1943,SNGL FAM URB,0.15,,130000,0,130000,509900,0,639900,125000,0,125000,477100,0,602100,RPUD,RES/PUD,,,
19477,48-17-0-21-0,7738-20-3902,SNGL FAM URB,0.17,,130000,0,130000,340200,0,470200,125000,0,125000,320500,0,445500,RPUD,RES/PUD,,,
19478,48-17-0-22-0,7738-20-3806,SNGL FAM URB,0.2,,130000,0,130000,399600,0,529600,125000,0,125000,376900,0,501900,RPUD,RES/PUD,,,
19479,48-17-0-23-0,7738-20-2789,SNGL FAM URB,0.2,,130000,0,130000,399600,0,529600,125000,0,125000,377100,0,502100,RPUD,RES/PUD,,,
19480,48-17-0-24-0,7738-20-2762,SNGL FAM URB,0.21,,130000,0,130000,363000,0,493000,125000,0,125000,347800,0,472800,RPUD,RES/PUD,,,
19481,48-17-0-25-0,7738-20-2654,SNGL FAM URB,0.28,,130000,0,130000,402600,0,532600,125000,0,125000,379700,0,504700,RPUD,RES/PUD,,,
19482,48-17-0-26-0,7738-20-3506,SNGL FAM URB,0.27,,130000,0,130000,426700,0,556700,125000,0,125000,400900,0,525900,RPUD,RES/PUD,,,
19483,48-17-0-27-0,7738-20-4506,SNGL FAM URB,0.27,,130000,0,130000,395400,0,525400,125000,0,125000,375700,0,500700,RPUD,RES/PUD,,,
19484,48-17-0-28-0,7738-20-4662,SNGL FAM URB,0.29,,130000,0,130000,357200,0,487200,125000,0,125000,345400,0,470400,RPUD,RES/PUD,,,
19485,48-17-0-29-0,7738-20-4750,SNGL FAM URB,0.25,,130000,0,130000,380300,0,510300,125000,0,125000,364600,0,489600,RPUD,RES/PUD,,,
19486,48-17-0-30-0,7738-20-4747,SNGL FAM URB,0.22,,130000,0,130000,396600,0,526600,125000,0,125000,377200,0,502200,RPUD,RES/PUD,,,
19487,48-17-0-31-0,7738-20-4844,SNGL FAM URB,0.2,,130000,0,130000,383300,0,513300,125000,0,125000,367700,0,492700,RPUD,RES/PUD,,,
19488,48-17-0-32-0,7738-20-4951,SNGL FAM URB,0.17,,130000,0,130000,396000,0,526000,125000,0,125000,376400,0,501400,RPUD,RES/PUD,,,
19489,48-17-0-33-0,7738-10-8966,SNGL FAM URB,0.17,,130000,0,130000,460300,0,590300,125000,0,125000,430700,0,555700,RPUD,RES/PUD,,,
19490,48-17-0-34-0,7738-10-8859,SNGL FAM URB,0.2,,130000,0,130000,514100,0,644100,125000,0,125000,488100,0,613100,RPUD,RES/PUD,,,
19491,48-17-0-35-0,7738-10-8842,SNGL FAM URB,0.19,,130000,0,130000,426000,0,556000,125000,0,125000,413000,0,538000,RPUD,RES/PUD,,,
19492,48-17-0-36-0,7738-10-8735,SNGL FAM URB,0.36,,130000,0,130000,402600,0,532600,125000,0,125000,391100,0,516100,RPUD,RES/PUD,,,
19493,48-17-0-37-0,7738-10-7698,SNGL FAM URB,0.2,,130000,0,130000,467700,0,597700,125000,0,125000,449600,0,574600,RPUD,RES/PUD,,,
19494,48-17-0-38-0,7738-10-7652,SNGL FAM URB,0.18,,130000,0,130000,404200,0,534200,125000,0,125000,394300,0,519300,RPUD,RES/PUD,,,
19495,48-17-0-39-0,7738-10-6997,SNGL FAM URB,0.17,,130000,0,130000,388000,0,518000,125000,0,125000,368200,0,493200,RPUD,RES/PUD,,,
19496,48-17-0-40-0,7738-10-6991,SNGL FAM URB,0.18,,130000,0,130000,427600,0,557600,125000,0,125000,400500,0,525500,RPUD,RES/PUD,,,
19497,48-17-0-A-0,7738-11-6062,Cmn Area/Open Spc,0.26,,0,0,0,0,0,0,0,0,0,0,0,0,RPUD,RES/PUD,,,
19498,48-17-0-B-0,7738-20-4956,Cmn Area/Open Spc,0.46,,0,0,0,0,0,0,0,0,0,0,0,0,RPUD,RES/PUD,,,
19499,48-17-0-C-0,7738-20-5380,Cmn Area/Open Spc,7.44,,0,0,0,0,0,0,0,0,0,0,0,0,RPUD,RES/PUD,,,
19500,48-17-0-D-0,7738-21-0207,Cmn Area/Open Spc,1.33,,0,0,0,0,0,0,0,0,0,0,0,0,RPUD,RES/PUD,,,
19503,47-12-0-1-B2,7717-32-2495,AG 20-100 AC,29.988,,748500,733500,15000,0,0,748500,669300,656500,12800,0,0,669300,A2,AG/LTD,,,
19504,19-1-0-45-D,6831-60-3494,SNGL FAM SUB,2.583,,63900,0,63900,319100,0,383000,60600,0,60600,275700,0,336300,A1,AG/GEN,,,
19505,57-1-0-53-G,7715-08-2799,Cemetery,0.0001,,100,0,100,0,0,100,100,0,100,0,0,100,A2,AG/LTD,,,
19507,39-1-0-6-A,6727-19-9433,SNGL FAM SUB,14.886,,114700,0,114700,622700,8400,745800,112400,0,112400,547400,8300,668100,A1,AG/GEN,,,
19508,43-1-0-2-D,6768-71-1170,SNGL FAM SUB,2.796,,94900,0,94900,254000,31400,380300,84700,0,84700,204000,26000,314700,A2,AG/LTD,,,
19509,58-4-G-R-0,7716-55-0883,Roads,0,,0,0,0,0,0,0,0,0,0,0,0,0,A2,AG/LTD,,,
19510,18-1-0-11-B,6810-56-9406,Cemetery,0.0001,,100,0,100,0,0,100,100,0,100,0,0,100,A1,AG/GEN,,,
19511,18-1-0-11-C,6810-56-6118,Cemetery,0,,100,0,100,0,0,100,100,0,100,0,0,100,A1,AG/GEN,,,
19512,25-1-0-1-B,5799-44-5501,AG 20-100 AC,86.061,,309800,269000,40800,0,0,309800,301200,264500,36700,0,0,301200,A1,AG/GEN,,,
19514,27-1-0-67-A1,6728-58-0416,Cemetery,0,,100,0,100,0,0,100,100,0,100,0,0,100,A1,AG/GEN,,,
19516,28-1-0-11-A,6728-99-5543,SNGL FAM SUB,2.06,,48000,0,48000,63700,500,112200,46100,0,46100,63700,500,110300,A1,AG/GEN,,,
19517,41-1-0-7-C,6748-50-4649,SNGL FAM SUB,6.142,,101200,0,101200,265900,0,367100,95200,0,95200,224600,0,319800,A1,AG/GEN,,,
19518,43-1-0-67-A,6777-49-6920,SNGL FAM SUB,2.507,,91800,0,91800,283700,3000,378500,82000,0,82000,231700,3000,316700,A2,AG/LTD,,,
19519,43-1-0-67-B,6777-49-4755,SNGL FAM SUB,2.026,,84900,0,84900,274700,10600,370200,75800,0,75800,224300,9400,309500,A2,AG/LTD,,,
19520,43-1-0-67-C,6777-49-2660,SNGL FAM SUB,2.146,,86600,0,86600,268500,35900,391000,77400,0,77400,217800,30100,325300,A2,AG/LTD,,,
19521,26-1-0-28-E2,6718-09-5417,SNGL FAM SUB,10,,93700,0,93700,317300,0,411000,92000,0,92000,273100,0,365100,A1,AG/GEN,,,
19522,26-1-0-28-E3,6718-09-1190,SNGL FAM SUB,8,,85000,0,85000,351300,0,436300,83500,0,83500,297100,0,380600,A1,AG/GEN,,,
19523,26-1-0-28-E4,6718-08-1701,SNGL FAM SUB,10,,93700,0,93700,331000,0,424700,92000,0,92000,277900,0,369900,A1,AG/GEN,,,
19524,46-26-0-9-A,7707-56-3462,SNGL FAM SUB,7.05,,196600,0,196600,508800,0,705400,178800,0,178800,423800,0,602600,RR,RES/RUR,,,
19526,40-1-0-33-A1,6738-41-8567,Cemetery,0.0001,,100,0,100,0,0,100,100,0,100,0,0,100,A1,AG/GEN,,,
19539,6-1-0-32-0,6823-80-3175,General Gov,0.245,,11600,0,11600,0,20500,32100,11200,0,11200,0,14300,25500,A1,AG/GEN,,,
19540,57-2-0-R-0,7716-16-4560,Roads,0.0001,,0,0,0,0,0,0,0,0,0,0,0,0,A2,AG/LTD,,,
19541,44-2-0-11-A,6787-73-1863,Cemetery,0.0001,,100,0,100,0,0,100,100,0,100,0,0,100,A2,AG/LTD,,,
19542,48-18-0-1-0,7738-11-7107,SNGL FAM URB,0.23,,130000,0,130000,447200,0,577200,125000,0,125000,418500,0,543500,RPUD,RES/PUD,,,
19543,48-18-0-2-0,7738-11-7215,SNGL FAM URB,0.24,,130000,0,130000,421600,0,551600,125000,0,125000,400400,0,525400,RPUD,RES/PUD,,,
19544,48-18-0-3-0,7738-11-7303,SNGL FAM URB,0.2,,130000,0,130000,376700,0,506700,125000,0,125000,357600,0,482600,RPUD,RES/PUD,,,
19545,48-18-0-4-0,7738-11-6490,SNGL FAM URB,0.2,,130000,0,130000,389000,0,519000,125000,0,125000,369200,0,494200,RPUD,RES/PUD,,,
19546,48-18-0-5-0,7738-11-6590,SNGL FAM URB,0.2,,130000,0,130000,388300,0,518300,125000,0,125000,366400,0,491400,RPUD,RES/PUD,,,
19547,48-18-0-6-0,7738-11-6587,SNGL FAM URB,0.22,,130000,0,130000,362700,0,492700,125000,0,125000,346800,0,471800,RPUD,RES/PUD,,,
19548,48-18-0-7-0,7738-11-6644,SNGL FAM URB,0.2,,130000,0,130000,423300,0,553300,125000,0,125000,396700,0,521700,RPUD,RES/PUD,,,
19549,48-18-0-8-0,7738-11-6710,SNGL FAM URB,0.2,,130000,0,130000,425300,0,555300,125000,0,125000,396100,0,521100,RPUD,RES/PUD,,,
19550,48-18-0-9-0,7738-11-5786,SNGL FAM URB,0.2,,130000,0,130000,379200,0,509200,125000,0,125000,358000,0,483000,RPUD,RES/PUD,,,
19551,48-18-0-10-0,7738-11-5852,SNGL FAM URB,0.18,,130000,0,130000,348100,0,478100,125000,0,125000,327800,0,452800,RPUD,RES/PUD,,,
19552,48-18-0-11-0,7738-11-5829,SNGL FAM URB,0.17,,130000,0,130000,500400,0,630400,125000,0,125000,466300,0,591300,RPUD,RES/PUD,,,
19553,48-18-0-12-0,7738-12-4020,SNGL FAM URB,0.18,,130000,0,130000,379700,0,509700,125000,0,125000,360900,0,485900,RPUD,RES/PUD,,,
19554,48-18-0-13-0,7738-12-4083,SNGL FAM URB,0.2,,130000,0,130000,353900,0,483900,125000,0,125000,330900,0,455900,RPUD,RES/PUD,,,
19555,48-18-0-14-0,7738-12-5057,SNGL FAM URB,0.2,,130000,0,130000,432900,0,562900,125000,0,125000,406300,0,531300,RPUD,RES/PUD,,,
19556,48-18-0-15-0,7738-12-6120,SNGL FAM URB,0.28,,130000,0,130000,503700,0,633700,125000,0,125000,469300,0,594300,RPUD,RES/PUD,,,
19557,48-18-0-16-0,7738-12-7100,SNGL FAM URB,0.23,,130000,0,130000,513000,0,643000,125000,0,125000,472000,0,597000,RPUD,RES/PUD,,,
19558,48-18-0-17-0,7738-12-7088,SNGL FAM URB,0.18,,130000,0,130000,418300,0,548300,125000,0,125000,394700,0,519700,RPUD,RES/PUD,,,
19559,48-18-0-18-0,7738-12-8057,SNGL FAM URB,0.18,,130000,0,130000,358200,9900,498100,125000,0,125000,335100,10000,470100,RPUD,RES/PUD,,,
19560,48-18-0-19-0,7738-12-9026,SNGL FAM URB,0.18,,130000,0,130000,463800,0,593800,125000,0,125000,431300,0,556300,RPUD,RES/PUD,,,
19561,48-18-0-20-0,7738-12-9095,SNGL FAM URB,0.18,,130000,0,130000,409700,0,539700,125000,0,125000,382700,0,507700,RPUD,RES/PUD,,,
19562,48-18-0-21-0,7738-22-0063,SNGL FAM URB,0.18,,130000,0,130000,357500,0,487500,125000,0,125000,336500,0,461500,RPUD,RES/PUD,,,
19563,48-18-0-22-0,7738-22-1032,SNGL FAM URB,0.2,,130000,0,130000,431500,0,561500,125000,0,125000,403200,0,528200,RPUD,RES/PUD,,,
19564,48-18-0-23-0,7738-21-0514,SNGL FAM URB,0.22,,130000,0,130000,397400,0,527400,125000,0,125000,373900,0,498900,RPUD,RES/PUD,,,
19565,48-18-0-24-0,7738-21-0601,SNGL FAM URB,0.21,,130000,0,130000,374100,0,504100,125000,0,125000,353000,0,478000,RPUD,RES/PUD,,,
19566,48-18-0-25-0,7738-21-0628,SNGL FAM URB,0.21,,130000,0,130000,351800,0,481800,125000,0,125000,331400,0,456400,RPUD,RES/PUD,,,
19567,48-18-0-26-0,7738-21-0735,SNGL FAM URB,0.2,,130000,0,130000,341500,0,471500,125000,0,125000,321400,0,446400,RPUD,RES/PUD,,,
19568,48-18-0-27-0,7738-21-0852,SNGL FAM URB,0.18,,130000,0,130000,353900,0,483900,125000,0,125000,331700,0,456700,RPUD,RES/PUD,,,
19569,48-18-0-28-0,7738-21-0869,SNGL FAM URB,0.18,,130000,0,130000,375600,0,505600,125000,0,125000,350600,0,475600,RPUD,RES/PUD,,,
19570,48-18-0-29-0,7738-11-9858,SNGL FAM URB,0.2,,130000,0,130000,397100,0,527100,125000,0,125000,368100,0,493100,RPUD,RES/PUD,,,
19571,48-18-0-30-0,7738-11-8889,SNGL FAM URB,0.2,,130000,0,130000,395400,0,525400,125000,0,125000,373300,0,498300,RPUD,RES/PUD,,,
19572,48-18-0-31-0,7738-11-8911,SNGL FAM URB,0.2,,130000,0,130000,447200,0,577200,125000,0,125000,417800,0,542800,RPUD,RES/PUD,,,
19573,48-18-0-32-0,7738-11-7942,SNGL FAM URB,0.2,,130000,0,130000,413900,0,543900,125000,0,125000,382900,0,507900,RPUD,RES/PUD,,,
19574,48-18-0-33-0,7738-11-6973,SNGL FAM URB,0.24,,130000,0,130000,471100,0,601100,125000,0,125000,440300,0,565300,RPUD,RES/PUD,,,
19575,48-18-0-34-0,7738-11-7749,SNGL FAM URB,0.22,,130000,0,130000,413300,0,543300,125000,0,125000,392200,0,517200,RPUD,RES/PUD,,,
19576,48-18-0-35-0,7738-11-7793,SNGL FAM URB,0.2,,130000,0,130000,389000,0,519000,125000,0,125000,369200,0,494200,RPUD,RES/PUD,,,
19577,48-18-0-36-0,7738-11-8637,SNGL FAM URB,0.2,,130000,0,130000,374500,0,504500,125000,0,125000,357800,0,482800,RPUD,RES/PUD,,,
19578,48-18-0-37-0,7738-11-8660,SNGL FAM URB,0.23,,130000,0,130000,393900,0,523900,125000,0,125000,375700,0,500700,RPUD,RES/PUD,,,
19579,48-18-0-38-0,7738-11-8563,SNGL FAM URB,0.22,,130000,0,130000,470000,0,600000,125000,0,125000,434100,0,559100,RPUD,RES/PUD,,,
19580,48-18-0-39-0,7738-11-8460,SNGL FAM URB,0.2,,130000,0,130000,401100,0,531100,125000,0,125000,377500,0,502500,RPUD,RES/PUD,,,
19581,48-18-0-40-0,7738-11-8372,SNGL FAM URB,0.2,,130000,0,130000,388000,0,518000,125000,0,125000,368200,0,493200,RPUD,RES/PUD,,,
19582,48-18-0-41-0,7738-11-8284,SNGL FAM URB,0.2,,130000,0,130000,377600,0,507600,125000,0,125000,360000,0,485000,RPUD,RES/PUD,,,
19583,48-18-0-42-0,7738-11-8176,SNGL FAM URB,0.2,,130000,0,130000,424900,0,554900,125000,0,125000,398100,0,523100,RPUD,RES/PUD,,,
19584,48-18-0-A-0,7738-11-6182,Cmn Area/Open Spc,0.72,,0,0,0,0,0,0,0,0,0,0,0,0,RPUD,RES/PUD,,,
19585,48-18-0-B-0,7738-12-4154,Cmn Area/Open Spc,0.98,,0,0,0,0,0,0,0,0,0,0,0,0,RPUD,RES/PUD,,,
19586,48-18-0-C-1,7738-21-2887,Cmn Area/Open Spc,2.25,,0,0,0,0,0,0,0,0,0,0,0,0,RPUD,RES/PUD,,,
19587,48-18-0-D-0,7738-11-9705,Cmn Area/Open Spc,0.69,,0,0,0,0,0,0,0,0,0,0,0,0,RPUD,RES/PUD,,,
19588,48-18-0-E-0,7738-21-0297,Cmn Area/Open Spc,0.25,,0,0,0,0,0,0,0,0,0,0,0,0,RPUD,RES/PUD,,,
19589,48-18-0-F-0,7738-11-8170,Cmn Area/Open Spc,0.09,,0,0,0,0,0,0,0,0,0,0,0,0,RPUD,RES/PUD,,,
19591,62-1-0-9-A1,7704-93-3187,COMM & IND,23.173,,837100,0,837100,0,0,837100,775000,0,775000,0,0,775000,A2,AG/LTD,,,
19592,64-25-1-16-A,7724-68-5853,COMM & IND,3.211,,574500,0,574500,0,0,574500,547200,0,547200,0,0,547200,M1,INDUS/L,,,
19593,64-25-1-20-A,7724-59-6658,COMM & IND,8.647,,1464400,0,1464400,0,0,1464400,1394700,0,1394700,0,0,1394700,M1,INDUS/L,,,
19594,64-25-1-18-A,7724-69-5362,COMM & IND,1.55,,343000,0,343000,1495100,224500,2062600,326600,0,326600,1388100,208100,1922800,M1,INDUS/L,,,
19595,13-1-0-28-C,6842-91-2852,Cemetery,0,,100,0,100,0,0,100,100,0,100,0,0,100,A1,AG/GEN,,,
19596,29-1-0-135-A,6748-97-0450,Cemetery,0,,100,0,100,0,0,100,100,0,100,0,0,100,A1,AG/GEN,,,
19597,13-1-0-26-A,6841-88-4392,SNGL FAM SUB,4.48,,74600,0,74600,0,0,74600,73200,0,73200,0,0,73200,A1,AG/GEN,,,
19598,30-1-0-66-A,6759-61-1785,SNGL FAM SUB,3.458,,74800,0,74800,0,0,74800,66900,0,66900,0,0,66900,A2,AG/LTD,,,
19599,38-1-0-10-E,6708-90-1198,Cemetery,0.089,,100,0,100,0,0,100,100,0,100,0,0,100,A1,AG/GEN,,,
19618,48-6-0-1-C,7738-01-8997,COMM & IND,4.05,,524400,0,524400,0,0,524400,499400,0,499400,0,0,499400,B1,BUS/GEN,,,
19619,41-1-0-1-B,6748-21-7839,SNGL FAM SUB,7.675,,114300,0,114300,456200,0,570500,112600,0,112600,386700,0,499300,A1,AG/GEN,,,
19620,41-1-0-1-C,6748-32-0078,SNGL FAM SUB,6.872,,107500,0,107500,444700,0,552200,105100,0,105100,378300,0,483400,A1,AG/GEN,,,
19621,46-1-0-68-C,7707-80-7903,SNGL FAM SUB,2,,121800,0,121800,367000,2900,491700,108800,0,108800,306700,2900,418400,A2,AG/LTD,,,
19622,58-1-0-33-A,7715-23-6257,SNGL FAM SUB,1.322,,172700,0,172700,620000,0,792700,150200,0,150200,516700,0,666900,A2,AG/LTD,,,
19623,17-1-0-86-J,6719-17-1909,SNGL FAM SUB,12.094,,99900,54200,45700,178800,2000,280700,93500,50800,42700,153600,2000,249100,A1,AG/GEN,,,
19624,9-1-0-65-A,5892-51-4377,SNGL FAM SUB,2.168,,43000,0,43000,208800,0,251800,41500,0,41500,177800,0,219300,A1,AG/GEN,,,
19625,11-1-0-16-B,6811-89-5724,AG 20-100 AC,36.671,,123200,104700,18500,0,4500,127700,124700,109000,15700,0,4500,129200,A1,AG/GEN,,,
19626,11-1-0-16-C,6811-98-2908,SNGL FAM SUB,12.186,,101400,56900,44500,115900,5900,223200,99500,56700,42800,101700,5900,207100,A1,AG/GEN,,,
19627,11-1-0-16-D,6812-90-0473,AG 20-100 AC,48.857,,170900,147600,23300,0,54700,225600,171000,150100,20900,0,46500,217500,A1,AG/GEN,,,
19628,9-1-0-65-A1,5892-51-4377,Cemetery,0,,100,0,100,0,0,100,100,0,100,0,0,100,A1,AG/GEN,,,
19630,42-1-0-24-B,6766-17-2597,SNGL FAM SUB,2.24,,80500,0,80500,0,51400,131900,71800,0,71800,0,47800,119600,B1A2,BS AND,,,
19631,3-1-0-4-A,6803-23-7600,SNGL FAM SUB,3.075,,50600,0,50600,221400,0,272000,48400,0,48400,187600,0,236000,A1,AG/GEN,,,
19632,38-1-0-70-A,6717-05-4038,SNGL FAM SUB,8.88,,82900,0,82900,241000,0,323900,81300,0,81300,219700,0,301000,A1,AG/GEN,,,
19633,16-1-0-59-A1,6800-08-1657,Cemetery,0.001,,100,0,100,0,0,100,100,0,100,0,0,100,A1,AG/GEN,,,
19634,42-1-0-64-C,6757-98-4110,General Gov,13.77,,2120700,0,2120700,0,0,2120700,2087400,0,2087400,0,0,2087400,B1R3,BUS/GEN,,,
19635,26-1-0-22-A,6719-00-7398,Cemetery,0.0001,,100,0,100,0,0,100,100,0,100,0,0,100,A1,AG/GEN,,,
19636,21-1-0-41-E,6850-50-3584,SNGL FAM SUB,2.77,,75600,0,75600,349600,2800,428000,68300,0,68300,294100,3100,365500,A2,AG/LTD,,,
19637,29-10-0-1-0,6749-32-7642,SNGL FAM SUB,9.18,,112400,0,112400,250800,32600,395800,108500,0,108500,205800,27400,341700,A1,AG/GEN,,,
19638,29-10-0-2-0,6749-42-3161,AG 20-100 AC,21.46,,135400,79000,56400,270300,0,405700,128700,0,128700,222200,0,350900,A1,AG/GEN,,,
19639,29-10-0-3-0,6749-42-4776,SNGL FAM SUB,5.12,,81800,0,81800,265100,0,346900,76800,0,76800,217400,0,294200,A1,AG/GEN,,,
19640,29-10-0-4-0,6749-42-8747,SNGL FAM SUB,5.38,,83800,0,83800,274200,19700,377700,78900,0,78900,226500,18600,324000,A1,AG/GEN,,,
19641,29-10-0-5-0,6749-52-1395,AG 20-100 AC,22.08,,138100,81400,56700,265100,0,403200,131300,0,131300,217400,0,348700,A1,AG/GEN,,,
19642,29-10-0-6-0,6749-52-6951,SNGL FAM SUB,5.77,,86700,0,86700,265100,0,351800,81900,0,81900,217400,0,299300,A1,AG/GEN,,,
19643,46-1-0-118-B2,7717-04-8447,SNGL FAM SUB,2.008,,165000,0,165000,207400,1600,374000,150000,0,150000,170000,1500,321500,A2,AG/LTD,,,
19644,43-39-0-1-0,6777-07-0655,SNGL FAM SUB,2.01,,140000,0,140000,582400,0,722400,130000,0,130000,547300,0,677300,RP,"RURAL,P",,,
19645,43-39-0-2-0,6777-07-2439,SNGL FAM SUB,2,,140000,0,140000,465200,2000,607200,130000,0,130000,426400,2000,558400,RP,"RURAL,P",,,
19646,43-39-0-3-0,6777-07-4460,SNGL FAM SUB,2,,140000,0,140000,399500,3100,542600,130000,0,130000,364300,0,494300,RP,"RURAL,P",,,
19647,43-39-0-4-0,6777-07-7306,SNGL FAM SUB,2,,140000,0,140000,524300,0,664300,130000,0,130000,484200,0,614200,RP,"RURAL,P",,,
19648,43-39-0-5-0,6777-07-9352,SNGL FAM SUB,2.02,,140000,0,140000,477800,0,617800,130000,0,130000,432600,0,562600,RP,"RURAL,P",,,
19649,43-39-0-6-0,6777-17-2206,SNGL FAM SUB,2.01,,140000,0,140000,540400,0,680400,130000,0,130000,491800,0,621800,RP,"RURAL,P",,,
19650,43-39-0-7-0,6777-17-4124,SNGL FAM SUB,2.01,,140000,0,140000,528700,0,668700,130000,0,130000,484200,0,614200,RP,"RURAL,P",,,
19651,43-39-0-8-0,6777-17-6032,SNGL FAM SUB,2.01,,140000,0,140000,437200,0,577200,130000,0,130000,401900,0,531900,RP,"RURAL,P",,,
19652,43-39-0-9-0,6777-16-7851,SNGL FAM SUB,2.01,,140000,0,140000,448300,2500,590800,130000,0,130000,408300,0,538300,RP,"RURAL,P",,,
19653,43-39-0-10-0,6777-16-9539,SNGL FAM SUB,2.01,,140000,0,140000,419600,0,559600,130000,0,130000,386200,0,516200,RP,"RURAL,P",,,
19654,43-39-0-11-0,6777-26-4419,SNGL FAM SUB,2,,140000,0,140000,464200,0,604200,130000,0,130000,424400,0,554400,RP,"RURAL,P",,,
19655,43-39-0-12-0,6777-26-7452,SNGL FAM SUB,2.01,,140000,0,140000,547300,0,687300,130000,0,130000,503600,0,633600,RP,"RURAL,P",,,
19656,43-39-0-13-0,6777-26-6778,SNGL FAM SUB,2.02,,140000,0,140000,546500,0,686500,130000,0,130000,511700,0,641700,RP,"RURAL,P",,,
19657,43-39-0-14-0,6777-26-4824,SNGL FAM SUB,2.02,,140000,0,140000,468100,2500,610600,130000,0,130000,429100,0,559100,RP,"RURAL,P",,,
19658,43-39-0-15-0,6777-26-1926,SNGL FAM SUB,2.06,,140000,0,140000,444400,30300,614700,130000,0,130000,404800,40900,575700,RP,"RURAL,P",,,
19659,43-39-0-16-0,6777-27-0116,SNGL FAM SUB,2,,140000,0,140000,454300,0,594300,130000,0,130000,413700,0,543700,RP,"RURAL,P",,,
19660,43-39-0-17-0,6777-17-8376,SNGL FAM SUB,2.01,,140000,0,140000,525800,60200,726000,130000,0,130000,481700,54300,666000,RP,"RURAL,P",,,
19661,43-39-0-18-0,6777-17-6478,SNGL FAM SUB,2,,140000,0,140000,415000,0,555000,130000,0,130000,380900,0,510900,RP,"RURAL,P",,,
19662,43-39-0-19-0,6777-17-4578,SNGL FAM SUB,2.01,,140000,0,140000,418300,0,558300,130000,0,130000,381700,0,511700,RP,"RURAL,P",,,
19663,43-39-0-20-0,6777-17-2604,SNGL FAM SUB,2.04,,140000,0,140000,525100,2500,667600,130000,0,130000,481100,2300,613400,RP,"RURAL,P",,,
19664,43-39-0-21-0,6777-17-4844,SNGL FAM SUB,2.1,,140000,0,140000,446400,0,586400,130000,0,130000,403000,0,533000,RP,"RURAL,P",,,
19665,43-39-0-22-0,6777-18-4001,SNGL FAM SUB,2.14,,140000,0,140000,460700,0,600700,130000,0,130000,419400,0,549400,RP,"RURAL,P",,,
19666,43-39-0-23-0,6777-18-4257,SNGL FAM SUB,2.02,,140000,0,140000,497200,0,637200,130000,0,130000,462200,0,592200,RP,"RURAL,P",,,
19667,43-39-0-24-0,6777-18-0233,SNGL FAM SUB,2.02,,140000,0,140000,428900,0,568900,130000,0,130000,390800,0,520800,RP,"RURAL,P",,,
19668,43-39-0-25-0,6777-08-9033,SNGL FAM SUB,2.01,,140000,0,140000,432900,0,572900,130000,0,130000,398400,0,528400,RP,"RURAL,P",,,
19669,43-39-0-26-0,6777-07-8784,SNGL FAM SUB,2.02,,140000,0,140000,450100,0,590100,130000,0,130000,416600,0,546600,RP,"RURAL,P",,,
19670,43-39-0-27-0,6777-07-6840,SNGL FAM SUB,2,,140000,0,140000,417700,0,557700,130000,0,130000,388700,0,518700,RP,"RURAL,P",,,
19671,43-39-0-28-0,6777-07-4836,SNGL FAM SUB,2.01,,140000,0,140000,393800,28800,562600,130000,0,130000,347600,0,477600,RP,"RURAL,P",,,
19672,43-39-0-29-0,6777-08-3006,SNGL FAM SUB,2.01,,140000,0,140000,468200,0,608200,130000,0,130000,425200,0,555200,RP,"RURAL,P",,,
19673,43-39-0-A-0,6777-16-3751,Cmn Area/Open Spc,32.18,,0,0,0,0,0,0,0,0,0,0,0,0,RP,"RURAL,P",,,
19674,43-39-0-B-0,6777-27-6199,Cmn Area/Open Spc,32.97,,0,0,0,0,0,0,0,0,0,0,0,0,RP,"RURAL,P",,,
19675,43-39-0-R-0,6777-17-5298,Roads,5.33,,0,0,0,0,0,0,0,0,0,0,0,0,RP,"RURAL,P",,,
19676,43-39-0-R-1,6777-18-4600,Roads,1.12,,0,0,0,0,0,0,0,0,0,0,0,0,RP,"RURAL,P",,,
19677,57-1-0-43-C,7715-02-5570,SNGL FAM SUB,5.578,,277400,0,277400,510100,28600,816100,241100,0,241100,423900,24500,689500,A2,AG/LTD,,,
19678,47-1-0-43-P8,7716-98-9577,COMM & IND,1.049,,713800,0,713800,0,0,713800,648900,0,648900,0,0,648900,B1,BUS/GEN,,,
19680,47-1-0-43-P10,7726-08-3751,COMM & IND,0.764,,386600,0,386600,0,0,386600,351400,0,351400,0,0,351400,B1,BUS/GEN,,,
19681,63-1-0-79-A,7713-87-7169,Roads,0.0001,,0,0,0,0,0,0,0,0,0,0,0,0,A2,AG/LTD,,,
19682,42-1-0-60-F1,6757-56-7924,SNGL FAM SUB,4.1,,94500,0,94500,228100,800,323400,84200,0,84200,192100,800,277100,A2,AG/LTD,,,
19683,58-51-0-1-0,7715-69-6848,SNGL FAM URB,0.86,,287500,0,287500,0,0,287500,250000,0,250000,0,0,250000,RPUD,RES/PUD,,,
19684,58-51-0-2-0,7715-69-5817,SNGL FAM URB,0.69,,287500,0,287500,0,0,287500,250000,0,250000,0,0,250000,RPUD,RES/PUD,,,
19685,58-51-0-3-0,7715-69-3883,SNGL FAM URB,0.61,,287500,0,287500,0,0,287500,250000,0,250000,0,0,250000,RPUD,RES/PUD,,,
19686,58-51-0-4-0,7715-59-7798,SNGL FAM URB,1.6,,316300,0,316300,1391900,96400,1804600,275000,0,275000,1169400,86600,1531000,RPUD,RES/PUD,,,
19687,58-51-0-5-0,7715-59-7984,SNGL FAM URB,1.48,,316300,0,316300,1400300,78800,1795400,275000,0,275000,1196700,71900,1543600,RPUD,RES/PUD,,,
19688,58-51-0-6-0,7716-50-9014,SNGL FAM URB,0.91,,287500,0,287500,0,0,287500,250000,0,250000,0,0,250000,RPUD,RES/PUD,,,
19689,58-51-0-7-0,7716-60-1003,SNGL FAM URB,0.55,,287500,0,287500,957500,0,1245000,250000,0,250000,792500,0,1042500,RPUD,RES/PUD,,,
19690,58-51-0-8-0,7716-60-2032,SNGL FAM URB,0.66,,287500,0,287500,0,0,287500,250000,0,250000,0,0,250000,RPUD,RES/PUD,,,
19691,58-51-0-9-0,7716-60-3078,SNGL FAM URB,0.71,,287500,0,287500,0,0,287500,250000,0,250000,0,0,250000,RPUD,RES/PUD,,,
19692,58-51-0-10-0,7716-60-5126,SNGL FAM URB,0.95,,287500,0,287500,1036100,0,1323600,250000,0,250000,861800,0,1111800,RPUD,RES/PUD,,,
19693,58-51-0-11-0,7716-60-6205,SNGL FAM URB,0.78,,287500,0,287500,0,0,287500,250000,0,250000,0,0,250000,RPUD,RES/PUD,,,
19694,58-51-0-12-0,7716-60-6377,SNGL FAM URB,0.6,,287500,0,287500,1260500,11100,1559100,250000,0,250000,1069500,9800,1329300,RPUD,RES/PUD,,,
19695,58-51-0-13-0,7716-60-7478,SNGL FAM URB,0.6,,287500,0,287500,0,0,287500,250000,0,250000,0,0,250000,RPUD,RES/PUD,,,
19696,58-51-0-14-0,7716-60-9516,SNGL FAM URB,1.18,,316300,0,316300,0,0,316300,275000,0,275000,0,0,275000,RPUD,RES/PUD,,,
19697,58-51-0-15-0,7716-70-0458,SNGL FAM URB,0.87,,287500,0,287500,1043400,0,1330900,250000,0,250000,894700,0,1144700,RPUD,RES/PUD,,,
19698,58-51-0-16-0,7716-70-1368,SNGL FAM URB,0.87,,287500,0,287500,0,0,287500,250000,0,250000,0,0,250000,RPUD,RES/PUD,,,
19699,58-51-0-17-0,7716-70-2236,SNGL FAM URB,1.07,,316300,0,316300,0,0,316300,275000,0,275000,0,0,275000,RPUD,RES/PUD,,,
19700,58-51-0-18-0,7716-70-2142,SNGL FAM URB,1.44,,316300,0,316300,0,0,316300,275000,0,275000,0,0,275000,RPUD,RES/PUD,,,
19701,58-51-0-19-0,7716-70-3054,SNGL FAM URB,1.23,,316300,0,316300,0,0,316300,275000,0,275000,0,0,275000,RPUD,RES/PUD,,,
19702,58-51-0-20-0,7715-79-5680,SNGL FAM URB,1.32,,316300,0,316300,0,0,316300,275000,0,275000,0,0,275000,RPUD,RES/PUD,,,
19703,58-51-0-21-0,7715-79-6425,SNGL FAM URB,1.32,,316300,0,316300,0,0,316300,275000,0,275000,0,0,275000,RPUD,RES/PUD,,,
19704,58-51-0-22-0,7715-79-6370,SNGL FAM URB,1.28,,316300,0,316300,0,0,316300,275000,0,275000,0,0,275000,RPUD,RES/PUD,,,
19705,58-51-0-23-0,7715-79-3233,SNGL FAM URB,0.72,,287500,0,287500,0,0,287500,250000,0,250000,0,0,250000,RPUD,RES/PUD,,,
19706,58-51-0-24-0,7715-79-2398,SNGL FAM URB,0.78,,287500,0,287500,0,0,287500,250000,0,250000,0,0,250000,RPUD,RES/PUD,,,
19707,58-51-0-25-0,7715-79-2573,SNGL FAM URB,0.6,,287500,0,287500,0,0,287500,250000,0,250000,0,0,250000,RPUD,RES/PUD,,,
19708,58-51-0-26-0,7715-79-2635,SNGL FAM URB,0.63,,287500,0,287500,0,0,287500,250000,0,250000,0,0,250000,RPUD,RES/PUD,,,
19709,58-51-0-27-0,7715-79-0798,SNGL FAM URB,0.81,,287500,0,287500,0,0,287500,250000,0,250000,0,0,250000,RPUD,RES/PUD,,,
19710,58-51-0-28-0,7715-69-9885,SNGL FAM URB,0.8,,287500,0,287500,0,0,287500,250000,0,250000,0,0,250000,RPUD,RES/PUD,,,
19711,58-51-0-29-0,7715-69-8839,SNGL FAM URB,1,,316300,0,316300,1289000,6000,1611300,275000,0,275000,0,0,275000,RPUD,RES/PUD,,,
19712,58-51-0-30-0,7715-69-8611,SNGL FAM URB,0.53,,287500,0,287500,0,0,287500,250000,0,250000,0,0,250000,RPUD,RES/PUD,,,
19713,58-51-0-31-0,7715-69-9539,SNGL FAM URB,0.5,,287500,0,287500,0,0,287500,250000,0,250000,0,0,250000,RPUD,RES/PUD,,,
19714,58-51-0-32-0,7715-79-0551,SNGL FAM URB,0.52,,287500,0,287500,0,0,287500,250000,0,250000,0,0,250000,RPUD,RES/PUD,,,
19715,58-51-0-33-0,7715-79-0394,SNGL FAM URB,0.71,,287500,0,287500,0,0,287500,250000,0,250000,0,0,250000,RPUD,RES/PUD,,,
19716,58-51-0-34-0,7715-69-9362,SNGL FAM URB,0.66,,287500,0,287500,0,0,287500,250000,0,250000,0,0,250000,RPUD,RES/PUD,,,
19717,58-51-0-35-0,7715-69-8306,SNGL FAM URB,0.61,,230000,0,230000,0,0,230000,200000,0,200000,0,0,200000,RPUD,RES/PUD,,,
19718,58-51-0-36-0,7715-69-6366,SNGL FAM URB,0.62,,230000,0,230000,0,0,230000,200000,0,200000,0,0,200000,RPUD,RES/PUD,,,
19719,58-51-0-37-0,7715-69-5336,SNGL FAM URB,0.62,,230000,0,230000,0,0,230000,200000,0,200000,0,0,200000,RPUD,RES/PUD,,,
19720,58-51-0-38-0,7715-69-4306,SNGL FAM URB,0.55,,230000,0,230000,0,0,230000,200000,0,200000,0,0,200000,RPUD,RES/PUD,,,
19721,58-51-0-39-0,7715-69-2395,SNGL FAM URB,0.47,,230000,0,230000,0,0,230000,200000,0,200000,0,0,200000,RPUD,RES/PUD,,,
19722,58-51-0-40-0,7715-69-1364,SNGL FAM URB,0.55,,287500,0,287500,0,0,287500,250000,0,250000,0,0,250000,RPUD,RES/PUD,,,
19723,58-51-0-41-0,7715-69-0442,SNGL FAM URB,0.67,,287500,0,287500,0,0,287500,250000,0,250000,0,0,250000,RPUD,RES/PUD,,,
19724,58-51-0-42-0,7715-69-0554,SNGL FAM URB,0.65,,287500,0,287500,0,0,287500,250000,0,250000,0,0,250000,RPUD,RES/PUD,,,
19725,58-51-0-43-0,7715-69-1682,SNGL FAM URB,0.52,,287500,0,287500,0,0,287500,250000,0,250000,0,0,250000,RPUD,RES/PUD,,,
19726,58-51-0-44-0,7715-69-3602,SNGL FAM URB,0.54,,287500,0,287500,0,0,287500,250000,0,250000,0,0,250000,RPUD,RES/PUD,,,
19727,58-51-0-45-0,7715-69-4611,SNGL FAM URB,0.56,,287500,0,287500,0,0,287500,250000,0,250000,0,0,250000,RPUD,RES/PUD,,,
19728,58-51-0-46-0,7715-69-5631,SNGL FAM URB,0.53,,287500,0,287500,0,0,287500,250000,0,250000,0,0,250000,RPUD,RES/PUD,,,
19729,58-51-0-47-0,7715-69-6651,SNGL FAM URB,0.53,,287500,0,287500,0,0,287500,250000,0,250000,0,0,250000,RPUD,RES/PUD,,,
19730,58-51-0-A-0,7715-79-6120,Cmn Area/Open Spc,29.45,,0,0,0,0,0,0,0,0,0,0,0,0,RPUD,RES/PUD,,,
19731,58-51-0-B-0,7716-60-8187,Cmn Area/Open Spc,1.33,,0,0,0,0,0,0,0,0,0,0,0,0,RPUD,RES/PUD,,,
19732,58-51-0-R-0,7715-79-1933,Roads,5.25,,0,0,0,0,0,0,0,0,0,0,0,0,RPUD,RES/PUD,,,
19733,56-1-0-55-A,6796-36-3994,SNGL FAM SUB,,,0,0,0,123300,31100,154400,0,0,0,97300,26000,123300,A2,AG/LTD,,,
19734,32-19-0-1-0,6779-95-3739,SNGL FAM SUB,3.02,,99200,0,99200,313500,0,412700,88700,0,88700,256000,0,344700,A2,AG/LTD,,,
19735,32-19-0-2-0,6779-85-8857,SNGL FAM SUB,2.57,,92700,0,92700,371800,0,464500,82900,0,82900,300400,0,383300,A2,AG/LTD,,,
19736,32-19-0-3-0,6779-96-1041,SNGL FAM SUB,2.247,,88100,0,88100,308400,0,396500,78700,0,78700,249900,0,328600,A2,AG/LTD,,,
19737,32-19-0-4-0,6779-86-9117,SNGL FAM SUB,2.005,,84600,0,84600,317000,0,401600,75600,0,75600,261200,0,336800,A2,AG/LTD,,,
19738,26-2-0-2-B2,6718-09-0968,SNGL FAM SUB,5,,61200,0,61200,395300,0,456500,60000,0,60000,331400,0,391400,A1,AG/GEN,,,
19739,46-1-0-76-D5,7707-22-8457,SNGL FAM SUB,3.62,,132300,0,132300,0,0,132300,122300,0,122300,0,0,122300,A2,AG/LTD,,,
19740,63-41-0-1-MC,7724-13-8334,Cmn Area/Open Spc,1.268,,0,0,0,0,0,0,0,0,0,0,0,0,R3,RES/GEN,,,
19741,63-41-0-2-MC,7724-23-0300,Cmn Area/Open Spc,0.821,,0,0,0,0,0,0,0,0,0,0,0,0,R3,RES/GEN,,,
19742,63-41-0-3-MC,7724-23-1378,Cmn Area/Open Spc,0.851,,0,0,0,0,0,0,0,0,0,0,0,0,R3,RES/GEN,,,
19743,63-41-0-4-MC,7724-23-2596,Cmn Area/Open Spc,0.86,,0,0,0,0,0,0,0,0,0,0,0,0,R3,RES/GEN,,,
19744,63-41-0-5-0,7724-23-1627,MultiFamily,0.805,,336900,0,336900,0,0,336900,300000,0,300000,0,0,300000,R3,RES/GEN,,,
19745,63-41-0-6-MC,7724-23-2757,Cmn Area/Open Spc,0.869,,0,0,0,0,0,0,300000,0,300000,1189600,0,1489600,R3,RES/GEN,,,
19746,63-41-0-A-0,7724-23-3923,Cmn Area/Open Spc,0.99,,0,0,0,0,0,0,0,0,0,0,0,0,R3,RES/GEN,,,
19747,63-41-0-R-0,7724-23-0515,Roads,0.371,,0,0,0,0,0,0,0,0,0,0,0,0,R3,RES/GEN,,,
19748,45-1-0-74-B,6796-88-1664-0001,AG > 100 AC,0,,0,0,0,124600,0,124600,0,0,0,96800,0,96800,A2,AG/LTD,,,
19749,67-2-A-6-B,7723-66-0126,SNGL FAM SUB,0.088,,4800,0,4800,0,0,4800,4200,0,4200,0,0,4200,R1,RES/LTD,,,
19750,67-1-0-11-C1,7723-52-2477,SNGL FAM SUB,2.33,,22100,0,22100,0,0,22100,19300,0,19300,0,0,19300,A2,AG/LTD,,,
19751,58-52-1-1-0,7715-23-7095,SNGL FAM SUB,2,,193900,0,193900,546700,9900,750500,168600,0,168600,454600,10000,633200,A2,AG/LTD,,,
19752,58-52-1-2-0,7715-22-9989,SNGL FAM SUB,2,,193900,0,193900,573900,0,767800,168600,0,168600,473100,4600,646300,A2,AG/LTD,,,
19753,58-52-1-3-0,7715-32-1920,SNGL FAM SUB,2.121,,197700,0,197700,628800,0,826500,171900,0,171900,539900,0,711800,A2,AG/LTD,,,
19754,58-52-1-R-0,7715-33-1109,Roads,0.677,,0,0,0,0,0,0,0,0,0,0,0,0,A2,AG/LTD,,,
19755,59-4-0-1-0,7726-76-8786,COMM & IND,6.274,,6184100,0,6184100,3344400,614500,10143000,5621900,0,5621900,3236200,633300,9491400,B1,BUS/GEN,,,
19756,59-4-0-2-T,7726-87-1074-9999,COMM & IND,4.046,,3377300,0,3377300,0,0,3377300,3070300,0,3070300,0,0,3070300,B1,BUS/GEN,,,
19757,59-4-0-3-0,7726-86-2437,COMM & IND,1.276,,1389600,0,1389600,0,0,1389600,1263200,0,1263200,0,0,1263200,B1,BUS/GEN,,,
19758,59-4-0-4-0,7726-77-8351,COMM & IND,0.679,,436900,0,436900,243700,66600,747200,397200,0,397200,236900,68700,702800,B1,BUS/GEN,,,
19759,59-4-0-5-0,7726-76-6945,COMM & IND,2.286,,2263100,0,2263100,0,0,2263100,2057400,0,2057400,0,0,2057400,B3,INTRCHGCOM,,,
19760,59-4-0-R-0,7726-86-1543,Roads,0.85,,0,0,0,0,0,0,0,0,0,0,0,0,B1,BUS/GEN,,,
19761,59-4-0-A-0,7726-77-9489,Cmn Area/Open Spc,0.038,,0,0,0,0,0,0,0,0,0,0,0,0,B1,BUS/GEN,,,
19762,6-1-0-38-B,6822-87-5341,SNGL FAM SUB,3.09,,57400,56000,1400,0,0,57400,55700,54300,1400,0,0,55700,A1,AG/GEN,,,
19763,4-14-0-1-0,6803-70-9216,SNGL FAM SUB,17.95,,94300,0,94300,0,0,94300,92100,0,92100,0,0,92100,A1,AG/GEN,,,
19764,4-14-0-2-0,6802-89-1706,SNGL FAM SUB,19.89,,101800,0,101800,369600,12500,483900,99300,0,99300,315200,12600,427100,A1,AG/GEN,,,
19765,4-14-0-3-0,6802-89-0238,SNGL FAM SUB,17.23,,91500,0,91500,0,0,91500,89400,0,89400,0,0,89400,A1,AG/GEN,,,
19766,4-14-0-4-0,6802-78-9704,AG 20-100 AC,24.64,,160100,109800,50300,366200,0,526300,156200,108100,48100,317900,0,474100,A1,AG/GEN,,,
19767,43-40-C-R-0,6777-55-9485,Roads,5.65,,0,0,0,0,0,0,0,0,0,0,0,0,RP,"RURAL,P",,,
19768,48-19-0-1-0,7738-11-3966,SNGL FAM URB,0.18,,130000,0,130000,405500,0,535500,125000,0,125000,379500,0,504500,RPUD,RES/PUD,,,
19769,48-19-0-2-0,7738-11-3903,SNGL FAM URB,0.18,,130000,0,130000,348300,0,478300,125000,0,125000,326600,0,451600,RPUD,RES/PUD,,,
19770,48-19-0-3-0,7738-11-2940,SNGL FAM URB,0.18,,130000,0,130000,416500,0,546500,125000,0,125000,394300,0,519300,RPUD,RES/PUD,,,
19771,48-19-0-4-0,7738-11-1887,SNGL FAM URB,0.18,,130000,0,130000,376800,0,506800,125000,0,125000,350900,0,475900,RPUD,RES/PUD,,,
19772,48-19-0-5-0,7738-11-3778,SNGL FAM URB,0.17,,130000,0,130000,378200,0,508200,125000,0,125000,361200,0,486200,RPUD,RES/PUD,,,
19773,48-19-0-6-0,7738-11-4831,SNGL FAM URB,0.2,,130000,0,130000,418200,0,548200,125000,0,125000,394800,0,519800,RPUD,RES/PUD,,,
19774,48-19-0-7-0,7738-11-4668,SNGL FAM URB,0.2,,130000,0,130000,420900,0,550900,125000,0,125000,394500,0,519500,RPUD,RES/PUD,,,
19775,48-19-0-8-0,7738-11-4692,SNGL FAM URB,0.2,,130000,0,130000,375600,0,505600,125000,0,125000,349400,0,474400,RPUD,RES/PUD,,,
19776,48-19-0-9-0,7738-11-5525,SNGL FAM URB,0.2,,130000,0,130000,383300,0,513300,125000,0,125000,358500,0,483500,RPUD,RES/PUD,,,
19777,48-19-0-A-0,7738-11-0848,Cmn Area/Open Spc,0.67,,0,0,0,0,0,0,0,0,0,0,0,0,RPUD,RES/PUD,,,
19778,48-19-0-B-0,7738-11-4742,Cmn Area/Open Spc,0.09,,0,0,0,0,0,0,0,0,0,0,0,0,RPUD,RES/PUD,,,
19779,48-19-0-C-0,7738-11-0413,Cmn Area/Open Spc,1.78,,0,0,0,0,0,0,0,0,0,0,0,0,RPUD,RES/PUD,,,
19780,48-19-0-R-0,7738-11-1222,Roads,2.11,,0,0,0,0,0,0,0,0,0,0,0,0,RPUD,RES/PUD,,,
19781,48-19-0-10-0,7738-11-5458,SNGL FAM URB,0.24,,130000,0,130000,414600,0,544600,125000,0,125000,384100,0,509100,RPUD,RES/PUD,,,
19782,48-19-0-11-0,7738-11-5450,SNGL FAM URB,0.2,,130000,0,130000,424800,0,554800,125000,0,125000,395100,0,520100,RPUD,RES/PUD,,,
19783,48-19-0-12-0,7738-11-5353,SNGL FAM URB,0.22,,130000,0,130000,417400,0,547400,125000,0,125000,386600,0,511600,RPUD,RES/PUD,,,
19784,48-19-0-13-0,7738-11-5244,SNGL FAM URB,0.3,,130000,0,130000,491100,0,621100,125000,0,125000,451600,0,576600,RPUD,RES/PUD,,,
19785,48-19-0-14-0,7738-11-4261,SNGL FAM URB,0.27,,130000,0,130000,540400,9900,680300,125000,0,125000,501400,10000,636400,RPUD,RES/PUD,,,
19786,48-19-0-15-0,7738-11-3264,SNGL FAM URB,0.28,,130000,0,130000,531300,0,661300,125000,0,125000,493100,0,618100,RPUD,RES/PUD,,,
19787,48-19-0-16-0,7738-11-3320,SNGL FAM URB,0.26,,130000,0,130000,546500,0,676500,125000,0,125000,504300,0,629300,RPUD,RES/PUD,,,
19788,48-19-0-17-0,7738-11-3471,SNGL FAM URB,0.25,,130000,0,130000,527400,0,657400,125000,0,125000,491900,0,616900,RPUD,RES/PUD,,,
19789,48-19-0-18-0,7738-11-3468,SNGL FAM URB,0.21,,130000,0,130000,499700,0,629700,125000,0,125000,459500,0,584500,RPUD,RES/PUD,,,
19790,48-19-0-19-0,7738-11-3535,SNGL FAM URB,0.18,,130000,0,130000,422200,0,552200,125000,0,125000,389200,0,514200,RPUD,RES/PUD,,,
19791,48-19-0-20-0,7738-11-3601,SNGL FAM URB,0.18,,130000,0,130000,460100,0,590100,125000,0,125000,427300,0,552300,RPUD,RES/PUD,,,
19792,48-19-0-21-0,7738-11-2678,SNGL FAM URB,0.18,,130000,0,130000,354100,0,484100,125000,0,125000,332700,0,457700,RPUD,RES/PUD,,,
19793,48-19-0-22-0,7738-11-2744,SNGL FAM URB,0.17,,130000,0,130000,430900,0,560900,125000,0,125000,401800,0,526800,RPUD,RES/PUD,,,
19794,48-19-0-23-0,7738-11-1646,SNGL FAM URB,0.2,,130000,0,130000,490800,0,620800,125000,0,125000,451900,0,576900,RPUD,RES/PUD,,,
19795,48-19-0-24-0,7738-11-0682,SNGL FAM URB,0.2,,130000,0,130000,515500,0,645500,125000,0,125000,472600,0,597600,RPUD,RES/PUD,,,
19796,48-19-0-25-0,7738-11-1573,SNGL FAM URB,0.2,,130000,0,130000,526000,0,656000,125000,0,125000,482000,0,607000,RPUD,RES/PUD,,,
19797,48-19-0-26-0,7738-11-2426,SNGL FAM URB,0.21,,130000,0,130000,513500,0,643500,125000,0,125000,471600,0,596600,RPUD,RES/PUD,,,
19798,48-19-0-27-0,7738-11-2318,SNGL FAM URB,0.21,,130000,0,130000,418800,0,548800,125000,0,125000,388500,0,513500,RPUD,RES/PUD,,,
19799,48-19-0-28-0,7738-11-1343,SNGL FAM URB,0.24,,130000,0,130000,455900,0,585900,125000,0,125000,423700,0,548700,RPUD,RES/PUD,,,
19800,48-19-0-29-0,7738-01-9577,SNGL FAM URB,0.17,,130000,0,130000,510900,0,640900,125000,0,125000,466600,0,591600,RPUD,RES/PUD,,,
19801,48-19-0-30-0,7738-01-9504,SNGL FAM URB,0.21,,130000,0,130000,482000,0,612000,125000,0,125000,445700,0,570700,RPUD,RES/PUD,,,
19802,48-19-0-31-0,7738-01-8617,SNGL FAM URB,0.16,,130000,0,130000,475500,0,605500,125000,0,125000,437200,0,562200,RPUD,RES/PUD,,,
19803,48-19-0-32-0,7738-01-8770,SNGL FAM URB,0.18,,130000,0,130000,446200,0,576200,125000,0,125000,415000,0,540000,RPUD,RES/PUD,,,
19804,48-19-0-33-0,7738-01-9734,SNGL FAM URB,0.18,,130000,0,130000,320000,0,450000,125000,0,125000,304700,0,429700,RPUD,RES/PUD,,,
19805,48-19-0-34-0,7738-01-9797,SNGL FAM URB,0.18,,130000,0,130000,380300,0,510300,125000,0,125000,355300,0,480300,RPUD,RES/PUD,,,
19806,48-19-0-35-0,7738-11-0850,SNGL FAM URB,0.18,,130000,0,130000,377100,0,507100,125000,0,125000,351900,0,476900,RPUD,RES/PUD,,,
19807,48-19-0-36-0,7738-11-1813,SNGL FAM URB,0.18,,130000,0,130000,411500,0,541500,125000,0,125000,388800,0,513800,RPUD,RES/PUD,,,
19808,59-3-2-89-A,7726-74-7941,COMM & IND,7.682,,3480700,0,3480700,0,0,3480700,3164400,0,3164400,0,0,3164400,M1,INDUS/L,,,
19809,59-3-2-90-E,7726-85-4335,COMM & IND,4.297,,20600,0,20600,0,0,20600,18900,0,18900,0,0,18900,M1,INDUS/L,,,
19812,6-1-0-54-C,6822-99-7651,SNGL FAM SUB,3,,56600,0,56600,222400,8500,287500,55000,0,55000,194300,7400,256700,A1,AG/GEN,,,
19813,20-12-0-6-A,6840-99-3093,Cemetery,0.0001,,100,0,100,0,0,100,100,0,100,0,0,100,A1,AG/GEN,,,
19814,5-6-0-D-1,6813-66-5097,Cemetery,0.0001,,100,0,100,0,0,100,100,0,100,0,0,100,A1,AG/GEN,,,
19815,43-40-C-1-0,6777-56-9495,SNGL FAM SUB,2.317,,150000,0,150000,755600,0,905600,140000,0,140000,699100,0,839100,RP,"RURAL,P",,,
19816,43-40-C-2-0,6777-66-2232,SNGL FAM SUB,2.114,,150000,0,150000,630700,34000,814700,140000,0,140000,565800,31300,737100,RP,"RURAL,P",,,
19817,43-40-C-3-0,6777-66-3472,SNGL FAM SUB,2.222,,157500,0,157500,680300,0,837800,147000,0,147000,615900,0,762900,RP,"RURAL,P",,,
19818,43-40-C-4-0,6777-66-5613,SNGL FAM SUB,2.444,,157500,0,157500,991000,59200,1207700,147000,0,147000,910000,52900,1109900,RP,"RURAL,P",,,
19819,43-40-C-5-0,6777-66-6834,SNGL FAM SUB,2.374,,157500,0,157500,756400,9900,923800,147000,0,147000,682800,10000,839800,RP,"RURAL,P",,,
19820,43-40-C-6-0,6777-67-7058,SNGL FAM SUB,2.47,,157500,0,157500,911200,40800,1109500,147000,0,147000,820600,36700,1004300,RP,"RURAL,P",,,
19821,43-40-C-7-0,6777-67-8395,SNGL FAM SUB,2.025,,157500,0,157500,820300,76000,1053800,147000,0,147000,743000,66000,956000,RP,"RURAL,P",,,
19822,43-40-C-8-0,6777-77-0690,SNGL FAM SUB,2.272,,157500,0,157500,1108700,0,1266200,147000,0,147000,998700,0,1145700,RP,"RURAL,P",,,
19823,43-40-C-9-0,6777-77-3821,SNGL FAM SUB,2.511,,157500,0,157500,903500,39400,1100400,147000,0,147000,819200,12600,978800,RP,"RURAL,P",,,
19824,43-40-C-10-0,6777-77-9888,SNGL FAM SUB,2.456,,150000,0,150000,424900,0,574900,140000,0,140000,387200,0,527200,RP,"RURAL,P",,,
19825,43-40-C-11-0,6777-77-9650,SNGL FAM SUB,2.598,,150000,0,150000,667100,0,817100,140000,0,140000,601100,0,741100,RP,"RURAL,P",,,
19826,43-40-C-13-0,6777-77-3269,SNGL FAM SUB,2.904,,150000,0,150000,0,0,150000,140000,0,140000,0,0,140000,RP,"RURAL,P",,,
19827,43-40-C-12-0,6777-77-6477,SNGL FAM SUB,2.949,,150000,0,150000,562900,0,712900,140000,0,140000,508200,0,648200,RP,"RURAL,P",,,
19828,43-40-C-25-0,6777-55-8786,SNGL FAM SUB,2.142,,150000,0,150000,0,0,150000,140000,0,140000,0,0,140000,RP,"RURAL,P",,,
19829,43-40-C-26-0,6777-65-0928,SNGL FAM SUB,2.201,,150000,0,150000,780900,0,930900,140000,0,140000,736500,0,876500,RP,"RURAL,P",,,
19830,43-40-C-24-0,6777-55-7552,SNGL FAM SUB,2.31,,150000,0,150000,762400,0,912400,140000,0,140000,692100,0,832100,RP,"RURAL,P",,,
19831,43-40-C-18-0,6777-65-6939,SNGL FAM SUB,2.136,,150000,0,150000,860600,0,1010600,140000,0,140000,782500,0,922500,RP,"RURAL,P",,,
19832,43-40-C-20-0,6777-65-3637,SNGL FAM SUB,2.17,,150000,0,150000,0,0,150000,140000,0,140000,0,0,140000,RP,"RURAL,P",,,
19833,43-40-C-21-0,6777-65-2457,SNGL FAM SUB,2.178,,150000,0,150000,890600,0,1040600,140000,0,140000,814300,0,954300,RP,"RURAL,P",,,
19834,43-40-C-23-0,6777-55-8256,SNGL FAM SUB,2.185,,150000,0,150000,0,0,150000,140000,0,140000,0,0,140000,RP,"RURAL,P",,,
19835,43-40-C-17-0,6777-66-7158,SNGL FAM SUB,2.266,,150000,0,150000,0,0,150000,140000,0,140000,0,0,140000,RP,"RURAL,P",,,
19836,43-40-C-19-0,6777-65-5802,SNGL FAM SUB,2.335,,150000,0,150000,0,0,150000,140000,0,140000,0,0,140000,RP,"RURAL,P",,,
19837,43-40-C-16-0,6777-66-9413,SNGL FAM SUB,2.547,,150000,0,150000,0,0,150000,140000,0,140000,0,0,140000,RP,"RURAL,P",,,
19838,43-40-C-22-0,6777-65-1199,SNGL FAM SUB,3.091,,150000,0,150000,639100,32000,821100,140000,0,140000,572500,0,712500,RP,"RURAL,P",,,
19839,43-40-C-14-0,6777-77-2005,SNGL FAM SUB,3.094,,150000,0,150000,826000,0,976000,140000,0,140000,772200,0,912200,RP,"RURAL,P",,,
19840,43-40-C-15-0,6777-76-0775,SNGL FAM SUB,3.255,,150000,0,150000,811000,0,961000,140000,0,140000,761200,0,901200,RP,"RURAL,P",,,
19841,43-40-C-A-0,6777-77-8025,Cmn Area/Open Spc,62.4,,0,0,0,0,0,0,0,0,0,0,0,0,RP,"RURAL,P",,,
19842,43-40-C-B-0,6777-77-5797,Cmn Area/Open Spc,0.212,,0,0,0,0,0,0,0,0,0,0,0,0,RP,"RURAL,P",,,
19843,39-1-0-86-A,6726-58-3809,AG 20-100 AC,42.03,,207000,147500,59500,427200,3700,637900,202100,146500,55600,402700,4000,608800,A1,AG/GEN,,,
19844,19-1-0-36-C1,6831-10-3686,SNGL FAM SUB,8.008,,77500,0,77500,350300,0,427800,72400,0,72400,296000,0,368400,A1,AG/GEN,,,
19845,12-1-0-59-D1,6832-42-6175,SNGL FAM SUB,2.01,,48500,0,48500,261500,0,310000,47100,0,47100,220100,0,267200,A1,AG/GEN,,,
19846,43-41-0-1-0,6767-45-4189,SNGL FAM SUB,4.582,,93900,0,93900,462400,0,556300,86400,0,86400,427200,0,513600,A2,AG/LTD,,,
19847,43-41-0-2-0,6767-45-7556,SNGL FAM SUB,6.495,,109200,0,109200,0,0,109200,101000,0,101000,0,0,101000,A2,AG/LTD,,,
19848,43-41-0-3-0,6767-55-1313,SNGL FAM SUB,7.318,,115700,0,115700,440100,2400,558200,107200,0,107200,397000,2700,506900,A2,AG/LTD,,,
19849,43-41-0-4-0,6767-44-8845,SNGL FAM SUB,4.321,,91800,0,91800,560100,0,651900,84400,0,84400,506900,0,591300,A2,AG/LTD,,,
19850,55-1-0-1-B1,6776-84-7218,SNGL FAM SUB,6.28,,146100,0,146100,392000,0,538100,130700,0,130700,307800,0,438500,A2,AG/LTD,,,
19851,4-1-0-12-A,6803-33-6005,AG 20-100 AC,36.09,,192900,0,192900,0,0,192900,188600,0,188600,0,0,188600,A1,AG/GEN,,,
19852,58-1-0-93-A,7726-13-5899,Cemetery,0.0001,,100,0,100,0,0,100,100,0,100,0,0,100,RPUD,RES/PUD,,,
19853,9-1-0-1-A,5892-76-6425,SNGL FAM SUB,3,,46000,0,46000,0,0,46000,45000,0,45000,0,0,45000,A1,AG/GEN,,,
19854,58-1-0-77-C,7726-04-6172,Roads,0.15,,0,0,0,0,0,0,0,0,0,0,0,0,A2,AG/LTD,,,
19855,58-32-3-R-P3,7725-07-7093,COMM & IND,0.101,,400,0,400,0,0,400,400,0,400,0,0,400,M1,INDUS/L,,,
19856,58-32-3-R-P4,7725-16-7831,COMM & IND,0.164,,600,0,600,0,0,600,600,0,600,0,0,600,M1,INDUS/L,,,
19857,58-44-0-8-0,7716-46-0824,SNGL FAM SUB,2.191,,166800,0,166800,880400,0,1047200,145000,0,145000,734100,0,879100,A2,AG/LTD,,,
19858,20-28-A-1-0,6749-89-8981,SNGL FAM SUB,1.53,,80000,0,80000,0,0,80000,80000,0,80000,0,0,80000,R1,RES/LTD,,,
19859,20-28-A-2-0,6840-80-6030,SNGL FAM SUB,2.142,,80000,0,80000,451200,0,531200,80000,0,80000,379300,0,459300,R1,RES/LTD,,,
19860,20-28-A-3-0,6749-89-3995,SNGL FAM SUB,2.335,,80000,0,80000,0,0,80000,80000,0,80000,0,0,80000,R1,RES/LTD,,,
19861,20-28-A-4-0,6749-89-0885,SNGL FAM SUB,1.522,,80000,0,80000,337500,2500,420000,80000,0,80000,0,0,80000,R1,RES/LTD,,,
19862,20-28-A-5-0,6840-80-1016,SNGL FAM SUB,2.043,,80000,0,80000,389500,0,469500,80000,0,80000,262900,0,342900,R1,RES/LTD,,,
19863,20-28-A-6-0,6840-80-2216,SNGL FAM SUB,1.834,,80000,0,80000,0,0,80000,80000,0,80000,0,0,80000,R1,RES/LTD,,,
19864,20-28-A-7-0,6840-70-9332,SNGL FAM SUB,1.509,,80000,0,80000,389300,0,469300,80000,0,80000,0,0,80000,R1,RES/LTD,,,
19865,20-28-A-8-0,6840-70-7222,SNGL FAM SUB,1.517,,80000,0,80000,468300,0,548300,80000,0,80000,413400,0,493400,R1,RES/LTD,,,
19866,20-28-A-9-0,6749-79-6989,SNGL FAM SUB,1.518,,80000,0,80000,518700,0,598700,80000,0,80000,460300,0,540300,R1,RES/LTD,,,
19867,20-28-A-10-0,6749-89-3599,SNGL FAM SUB,1.546,,80000,0,80000,0,0,80000,80000,0,80000,0,0,80000,R1,RES/LTD,,,
19868,20-28-A-11-0,6749-89-6528,SNGL FAM SUB,1.823,,80000,0,80000,0,0,80000,80000,0,80000,0,5000,85000,R1,RES/LTD,,,
19869,20-28-A-12-0,6749-89-8533,SNGL FAM SUB,1.838,,80000,0,80000,472700,3100,555800,80000,0,80000,392300,0,472300,R1,RES/LTD,,,
19870,20-28-A-A-0,6749-79-7779,Cmn Area/Open Spc,9.276,,0,0,0,0,0,0,0,0,0,0,0,0,R1,RES/LTD,,,
19871,20-28-A-R-0,6749-89-6728,Roads,3.355,,0,0,0,0,0,0,0,0,0,0,0,0,R1,RES/LTD,,,
19872,20-28-B-1-0,6749-99-3716,SNGL FAM SUB,1.666,,80000,0,80000,497600,0,577600,80000,0,80000,437100,0,517100,R1,RES/LTD,,,
19873,20-28-B-2-0,6749-99-5751,SNGL FAM SUB,1.631,,80000,0,80000,480100,0,560100,80000,0,80000,410100,0,490100,R1,RES/LTD,,,
19874,20-28-B-3-0,6749-99-5441,SNGL FAM SUB,2.038,,80000,0,80000,0,0,80000,80000,0,80000,0,0,80000,R1,RES/LTD,,,
19875,20-28-B-A-0,6749-99-1427,Cmn Area/Open Spc,1.768,,0,0,0,0,0,0,0,0,0,0,0,0,R1,RES/LTD,,,
19876,20-28-B-B-0,6749-99-3975,Cmn Area/Open Spc,1.447,,0,0,0,0,0,0,0,0,0,0,0,0,R1,RES/LTD,,,
19877,47-1-0-45-C,7727-01-7490,SNGL FAM SUB,3.001,,150100,0,150100,0,0,150100,134000,0,134000,0,0,134000,A2,AG/LTD,,,
19878,17-1-0-87-A,6719-28-4743,Cemetery,0,,100,0,100,0,0,100,100,0,100,0,0,100,A1,AG/GEN,,,
19879,59-1-0-47-0,7726-76-4548,COMM & IND,1.041,,1030600,0,1030600,0,0,1030600,936900,0,936900,0,0,936900,B3,INTRCHGCOM,,,
19880,11-1-0-41-D,6821-38-0436,SNGL FAM SUB,5.8125,,67600,0,67600,342100,0,409700,66900,0,66900,276800,0,343700,A1,AG/GEN,,,
19881,32-1-0-40-E1,6778-74-6446,SNGL FAM SUB,7.111,,133800,0,133800,240700,0,374500,119500,0,119500,192200,0,311700,A2,AG/LTD,,,
19882,63-37-1-9-G1,7725-40-9492,COMM & IND,1.323,,48000,0,48000,0,0,48000,47600,0,47600,0,0,47600,M1,INDUS/L,,,
19883,63-37-3-B-B3A,7725-40-6877,COMM & IND,9.567,,31100,0,31100,0,0,31100,31100,0,31100,0,0,31100,M1,INDUS/L,,,
19884,58-32-3-33-A,7725-41-2262,COMM & IND,0.691,,2600,0,2600,0,0,2600,2600,0,2600,0,0,2600,M1,INDUS/L,,,
19885,32-1-0-10-A,6779-84-4985,Cemetery,0,,100,0,100,0,0,100,100,0,100,0,0,100,A2,AG/LTD,,,
19886,32-1-0-10-B,6779-85-1101,SNGL FAM SUB,5.23,,125000,0,125000,507700,0,632700,111800,0,111800,411400,0,523200,A2,AG/LTD,,,
19891,64-1-0-36-A,7724-62-9291,SNGL FAM SUB,3.8,,236900,0,236900,0,0,236900,206000,0,206000,0,0,206000,R3,RES/GEN,,,
19892,59-4-0-2-A,7726-86-4839,COMM & IND,1.821,,901400,0,901400,0,0,901400,901400,0,901400,0,0,901400,B1,BUS/GEN,,,
19893,59-4-0-2-R1,7726-86-3947,Roads,0.855,,0,0,0,0,0,0,0,0,0,0,0,0,B1,BUS/GEN,,,
19894,38-1-0-130-A,6717-12-0737,Cemetery,,,100,0,100,0,0,100,100,0,100,0,0,100,A1,AG/GEN,,,
19895,58-48-8-50-0,7715-47-5031,SNGL FAM URB,0.57,,154900,0,154900,741800,0,896700,151800,0,151800,710600,0,862400,RPUD,RES/PUD,,,
19896,58-48-8-51-0,7715-46-4887,SNGL FAM URB,0.512,,154900,0,154900,648400,0,803300,151800,0,151800,619200,0,771000,RPUD,RES/PUD,,,
19897,58-48-8-52-0,7715-46-4785,SNGL FAM URB,0.517,,154900,0,154900,821600,0,976500,151800,0,151800,789400,0,941200,RPUD,RES/PUD,,,
19898,58-48-8-53-0,7715-46-5665,SNGL FAM URB,0.337,,154900,0,154900,0,0,154900,151800,0,151800,0,0,151800,RPUD,RES/PUD,,,
19899,58-48-8-54-0,7715-46-4622,SNGL FAM URB,0.596,,154900,0,154900,783800,9900,948600,151800,0,151800,759200,10000,921000,RPUD,RES/PUD,,,
19900,58-48-8-55-0,7715-46-4442,SNGL FAM URB,0.645,,154900,0,154900,732600,0,887500,151800,0,151800,702400,0,854200,RPUD,RES/PUD,,,
19901,58-48-8-56-0,7715-46-5357,SNGL FAM URB,0.662,,154900,0,154900,784800,0,939700,151800,0,151800,750000,0,901800,RPUD,RES/PUD,,,
19912,58-48-8-67-0,7715-46-9072,SNGL FAM URB,0.63,,328100,0,328100,728900,0,1057000,323400,0,323400,694700,0,1018100,RPUD,RES/PUD,,,
19913,58-48-8-68-0,7715-56-1045,SNGL FAM URB,0.78,,368600,0,368600,1346900,0,1715500,363300,0,363300,1297700,0,1661000,RPUD,RES/PUD,,,
19914,58-48-8-69-0,7715-56-2117,SNGL FAM URB,0.91,,348300,0,348300,1021200,9900,1379400,343300,0,343300,970800,10000,1324100,RPUD,RES/PUD,,,
19915,58-48-8-70-0,7715-56-0360,SNGL FAM URB,0.484,,154900,0,154900,901100,0,1056000,151800,0,151800,856600,0,1008400,RPUD,RES/PUD,,,
19916,58-48-8-71-0,7715-46-9248,SNGL FAM URB,0.44,,154900,0,154900,0,0,154900,151800,0,151800,0,0,151800,RPUD,RES/PUD,,,
19917,58-48-8-72-0,7715-46-9463,SNGL FAM URB,0.541,,154900,0,154900,918300,0,1073200,151800,0,151800,874100,0,1025900,RPUD,RES/PUD,,,
19918,58-48-8-73-0,7715-46-9514,SNGL FAM URB,0.497,,154900,0,154900,1259500,10000,1424400,151800,0,151800,1193900,10000,1355700,RPUD,RES/PUD,,,
19919,58-48-8-74-0,7715-46-8644,SNGL FAM URB,0.451,,154900,0,154900,778300,0,933200,151800,0,151800,743000,0,894800,RPUD,RES/PUD,,,
19920,58-48-8-75-0,7715-46-7773,SNGL FAM URB,0.486,,154900,0,154900,820400,10000,985300,151800,0,151800,795900,10000,957700,RPUD,RES/PUD,,,
19921,58-48-8-76-0,7715-46-7804,SNGL FAM URB,0.588,,154900,0,154900,1048600,0,1203500,151800,0,151800,991600,0,1143400,RPUD,RES/PUD,,,
19922,58-48-8-E-0,7715-46-9628,Cmn Area/Open Spc,0.32,,0,0,0,0,0,0,0,0,0,0,0,0,RPUD,RES/PUD,,,
19923,58-48-8-F-0,7715-45-7920,Cmn Area/Open Spc,2.34,,0,0,0,0,0,0,0,0,0,0,0,0,RPUD,RES/PUD,,,
19924,58-48-8-R-1,7715-46-7193,Roads,2.123,,0,0,0,0,0,0,0,0,0,0,0,0,RPUD,RES/PUD,,,
19925,13-2-0-1-A,6841-97-4540,SNGL FAM SUB,10.107,,122500,0,122500,0,0,122500,120200,0,120200,0,0,120200,A1,AG/GEN,,,
19926,55-1-0-64-C1,6786-53-5914,SNGL FAM SUB,5,,136100,0,136100,0,0,136100,121400,0,121400,0,0,121400,A2,AG/LTD,,,
19927,58-48-8-D-1,7715-57-3762,Cmn Area/Open Spc,0.32,,0,0,0,0,0,0,0,0,0,0,0,0,RPUD,RES/PUD,,,
19928,58-50-10-1-0,7725-07-1979,SNGL FAM URB,0.383,,147800,0,147800,554100,0,701900,144900,0,144900,537800,0,682700,RPUD,RES/PUD,,,
19929,58-50-10-2-0,7725-07-2943,SNGL FAM URB,0.248,,147800,0,147800,497200,0,645000,144900,0,144900,471100,0,616000,RPUD,RES/PUD,,,
19930,58-50-10-3-0,7725-07-2888,SNGL FAM URB,0.243,,147800,0,147800,502500,0,650300,144900,0,144900,447100,0,592000,RPUD,RES/PUD,,,
19931,58-50-10-4-0,7725-07-3832,SNGL FAM URB,0.238,,147800,0,147800,514900,0,662700,144900,0,144900,500100,0,645000,RPUD,RES/PUD,,,
20074,21-15-1-B-0,6850-30-0176,Cmn Area/Open Spc,1.45,AC,0,0,0,0,0,0,0,0,0,0,0,0,R1,RES/LTD,,,
20075,21-15-1-R-0,6850-30-8859,Roads,4.35,AC,0,0,0,0,0,0,0,0,0,0,0,0,R1,RES/LTD,,,
20076,21-15-1-R-1,6850-30-9534,Roads,2.04,AC,0,0,0,0,0,0,0,0,0,0,0,0,R1,RES/LTD,,,
20077,21-15-1-C-0,6850-41-2095,Cmn Area/Open Spc,0.39,AC,0,0,0,0,0,0,0,0,0,0,0,0,R1,RES/LTD,,,
20078,21-15-1-D-0,6850-41-0115,Cmn Area/Open Spc,0.02,AC,0,0,0,0,0,0,0,0,0,0,0,0,R1,RES/LTD,,,
20079,42-40-0-1-0,6767-01-5714,SNGL FAM SUB,0.459,AC,88000,0,88000,378900,0,466900,84000,0,84000,339000,0,423000,R3,RES/GEN,,,
20080,42-40-0-2-0,6767-01-4749,SNGL FAM SUB,0.46,AC,88000,0,88000,377800,1300,467100,84000,0,84000,339200,1200,424400,R3,RES/GEN,,,
20081,42-40-0-3-0,6767-01-3853,SNGL FAM SUB,0.461,AC,88000,0,88000,0,0,88000,84000,0,84000,0,0,84000,R3,RES/GEN,,,
20082,42-40-0-4-0,6767-01-2866,SNGL FAM SUB,0.461,AC,88000,0,88000,511200,0,599200,84000,0,84000,461800,0,545800,R3,RES/GEN,,,
20083,42-40-0-5-0,6767-01-1970,SNGL FAM SUB,0.461,AC,88000,0,88000,0,0,88000,84000,0,84000,0,0,84000,R3,RES/GEN,,,
20084,42-40-0-6-0,6767-01-0993,SNGL FAM SUB,0.46,AC,88000,0,88000,412600,0,500600,84000,0,84000,372200,0,456200,R3,RES/GEN,,,
20085,42-40-0-7-0,6757-91-9974,SNGL FAM SUB,0.582,AC,88000,0,88000,433100,1900,523000,84000,0,84000,388200,2000,474200,R3,RES/GEN,,,
20086,42-40-0-8-0,6757-91-8804,SNGL FAM SUB,0.462,AC,88000,0,88000,0,0,88000,84000,0,84000,0,0,84000,R3,RES/GEN,,,
20087,42-40-0-9-0,6757-91-7810,SNGL FAM SUB,0.525,AC,88000,0,88000,0,0,88000,84000,0,84000,0,0,84000,R3,RES/GEN,,,
20088,42-40-0-10-0,6757-91-6792,SNGL FAM SUB,0.464,AC,88000,0,88000,0,0,88000,84000,0,84000,0,0,84000,R3,RES/GEN,,,
20089,42-40-0-11-0,6757-91-6682,SNGL FAM SUB,0.612,AC,88000,0,88000,475200,0,563200,84000,0,84000,428700,0,512700,R3,RES/GEN,,,
20090,42-40-0-12-0,6757-91-6582,SNGL FAM SUB,0.461,AC,88000,0,88000,0,0,88000,84000,0,84000,0,0,84000,R3,RES/GEN,,,
20091,42-40-0-13-0,6757-91-6454,SNGL FAM SUB,0.461,AC,88000,0,88000,0,0,88000,84000,0,84000,0,0,84000,R3,RES/GEN,,,
20092,42-40-0-14-0,6757-91-6324,SNGL FAM SUB,0.557,AC,88000,0,88000,449200,22200,559400,84000,0,84000,402100,18600,504700,R3,RES/GEN,,,
20093,42-40-0-15-0,6757-91-6295,SNGL FAM SUB,0.585,AC,88000,0,88000,0,0,88000,84000,0,84000,0,0,84000,R3,RES/GEN,,,
19932,58-50-10-5-0,7725-07-3787,SNGL FAM URB,0.245,,147800,0,147800,472400,0,620200,144900,0,144900,446500,0,591400,RPUD,RES/PUD,,,
19933,58-50-10-6-0,7725-07-5562,SNGL FAM URB,0.897,,155200,0,155200,502900,0,658100,152100,0,152100,492900,0,645000,RPUD,RES/PUD,,,
19934,58-50-10-7-0,7725-07-6620,SNGL FAM URB,0.567,,155200,0,155200,0,0,155200,152100,0,152100,0,0,152100,RPUD,RES/PUD,,,
19935,58-50-10-8-0,7725-07-6732,SNGL FAM URB,0.44,,147800,0,147800,0,0,147800,144900,0,144900,0,0,144900,RPUD,RES/PUD,,,
19936,58-50-10-9-0,7725-07-6813,SNGL FAM URB,0.35,,147800,0,147800,513800,0,661600,144900,0,144900,0,0,144900,RPUD,RES/PUD,,,
19937,58-50-10-10-0,7725-07-5970,SNGL FAM URB,0.335,,147800,0,147800,539700,0,687500,144900,0,144900,521100,0,666000,RPUD,RES/PUD,,,
19938,58-50-10-11-0,7725-07-5936,SNGL FAM URB,0.381,,147800,0,147800,560400,0,708200,144900,0,144900,547000,0,691900,RPUD,RES/PUD,,,
19939,58-50-10-12-0,7725-08-5002,SNGL FAM URB,0.419,,147800,0,147800,582300,0,730100,144900,0,144900,568100,0,713000,RPUD,RES/PUD,,,
19940,58-50-10-13-0,7725-08-4068,SNGL FAM URB,0.45,,147800,0,147800,572800,0,720600,144900,0,144900,551300,0,696200,RPUD,RES/PUD,,,
19941,58-50-10-14-0,7725-08-4128,SNGL FAM URB,0.688,,155200,0,155200,610500,1600,767300,152100,0,152100,587300,1300,740700,RPUD,RES/PUD,,,
19942,58-50-10-15-0,7725-08-2223,SNGL FAM URB,0.604,,155200,0,155200,503600,0,658800,152100,0,152100,488100,0,640200,RPUD,RES/PUD,,,
19943,58-50-10-16-0,7715-98-3186,SNGL FAM URB,0.302,,147800,0,147800,433300,0,581100,144900,0,144900,424600,0,569500,RPUD,RES/PUD,,,
19944,58-50-10-17-0,7715-98-4176,SNGL FAM URB,0.189,,147800,0,147800,549800,0,697600,144900,0,144900,527500,0,672400,RPUD,RES/PUD,,,
19945,58-50-10-18-0,7715-98-5147,SNGL FAM URB,0.179,,147800,0,147800,444200,0,592000,144900,0,144900,434800,0,579700,RPUD,RES/PUD,,,
19946,58-50-10-19-0,7715-98-6126,SNGL FAM URB,0.199,,147800,0,147800,493100,0,640900,144900,0,144900,462300,0,607200,RPUD,RES/PUD,,,
19947,58-50-10-20-0,7715-98-7136,SNGL FAM URB,0.484,,147800,0,147800,585300,0,733100,144900,0,144900,567800,0,712700,RPUD,RES/PUD,,,
19948,58-50-10-21-0,7715-98-9240,SNGL FAM URB,0.795,,155200,0,155200,501600,0,656800,152100,0,152100,486700,0,638800,RPUD,RES/PUD,,,
19949,58-50-10-22-0,7715-98-8322,SNGL FAM URB,0.715,,155200,0,155200,555300,0,710500,152100,0,152100,536600,0,688700,RPUD,RES/PUD,,,
19950,58-50-10-23-0,7715-98-4306,SNGL FAM URB,0.202,,147800,0,147800,508200,0,656000,144900,0,144900,495200,0,640100,RPUD,RES/PUD,,,
19951,58-50-10-24-0,7715-98-3348,SNGL FAM URB,0.19,,147800,0,147800,491100,0,638900,144900,0,144900,477700,0,622600,RPUD,RES/PUD,,,
19952,58-50-10-25-0,7715-98-2389,SNGL FAM URB,0.177,,147800,0,147800,483500,0,631300,144900,0,144900,471900,0,616800,RPUD,RES/PUD,,,
19953,58-50-10-26-0,7715-98-2411,SNGL FAM URB,0.164,,147800,0,147800,457100,0,604900,144900,0,144900,454600,0,599500,RPUD,RES/PUD,,,
19954,58-50-10-27-0,7715-98-1452,SNGL FAM URB,0.151,,147800,0,147800,512600,0,660400,144900,0,144900,489400,0,634300,RPUD,RES/PUD,,,
19955,58-50-10-28-0,7715-98-0494,SNGL FAM URB,0.138,,147800,0,147800,500500,0,648300,144900,0,144900,457300,0,602200,RPUD,RES/PUD,,,
19956,58-50-10-29-0,7715-98-0426,SNGL FAM URB,0.145,,147800,0,147800,579800,0,727600,144900,0,144900,552300,0,697200,RPUD,RES/PUD,,,
19957,58-50-10-30-0,7715-88-8336,SNGL FAM URB,0.222,,147800,0,147800,531800,0,679600,144900,0,144900,516400,0,661300,RPUD,RES/PUD,,,
19958,58-50-10-31-0,7715-88-8392,SNGL FAM URB,0.191,,147800,0,147800,487900,0,635700,144900,0,144900,471600,0,616500,RPUD,RES/PUD,,,
19959,58-50-10-32-0,7715-98-0229,SNGL FAM URB,0.171,,147800,0,147800,0,0,147800,144900,0,144900,0,0,144900,RPUD,RES/PUD,,,
19960,58-50-10-33-0,7715-98-0297,SNGL FAM URB,0.21,,147800,0,147800,0,0,147800,144900,0,144900,0,0,144900,RPUD,RES/PUD,,,
19961,58-50-10-A-0,7715-98-9095,Cmn Area/Open Spc,10.341,,0,0,0,0,0,0,0,0,0,0,0,0,RPUD,RES/PUD,,,
19962,58-50-10-B-0,7725-08-2182,Cmn Area/Open Spc,0.318,,0,0,0,0,0,0,0,0,0,0,0,0,RPUD,RES/PUD,,,
19963,58-50-10-C-0,7715-98-2250,Cmn Area/Open Spc,0.522,,0,0,0,0,0,0,0,0,0,0,0,0,RPUD,RES/PUD,,,
19964,58-50-10-D-0,7715-98-0229,Cmn Area/Open Spc,0.161,,0,0,0,0,0,0,0,0,0,0,0,0,RPUD,RES/PUD,,,
19965,58-50-10-R-0,7715-98-2342,Roads,2.276,,0,0,0,0,0,0,0,0,0,0,0,0,RPUD,RES/PUD,,,
19966,44-28-0-1-A,6787-34-1739,SNGL FAM SUB,10,,209400,0,209400,0,0,209400,186800,0,186800,0,0,186800,A2,AG/LTD,,,
19967,12-31-0-1-0,6831-33-1538,SNGL FAM SUB,3,AC,60200,0,60200,263600,0,323800,60300,0,60300,216700,0,277000,A1,AG/GEN,,,
19968,12-31-0-2-0,6831-33-4521,SNGL FAM SUB,3,AC,60200,0,60200,263600,14700,338500,60300,0,60300,216700,13200,290200,A1,AG/GEN,,,
19969,12-31-0-3-0,6831-22-9476,SNGL FAM SUB,11.52,AC,101900,0,101900,265000,0,366900,99400,0,99400,217900,0,317300,A1,AG/GEN,,,
19970,12-31-0-4-0,6831-32-4646,SNGL FAM SUB,9.1,AC,92400,0,92400,263600,0,356000,86800,0,86800,216700,0,303500,A1,AG/GEN,,,
19971,31-1-0-90-A1,6778-34-7299,SNGL FAM SUB,8.137,AC,147300,143100,4200,0,0,147300,131500,128000,3500,0,0,131500,A2,AG/LTD,,,
19972,48-1-0-36-A,7726-87-5966,COMM & IND,13.156,AC,5442600,0,5442600,7302400,1915800,14660800,4712500,0,4712500,6889000,1947900,13549400,B1,BUS/GEN,,,
19973,12-31-0-3-A,6831-32-2757,Cemetery,0,AC,100,0,100,0,0,100,100,0,100,0,0,100,A1,AG/GEN,,,
19974,1-1-0-38-0,6805-93-7005,SNGL FAM SUB,12.106,AC,88800,0,88800,0,0,88800,87200,0,87200,0,0,87200,A1,AG/GEN,,,
19975,17-1-0-41-B,6811-10-5019,SNGL FAM SUB,11.08,AC,96300,0,96300,0,2500,98800,92900,0,92900,0,2500,95400,A1,AG/GEN,,,
19976,42-1-0-79-B,6767-08-4419,General Gov,1.418,AC,220100,0,220100,0,16000,236100,211600,0,211600,0,15200,226800,B1,BUS/GEN,,,
19977,59-1-0-38-A4,7726-96-8172,COMM & IND,6.024,AC,3288200,0,3288200,0,0,3288200,2989400,0,2989400,0,0,2989400,M2,INDUS/G,,,
19979,9-12-0-2-B,5891-83-9028,SNGL FAM SUB,14.31,AC,73000,0,73000,389700,17900,480600,71300,0,71300,360200,17500,449000,A1,AG/GEN,,,
19980,58-1-0-30-CR,7715-45-1025,Roads,0.0006,AC,0,0,0,0,0,0,0,0,0,0,0,0,A2,AG/LTD,,,
19981,32-1-0-10-C,6779-85-6018,SNGL FAM SUB,5.15,AC,123900,0,123900,500,0,124400,110700,0,110700,500,0,111200,A2,AG/LTD,,,
19982,32-1-0-10-D,6779-85-9071,SNGL FAM SUB,5.11,AC,123300,0,123300,0,0,123300,110200,0,110200,0,0,110200,A2,AG/LTD,,,
19983,63-41-0-2-A,7724-13-9386,SNGL FAM URB,0,,112300,0,112300,375400,0,487700,110100,0,110100,375400,0,485500,R3,RES/GEN,,,
19984,63-41-0-2-B,7724-23-0316,SNGL FAM URB,0,,84300,0,84300,294600,0,378900,82600,0,82600,294600,0,377200,R3,RES/GEN,,,
19985,63-41-0-2-C,7724-23-0356,SNGL FAM URB,0,,112300,0,112300,334100,0,446400,110100,0,110100,334100,0,444200,R3,RES/GEN,,,
19987,58-49-9-1-0,7715-45-4435,SNGL FAM URB,0.875,,345900,0,345900,0,0,345900,288200,0,288200,0,0,288200,RPUD,RES/PUD,,,
19988,58-49-9-2-0,7715-45-5629,SNGL FAM URB,1.47,,378800,0,378800,0,0,378800,343100,0,343100,0,0,343100,RPUD,RES/PUD,,,
19989,58-49-9-3-0,7715-45-6694,SNGL FAM URB,1.116,,362300,0,362300,0,0,362300,302000,0,302000,0,0,302000,RPUD,RES/PUD,,,
19990,58-49-9-4-0,7715-45-7467,SNGL FAM URB,1.238,,345900,0,345900,0,0,345900,288200,0,288200,0,0,288200,RPUD,RES/PUD,,,
19991,58-49-9-5-0,7715-55-1607,SNGL FAM URB,1.59,AC,579600,0,579600,0,0,579600,569300,0,569300,0,0,569300,RPUD,RES/PUD,,,
19992,58-49-9-6-0,7715-55-3703,SNGL FAM URB,1.47,AC,611800,0,611800,0,0,611800,600900,0,600900,0,0,600900,RPUD,RES/PUD,,,
19993,58-49-9-7-0,7715-55-5717,SNGL FAM URB,1.06,AC,644000,0,644000,0,0,644000,632500,0,632500,0,0,632500,RPUD,RES/PUD,,,
19994,58-49-9-8-0,7715-55-7823,SNGL FAM URB,1.58,AC,672000,0,672000,0,0,672000,660000,0,660000,0,0,660000,RPUD,RES/PUD,,,
19995,58-49-9-9-0,7715-55-9824,SNGL FAM URB,1.41,AC,672000,0,672000,0,0,672000,660000,0,660000,0,0,660000,RPUD,RES/PUD,,,
19996,58-49-9-10-0,7715-65-1718,SNGL FAM URB,1.28,AC,672000,0,672000,0,0,672000,660000,0,660000,0,0,660000,RPUD,RES/PUD,,,
19997,58-49-9-11-0,7715-65-3703,SNGL FAM URB,1.2,AC,672000,0,672000,0,0,672000,660000,0,660000,0,0,660000,RPUD,RES/PUD,,,
19998,58-49-9-12-0,7715-65-4697,SNGL FAM URB,1.18,AC,672000,0,672000,0,0,672000,660000,0,660000,0,0,660000,RPUD,RES/PUD,,,
19999,58-49-9-13-0,7715-65-6558,SNGL FAM URB,1.16,AC,672000,0,672000,0,0,672000,660000,0,660000,0,0,660000,RPUD,RES/PUD,,,
20000,58-49-9-14-0,7715-65-8427,SNGL FAM URB,1.13,AC,672000,0,672000,0,0,672000,660000,0,660000,0,0,660000,RPUD,RES/PUD,,,
20001,58-49-9-15-0,7715-65-9374,SNGL FAM URB,1.19,AC,638400,0,638400,0,0,638400,627000,0,627000,0,0,627000,RPUD,RES/PUD,,,
20002,58-49-9-16-0,7715-75-1392,SNGL FAM URB,2.36,AC,1260000,0,1260000,2390200,0,3650200,1237500,0,1237500,2327400,0,3564900,RPUD,RES/PUD,,,
20003,58-49-9-18-0,7715-75-4198,SNGL FAM URB,1.45,AC,966000,0,966000,0,0,966000,1072500,0,1072500,0,0,1072500,RPUD,RES/PUD,,,
20004,58-49-9-19-0,7715-74-4948,SNGL FAM URB,1.03,AC,840000,0,840000,1159700,73800,2073500,825000,0,825000,1124900,68200,2018100,RPUD,RES/PUD,,,
20005,58-49-9-20-0,7715-74-2875,SNGL FAM URB,1.04,AC,840000,0,840000,0,0,840000,825000,0,825000,0,0,825000,RPUD,RES/PUD,,,
20006,58-49-9-21-0,7715-74-0970,SNGL FAM URB,1.523,AC,845300,0,845300,1975700,0,2821000,790600,0,790600,1924500,0,2715100,RPUD,RES/PUD,,,
20008,58-49-9-23-0,7715-65-8057,SNGL FAM URB,1.234,AC,439700,0,439700,0,0,439700,400000,0,400000,0,0,400000,RPUD,RES/PUD,,,
20009,58-49-9-24-0,7715-65-6291,SNGL FAM URB,0.834,AC,418800,0,418800,1327700,0,1746500,400000,0,400000,1237600,0,1637600,RPUD,RES/PUD,,,
20010,58-49-9-25-0,7715-65-5351,SNGL FAM URB,0.78,AC,418800,0,418800,0,0,418800,400000,0,400000,0,0,400000,RPUD,RES/PUD,,,
20011,58-49-9-26-0,7715-65-4319,SNGL FAM URB,0.804,AC,418800,0,418800,0,0,418800,400000,0,400000,0,0,400000,RPUD,RES/PUD,,,
20012,58-49-9-27-0,7715-65-2453,SNGL FAM URB,0.9,AC,418800,0,418800,0,0,418800,400000,0,400000,0,0,400000,RPUD,RES/PUD,,,
20013,58-49-9-28-0,7715-65-0497,SNGL FAM URB,0.96,AC,439700,0,439700,0,0,439700,420000,0,420000,0,0,420000,RPUD,RES/PUD,,,
20014,58-49-9-29-0,7715-55-9511,SNGL FAM URB,1.012,AC,439700,0,439700,0,0,439700,420000,0,420000,0,0,420000,RPUD,RES/PUD,,,
20015,58-49-9-30-0,7715-55-7439,SNGL FAM URB,0.967,AC,439700,0,439700,0,0,439700,420000,0,420000,0,0,420000,RPUD,RES/PUD,,,
20016,58-49-9-31-0,7715-55-5448,SNGL FAM URB,1.054,AC,439700,0,439700,0,0,439700,420000,0,420000,0,0,420000,RPUD,RES/PUD,,,
20017,58-49-9-C-1,7715-45-2535,Cmn Area/Open Spc,1.4,AC,0,0,0,0,0,0,0,0,0,0,0,0,RPUD,RES/PUD,,,
20018,58-49-9-C-2,7715-55-1349,Cmn Area/Open Spc,3.164,AC,0,0,0,0,0,0,0,0,0,0,0,0,RPUD,RES/PUD,,,
20019,58-49-9-C-3,7715-45-8792,Cmn Area/Open Spc,1.95,AC,0,0,0,0,0,0,0,0,0,0,0,0,RPUD,RES/PUD,,,
20020,58-49-9-C-4,7715-75-2038,Cmn Area/Open Spc,0.284,AC,0,0,0,0,0,0,0,0,0,0,0,0,RPUD,RES/PUD,,,
20021,58-49-9-R-1,7715-55-7623,Roads,5,AC,0,0,0,0,0,0,0,0,0,0,0,0,RPUD,RES/PUD,,,
20022,46-1-0-76-D6,7707-32-0129,SNGL FAM SUB,3.62,,132300,0,132300,0,0,132300,122300,0,122300,0,0,122300,A2,AG/LTD,,,
20023,17-1-0-41-C,6810-39-4920,AG 20-100 AC,57.15,AC,192000,163900,28100,0,13800,205800,190500,166000,24500,0,11900,202400,A1,AG/GEN,,,
20024,5-33-0-1-0,6813-74-6906,SNGL FAM SUB,3,AC,49900,0,49900,220500,0,270400,49000,0,49000,195800,0,244800,A1,AG/GEN,,,
20025,5-33-0-2-0,6813-74-6625,SNGL FAM SUB,4.27,AC,56400,0,56400,232400,0,288800,55400,0,55400,206800,0,262200,A1,AG/GEN,,,
20026,5-33-0-3-0,6813-74-0876,SNGL FAM SUB,2.74,AC,48600,0,48600,233100,3100,284800,47700,0,47700,206800,3400,257900,A1,AG/GEN,,,
20027,5-33-0-4-0,6813-74-2978,SNGL FAM SUB,3.06,AC,50200,0,50200,232400,2300,284900,49300,0,49300,206800,2500,258600,A1,AG/GEN,,,
20028,44-1-0-24-B,6777-91-2459,SNGL FAM SUB,4.145,AC,119800,0,119800,0,0,119800,106900,0,106900,0,0,106900,A2,AG/LTD,,,
20029,58-50-10-E-0,7715-98-6101,Cmn Area/Open Spc,0.352,,0,0,0,0,0,0,0,0,0,0,0,0,RPUD,RES/PUD,,,
20030,58-50-10-F-0,7715-88-8268,Cmn Area/Open Spc,0.078,,0,0,0,0,0,0,0,0,0,0,0,0,RPUD,RES/PUD,,,
20031,58-50-10-G-0,7715-98-0243,Cmn Area/Open Spc,0.085,,0,0,0,0,0,0,0,0,0,0,0,0,RPUD,RES/PUD,,,
20032,59-3-2-90-F,7726-85-1752,COMM & IND,3.376,,3342200,0,3342200,8605900,333400,12281500,3038400,0,3038400,11472000,332800,14843200,B1,BUS/GEN,,,
20033,13-1-0-46-ATW,6841-63-5038-9998,Non-Profit,0,AC,0,0,0,0,236500,236500,0,0,0,0,230000,230000,A1,AG/GEN,,,
20034,25-1-0-3-D,5799-53-6508,SNGL FAM URB,0.366,AC,1700,0,1700,0,0,1700,1600,0,1600,0,0,1600,A1,AG/GEN,,,
20035,27-15-0-1-0,6718-58-5270,SNGL FAM SUB,9.47,AC,90500,0,90500,0,0,90500,88800,0,88800,0,0,88800,A1,AG/GEN,,,
20036,27-15-0-2-0,6718-67-0846,SNGL FAM SUB,7.63,AC,79200,0,79200,189900,0,269100,77800,0,77800,149100,0,226900,A1,AG/GEN,,,
20037,27-15-0-3-0,6718-67-5496,AG 20-100 AC,21.91,AC,135400,0,135400,150200,0,285600,132900,0,132900,122800,0,255700,A1,AG/GEN,,,
20038,27-15-0-4-0,6718-67-0049,SNGL FAM SUB,14.77,AC,109600,0,109600,0,0,109600,107700,0,107700,0,0,107700,A1,AG/GEN,,,
20039,27-15-0-5-0,6718-57-3504,SNGL FAM SUB,5.57,AC,66700,0,66700,240300,1900,308900,65400,0,65400,208900,2000,276300,A1,AG/GEN,,,
20040,27-15-0-6-0,6718-47-7985,AG 20-100 AC,20.34,AC,137400,0,137400,495800,131800,765000,134700,0,134700,449800,0,584500,A1,AG/GEN,,,
20041,48-1-0-17-TW,7727-47-5784-9998,COMM & IND,0,AC,0,0,0,0,160600,160600,0,0,0,0,158500,158500,A2,AG/LTD,,,
20044,58-52-2-1-0,7715-42-3556,SNGL FAM SUB,2.433,AC,207500,0,207500,629400,0,836900,180400,0,180400,534600,0,715000,A2,AG/LTD,,,
20045,58-52-2-2-0,7715-42-5710,SNGL FAM SUB,2,AC,193900,0,193900,664200,0,858100,168600,0,168600,550900,0,719500,A2,AG/LTD,,,
20046,58-52-2-3-0,7715-42-4978,SNGL FAM SUB,2,AC,193900,0,193900,563500,0,757400,168600,0,168600,467200,0,635800,A2,AG/LTD,,,
20047,58-52-2-4-0,7715-43-2291,SNGL FAM SUB,2,AC,193900,0,193900,608300,0,802200,168600,0,168600,505400,0,674000,A2,AG/LTD,,,
20049,58-52-0-R-1,7715-32-7879,Roads,1.271,AC,0,0,0,0,0,0,0,0,0,0,0,0,A2,AG/LTD,,,
20051,21-15-1-2-0,6850-30-6583,SNGL FAM SUB,1.7,AC,90000,0,90000,305200,0,395200,90000,0,90000,278400,0,368400,R1,RES/LTD,,,
20052,21-15-1-3-0,6850-30-4543,SNGL FAM SUB,1.92,AC,90000,0,90000,331800,0,421800,90000,0,90000,302600,0,392600,R1,RES/LTD,,,
20053,21-15-1-4-0,6850-30-4300,SNGL FAM SUB,2.61,AC,90000,0,90000,296900,29900,416800,90000,0,90000,271400,25800,387200,R1,RES/LTD,,,
20054,21-15-1-5-0,6850-30-2151,SNGL FAM SUB,2.18,AC,90000,0,90000,294900,0,384900,90000,0,90000,268700,0,358700,R1,RES/LTD,,,
20055,21-15-1-6-0,6850-20-8356,SNGL FAM SUB,1.5,AC,90000,0,90000,391300,0,481300,90000,0,90000,356100,0,446100,R1,RES/LTD,,,
20056,21-15-1-7-0,6850-30-0673,SNGL FAM SUB,1.5,AC,90000,0,90000,332100,0,422100,90000,0,90000,301800,0,391800,R1,RES/LTD,,,
20057,21-15-1-8-0,6850-20-8649,SNGL FAM SUB,1.63,AC,90000,0,90000,339300,2500,431800,90000,0,90000,308400,0,398400,R1,RES/LTD,,,
20058,21-15-1-9-0,6850-20-6882,SNGL FAM SUB,1.59,AC,90000,0,90000,336400,0,426400,90000,0,90000,306400,0,396400,R1,RES/LTD,,,
20059,21-15-1-10-0,6850-20-5918,SNGL FAM SUB,1.5,AC,90000,0,90000,346000,0,436000,90000,0,90000,314700,0,404700,R1,RES/LTD,,,
20060,21-15-1-11-0,6850-21-5202,SNGL FAM SUB,1.63,AC,90000,0,90000,334400,0,424400,90000,0,90000,304300,0,394300,R1,RES/LTD,,,
20061,21-15-1-12-0,6850-21-6299,SNGL FAM SUB,1.58,AC,90000,0,90000,299000,0,389000,90000,0,90000,273000,0,363000,R1,RES/LTD,,,
20062,21-15-1-13-0,6850-21-8196,SNGL FAM SUB,1.5,AC,90000,0,90000,395500,0,485500,90000,0,90000,360200,0,450200,R1,RES/LTD,,,
20063,21-15-1-14-0,6850-31-0044,SNGL FAM SUB,1.5,AC,90000,0,90000,320300,0,410300,90000,0,90000,291600,0,381600,R1,RES/LTD,,,
20064,21-15-1-15-0,6850-30-2914,SNGL FAM SUB,1.55,AC,90000,0,90000,334100,0,424100,90000,0,90000,304300,0,394300,R1,RES/LTD,,,
20065,21-15-1-16-0,6850-30-4901,SNGL FAM SUB,1.54,AC,90000,0,90000,292800,0,382800,90000,0,90000,267100,0,357100,R1,RES/LTD,,,
20066,21-15-1-17-0,6850-30-5991,SNGL FAM SUB,1.63,AC,90000,0,90000,318400,0,408400,90000,0,90000,290000,0,380000,R1,RES/LTD,,,
20067,21-15-1-18-0,6850-31-7189,SNGL FAM SUB,1.5,AC,90000,0,90000,351000,0,441000,90000,0,90000,319900,0,409900,R1,RES/LTD,,,
20068,21-15-1-19-0,6850-41-0403,SNGL FAM SUB,1.5,AC,90000,0,90000,352300,0,442300,90000,0,90000,318900,0,408900,R1,RES/LTD,,,
20069,21-15-1-20-0,6850-41-3313,SNGL FAM SUB,1.5,AC,90000,0,90000,333300,0,423300,90000,0,90000,303800,0,393800,R1,RES/LTD,,,
20070,21-15-1-21-0,6850-41-1175,SNGL FAM SUB,1.5,AC,90000,0,90000,293100,0,383100,90000,0,90000,267100,0,357100,R1,RES/LTD,,,
20071,21-15-1-22-0,6850-40-0926,SNGL FAM SUB,1.65,AC,90000,0,90000,0,0,90000,90000,0,90000,0,0,90000,R1,RES/LTD,,,
20072,21-15-1-1-0,6850-30-8730,SNGL FAM SUB,1.52,AC,90000,0,90000,293100,0,383100,90000,0,90000,267100,0,357100,R1,RES/LTD,,,
20073,21-15-1-A-0,6850-20-5533,Cmn Area/Open Spc,14.55,AC,0,0,0,0,0,0,0,0,0,0,0,0,R1,RES/LTD,,,
20094,42-40-0-16-0,6757-91-8221,SNGL FAM SUB,0.503,AC,88000,0,88000,0,0,88000,84000,0,84000,0,0,84000,R3,RES/GEN,,,
20095,42-40-0-17-0,6757-91-9218,SNGL FAM SUB,0.568,AC,88000,0,88000,0,0,88000,84000,0,84000,0,0,84000,R3,RES/GEN,,,
20096,42-40-0-18-0,6757-91-9452,SNGL FAM SUB,0.468,AC,88000,0,88000,423100,1000,512100,84000,0,84000,377700,0,461700,R3,RES/GEN,,,
20097,42-40-0-19-0,6757-91-9552,SNGL FAM SUB,0.491,AC,88000,0,88000,387900,0,475900,84000,0,84000,349400,0,433400,R3,RES/GEN,,,
20098,42-40-0-20-0,6757-91-9651,SNGL FAM SUB,0.46,AC,88000,0,88000,446500,22400,556900,84000,0,84000,399200,18600,501800,R3,RES/GEN,,,
20099,42-40-0-21-0,6767-01-0701,SNGL FAM SUB,0.461,AC,88000,0,88000,0,0,88000,84000,0,84000,0,0,84000,R3,RES/GEN,,,
20100,42-40-0-22-0,6767-01-1636,SNGL FAM SUB,0.461,AC,88000,0,88000,508700,0,596700,84000,0,84000,454500,0,538500,R3,RES/GEN,,,
20101,42-40-0-23-0,6767-01-2653,SNGL FAM SUB,0.459,AC,88000,0,88000,0,0,88000,84000,0,84000,0,0,84000,R3,RES/GEN,,,
20102,42-40-0-24-0,6767-01-2543,SNGL FAM SUB,0.465,AC,88000,0,88000,405000,0,493000,84000,0,84000,365600,0,449600,R3,RES/GEN,,,
20103,42-40-0-25-0,6767-01-1465,SNGL FAM SUB,0.463,AC,88000,0,88000,379300,0,467300,84000,0,84000,0,0,84000,R3,RES/GEN,,,
20243,63-41-0-4-A,7724-23-2521,SNGL FAM URB,0,,112300,0,112300,375400,0,487700,110100,0,110100,375400,0,485500,R3,RES/GEN,,,
20244,63-41-0-4-B,7724-23-2515,SNGL FAM URB,0,,84300,0,84300,326100,0,410400,82600,0,82600,326100,0,408700,R3,RES/GEN,,,
20245,63-41-0-4-C,7724-23-2508,SNGL FAM URB,0,,112300,0,112300,339100,0,451400,110100,0,110100,339100,0,449200,R3,RES/GEN,,,
20246,9-14-0-1-0,5892-60-9911,SNGL FAM SUB,4.13,AC,50100,0,50100,233400,0,283500,49000,0,49000,206800,0,255800,A1,AG/GEN,,,
20247,9-14-0-2-0,5892-60-9635,SNGL FAM SUB,5.07,AC,53500,0,53500,232800,0,286300,52200,0,52200,206300,0,258500,A1,AG/GEN,,,
20248,9-14-0-3-0,5892-60-9367,SNGL FAM SUB,5.06,AC,53400,0,53400,248100,0,301500,52200,0,52200,221200,0,273400,A1,AG/GEN,,,
20251,6-17-0-2-0,6823-75-0107,SNGL FAM SUB,4.516,AC,57600,0,57600,225100,22400,305100,56600,0,56600,208500,19800,284900,A1,AG/GEN,,,
20252,6-17-0-1-0,6823-74-2885,SNGL FAM SUB,5.022,AC,60200,0,60200,0,0,60200,59100,0,59100,0,0,59100,A1,AG/GEN,,,
20254,58-54-0-3-0,7725-30-0045,AG 20-100 AC,21.943,AC,1810300,0,1810300,0,0,1810300,2207200,0,2207200,0,0,2207200,RPUD,RES/PUD,,,
20255,58-54-0-4-0,7725-40-7010,SNGL FAM URB,7.513,AC,619800,0,619800,0,0,619800,1303300,0,1303300,0,0,1303300,RPUD,RES/PUD,,,
20398,58-54-1-27-0,7725-15-3961,SNGL FAM URB,0.226,AC,145000,0,145000,454000,0,599000,135000,0,135000,0,0,135000,RPUD,RES/PUD,,,
20399,58-54-1-28-0,7725-15-4943,SNGL FAM URB,0.33,AC,145000,0,145000,524900,0,669900,135000,0,135000,0,0,135000,RPUD,RES/PUD,,,
20400,58-54-1-29-0,7725-15-5837,SNGL FAM URB,0.372,AC,145000,0,145000,434200,0,579200,135000,0,135000,410700,0,545700,RPUD,RES/PUD,,,
20401,58-54-1-30-0,7725-15-5746,SNGL FAM URB,0.34,AC,145000,0,145000,439100,0,584100,135000,0,135000,413500,0,548500,RPUD,RES/PUD,,,
20402,58-54-1-31-0,7725-15-4678,SNGL FAM URB,0.346,AC,145000,0,145000,531200,0,676200,135000,0,135000,495400,0,630400,RPUD,RES/PUD,,,
20403,58-54-1-32-0,7725-15-3688,SNGL FAM URB,0.248,AC,145000,0,145000,547800,0,692800,135000,0,135000,519700,0,654700,RPUD,RES/PUD,,,
20404,58-54-1-33-0,7725-15-3618,SNGL FAM URB,0.306,AC,145000,0,145000,590500,0,735500,135000,0,135000,544300,0,679300,RPUD,RES/PUD,,,
20405,58-54-1-34-0,7725-15-3517,SNGL FAM URB,0.269,AC,145000,0,145000,343800,0,488800,135000,0,135000,331300,0,466300,RPUD,RES/PUD,,,
20406,58-54-1-35-0,7725-15-2561,SNGL FAM URB,0.215,AC,145000,0,145000,441400,0,586400,135000,0,135000,419900,0,554900,RPUD,RES/PUD,,,
20407,58-54-1-36-0,7725-15-2426,SNGL FAM URB,0.226,AC,145000,0,145000,383500,0,528500,135000,0,135000,0,0,135000,RPUD,RES/PUD,,,
20408,58-54-1-37-0,7725-05-9391,SNGL FAM URB,0.175,AC,145000,0,145000,313100,0,458100,135000,0,135000,303000,0,438000,RPUD,RES/PUD,,,
20409,58-54-1-38-0,7725-05-9257,SNGL FAM URB,0.193,AC,145000,0,145000,308700,0,453700,135000,0,135000,298600,0,433600,RPUD,RES/PUD,,,
20410,58-54-1-39-0,7725-05-9203,SNGL FAM URB,0.222,AC,145000,0,145000,308700,0,453700,135000,0,135000,298600,0,433600,RPUD,RES/PUD,,,
20411,58-54-1-40-0,7725-05-8148,SNGL FAM URB,0.248,AC,145000,0,145000,363200,0,508200,135000,0,135000,350400,0,485400,RPUD,RES/PUD,,,
20412,58-54-1-41-0,7725-05-8112,SNGL FAM URB,0.276,AC,145000,0,145000,298700,0,443700,135000,0,135000,289000,0,424000,RPUD,RES/PUD,,,
20693,21-15-2-25-0,6850-41-7812,SNGL FAM SUB,1.5,AC,90000,0,90000,0,0,90000,90000,0,90000,0,0,90000,R1,RES/LTD,,,
20694,21-15-2-26-0,6850-41-5657,SNGL FAM SUB,1.52,AC,90000,0,90000,0,0,90000,90000,0,90000,0,0,90000,R1,RES/LTD,,,
20695,21-15-2-27-0,6850-41-4521,SNGL FAM SUB,1.56,AC,90000,0,90000,0,0,90000,90000,0,90000,0,0,90000,R1,RES/LTD,,,
20696,21-15-2-R-0,6850-41-8788,Roads,1.29,AC,0,0,0,0,0,0,0,0,0,0,0,0,R1,RES/LTD,,,
20697,21-15-2-R-1,6850-31-2646,Roads,4.14,AC,0,0,0,0,0,0,0,0,0,0,0,0,R1,RES/LTD,,,
20104,42-40-0-26-0,6767-01-1317,SNGL FAM SUB,0.461,AC,88000,0,88000,0,0,88000,84000,0,84000,0,0,84000,R3,RES/GEN,,,
20105,42-40-0-27-0,6767-01-2008,SNGL FAM SUB,0.755,AC,88000,0,88000,0,0,88000,84000,0,84000,0,0,84000,R3,RES/GEN,,,
20106,42-40-0-28-0,6767-01-3027,SNGL FAM SUB,0.68,AC,88000,0,88000,476800,25700,590500,84000,0,84000,427600,18000,529600,R3,RES/GEN,,,
20107,42-40-0-29-0,6767-01-3267,SNGL FAM SUB,0.486,AC,88000,0,88000,0,0,88000,84000,0,84000,0,0,84000,R3,RES/GEN,,,
20108,42-40-0-30-0,6767-01-3474,SNGL FAM SUB,0.598,AC,88000,0,88000,0,0,88000,84000,0,84000,0,0,84000,R3,RES/GEN,,,
20109,42-40-0-A-0,6767-01-4222,Cmn Area/Open Spc,5.183,AC,0,0,0,0,0,0,0,0,0,0,0,0,R3,RES/GEN,,,
20110,42-40-0-B-0,6767-01-1104,General Gov,0.471,AC,22000,0,22000,0,0,22000,20000,0,20000,0,0,20000,R3,RES/GEN,,,
20111,42-40-0-R-0,6767-01-2351,Roads,2.555,AC,0,0,0,0,0,0,0,0,0,0,0,0,R3,RES/GEN,,,
20112,42-40-0-R-1,6767-01-7550,Roads,0.089,AC,0,0,0,0,0,0,0,0,0,0,0,0,R3,RES/GEN,,,
20113,28-20-0-1-0,6738-18-7144,SNGL FAM SUB,3.903,AC,59900,0,59900,260800,0,320700,57500,0,57500,227900,0,285400,A1,AG/GEN,,,
20114,28-20-0-2-0,6738-17-5812,SNGL FAM SUB,3.214,AC,55300,0,55300,266500,3500,325300,53200,0,53200,233100,3800,290100,A1,AG/GEN,,,
20115,28-20-0-3-0,6738-17-3425,SNGL FAM SUB,3.309,AC,55900,0,55900,266400,20500,342800,53800,0,53800,232700,19000,305500,A1,AG/GEN,,,
20116,28-20-0-4-0,6738-17-6347,SNGL FAM SUB,2.387,AC,50200,0,50200,266100,2000,318300,48100,0,48100,233300,2200,283600,A1,AG/GEN,,,
20117,28-21-0-1-0,6739-01-0374,SNGL FAM SUB,5.79,AC,72100,0,72100,247200,0,319300,69200,0,69200,200000,0,269200,A1,AG/GEN,,,
20118,28-21-0-2-0,6739-01-1141,SNGL FAM SUB,6.67,AC,77600,0,77600,246700,0,324300,74700,0,74700,199500,0,274200,A1,AG/GEN,,,
20119,28-21-0-3-0,6739-00-2853,SNGL FAM SUB,8.01,AC,86300,0,86300,265800,1000,353100,83000,0,83000,216900,1000,300900,A1,AG/GEN,,,
20120,28-21-0-4-0,6739-00-4589,SNGL FAM SUB,5.96,AC,73200,0,73200,247200,0,320400,70300,0,70300,200000,0,270300,A1,AG/GEN,,,
20121,43-42-D-1-0,6777-36-8681,SNGL FAM SUB,2.05,AC,187500,0,187500,620200,6000,813700,175000,0,175000,554100,5300,734400,RP,"RURAL,P",,,
20122,43-42-D-2-0,6777-36-6774,SNGL FAM SUB,2.05,AC,187500,0,187500,842300,0,1029800,175000,0,175000,751300,0,926300,RP,"RURAL,P",,,
20123,43-42-D-3-0,6777-37-3574,SNGL FAM SUB,2.03,AC,187500,0,187500,0,0,187500,175000,0,175000,0,0,175000,RP,"RURAL,P",,,
20124,43-42-D-4-0,6777-37-2708,SNGL FAM SUB,2.05,AC,150000,0,150000,0,0,150000,140000,0,140000,0,0,140000,RP,"RURAL,P",,,
20125,43-42-D-5-0,6777-27-9997,SNGL FAM SUB,2.07,AC,150000,0,150000,439500,0,589500,140000,0,140000,401600,0,541600,RP,"RURAL,P",,,
20126,43-42-D-6-0,6777-28-7185,SNGL FAM SUB,2.04,AC,150000,0,150000,0,0,150000,140000,0,140000,0,0,140000,RP,"RURAL,P",,,
20127,43-42-D-7-0,6777-27-5938,SNGL FAM SUB,2.08,AC,150000,0,150000,635300,0,785300,140000,0,140000,572600,0,712600,RP,"RURAL,P",,,
20128,43-42-D-8-0,6777-27-6700,SNGL FAM SUB,2.04,AC,150000,0,150000,678600,17900,846500,140000,0,140000,613400,16500,769900,RP,"RURAL,P",,,
20129,43-42-D-9-0,6777-27-8621,SNGL FAM SUB,2.07,AC,150000,0,150000,916100,38400,1104500,140000,0,140000,817300,32100,989400,RP,"RURAL,P",,,
20130,43-42-D-10-0,6777-36-2427,SNGL FAM SUB,2.04,AC,150000,0,150000,0,0,150000,140000,0,140000,0,0,140000,RP,"RURAL,P",,,
20131,43-42-D-11-0,6777-36-5396,SNGL FAM SUB,2.5,AC,150000,0,150000,744600,0,894600,140000,0,140000,667500,0,807500,RP,"RURAL,P",,,
20132,43-42-D-12-0,6777-45-0446,SNGL FAM SUB,2.17,AC,150000,0,150000,450200,0,600200,140000,0,140000,411900,0,551900,RP,"RURAL,P",,,
20133,43-42-D-13-0,6777-45-0138,SNGL FAM SUB,2.42,AC,150000,0,150000,722400,9800,882200,140000,0,140000,649100,8600,797700,RP,"RURAL,P",,,
20134,43-42-D-14-0,6777-44-1942,SNGL FAM SUB,2.47,AC,150000,0,150000,419700,0,569700,140000,0,140000,380100,0,520100,RP,"RURAL,P",,,
20135,43-42-D-15-0,6777-45-5200,SNGL FAM SUB,2.03,AC,150000,0,150000,0,0,150000,140000,0,140000,0,0,140000,RP,"RURAL,P",,,
20136,43-42-D-16-0,6777-45-4460,SNGL FAM SUB,2.03,AC,150000,0,150000,648900,0,798900,140000,0,140000,584000,0,724000,RP,"RURAL,P",,,
20137,43-42-D-17-0,6777-45-4810,SNGL FAM SUB,2.01,AC,150000,0,150000,703100,82000,935100,140000,0,140000,627700,73300,841000,RP,"RURAL,P",,,
20138,43-42-D-18-0,6777-45-4640,SNGL FAM SUB,2,AC,150000,0,150000,910800,0,1060800,140000,0,140000,775200,0,915200,RP,"RURAL,P",,,
20139,43-42-D-19-0,6777-46-3053,SNGL FAM SUB,2.01,AC,150000,0,150000,781300,37100,968400,140000,0,140000,699800,31400,871200,RP,"RURAL,P",,,
20140,43-42-D-20-0,6777-46-1413,SNGL FAM SUB,2.02,AC,150000,0,150000,0,0,150000,140000,0,140000,0,0,140000,RP,"RURAL,P",,,
20141,43-42-D-A-0,6777-37-6081,Cmn Area/Open Spc,20,AC,0,0,0,0,0,0,0,0,0,0,0,0,RP,"RURAL,P",,,
20142,43-42-D-B-0,6777-36-2185,Cmn Area/Open Spc,12.43,AC,0,0,0,0,0,0,0,0,0,0,0,0,RP,"RURAL,P",,,
20143,43-42-D-C-0,6777-46-5126,Cmn Area/Open Spc,6.96,AC,0,0,0,0,0,0,0,0,0,0,0,0,RP,"RURAL,P",,,
20144,43-42-D-R-0,6777-36-5539,Roads,5.47,AC,0,0,0,0,0,0,0,0,0,0,0,0,RP,"RURAL,P",,,
20145,43-42-D-R-1,6777-38-0526,Roads,0.33,AC,0,0,0,0,0,0,0,0,0,0,0,0,RP,"RURAL,P",,,
20147,9-1-0-67-A,5892-61-8745,SNGL FAM SUB,4,AC,49600,0,49600,0,0,49600,48500,0,48500,0,0,48500,A1,AG/GEN,,,
20148,12-32-0-A-0,6831-52-0144,SNGL FAM SUB,4.917,AC,65100,0,65100,96700,800,162600,61400,0,61400,80400,700,142500,A1,AG/GEN,,,
20149,12-32-0-B-0,6831-52-8185,SNGL FAM SUB,0.691,AC,6800,0,6800,0,0,6800,3900,0,3900,0,0,3900,A1,AG/GEN,,,
20150,17-14-0-1-0,6810-11-5756,SNGL FAM SUB,3.95,AC,57400,0,57400,247200,1200,305800,54200,0,54200,206800,1300,262300,A1,AG/GEN,,,
20151,17-14-0-2-0,6810-11-2522,SNGL FAM SUB,5.04,AC,63700,0,63700,242500,1200,307400,60200,0,60200,201800,1300,263300,A1,AG/GEN,,,
20152,17-14-0-3-0,6810-01-9646,SNGL FAM SUB,3.55,AC,55100,0,55100,249800,1200,306100,52000,0,52000,208900,1300,262200,A1,AG/GEN,,,
20153,17-14-0-4-0,6810-11-0917,SNGL FAM SUB,3.73,AC,56100,0,56100,249800,1200,307100,53000,0,53000,208900,1300,263200,A1,AG/GEN,,,
20154,63-38-0-A-0,7724-14-4456,SNGL FAM SUB,0.006,AC,100,0,100,0,0,100,100,0,100,0,0,100,R3,RES/GEN,,,
20155,30-1-0-111-C,6759-73-9626,Cemetery,0.1,AC,100,0,100,0,0,100,100,0,100,0,0,100,A2,AG/LTD,,,
20156,28-1-0-16-B,6728-87-6430,Cemetery,0.1,AC,100,0,100,0,0,100,100,0,100,0,0,100,A1,AG/GEN,,,
20157,63-41-0-3-A,7724-23-1348,SNGL FAM URB,0,,112300,0,112300,341800,0,454100,110100,0,110100,341800,0,451900,R3,RES/GEN,,,
20158,63-41-0-3-B,7724-23-1460,SNGL FAM URB,0,,84300,0,84300,326100,0,410400,82600,0,82600,326100,0,408700,R3,RES/GEN,,,
20159,63-41-0-3-C,7724-23-1493,SNGL FAM URB,0,,112300,0,112300,346800,0,459100,110100,0,110100,346800,0,456900,R3,RES/GEN,,,
20160,59-5-0-1-0,7726-71-9334,COMM & IND,93.746,AC,26908300,0,26908300,617400,206500,27732200,26222300,0,26222300,591900,203500,27017700,M1,INDUS/L,,,
20161,59-5-0-2-0,7726-83-3258,COMM & IND,26.815,AC,10036900,0,10036900,0,0,10036900,9605100,0,9605100,0,0,9605100,M1,INDUS/L,,,
20162,59-5-0-3-0,7725-89-0785,COMM & IND,34.058,AC,123700,0,123700,0,0,123700,119200,0,119200,0,0,119200,M1,INDUS/L,,,
20163,59-5-0-4-R,7726-72-6630,COMM & IND,5.181,AC,10400,0,10400,0,0,10400,10400,0,10400,0,0,10400,M1,INDUS/L,,,
20164,59-5-0-5-0,7726-72-1679,COMM & IND,18.892,AC,6699100,0,6699100,0,0,6699100,6428800,0,6428800,0,0,6428800,M1,INDUS/L,,,
20165,58-53-0-1-0,7726-04-8541,SNGL FAM URB,0.29,AC,130000,0,130000,415700,0,545700,125000,0,125000,399100,0,524100,RPUD,RES/PUD,,,
20166,58-53-0-2-0,7726-04-9417,SNGL FAM URB,0.27,AC,130000,0,130000,424200,0,554200,125000,0,125000,406400,0,531400,RPUD,RES/PUD,,,
20167,58-53-0-3-0,7726-04-9497,SNGL FAM URB,0.29,AC,130000,0,130000,346700,0,476700,125000,0,125000,333400,0,458400,RPUD,RES/PUD,,,
20168,58-53-0-4-0,7726-04-8715,SNGL FAM URB,0.34,AC,130000,0,130000,499800,0,629800,125000,0,125000,475300,0,600300,RPUD,RES/PUD,,,
20169,58-53-0-5-0,7726-04-8791,SNGL FAM URB,0.27,AC,130000,0,130000,504600,0,634600,125000,0,125000,492200,0,617200,RPUD,RES/PUD,,,
20170,58-53-0-6-0,7726-04-9668,SNGL FAM URB,0.23,AC,130000,0,130000,406100,0,536100,125000,0,125000,407900,0,532900,RPUD,RES/PUD,,,
20171,58-53-0-7-0,7726-14-0625,SNGL FAM URB,0.22,AC,130000,0,130000,475200,0,605200,125000,0,125000,472500,0,597500,RPUD,RES/PUD,,,
20172,58-53-0-8-0,7726-14-0693,SNGL FAM URB,0.22,AC,130000,0,130000,448500,0,578500,125000,0,125000,423700,0,548700,RPUD,RES/PUD,,,
20173,58-53-0-9-0,7726-14-1681,SNGL FAM URB,0.23,AC,130000,0,130000,428800,0,558800,125000,0,125000,428600,0,553600,RPUD,RES/PUD,,,
20174,44-1-0-47-B,6787-63-6597,Cemetery,0,AC,100,0,100,0,0,100,100,0,100,0,0,100,A2,AG/LTD,,,
20175,58-53-0-10-0,7726-14-3455,SNGL FAM URB,0.24,AC,130000,0,130000,374100,0,504100,125000,0,125000,374900,0,499900,RPUD,RES/PUD,,,
20176,58-53-0-11-0,7726-14-4500,SNGL FAM URB,0.25,AC,130000,0,130000,347800,0,477800,125000,0,125000,337400,0,462400,RPUD,RES/PUD,,,
20177,58-53-0-12-0,7726-14-4563,SNGL FAM URB,0.23,AC,130000,0,130000,464700,0,594700,125000,0,125000,463000,0,588000,RPUD,RES/PUD,,,
20178,58-53-0-13-0,7726-14-5517,SNGL FAM URB,0.23,AC,130000,0,130000,535700,0,665700,125000,0,125000,526400,0,651400,RPUD,RES/PUD,,,
20179,58-53-0-14-0,7726-14-5671,SNGL FAM URB,0.21,AC,130000,0,130000,499100,0,629100,125000,0,125000,490700,0,615700,RPUD,RES/PUD,,,
20180,58-53-0-15-0,7726-14-6643,SNGL FAM URB,0.21,AC,130000,0,130000,397500,0,527500,125000,0,125000,397100,0,522100,RPUD,RES/PUD,,,
20181,58-53-0-16-0,7726-14-7615,SNGL FAM URB,0.21,AC,130000,0,130000,396400,0,526400,125000,0,125000,397700,0,522700,RPUD,RES/PUD,,,
20182,58-53-0-17-0,7726-14-7677,SNGL FAM URB,0.22,AC,130000,0,130000,335500,0,465500,125000,0,125000,325700,0,450700,RPUD,RES/PUD,,,
20183,58-53-0-18-0,7726-14-8722,SNGL FAM URB,0.21,AC,130000,0,130000,407300,0,537300,125000,0,125000,406600,0,531600,RPUD,RES/PUD,,,
20184,58-53-0-19-0,7726-14-8777,SNGL FAM URB,0.21,AC,130000,0,130000,404100,0,534100,125000,0,125000,404000,0,529000,RPUD,RES/PUD,,,
20185,58-53-0-20-0,7726-14-9865,SNGL FAM URB,0.21,AC,130000,0,130000,325700,0,455700,125000,0,125000,327300,0,452300,RPUD,RES/PUD,,,
20186,58-53-0-21-0,7726-24-0900,SNGL FAM URB,0.21,AC,130000,0,130000,417200,0,547200,125000,0,125000,418300,0,543300,RPUD,RES/PUD,,,
20187,58-53-0-22-0,7726-24-0956,SNGL FAM URB,0.2,AC,130000,0,130000,439400,0,569400,125000,0,125000,435000,0,560000,RPUD,RES/PUD,,,
20188,58-53-0-23-0,7726-24-1938,SNGL FAM URB,0.24,AC,130000,0,130000,696700,0,826700,125000,0,125000,670400,0,795400,RPUD,RES/PUD,,,
20189,58-53-0-24-0,7726-24-2903,SNGL FAM URB,0.25,AC,130000,0,130000,469200,0,599200,125000,0,125000,464100,0,589100,RPUD,RES/PUD,,,
20190,58-53-0-25-0,7726-24-2876,SNGL FAM URB,0.38,AC,130000,0,130000,516200,0,646200,125000,0,125000,507900,0,632900,RPUD,RES/PUD,,,
20191,58-53-0-26-0,7726-24-2719,SNGL FAM URB,0.25,AC,130000,0,130000,379000,0,509000,125000,0,125000,380200,0,505200,RPUD,RES/PUD,,,
20192,58-53-0-27-0,7726-24-1755,SNGL FAM URB,0.24,AC,130000,0,130000,529600,0,659600,125000,0,125000,515400,0,640400,RPUD,RES/PUD,,,
20193,58-53-0-28-0,7726-24-1700,SNGL FAM URB,0.27,AC,130000,0,130000,401200,0,531200,125000,0,125000,389600,0,514600,RPUD,RES/PUD,,,
20194,58-53-0-29-0,7726-24-2600,SNGL FAM URB,0.22,AC,130000,0,130000,476600,0,606600,125000,0,125000,451600,0,576600,RPUD,RES/PUD,,,
20195,58-53-0-30-0,7726-24-2654,SNGL FAM URB,0.21,AC,130000,0,130000,372300,0,502300,125000,0,125000,357700,0,482700,RPUD,RES/PUD,,,
20196,58-53-0-31-0,7726-24-3700,SNGL FAM URB,0.24,AC,130000,0,130000,540100,0,670100,125000,0,125000,501600,0,626600,RPUD,RES/PUD,,,
20197,58-53-0-32-0,7726-24-3776,SNGL FAM URB,0.35,AC,130000,0,130000,578600,3500,712100,125000,0,125000,559700,0,684700,RPUD,RES/PUD,,,
20198,58-53-0-33-0,7726-24-4762,SNGL FAM URB,0.33,AC,130000,0,130000,460000,0,590000,125000,0,125000,452500,0,577500,RPUD,RES/PUD,,,
20199,58-53-0-34-0,7726-24-5615,SNGL FAM URB,0.3,AC,130000,0,130000,451600,0,581600,125000,0,125000,452300,0,577300,RPUD,RES/PUD,,,
20200,58-53-0-35-0,7726-24-5517,SNGL FAM URB,0.3,AC,130000,0,130000,466500,0,596500,125000,0,125000,458200,0,583200,RPUD,RES/PUD,,,
20201,58-53-0-36-0,7726-24-4551,SNGL FAM URB,0.24,AC,130000,0,130000,564500,0,694500,125000,0,125000,531500,0,656500,RPUD,RES/PUD,,,
20202,58-53-0-37-0,7726-24-3488,SNGL FAM URB,0.27,AC,130000,0,130000,398200,0,528200,125000,0,125000,383300,0,508300,RPUD,RES/PUD,,,
20203,58-53-0-38-0,7726-24-3424,SNGL FAM URB,0.28,AC,130000,0,130000,429400,0,559400,125000,0,125000,413700,0,538700,RPUD,RES/PUD,,,
20204,58-53-0-39-0,7726-24-0603,SNGL FAM URB,0.23,AC,130000,0,130000,339600,0,469600,125000,0,125000,317100,0,442100,RPUD,RES/PUD,,,
20205,58-53-0-40-0,7726-14-9558,SNGL FAM URB,0.22,AC,130000,0,130000,455400,0,585400,125000,0,125000,426800,0,551800,RPUD,RES/PUD,,,
20206,58-53-0-41-0,7726-14-9504,SNGL FAM URB,0.22,AC,130000,0,130000,433900,0,563900,125000,0,125000,414700,0,539700,RPUD,RES/PUD,,,
20207,58-53-0-42-0,7726-14-8458,SNGL FAM URB,0.29,AC,130000,0,130000,349100,0,479100,125000,0,125000,340200,0,465200,RPUD,RES/PUD,,,
20208,58-53-0-43-0,7726-14-7486,SNGL FAM URB,0.25,AC,130000,0,130000,317400,0,447400,125000,0,125000,313000,0,438000,RPUD,RES/PUD,,,
20209,58-53-0-44-0,7726-14-7415,SNGL FAM URB,0.24,AC,130000,0,130000,430200,0,560200,125000,0,125000,412900,0,537900,RPUD,RES/PUD,,,
20210,58-53-0-45-0,7726-14-6443,SNGL FAM URB,0.27,AC,130000,0,130000,291700,0,421700,125000,0,125000,288300,0,413300,RPUD,RES/PUD,,,
20211,58-53-0-46-0,7726-14-5388,SNGL FAM URB,0.25,AC,130000,0,130000,373000,0,503000,125000,0,125000,360600,0,485600,RPUD,RES/PUD,,,
20212,58-53-0-47-0,7726-14-4384,SNGL FAM URB,0.24,AC,130000,0,130000,340600,0,470600,125000,0,125000,329700,0,454700,RPUD,RES/PUD,,,
20213,58-53-0-48-0,7726-14-5238,SNGL FAM URB,0.22,AC,130000,0,130000,376200,0,506200,125000,0,125000,360200,0,485200,RPUD,RES/PUD,,,
20214,58-53-0-49-0,7726-14-5272,SNGL FAM URB,0.22,AC,130000,0,130000,316500,0,446500,125000,0,125000,307700,0,432700,RPUD,RES/PUD,,,
20215,44-1-0-64-A,6786-66-4631,SNGL FAM SUB,7.537,AC,192600,0,192600,621800,0,814400,171900,0,171900,499300,0,671200,A2,AG/LTD,,,
20216,44-1-0-64-B,6786-67-2487,SNGL FAM SUB,7.859,AC,197700,0,197700,539400,0,737100,176400,0,176400,436400,0,612800,A2,AG/LTD,,,
20217,44-16-0-14-A,6787-48-7469,SNGL FAM SUB,7.207,AC,148400,0,148400,452700,0,601100,132300,0,132300,406800,0,539100,A2,AG/LTD,,,
20218,44-16-0-16-0,6787-38-9309,SNGL FAM SUB,6.906,AC,148400,0,148400,0,0,148400,132300,0,132300,0,0,132300,A2,AG/LTD,,,
20219,6-16-0-1-0,6823-85-2614,SNGL FAM SUB,4.5,AC,57600,0,57600,134600,0,192200,56500,0,56500,122500,0,179000,A1,AG/GEN,,,
20220,6-16-0-2-0,6823-74-7895,SNGL FAM SUB,3,AC,49900,0,49900,206700,0,256600,49000,0,49000,199300,0,248300,A1,AG/GEN,,,
20221,6-16-0-3-0,6823-84-5857,AG 20-100 AC,33.242,AC,141400,0,141400,0,0,141400,148300,0,148300,0,0,148300,A1,AG/GEN,,,
20222,6-16-0-1-A,6823-75-7698,Cemetery,0,AC,100,0,100,0,0,100,100,0,100,0,0,100,A1,AG/GEN,,,
20223,28-22-0-B-0,6738-09-4767,SNGL FAM SUB,6,AC,73400,0,73400,0,0,73400,73500,0,73500,0,0,73500,A1,AG/GEN,,,
20224,28-22-0-C-0,6738-19-2872,SNGL FAM SUB,0.292,AC,2200,0,2200,0,0,2200,1700,0,1700,0,0,1700,A1,AG/GEN,,,
20225,58-53-0-A-0,7726-14-5726,Cmn Area/Open Spc,4.1,AC,0,0,0,0,0,0,0,0,0,0,0,0,RPUD,RES/PUD,,,
20226,58-53-0-B-0,7726-24-6364,Cmn Area/Open Spc,3.43,AC,0,0,0,0,0,0,0,0,0,0,0,0,RPUD,RES/PUD,,,
20227,58-53-0-C-0,7726-04-8306,Cmn Area/Open Spc,1.23,AC,0,0,0,0,0,0,0,0,0,0,0,0,RPUD,RES/PUD,,,
20228,58-53-0-R-1,7726-14-9794,Roads,5.41,AC,0,0,0,0,0,0,0,0,0,0,0,0,RPUD,RES/PUD,,,
20229,58-53-0-R-2,7726-04-7253,Roads,0.51,AC,0,0,0,0,0,0,0,0,0,0,0,0,RPUD,RES/PUD,,,
20230,5-34-0-B-0,6814-82-7068,SNGL FAM SUB,4,AC,55000,0,55000,0,0,55000,54000,0,54000,0,0,54000,A1,AG/GEN,,,
20231,5-34-0-C-0,6814-92-1621,SNGL FAM SUB,3.213,AC,50400,0,50400,0,0,50400,49500,0,49500,0,0,49500,A1,AG/GEN,,,
20232,59-6-0-A-0,7726-64-5315,COMM & IND,21.191,AC,6762900,0,6762900,0,0,6762900,6490000,0,6490000,0,0,6490000,B1,BUS/GEN,,,
20233,59-6-0-B-0,7726-73-0634,COMM & IND,21.191,AC,6762900,0,6762900,0,0,6762900,6490000,0,6490000,0,0,6490000,B1,BUS/GEN,,,
20234,59-6-0-C-0,7726-64-8936,Cemetery,0.007,AC,100,0,100,0,0,100,100,0,100,0,0,100,B1,BUS/GEN,,,
20235,13-11-0-1-0,6841-66-2547,SNGL FAM SUB,3.57,AC,65500,0,65500,269400,0,334900,70800,0,70800,260100,0,330900,A1,AG/GEN,,,
20236,13-11-0-2-0,6841-66-5351,SNGL FAM SUB,3,AC,62000,0,62000,267000,0,329000,66000,0,66000,255600,0,321600,A1,AG/GEN,,,
20237,13-11-0-3-0,6841-66-9018,SNGL FAM SUB,3.19,AC,63200,0,63200,267000,0,330200,67600,0,67600,257800,0,325400,A1,AG/GEN,,,
20238,4-1-0-25-D,6803-61-5113,SNGL FAM SUB,19.25,AC,132400,123100,9300,0,0,132400,129300,121100,8200,0,0,129300,A1,AG/GEN,,,
20239,56-7-0-3-A,6785-94-0784,SNGL FAM SUB,,,0,0,0,8200,200,8400,0,0,0,7800,200,8000,A2,AG/LTD,,,
20242,51-1-0-17-A,6735-26-8629,AG 20-100 AC,28.85,AC,132700,0,132700,0,100,132800,129800,0,129800,0,100,129900,A1,AG/GEN,,,
20256,46-43-0-2-0,7707-91-4667,SNGL FAM SUB,4.636,AC,196800,0,196800,0,0,196800,175900,0,175900,0,0,175900,A2,AG/LTD,,,
20257,5-1-0-36-B1,6823-08-6222,SNGL FAM SUB,0.679,AC,3200,0,3200,0,0,3200,3100,0,3100,0,0,3100,A1,AG/GEN,,,
20258,31-12-0-4-B,6769-66-3415,SNGL FAM SUB,5.419,AC,112600,0,112600,478500,0,591100,101100,0,101100,422100,0,523200,A2,AG/LTD,,,
20259,13-1-0-7-A,6842-61-3399,Cemetery,0.23,AC,100,0,100,0,0,100,100,0,100,0,0,100,A1,AG/GEN,,,
20260,63-30-0-C-1,7714-69-3976,Cemetery,0,AC,100,0,100,0,0,100,100,0,100,0,0,100,A2,AG/LTD,,,
20262,6-18-0-2-0,6832-07-7584,SNGL FAM SUB,3.57,AC,53300,0,53300,206200,0,259500,51900,0,51900,172300,0,224200,A1,AG/GEN,,,
20263,20-29-0-2-0,6840-26-3780,SNGL FAM SUB,3.12,AC,74300,0,74300,245500,0,319800,67500,0,67500,198300,0,265800,A1,AG/GEN,,,
20264,20-29-0-3-0,6840-26-6615,SNGL FAM SUB,3.33,AC,76200,0,76200,267400,0,343600,69200,0,69200,218200,0,287400,A1,AG/GEN,,,
20265,20-29-0-4-0,6840-26-8631,SNGL FAM SUB,3.25,AC,75500,0,75500,299300,0,374800,68600,0,68600,244500,0,313100,A1,AG/GEN,,,
20266,11-17-0-B-0,6821-38-6870,SNGL FAM SUB,18.55,AC,131500,78700,52800,559000,0,690500,126500,71400,55100,443900,0,570400,A1,AG/GEN,,,
20267,11-17-0-C-0,6821-48-2623,AG 20-100 AC,28.16,AC,167600,154000,13600,0,0,167600,169700,157700,12000,0,0,169700,A1,AG/GEN,,,
20268,12-1-0-75-C,6831-74-8882,SNGL FAM SUB,2.466,AC,51800,0,51800,328300,3300,383400,48000,0,48000,286900,4200,339100,A1,AG/GEN,,,
20269,20-30-0-1-0,6840-11-7649,SNGL FAM SUB,8.23,AC,78800,0,78800,298700,0,377500,74600,0,74600,244000,0,318600,A1,AG/GEN,,,
20270,20-30-0-2-0,6840-21-0648,SNGL FAM SUB,3,AC,69800,0,69800,247500,2500,319800,66700,0,66700,200000,0,266700,A1,AG/GEN,,,
20271,20-30-0-3-0,6840-21-2637,SNGL FAM SUB,3.58,AC,78500,0,78500,298700,0,377200,76700,0,76700,244000,0,320700,A1,AG/GEN,,,
20272,42-1-0-58-A1,6757-95-1948,Cemetery,0,AC,100,0,100,0,0,100,100,0,100,0,0,100,R3,RES/GEN,,,
20273,43-44-0-2-0,6777-00-1929,SNGL FAM SUB,3.034,AC,99400,0,99400,0,0,99400,88800,0,88800,0,0,88800,A2,AG/LTD,,,
20274,43-44-0-3-0,6767-90-9489,SNGL FAM SUB,3.755,AC,109800,0,109800,201400,0,311200,98100,0,98100,193900,0,292000,A2,AG/LTD,,,
20275,58-55-2-1-0,7726-15-7103,SNGL FAM URB,0.29,AC,130000,0,130000,524700,0,654700,125000,0,125000,494200,0,619200,RPUD,RES/PUD,,,
20276,58-55-2-2-0,7726-15-7240,SNGL FAM URB,0.27,AC,130000,0,130000,453800,0,583800,125000,0,125000,428900,0,553900,RPUD,RES/PUD,,,
20277,58-55-2-3-0,7726-15-7258,SNGL FAM URB,0.25,AC,130000,0,130000,524000,0,654000,125000,0,125000,511900,0,636900,RPUD,RES/PUD,,,
20278,58-55-2-4-0,7726-15-7357,SNGL FAM URB,0.28,AC,130000,0,130000,465700,0,595700,125000,0,125000,459600,0,584600,RPUD,RES/PUD,,,
20279,58-55-2-5-0,7726-15-7414,SNGL FAM URB,0.24,AC,130000,0,130000,530700,0,660700,125000,0,125000,517700,0,642700,RPUD,RES/PUD,,,
20280,58-55-2-6-0,7726-15-6562,SNGL FAM URB,0.29,AC,130000,0,130000,460600,0,590600,125000,0,125000,451600,0,576600,RPUD,RES/PUD,,,
20281,58-55-2-7-0,7726-15-5577,SNGL FAM URB,0.38,AC,130000,0,130000,482900,0,612900,125000,0,125000,478900,0,603900,RPUD,RES/PUD,,,
20282,58-55-2-8-0,7726-15-4572,SNGL FAM URB,0.37,AC,130000,0,130000,0,0,130000,125000,0,125000,0,0,125000,RPUD,RES/PUD,,,
20283,58-55-2-9-0,7726-15-4462,SNGL FAM URB,0.25,AC,130000,0,130000,532700,0,662700,125000,0,125000,499200,0,624200,RPUD,RES/PUD,,,
20284,58-55-2-10-0,7726-15-5314,SNGL FAM URB,0.35,AC,130000,0,130000,496600,0,626600,125000,0,125000,470400,0,595400,RPUD,RES/PUD,,,
20285,58-55-2-11-0,7726-15-5255,SNGL FAM URB,0.35,AC,130000,0,130000,478000,0,608000,125000,0,125000,456600,0,581600,RPUD,RES/PUD,,,
20286,58-55-2-12-0,7726-15-4198,SNGL FAM URB,0.27,AC,130000,0,130000,453100,0,583100,125000,0,125000,428000,0,553000,RPUD,RES/PUD,,,
20287,58-55-2-13-0,7726-15-3048,SNGL FAM URB,0.29,AC,130000,0,130000,533900,0,663900,125000,0,125000,519500,0,644500,RPUD,RES/PUD,,,
20288,58-55-2-14-0,7726-15-3146,SNGL FAM URB,0.25,AC,130000,0,130000,500100,0,630100,125000,0,125000,489500,0,614500,RPUD,RES/PUD,,,
20289,58-55-2-15-0,7726-15-3233,SNGL FAM URB,0.25,AC,130000,0,130000,421500,0,551500,125000,0,125000,420000,0,545000,RPUD,RES/PUD,,,
20290,58-55-2-16-0,7726-15-3330,SNGL FAM URB,0.25,AC,130000,0,130000,423100,0,553100,125000,0,125000,408300,0,533300,RPUD,RES/PUD,,,
20291,58-55-2-17-0,7726-15-3327,SNGL FAM URB,0.25,AC,130000,0,130000,528700,0,658700,125000,0,125000,514400,0,639400,RPUD,RES/PUD,,,
20292,58-55-2-18-0,7726-15-3423,SNGL FAM URB,0.24,AC,130000,0,130000,338200,0,468200,125000,0,125000,337900,0,462900,RPUD,RES/PUD,,,
20293,58-55-2-19-0,7726-15-3530,SNGL FAM URB,0.25,AC,130000,0,130000,0,0,130000,125000,0,125000,0,0,125000,RPUD,RES/PUD,,,
20294,58-55-2-20-0,7726-15-3537,SNGL FAM URB,0.23,AC,130000,0,130000,0,0,130000,125000,0,125000,0,0,125000,RPUD,RES/PUD,,,
20295,58-55-2-21-0,7726-15-3644,SNGL FAM URB,0.24,AC,130000,0,130000,520400,0,650400,125000,0,125000,503500,0,628500,RPUD,RES/PUD,,,
20296,58-55-2-22-0,7726-15-1740,SNGL FAM URB,0.24,AC,130000,0,130000,328900,0,458900,125000,0,125000,315100,0,440100,RPUD,RES/PUD,,,
20297,58-55-2-23-0,7726-15-1643,SNGL FAM URB,0.22,AC,130000,0,130000,311400,0,441400,125000,0,125000,291900,0,416900,RPUD,RES/PUD,,,
20298,58-55-2-24-0,7726-15-1537,SNGL FAM URB,0.22,AC,130000,0,130000,445500,0,575500,125000,0,125000,420900,0,545900,RPUD,RES/PUD,,,
20299,58-55-2-25-0,7726-15-1530,SNGL FAM URB,0.23,AC,130000,0,130000,436700,0,566700,125000,0,125000,415300,0,540300,RPUD,RES/PUD,,,
20300,58-55-2-26-0,7726-15-1423,SNGL FAM URB,0.23,AC,130000,0,130000,445400,0,575400,125000,0,125000,0,0,125000,RPUD,RES/PUD,,,
20301,58-55-2-27-0,7726-15-1326,SNGL FAM URB,0.23,AC,130000,0,130000,342100,0,472100,125000,0,125000,326500,0,451500,RPUD,RES/PUD,,,
20302,58-55-2-28-0,7726-15-1239,SNGL FAM URB,0.23,AC,130000,0,130000,294500,0,424500,125000,0,125000,287100,0,412100,RPUD,RES/PUD,,,
20303,58-55-2-29-0,7726-15-1232,SNGL FAM URB,0.23,AC,130000,0,130000,352500,0,482500,125000,0,125000,339000,0,464000,RPUD,RES/PUD,,,
20304,58-55-2-30-0,7726-15-1146,SNGL FAM URB,0.23,AC,130000,0,130000,311000,0,441000,125000,0,125000,298400,0,423400,RPUD,RES/PUD,,,
20305,58-55-2-31-0,7726-15-1058,SNGL FAM URB,0.28,AC,130000,0,130000,353800,0,483800,125000,0,125000,341800,0,466800,RPUD,RES/PUD,,,
20306,58-55-2-32-0,7726-15-0107,SNGL FAM URB,0.44,AC,130000,0,130000,591300,0,721300,125000,0,125000,549600,0,674600,RPUD,RES/PUD,,,
20307,58-55-2-33-0,7726-05-9288,SNGL FAM URB,0.27,AC,130000,0,130000,588500,0,718500,125000,0,125000,0,0,125000,RPUD,RES/PUD,,,
20308,58-55-2-34-0,7726-05-9375,SNGL FAM URB,0.27,AC,130000,0,130000,469300,0,599300,125000,0,125000,463300,0,588300,RPUD,RES/PUD,,,
20309,58-55-2-35-0,7726-05-9473,SNGL FAM URB,0.27,AC,130000,0,130000,375600,0,505600,125000,0,125000,364100,0,489100,RPUD,RES/PUD,,,
20310,58-55-2-36-0,7726-05-9580,SNGL FAM URB,0.26,AC,130000,0,130000,460500,0,590500,125000,0,125000,459300,0,584300,RPUD,RES/PUD,,,
20311,58-55-2-37-0,7726-15-0610,SNGL FAM URB,0.34,AC,130000,0,130000,402600,0,532600,125000,0,125000,400900,0,525900,RPUD,RES/PUD,,,
20312,58-55-2-38-0,7726-05-9689,SNGL FAM URB,0.39,AC,130000,0,130000,524600,0,654600,125000,0,125000,491900,0,616900,RPUD,RES/PUD,,,
20313,58-55-2-39-0,7726-05-8751,SNGL FAM URB,0.31,AC,130000,0,130000,477700,0,607700,125000,0,125000,448200,0,573200,RPUD,RES/PUD,,,
20314,58-55-2-40-0,7726-05-7686,SNGL FAM URB,0.39,AC,130000,0,130000,291000,0,421000,125000,0,125000,282100,0,407100,RPUD,RES/PUD,,,
20315,58-55-2-41-0,7726-05-7583,SNGL FAM URB,0.28,AC,130000,0,130000,462700,0,592700,125000,0,125000,440200,0,565200,RPUD,RES/PUD,,,
20316,58-55-2-42-0,7726-05-7484,SNGL FAM URB,0.23,AC,130000,0,130000,309700,0,439700,125000,0,125000,291500,0,416500,RPUD,RES/PUD,,,
20317,58-55-2-43-0,7726-05-7387,SNGL FAM URB,0.23,AC,130000,0,130000,330200,0,460200,125000,0,125000,317000,0,442000,RPUD,RES/PUD,,,
20318,58-55-2-44-0,7726-05-7289,SNGL FAM URB,0.23,AC,130000,0,130000,307900,0,437900,125000,0,125000,297700,0,422700,RPUD,RES/PUD,,,
20319,58-55-2-45-0,7726-05-7282,SNGL FAM URB,0.24,AC,130000,0,130000,382100,0,512100,125000,0,125000,360300,0,485300,RPUD,RES/PUD,,,
20320,58-55-2-46-0,7726-05-8104,SNGL FAM URB,0.25,AC,130000,0,130000,317400,0,447400,125000,0,125000,305300,0,430300,RPUD,RES/PUD,,,
20321,58-55-2-47-0,7726-05-8057,SNGL FAM URB,0.26,AC,130000,0,130000,425200,0,555200,125000,0,125000,408600,0,533600,RPUD,RES/PUD,,,
20322,58-55-2-48-0,7726-05-9011,SNGL FAM URB,0.25,AC,130000,0,130000,453100,0,583100,125000,0,125000,434800,0,559800,RPUD,RES/PUD,,,
20323,58-55-2-49-0,7726-04-9988,SNGL FAM URB,0.21,AC,130000,0,130000,458200,0,588200,125000,0,125000,431600,0,556600,RPUD,RES/PUD,,,
20324,58-55-2-50-0,7726-14-0945,SNGL FAM URB,0.21,AC,130000,0,130000,412700,0,542700,125000,0,125000,397000,0,522000,RPUD,RES/PUD,,,
20325,58-55-2-51-0,7726-14-1912,SNGL FAM URB,0.25,AC,130000,0,130000,463500,0,593500,125000,0,125000,457300,0,582300,RPUD,RES/PUD,,,
20326,58-55-2-52-0,7726-14-1889,SNGL FAM URB,0.3,AC,130000,0,130000,502900,0,632900,125000,0,125000,491300,0,616300,RPUD,RES/PUD,,,
20327,58-55-2-53-0,7726-14-2868,SNGL FAM URB,0.31,AC,130000,0,130000,532300,0,662300,125000,0,125000,518000,0,643000,RPUD,RES/PUD,,,
20328,58-55-2-54-0,7726-14-3940,SNGL FAM URB,0.28,AC,130000,0,130000,513300,0,643300,125000,0,125000,505200,0,630200,RPUD,RES/PUD,,,
20329,58-55-2-55-0,7726-14-4912,SNGL FAM URB,0.25,AC,130000,0,130000,485300,0,615300,125000,0,125000,477100,0,602100,RPUD,RES/PUD,,,
20330,58-55-2-56-0,7726-14-4986,SNGL FAM URB,0.23,AC,130000,0,130000,470300,0,600300,125000,0,125000,461600,0,586600,RPUD,RES/PUD,,,
20331,58-55-2-57-0,7726-14-5949,SNGL FAM URB,0.23,AC,130000,0,130000,393900,0,523900,125000,0,125000,374900,0,499900,RPUD,RES/PUD,,,
20332,58-55-2-58-0,7726-15-6003,SNGL FAM URB,0.24,AC,130000,0,130000,403800,0,533800,125000,0,125000,393800,0,518800,RPUD,RES/PUD,,,
20333,58-55-2-A-0,7726-04-8963,Cmn Area/Open Spc,3.3,AC,0,0,0,0,0,0,0,0,0,0,0,0,RPUD,RES/PUD,,,
20334,58-55-2-B-0,7726-25-0307,Cmn Area/Open Spc,12.5,AC,0,0,0,0,0,0,0,0,0,0,0,0,RPUD,RES/PUD,,,
20335,58-55-2-C-0,7726-15-4134,Cmn Area/Open Spc,0.22,AC,0,0,0,0,0,0,0,0,0,0,0,0,RPUD,RES/PUD,,,
20336,58-55-2-R-0,7726-15-1070,Roads,4.43,AC,0,0,0,0,0,0,0,0,0,0,0,0,RPUD,RES/PUD,,,
20337,29-11-0-3-A,6749-32-4881,Cemetery,0,AC,100,0,100,0,0,100,100,0,100,0,0,100,A1,AG/GEN,,,
20338,58-16-0-2-0,7726-05-3166,SNGL FAM SUB,0.423,AC,163800,0,163800,0,0,163800,157500,0,157500,0,0,157500,RN,RESIDEN,,,
20339,58-16-0-3-0,7726-05-2174,SNGL FAM SUB,0.407,AC,163800,0,163800,465500,0,629300,157500,0,157500,446000,0,603500,RN,RESIDEN,,,
20340,58-16-0-4-0,7726-05-1182,SNGL FAM SUB,0.413,AC,163800,0,163800,0,0,163800,157500,0,157500,0,0,157500,RN,RESIDEN,,,
20341,58-16-0-5-0,7726-05-0099,SNGL FAM SUB,0.427,AC,163800,0,163800,0,0,163800,157500,0,157500,0,0,157500,RN,RESIDEN,,,
20342,58-16-0-B-0,7726-05-3041,Cmn Area/Open Spc,0.826,AC,0,0,0,0,0,0,0,0,0,0,0,0,RN,RESIDEN,,,
20343,29-14-0-3-A,6749-41-7555,Cemetery,0,AC,100,0,100,0,0,100,100,0,100,0,0,100,A1,AG/GEN,,,
20344,19-16-0-B-0,6830-42-9307,AG 20-100 AC,51.666,AC,303000,278700,24300,0,0,303000,294500,272500,22000,0,0,294500,A1,AG/GEN,,,
20345,47-4-0-1-B,7727-34-4897,Cemetery,0,AC,100,0,100,0,0,100,100,0,100,0,0,100,A2,AG/LTD,,,
20346,58-48-8-31-A,7715-56-2783,SNGL FAM URB,0.285,,176000,0,176000,999700,0,1175700,172500,0,172500,903400,0,1075900,RPUD,RES/PUD,,,
20347,26-1-0-72-A,6719-45-6042,SNGL FAM SUB,0,AC,0,0,0,41700,0,41700,0,0,0,38400,0,38400,A1,AG/GEN,,,
20348,3-4-0-3-A,5892-99-3154,SNGL FAM SUB,0,AC,0,0,0,19800,0,19800,0,0,0,20200,0,20200,A1,AG/GEN,,,
20349,28-1-0-87-C1,6739-24-7718,SNGL FAM SUB,0,AC,0,0,0,12600,0,12600,0,0,0,11400,0,11400,A1,AG/GEN,,,
20350,21-1-0-15-D1,6850-53-5115,SNGL FAM SUB,0,AC,0,0,0,9500,0,9500,0,0,0,9000,0,9000,A2,AG/LTD,,,
20351,63-1-0-148-B,7714-79-8985,SNGL FAM SUB,0,AC,0,0,0,9100,0,9100,0,0,0,9100,0,9100,A2,AG/LTD,,,
20353,6-1-0-40-C,6832-08-6438,SNGL FAM SUB,0,AC,0,0,0,7200,0,7200,0,0,0,7000,0,7000,A1,AG/GEN,,,
20354,28-1-0-77-C1,6739-26-6933,SNGL FAM SUB,0,AC,0,0,0,8800,0,8800,0,0,0,8100,0,8100,A1,AG/GEN,,,
20358,5-15-0-2-A,6823-32-8402,SNGL FAM SUB,0,AC,0,0,0,7200,0,7200,0,0,0,6900,0,6900,A1,AG/GEN,,,
20359,26-1-0-2-D,6709-32-8536,AG 20-100 AC,0,AC,0,0,0,2700,0,2700,0,0,0,2500,0,2500,A1,AG/GEN,,,
20360,47-6-0-2-B1,7717-57-3515,AG 20-100 AC,0,AC,0,0,0,9600,0,9600,0,0,0,9400,0,9400,A2,AG/LTD,,,
20361,29-1-0-21-B1,6748-56-2549,SNGL FAM SUB,0,AC,0,0,0,900,0,900,0,0,0,900,0,900,A1,AG/GEN,,,
20362,21-16-0-1-0,6850-39-8964,SNGL FAM SUB,3.356,AC,70300,0,70300,199200,0,269500,69000,0,69000,184300,0,253300,A1,AG/GEN,,,
20363,21-16-0-3-0,6851-30-8361,SNGL FAM SUB,3.18,AC,68800,0,68800,207600,0,276400,67500,0,67500,192900,0,260400,A1,AG/GEN,,,
20364,4-15-0-1-A,6803-67-3553,AG 20-100 AC,60,AC,275000,207200,67800,540300,0,815300,269700,205500,64200,467100,0,736800,A1,AG/GEN,,,
20365,51-1-0-52-B,6736-52-1480,SNGL FAM SUB,4.105,AC,52300,0,52300,0,0,52300,51300,0,51300,0,0,51300,A1,AG/GEN,,,
20366,31-8-0-7-A,6779-51-3496,Cemetery,0,AC,100,0,100,0,0,100,100,0,100,0,0,100,A2,AG/LTD,,,
20367,63-41-0-1-A,7724-13-8454,SNGL FAM SUB,0,,112300,0,112300,323600,0,435900,110100,0,110100,323600,0,433700,R3,RES/GEN,,,
20368,63-41-0-1-B,7724-13-8472,SNGL FAM SUB,0,,84300,0,84300,326100,0,410400,82600,0,82600,326100,0,408700,R3,RES/GEN,,,
20369,63-41-0-1-C,7724-13-9309,SNGL FAM SUB,0,,112300,0,112300,323600,0,435900,110100,0,110100,323600,0,433700,R3,RES/GEN,,,
20370,4-1-0-46-E,6813-06-3207,SNGL FAM SUB,3.301,AC,51400,0,51400,0,0,51400,50500,0,50500,0,0,50500,A1,AG/GEN,,,
20371,4-1-0-46-F,6813-06-4085,SNGL FAM SUB,3.301,AC,51400,0,51400,0,0,51400,50500,0,50500,0,0,50500,A1,AG/GEN,,,
20372,58-54-1-1-0,7725-16-3466,SNGL FAM URB,0.253,AC,127100,0,127100,306800,0,433900,115000,0,115000,298400,0,413400,RPUD,RES/PUD,,,
20373,58-54-1-2-0,7725-16-4402,SNGL FAM URB,0.093,AC,105000,0,105000,276700,0,381700,95000,0,95000,268900,0,363900,RPUD,RES/PUD,,,
20374,58-54-1-3-0,7725-16-4420,SNGL FAM URB,0.102,AC,105000,0,105000,305600,0,410600,95000,0,95000,297600,0,392600,RPUD,RES/PUD,,,
20375,58-54-1-4-0,7725-16-4358,SNGL FAM URB,0.137,AC,115500,0,115500,316700,0,432200,104500,0,104500,307400,0,411900,RPUD,RES/PUD,,,
20376,58-54-1-5-0,7725-16-4385,SNGL FAM URB,0.136,AC,115500,0,115500,350000,0,465500,104500,0,104500,335400,0,439900,RPUD,RES/PUD,,,
20377,58-54-1-6-0,7725-16-5312,SNGL FAM URB,0.087,AC,105000,0,105000,281400,0,386400,95000,0,95000,273400,0,368400,RPUD,RES/PUD,,,
20378,58-54-1-7-0,7725-16-5330,SNGL FAM URB,0.136,AC,115500,0,115500,302900,0,418400,104500,0,104500,294900,0,399400,RPUD,RES/PUD,,,
20379,58-54-1-8-0,7725-16-5288,SNGL FAM URB,0.154,AC,115500,0,115500,330900,0,446400,104500,0,104500,320000,0,424500,RPUD,RES/PUD,,,
20380,58-54-1-9-0,7725-16-6217,SNGL FAM URB,0.088,AC,105000,0,105000,283300,0,388300,95000,0,95000,274500,0,369500,RPUD,RES/PUD,,,
20381,58-54-1-10-0,7725-16-6244,SNGL FAM URB,0.146,AC,115500,0,115500,298400,0,413900,104500,0,104500,291100,0,395600,RPUD,RES/PUD,,,
20382,58-54-1-11-0,7725-16-6140,SNGL FAM URB,0.157,AC,115500,0,115500,317400,0,432900,104500,0,104500,285300,0,389800,RPUD,RES/PUD,,,
20383,58-54-1-12-0,7725-16-6018,SNGL FAM URB,0.1,AC,105000,0,105000,301200,0,406200,95000,0,95000,293000,0,388000,RPUD,RES/PUD,,,
20384,58-54-1-13-0,7725-16-5086,SNGL FAM URB,0.1,AC,105000,0,105000,317400,0,422400,95000,0,95000,285300,0,380300,RPUD,RES/PUD,,,
20385,58-54-1-14-0,7725-16-5055,SNGL FAM URB,0.157,AC,115500,0,115500,337500,0,453000,104500,0,104500,324600,0,429100,RPUD,RES/PUD,,,
20386,58-54-1-15-0,7725-16-4067,SNGL FAM URB,0.132,AC,115500,0,115500,304000,0,419500,104500,0,104500,296300,0,400800,RPUD,RES/PUD,,,
20387,58-54-1-16-0,7725-16-4130,SNGL FAM URB,0.092,AC,105000,0,105000,277600,0,382600,95000,0,95000,259700,0,354700,RPUD,RES/PUD,,,
20388,58-54-1-17-0,7725-16-4113,SNGL FAM URB,0.165,AC,115500,0,115500,315700,0,431200,104500,0,104500,307100,0,411600,RPUD,RES/PUD,,,
20389,58-54-1-18-0,7725-16-3187,SNGL FAM URB,0.16,AC,115500,0,115500,310600,0,426100,104500,0,104500,299200,0,403700,RPUD,RES/PUD,,,
20390,58-54-1-19-0,7725-16-3260,SNGL FAM URB,0.107,AC,105000,0,105000,311000,0,416000,95000,0,95000,301900,0,396900,RPUD,RES/PUD,,,
20391,58-54-1-20-0,7725-16-3242,SNGL FAM URB,0.107,AC,105000,0,105000,315500,0,420500,95000,0,95000,307100,0,402100,RPUD,RES/PUD,,,
20392,58-54-1-21-0,7725-16-3224,SNGL FAM URB,0.093,AC,105000,0,105000,311000,0,416000,95000,0,95000,299900,0,394900,RPUD,RES/PUD,,,
20393,58-54-1-22-0,7725-16-2278,SNGL FAM URB,0.268,AC,127100,0,127100,345200,0,472300,115000,0,115000,332200,0,447200,RPUD,RES/PUD,,,
20394,58-54-1-23-0,7725-16-2145,SNGL FAM URB,0.3,AC,145000,0,145000,438200,0,583200,135000,0,135000,414500,0,549500,RPUD,RES/PUD,,,
20395,58-54-1-24-0,7725-16-2076,SNGL FAM URB,0.182,AC,145000,0,145000,357800,0,502800,135000,0,135000,343400,0,478400,RPUD,RES/PUD,,,
20396,58-54-1-25-0,7725-16-2091,SNGL FAM URB,0.182,AC,145000,0,145000,359500,0,504500,135000,0,135000,345400,0,480400,RPUD,RES/PUD,,,
20397,58-54-1-26-0,7725-15-2990,SNGL FAM URB,0.279,AC,145000,0,145000,0,0,145000,135000,0,135000,0,0,135000,RPUD,RES/PUD,,,
20413,58-54-1-42-0,7725-05-7094,SNGL FAM URB,0.285,AC,145000,0,145000,439100,0,584100,135000,0,135000,435100,0,570100,RPUD,RES/PUD,,,
20414,58-54-1-43-0,7725-04-8907,SNGL FAM URB,0.245,AC,145000,0,145000,457600,0,602600,135000,0,135000,441800,0,576800,RPUD,RES/PUD,,,
20415,58-54-1-44-0,7725-04-8900,SNGL FAM URB,0.255,AC,145000,0,145000,645500,0,790500,135000,0,135000,0,0,135000,RPUD,RES/PUD,,,
20416,58-54-1-45-0,7725-04-8813,SNGL FAM URB,0.277,AC,145000,0,145000,559500,0,704500,135000,0,135000,537800,0,672800,RPUD,RES/PUD,,,
20417,58-54-1-46-0,7725-04-7796,SNGL FAM URB,0.243,AC,145000,0,145000,409000,0,554000,135000,0,135000,401700,0,536700,RPUD,RES/PUD,,,
20418,58-54-1-47-0,7725-04-7780,SNGL FAM URB,0.235,AC,145000,0,145000,503500,0,648500,135000,0,135000,0,0,135000,RPUD,RES/PUD,,,
20419,58-54-1-48-0,7725-04-7664,SNGL FAM URB,0.211,AC,145000,0,145000,0,0,145000,135000,0,135000,0,0,135000,RPUD,RES/PUD,,,
20420,58-54-1-49-0,7725-04-7548,SNGL FAM URB,0.179,AC,145000,0,145000,365000,0,510000,135000,0,135000,349900,0,484900,RPUD,RES/PUD,,,
20433,58-54-1-1-RW,7725-15-3840,SNGL FAM URB,4.204,AC,18500,0,18500,0,0,18500,16800,0,16800,0,0,16800,RPUD,RES/PUD,,,
20434,29-5-0-1-F,6749-64-2988,SNGL FAM SUB,6.852,AC,107300,0,107300,0,0,107300,104900,0,104900,0,0,104900,RR,RES/RUR,,,
20435,40-7-0-1-0,6736-19-5415,SNGL FAM SUB,4.09,AC,63400,0,63400,263200,0,326600,62200,0,62200,228600,0,290800,A1,AG/GEN,,,
20436,40-7-0-2-0,6736-19-8315,SNGL FAM SUB,5.71,AC,72600,0,72600,283900,0,356500,71300,0,71300,248800,0,320100,A1,AG/GEN,,,
20437,40-7-0-4-0,6736-18-4804,SNGL FAM SUB,12.832,AC,114600,0,114600,317400,0,432000,112400,0,112400,263300,0,375700,A1,AG/GEN,,,
20438,30-1-0-25-A,6759-40-1167,Cemetery,0,AC,100,0,100,0,0,100,100,0,100,0,0,100,A2,AG/LTD,,,
20440,45-1-0-21-B,6788-90-7189,SNGL FAM SUB,2.317,AC,95700,0,95700,59900,1800,157400,85500,0,85500,49800,1800,137100,A2,AG/LTD,,,
20441,15-4-0-4-TW,5880-30-6020-9998,COMM & IND,0,AC,0,0,0,0,115200,115200,0,0,0,0,108700,108700,A1,AG/GEN,,,
20442,13-1-0-3-E1,6842-64-8973,Cemetery,0,AC,100,0,100,0,0,100,100,0,100,0,0,100,A1,AG/GEN,,,
20443,13-1-0-3-A1,6842-76-3339,Cemetery,0,AC,100,0,100,0,0,100,100,0,100,0,0,100,A1,AG/GEN,,,
20444,3-1-0-1-A1,6804-20-7010,Cemetery,0,AC,100,0,100,0,0,100,100,0,100,0,0,100,A1,AG/GEN,,,
20445,58-16-0-6-R,7726-05-2298,Roads,0.581,AC,0,0,0,0,0,0,0,0,0,0,0,0,RPUD,RES/PUD,,,
20446,20-5-0-C-2,6840-18-7395,AG 20-100 AC,0,AC,0,0,0,7700,0,7700,0,0,0,7300,0,7300,A1,AG/GEN,,,
20447,58-55-3-1-0,7726-14-2344,SNGL FAM URB,0.22,AC,130000,0,130000,468500,0,598500,125000,0,125000,0,0,125000,RPUD,RES/PUD,,,
20448,58-55-3-2-0,7726-14-2298,SNGL FAM URB,0.22,AC,130000,0,130000,458800,0,588800,125000,0,125000,439500,0,564500,RPUD,RES/PUD,,,
20449,58-55-3-3-0,7726-14-3232,SNGL FAM URB,0.22,AC,130000,0,130000,433100,0,563100,125000,0,125000,0,0,125000,RPUD,RES/PUD,,,
20450,58-55-3-4-0,7726-14-3177,SNGL FAM URB,0.22,AC,130000,0,130000,527800,0,657800,125000,0,125000,0,0,125000,RPUD,RES/PUD,,,
20451,58-55-3-5-0,7726-14-6127,SNGL FAM URB,0.24,AC,130000,0,130000,385800,0,515800,125000,0,125000,367600,0,492600,RPUD,RES/PUD,,,
20452,58-55-3-6-0,7726-14-6275,SNGL FAM URB,0.22,AC,130000,0,130000,0,0,130000,125000,0,125000,0,0,125000,RPUD,RES/PUD,,,
20453,58-55-3-7-0,7726-14-7331,SNGL FAM URB,0.28,AC,130000,0,130000,0,0,130000,125000,0,125000,0,0,125000,RPUD,RES/PUD,,,
20454,58-55-3-8-0,7726-14-8301,SNGL FAM URB,0.23,AC,130000,0,130000,466100,0,596100,125000,0,125000,0,0,125000,RPUD,RES/PUD,,,
20455,58-55-3-9-0,7726-14-8372,SNGL FAM URB,0.23,AC,130000,0,130000,0,0,130000,125000,0,125000,0,0,125000,RPUD,RES/PUD,,,
20456,58-55-3-10-0,7726-14-9333,SNGL FAM URB,0.22,AC,130000,0,130000,377800,0,507800,125000,0,125000,348800,0,473800,RPUD,RES/PUD,,,
20457,58-55-3-11-0,7726-24-0304,SNGL FAM URB,0.23,AC,130000,0,130000,0,0,130000,125000,0,125000,0,0,125000,RPUD,RES/PUD,,,
20458,58-55-3-12-0,7726-24-0365,SNGL FAM URB,0.22,AC,130000,0,130000,509300,0,639300,125000,0,125000,0,0,125000,RPUD,RES/PUD,,,
20459,58-55-3-13-0,7726-24-1336,SNGL FAM URB,0.23,AC,130000,0,130000,380400,0,510400,125000,0,125000,362300,0,487300,RPUD,RES/PUD,,,
20460,58-55-3-14-0,7726-24-2307,SNGL FAM URB,0.22,AC,130000,0,130000,0,0,130000,125000,0,125000,0,0,125000,RPUD,RES/PUD,,,
20461,58-55-3-15-0,7726-24-3363,SNGL FAM URB,0.2,AC,130000,0,130000,516400,0,646400,125000,0,125000,509100,0,634100,RPUD,RES/PUD,,,
20462,58-55-3-16-0,7726-24-3267,SNGL FAM URB,0.2,AC,130000,0,130000,523600,0,653600,125000,0,125000,471500,0,596500,RPUD,RES/PUD,,,
20463,58-55-3-17-0,7726-24-3270,SNGL FAM URB,0.2,AC,130000,0,130000,524800,0,654800,125000,0,125000,507100,0,632100,RPUD,RES/PUD,,,
20464,58-55-3-18-0,7726-24-3184,SNGL FAM URB,0.2,AC,130000,0,130000,499400,0,629400,125000,0,125000,490900,0,615900,RPUD,RES/PUD,,,
20465,58-55-3-19-0,7726-24-3097,SNGL FAM URB,0.21,AC,130000,0,130000,543000,0,673000,125000,0,125000,505400,0,630400,RPUD,RES/PUD,,,
20466,58-55-3-20-0,7726-24-4001,SNGL FAM URB,0.21,AC,130000,0,130000,419700,0,549700,125000,0,125000,389500,0,514500,RPUD,RES/PUD,,,
20467,58-55-3-21-0,7726-24-5036,SNGL FAM URB,0.25,AC,130000,0,130000,507200,0,637200,125000,0,125000,485800,0,610800,RPUD,RES/PUD,,,
20468,58-55-3-22-0,7726-24-6009,SNGL FAM URB,0.22,AC,130000,0,130000,463200,0,593200,125000,0,125000,445800,0,570800,RPUD,RES/PUD,,,
20469,58-55-3-23-0,7726-24-6161,SNGL FAM URB,0.22,AC,130000,0,130000,0,0,130000,125000,0,125000,0,0,125000,RPUD,RES/PUD,,,
20470,58-55-3-24-0,7726-24-7124,SNGL FAM URB,0.2,AC,130000,0,130000,539900,0,669900,125000,0,125000,506700,0,631700,RPUD,RES/PUD,,,
20471,58-55-3-25-0,7726-24-8107,SNGL FAM URB,0.3,AC,130000,0,130000,452800,0,582800,125000,0,125000,409600,0,534600,RPUD,RES/PUD,,,
20472,58-55-3-26-0,7726-24-8183,SNGL FAM URB,0.35,AC,130000,0,130000,486400,0,616400,125000,0,125000,458500,0,583500,RPUD,RES/PUD,,,
20473,58-55-3-27-0,7726-24-9005,SNGL FAM URB,0.28,AC,130000,0,130000,558200,0,688200,125000,0,125000,0,0,125000,RPUD,RES/PUD,,,
20474,58-55-3-28-0,7726-23-8985,SNGL FAM URB,0.36,AC,130000,0,130000,0,0,130000,125000,0,125000,0,0,125000,RPUD,RES/PUD,,,
20475,58-55-3-29-0,7726-23-8901,SNGL FAM URB,0.28,AC,130000,0,130000,446600,0,576600,125000,0,125000,422100,0,547100,RPUD,RES/PUD,,,
20476,58-55-3-30-0,7726-23-7921,SNGL FAM URB,0.24,AC,130000,0,130000,502300,0,632300,125000,0,125000,0,0,125000,RPUD,RES/PUD,,,
20477,58-55-3-31-0,7726-23-6960,SNGL FAM URB,0.24,AC,130000,0,130000,435600,0,565600,125000,0,125000,409300,0,534300,RPUD,RES/PUD,,,
20478,58-55-3-32-0,7726-23-5898,SNGL FAM URB,0.21,AC,130000,0,130000,0,0,130000,125000,0,125000,0,0,125000,RPUD,RES/PUD,,,
20479,58-55-3-33-0,7726-23-5827,SNGL FAM URB,0.2,AC,130000,0,130000,369400,0,499400,125000,0,125000,355700,0,480700,RPUD,RES/PUD,,,
20480,58-55-3-34-0,7726-23-4866,SNGL FAM URB,0.2,AC,130000,0,130000,440500,0,570500,125000,0,125000,0,0,125000,RPUD,RES/PUD,,,
20481,58-55-3-35-0,7726-23-3895,SNGL FAM URB,0.21,AC,130000,0,130000,0,0,130000,125000,0,125000,0,0,125000,RPUD,RES/PUD,,,
20482,58-55-3-36-0,7726-23-2873,SNGL FAM URB,0.22,AC,130000,0,130000,474000,0,604000,125000,0,125000,450600,0,575600,RPUD,RES/PUD,,,
20483,58-55-3-37-0,7726-23-2802,SNGL FAM URB,0.21,AC,130000,0,130000,493700,0,623700,125000,0,125000,463800,0,588800,RPUD,RES/PUD,,,
20484,58-55-3-38-0,7726-23-2802,SNGL FAM URB,0.21,AC,130000,0,130000,523000,0,653000,125000,0,125000,490500,0,615500,RPUD,RES/PUD,,,
20485,58-55-3-39-0,7726-23-0870,SNGL FAM URB,0.21,AC,130000,0,130000,490700,0,620700,125000,0,125000,486900,0,611900,RPUD,RES/PUD,,,
20486,58-55-3-40-0,7726-23-0800,SNGL FAM URB,0.21,AC,130000,0,130000,463700,0,593700,125000,0,125000,439200,0,564200,RPUD,RES/PUD,,,
20487,58-55-3-41-0,7726-13-9749,SNGL FAM URB,0.2,AC,130000,0,130000,396400,0,526400,125000,0,125000,374100,0,499100,RPUD,RES/PUD,,,
20488,58-55-3-42-0,7726-13-8778,SNGL FAM URB,0.21,AC,130000,0,130000,573800,0,703800,125000,0,125000,543100,0,668100,RPUD,RES/PUD,,,
20489,58-55-3-43-0,7726-13-8717,SNGL FAM URB,0.21,AC,130000,0,130000,427500,0,557500,125000,0,125000,405400,0,530400,RPUD,RES/PUD,,,
20490,58-55-3-44-0,7726-13-7746,SNGL FAM URB,0.2,AC,130000,0,130000,455500,0,585500,125000,0,125000,437000,0,562000,RPUD,RES/PUD,,,
20491,58-55-3-45-0,7726-13-6785,SNGL FAM URB,0.21,AC,130000,0,130000,506700,0,636700,125000,0,125000,486300,0,611300,RPUD,RES/PUD,,,
20492,58-55-3-46-0,7726-13-5794,SNGL FAM URB,0.41,AC,130000,0,130000,489100,0,619100,125000,0,125000,457400,0,582400,RPUD,RES/PUD,,,
20493,58-55-3-47-0,7726-13-8946,SNGL FAM URB,0.25,AC,130000,0,130000,0,0,130000,125000,0,125000,0,0,125000,RPUD,RES/PUD,,,
20494,58-55-3-48-0,7726-13-9917,SNGL FAM URB,0.22,AC,130000,0,130000,359400,0,489400,125000,0,125000,335700,0,460700,RPUD,RES/PUD,,,
20495,58-55-3-49-0,7726-13-9988,SNGL FAM URB,0.22,AC,130000,0,130000,0,0,130000,125000,0,125000,0,0,125000,RPUD,RES/PUD,,,
20496,58-55-3-50-0,7726-23-0959,SNGL FAM URB,0.22,AC,130000,0,130000,0,0,130000,125000,0,125000,0,0,125000,RPUD,RES/PUD,,,
20497,58-55-3-51-0,7726-24-1010,SNGL FAM URB,0.22,AC,130000,0,130000,0,0,130000,125000,0,125000,0,0,125000,RPUD,RES/PUD,,,
20498,58-55-3-52-0,7726-24-1081,SNGL FAM URB,0.22,AC,130000,0,130000,391700,0,521700,125000,0,125000,363200,0,488200,RPUD,RES/PUD,,,
20499,58-55-3-53-0,7726-24-2052,SNGL FAM URB,0.24,AC,130000,0,130000,0,0,130000,125000,0,125000,0,0,125000,RPUD,RES/PUD,,,
20500,58-55-3-54-0,7726-24-2127,SNGL FAM URB,0.25,AC,130000,0,130000,0,0,130000,125000,0,125000,0,0,125000,RPUD,RES/PUD,,,
20501,58-55-3-55-0,7726-24-1166,SNGL FAM URB,0.23,AC,130000,0,130000,564600,0,694600,125000,0,125000,526700,0,651700,RPUD,RES/PUD,,,
20502,58-55-3-56-0,7726-24-0195,SNGL FAM URB,0.24,AC,130000,0,130000,414400,0,544400,125000,0,125000,0,0,125000,RPUD,RES/PUD,,,
20503,58-55-3-57-0,7726-24-0124,SNGL FAM URB,0.23,AC,130000,0,130000,500200,0,630200,125000,0,125000,0,0,125000,RPUD,RES/PUD,,,
20504,58-55-3-58-0,7726-14-9163,SNGL FAM URB,0.24,AC,130000,0,130000,468500,0,598500,125000,0,125000,445300,0,570300,RPUD,RES/PUD,,,
20505,58-55-3-59-0,7726-14-8192,SNGL FAM URB,0.24,AC,130000,0,130000,0,0,130000,125000,0,125000,0,0,125000,RPUD,RES/PUD,,,
20506,58-55-3-60-0,7726-14-8122,SNGL FAM URB,0.28,AC,130000,0,130000,0,0,130000,125000,0,125000,0,0,125000,RPUD,RES/PUD,,,
20507,58-55-3-61-0,7726-14-7068,SNGL FAM URB,0.21,AC,130000,0,130000,0,0,130000,125000,0,125000,0,0,125000,RPUD,RES/PUD,,,
20508,58-55-3-62-0,7726-14-7014,SNGL FAM URB,0.2,AC,130000,0,130000,355300,0,485300,125000,0,125000,332000,0,457000,RPUD,RES/PUD,,,
20509,58-55-3-63-0,7726-13-6959,SNGL FAM URB,0.24,AC,130000,0,130000,446900,0,576900,125000,0,125000,426900,0,551900,RPUD,RES/PUD,,,
20510,58-55-3-64-0,7726-13-5805,SNGL FAM URB,0.27,AC,130000,0,130000,552400,0,682400,125000,0,125000,518100,0,643100,RPUD,RES/PUD,,,
20511,58-55-3-65-0,7726-13-4861,SNGL FAM URB,0.25,AC,130000,0,130000,410800,0,540800,125000,0,125000,389900,0,514900,RPUD,RES/PUD,,,
20512,58-55-3-66-0,7726-13-4716,SNGL FAM URB,0.24,AC,130000,0,130000,448200,0,578200,125000,0,125000,429300,0,554300,RPUD,RES/PUD,,,
20513,58-55-3-67-0,7726-13-3760,SNGL FAM URB,0.26,AC,130000,0,130000,396500,0,526500,125000,0,125000,374200,0,499200,RPUD,RES/PUD,,,
20514,58-55-3-68-0,7726-13-2699,SNGL FAM URB,0.21,AC,130000,0,130000,0,0,130000,125000,0,125000,0,0,125000,RPUD,RES/PUD,,,
20515,58-55-3-69-0,7726-13-2638,SNGL FAM URB,0.2,AC,130000,0,130000,0,0,130000,125000,0,125000,0,0,125000,RPUD,RES/PUD,,,
20516,58-55-3-70-0,7726-13-1677,SNGL FAM URB,0.2,AC,130000,0,130000,459400,0,589400,125000,0,125000,0,0,125000,RPUD,RES/PUD,,,
20517,58-55-3-71-0,7726-13-0694,SNGL FAM URB,0.22,AC,130000,0,130000,0,0,130000,125000,0,125000,0,0,125000,RPUD,RES/PUD,,,
20518,58-55-3-72-0,7726-13-0605,SNGL FAM URB,0.32,AC,130000,0,130000,526300,0,656300,125000,0,125000,0,0,125000,RPUD,RES/PUD,,,
20519,58-55-3-73-0,7726-03-9784,SNGL FAM URB,0.27,AC,130000,0,130000,0,0,130000,125000,0,125000,0,0,125000,RPUD,RES/PUD,,,
20520,58-55-3-74-0,7726-03-9884,SNGL FAM URB,0.34,AC,130000,0,130000,0,0,130000,125000,0,125000,0,0,125000,RPUD,RES/PUD,,,
20521,58-55-3-75-0,7726-13-0877,SNGL FAM URB,0.24,AC,130000,0,130000,467700,0,597700,125000,0,125000,0,0,125000,RPUD,RES/PUD,,,
20522,58-55-3-76-0,7726-13-1847,SNGL FAM URB,0.27,AC,130000,0,130000,0,0,130000,125000,0,125000,0,0,125000,RPUD,RES/PUD,,,
20523,58-55-3-77-0,7726-13-2827,SNGL FAM URB,0.27,AC,130000,0,130000,0,0,130000,125000,0,125000,0,0,125000,RPUD,RES/PUD,,,
20524,58-55-3-78-0,7726-13-2981,SNGL FAM URB,0.24,AC,130000,0,130000,447600,0,577600,125000,0,125000,420300,0,545300,RPUD,RES/PUD,,,
20525,58-55-3-79-0,7726-13-3926,SNGL FAM URB,0.22,AC,130000,0,130000,458700,0,588700,125000,0,125000,0,0,125000,RPUD,RES/PUD,,,
20526,58-55-3-80-0,7726-14-3071,SNGL FAM URB,0.21,AC,130000,0,130000,0,0,130000,125000,0,125000,0,0,125000,RPUD,RES/PUD,,,
20527,58-55-3-81-0,7726-14-4065,SNGL FAM URB,0.24,AC,130000,0,130000,0,0,130000,125000,0,125000,0,0,125000,RPUD,RES/PUD,,,
20528,58-55-3-82-0,7726-14-4121,SNGL FAM URB,0.23,AC,130000,0,130000,0,0,130000,125000,0,125000,0,0,125000,RPUD,RES/PUD,,,
20529,58-55-3-A-0,7726-24-0458,Cmn Area/Open Spc,0.7,AC,0,0,0,0,0,0,0,0,0,0,0,0,RPUD,RES/PUD,,,
20530,58-55-3-B-0,7726-24-3357,Cmn Area/Open Spc,0.06,AC,0,0,0,0,0,0,0,0,0,0,0,0,RPUD,RES/PUD,,,
20531,58-55-3-C-0,7726-24-4086,Cmn Area/Open Spc,0.1,AC,0,0,0,0,0,0,0,0,0,0,0,0,RPUD,RES/PUD,,,
20532,58-55-3-D-0,7726-23-8874,Cmn Area/Open Spc,4.34,AC,0,0,0,0,0,0,0,0,0,0,0,0,RPUD,RES/PUD,,,
20533,58-55-3-E-0,7726-13-1578,Cmn Area/Open Spc,3.48,AC,0,0,0,0,0,0,0,0,0,0,0,0,RPUD,RES/PUD,,,
20534,58-55-3-F-0,7726-13-7933,Cmn Area/Open Spc,0.74,AC,0,0,0,0,0,0,0,0,0,0,0,0,RPUD,RES/PUD,,,
20535,58-55-3-R-0,7726-13-2799,Roads,3.5,AC,0,0,0,0,0,0,0,0,0,0,0,0,RPUD,RES/PUD,,,
20536,48-17-4-2-0,7738-01-6469,SNGL FAM URB,0.21,AC,130000,0,130000,420300,0,550300,125000,0,125000,389800,0,514800,RPUD,RES/PUD,,,
20537,48-17-4-3-0,7738-01-7413,SNGL FAM URB,0.21,AC,130000,0,130000,362500,0,492500,125000,0,125000,337700,0,462700,RPUD,RES/PUD,,,
20538,48-17-4-4-0,7738-01-7358,SNGL FAM URB,0.21,AC,130000,0,130000,272600,0,402600,125000,0,125000,259100,0,384100,RPUD,RES/PUD,,,
20539,48-17-4-5-0,7738-01-7392,SNGL FAM URB,0.22,AC,130000,0,130000,463800,0,593800,125000,0,125000,428400,0,553400,RPUD,RES/PUD,,,
20540,48-17-4-6-0,7738-01-8246,SNGL FAM URB,0.24,AC,130000,0,130000,301800,0,431800,125000,0,125000,286800,0,411800,RPUD,RES/PUD,,,
20541,48-17-4-7-0,7738-01-9201,SNGL FAM URB,0.23,AC,130000,0,130000,345600,0,475600,125000,0,125000,324900,0,449900,RPUD,RES/PUD,,,
20542,48-17-4-8-0,7738-01-9157,SNGL FAM URB,0.23,AC,130000,0,130000,356400,0,486400,125000,0,125000,339800,0,464800,RPUD,RES/PUD,,,
20543,48-17-4-9-0,7738-11-0113,SNGL FAM URB,0.23,AC,130000,0,130000,478400,0,608400,125000,0,125000,444700,0,569700,RPUD,RES/PUD,,,
20544,48-17-4-10-0,7738-11-0079,SNGL FAM URB,0.22,AC,130000,0,130000,318200,0,448200,125000,0,125000,303300,0,428300,RPUD,RES/PUD,,,
20545,48-17-4-11-0,7738-11-1035,SNGL FAM URB,0.25,AC,130000,0,130000,465000,0,595000,125000,0,125000,432400,0,557400,RPUD,RES/PUD,,,
20546,48-17-4-12-0,7738-10-1985,SNGL FAM URB,0.23,AC,130000,0,130000,562700,0,692700,125000,0,125000,525700,0,650700,RPUD,RES/PUD,,,
20547,48-17-4-13-0,7738-11-2030,SNGL FAM URB,0.22,AC,130000,0,130000,0,0,130000,125000,0,125000,0,0,125000,RPUD,RES/PUD,,,
20548,48-17-4-14-0,7738-11-2084,SNGL FAM URB,0.22,AC,130000,0,130000,430600,0,560600,125000,0,125000,399100,0,524100,RPUD,RES/PUD,,,
20549,48-17-4-15-0,7738-10-5916,SNGL FAM URB,0.25,AC,130000,0,130000,360500,0,490500,125000,0,125000,335500,0,460500,RPUD,RES/PUD,,,
20550,48-17-4-16-0,7738-10-4954,SNGL FAM URB,0.24,AC,130000,0,130000,436200,0,566200,125000,0,125000,408100,0,533100,RPUD,RES/PUD,,,
20551,48-17-4-17-0,7738-10-3856,SNGL FAM URB,0.27,AC,130000,0,130000,456000,0,586000,125000,0,125000,420600,0,545600,RPUD,RES/PUD,,,
20552,48-17-4-18-0,7738-10-3800,SNGL FAM URB,0.23,AC,130000,0,130000,508900,0,638900,125000,0,125000,467300,0,592300,RPUD,RES/PUD,,,
20553,48-17-4-19-0,7738-10-2756,SNGL FAM URB,0.24,AC,130000,0,130000,345900,0,475900,125000,0,125000,326000,0,451000,RPUD,RES/PUD,,,
20554,48-17-4-20-0,7738-10-2710,SNGL FAM URB,0.23,AC,130000,0,130000,371000,0,501000,125000,0,125000,350400,0,475400,RPUD,RES/PUD,,,
20555,48-17-4-21-0,7738-10-1674,SNGL FAM URB,0.23,AC,130000,0,130000,441600,0,571600,125000,0,125000,408200,0,533200,RPUD,RES/PUD,,,
20556,48-17-4-22-0,7738-10-2572,SNGL FAM URB,0.22,AC,130000,0,130000,385700,0,515700,125000,0,125000,375600,0,500600,RPUD,RES/PUD,,,
20557,48-17-4-23-0,7738-10-3527,SNGL FAM URB,0.23,AC,130000,0,130000,491900,0,621900,125000,0,125000,0,0,125000,RPUD,RES/PUD,,,
20558,48-17-4-24-0,7738-10-3681,SNGL FAM URB,0.23,AC,130000,0,130000,383800,0,513800,125000,0,125000,353900,0,478900,RPUD,RES/PUD,,,
20559,48-17-4-25-0,7738-10-4645,SNGL FAM URB,0.23,AC,130000,0,130000,483900,0,613900,125000,0,125000,0,0,125000,RPUD,RES/PUD,,,
20560,48-17-4-26-0,7738-10-5608,SNGL FAM URB,0.23,AC,130000,0,130000,426800,0,556800,125000,0,125000,407300,0,532300,RPUD,RES/PUD,,,
20561,48-17-4-27-0,7738-10-5752,SNGL FAM URB,0.24,AC,130000,0,130000,420000,0,550000,125000,0,125000,405100,0,530100,RPUD,RES/PUD,,,
20562,48-17-4-28-0,7738-10-6726,SNGL FAM URB,0.27,AC,130000,0,130000,431700,0,561700,125000,0,125000,419100,0,544100,RPUD,RES/PUD,,,
20563,48-17-4-29-0,7738-10-6873,SNGL FAM URB,0.27,AC,130000,0,130000,511600,0,641600,125000,0,125000,478600,0,603600,RPUD,RES/PUD,,,
20564,48-17-4-30-0,7738-10-6556,SNGL FAM URB,0.23,AC,130000,0,130000,388900,0,518900,125000,0,125000,360300,0,485300,RPUD,RES/PUD,,,
20565,48-17-4-31-0,7738-10-5592,SNGL FAM URB,0.22,AC,130000,0,130000,455700,0,585700,125000,0,125000,416900,0,541900,RPUD,RES/PUD,,,
20566,48-17-4-32-0,7738-10-5438,SNGL FAM URB,0.22,AC,130000,0,130000,317600,0,447600,125000,0,125000,295700,0,420700,RPUD,RES/PUD,,,
20567,48-17-4-33-0,7738-10-4464,SNGL FAM URB,0.23,AC,130000,0,130000,340800,0,470800,125000,0,125000,326100,0,451100,RPUD,RES/PUD,,,
20568,48-17-4-34-0,7738-10-3270,SNGL FAM URB,0.3,AC,130000,0,130000,524400,0,654400,125000,0,125000,482300,0,607300,RPUD,RES/PUD,,,
20569,48-17-4-35-0,7738-10-3224,SNGL FAM URB,0.28,AC,130000,0,130000,417500,0,547500,125000,0,125000,388000,0,513000,RPUD,RES/PUD,,,
20570,48-17-4-36-0,7738-10-2269,SNGL FAM URB,0.25,AC,130000,0,130000,458500,0,588500,125000,0,125000,445800,0,570800,RPUD,RES/PUD,,,
20571,48-17-4-37-0,7738-10-2313,SNGL FAM URB,0.23,AC,130000,0,130000,428000,0,558000,125000,0,125000,396800,0,521800,RPUD,RES/PUD,,,
20572,48-17-4-38-0,7738-10-1357,SNGL FAM URB,0.22,AC,130000,0,130000,280600,0,410600,125000,0,125000,267600,0,392600,RPUD,RES/PUD,,,
20573,48-17-4-39-0,7738-10-0491,SNGL FAM URB,0.22,AC,130000,0,130000,400900,0,530900,125000,0,125000,375400,0,500400,RPUD,RES/PUD,,,
20574,48-17-4-40-0,7738-10-0434,SNGL FAM URB,0.22,AC,130000,0,130000,311500,0,441500,125000,0,125000,292500,0,417500,RPUD,RES/PUD,,,
20575,48-17-4-41-0,7738-00-9478,SNGL FAM URB,0.23,AC,130000,0,130000,374200,0,504200,125000,0,125000,359300,0,484300,RPUD,RES/PUD,,,
20576,48-17-4-42-0,7738-00-9510,SNGL FAM URB,0.24,AC,130000,0,130000,416900,0,546900,125000,0,125000,410300,0,535300,RPUD,RES/PUD,,,
20577,48-17-4-43-0,7738-00-8543,SNGL FAM URB,0.26,AC,130000,0,130000,428600,0,558600,125000,0,125000,413800,0,538800,RPUD,RES/PUD,,,
20578,48-17-4-44-0,7738-00-7586,SNGL FAM URB,0.28,AC,130000,0,130000,415100,0,545100,125000,0,125000,408500,0,533500,RPUD,RES/PUD,,,
20579,48-17-4-45-0,7738-00-7620,SNGL FAM URB,0.26,AC,130000,0,130000,384200,0,514200,125000,0,125000,360900,0,485900,RPUD,RES/PUD,,,
20580,48-17-4-46-0,7738-00-8775,SNGL FAM URB,0.26,AC,130000,0,130000,355500,0,485500,125000,0,125000,331500,0,456500,RPUD,RES/PUD,,,
20581,48-17-4-47-0,7738-00-9666,SNGL FAM URB,0.23,AC,130000,0,130000,382800,0,512800,125000,0,125000,361400,0,486400,RPUD,RES/PUD,,,
20582,48-17-4-48-0,7738-10-0703,SNGL FAM URB,0.23,AC,130000,0,130000,526000,0,656000,125000,0,125000,483400,0,608400,RPUD,RES/PUD,,,
20583,48-17-4-49-0,7738-10-0748,SNGL FAM URB,0.21,AC,130000,0,130000,351800,0,481800,125000,0,125000,325400,0,450400,RPUD,RES/PUD,,,
20584,48-17-4-50-0,7738-10-0895,SNGL FAM URB,0.27,AC,130000,0,130000,479700,0,609700,125000,0,125000,441400,0,566400,RPUD,RES/PUD,,,
20585,48-17-4-51-0,7738-10-0900,SNGL FAM URB,0.24,AC,130000,0,130000,285900,0,415900,125000,0,125000,270400,0,395400,RPUD,RES/PUD,,,
20586,48-17-4-52-0,7738-00-9954,SNGL FAM URB,0.23,AC,130000,0,130000,433900,19100,583000,125000,0,125000,404200,17900,547100,RPUD,RES/PUD,,,
20587,48-17-4-53-0,7738-00-8998,SNGL FAM URB,0.22,AC,130000,0,130000,337900,0,467900,125000,0,125000,321300,0,446300,RPUD,RES/PUD,,,
20588,48-17-4-54-0,7738-01-8032,SNGL FAM URB,0.22,AC,130000,0,130000,341700,0,471700,125000,0,125000,321800,0,446800,RPUD,RES/PUD,,,
20589,48-17-4-55-0,7738-01-7077,SNGL FAM URB,0.25,AC,130000,0,130000,468700,0,598700,125000,0,125000,437500,0,562500,RPUD,RES/PUD,,,
20590,48-17-4-56-0,7738-01-7122,SNGL FAM URB,0.26,AC,130000,0,130000,375100,5400,510500,125000,0,125000,352400,0,477400,RPUD,RES/PUD,,,
20591,48-17-4-57-0,7738-01-6178,SNGL FAM URB,0.22,AC,130000,0,130000,310600,0,440600,125000,0,125000,295200,0,420200,RPUD,RES/PUD,,,
20592,48-17-4-58-0,7738-01-6233,SNGL FAM URB,0.22,AC,130000,0,130000,364200,0,494200,125000,0,125000,339300,0,464300,RPUD,RES/PUD,,,
20593,48-17-4-59-0,7738-01-5299,SNGL FAM URB,0.22,AC,130000,0,130000,510300,0,640300,125000,0,125000,484400,0,609400,RPUD,RES/PUD,,,
20594,48-17-4-60-0,7738-01-5345,SNGL FAM URB,0.22,AC,130000,0,130000,399100,0,529100,125000,0,125000,373000,0,498000,RPUD,RES/PUD,,,
20595,48-17-4-61-0,7738-01-5400,SNGL FAM URB,0.22,AC,130000,0,130000,360500,0,490500,125000,0,125000,343100,0,468100,RPUD,RES/PUD,,,
20596,48-17-4-62-0,7738-01-4456,SNGL FAM URB,0.27,AC,130000,0,130000,414600,0,544600,125000,0,125000,388900,0,513900,RPUD,RES/PUD,,,
20597,48-17-4-A-0,7738-01-3783,Cmn Area/Open Spc,1.98,,0,0,0,0,0,0,0,0,0,0,0,0,RPUD,RES/PUD,,,
20598,48-17-4-B-0,7738-11-0255,Cmn Area/Open Spc,2.26,,0,0,0,0,0,0,0,0,0,0,0,0,RPUD,RES/PUD,,,
20599,48-17-4-C-0,7738-10-4871,Cmn Area/Open Spc,1.34,,0,0,0,0,0,0,0,0,0,0,0,0,RPUD,RES/PUD,,,
20600,48-17-4-D-0,7738-10-6671,Cmn Area/Open Spc,0.03,,0,0,0,0,0,0,0,0,0,0,0,0,RPUD,RES/PUD,,,
20601,48-17-4-E-0,7738-10-6450,Cmn Area/Open Spc,0.93,,0,0,0,0,0,0,0,0,0,0,0,0,RPUD,RES/PUD,,,
20602,48-17-4-F-0,7738-10-0306,Cmn Area/Open Spc,1.78,,0,0,0,0,0,0,0,0,0,0,0,0,RPUD,RES/PUD,,,
20603,48-17-4-G-0,7738-01-6047,Cmn Area/Open Spc,1.49,,0,0,0,0,0,0,0,0,0,0,0,0,RPUD,RES/PUD,,,
20604,48-17-4-R-0,7738-00-9578,Roads,4.21,,0,0,0,0,0,0,0,0,0,0,0,0,RPUD,RES/PUD,,,
20605,44-29-0-3-0,6777-61-9808,SNGL FAM SUB,8.013,AC,162700,0,162700,0,0,162700,145400,0,145400,0,0,145400,A2,AG/LTD,,,
20606,44-29-0-4-A,6777-71-1002,Cemetery,0.049,AC,100,0,100,0,0,100,100,0,100,0,0,100,A2,AG/LTD,,,
20607,29-1-0-117-D,6748-99-7940,Cemetery,0,AC,100,0,100,0,0,100,100,0,100,0,0,100,A1,AG/GEN,,,
20608,17-1-0-74-B,6810-00-7559,SNGL FAM SUB,2.144,AC,46900,0,46900,255600,0,302500,44300,0,44300,215300,0,259600,A1,AG/GEN,,,
20609,21-17-0-2-0,6759-18-2890,SNGL FAM SUB,4,AC,82200,0,82200,321900,3100,407200,78100,0,78100,272900,0,351000,A2,AG/LTD,,,
20610,21-17-0-3-0,6759-09-9131,SNGL FAM SUB,3.856,AC,81000,0,81000,321900,15000,417900,76700,0,76700,272900,0,349600,A2,AG/LTD,,,
20611,58-54-4-3-0,7725-06-8015,SNGL FAM URB,0.096,AC,105000,0,105000,363300,0,468300,95000,0,95000,347500,0,442500,RPUD,RES/PUD,,,
20612,58-54-4-4-0,7725-06-8018,SNGL FAM URB,0.096,AC,105000,0,105000,330600,0,435600,95000,0,95000,319600,0,414600,RPUD,RES/PUD,,,
20613,58-54-4-5-0,7725-06-8112,SNGL FAM URB,0.096,AC,105000,0,105000,357400,0,462400,95000,0,95000,342100,0,437100,RPUD,RES/PUD,,,
20614,58-54-4-6-0,7725-06-8116,SNGL FAM URB,0.14,AC,115500,0,115500,396500,0,512000,95000,0,95000,375900,0,470900,RPUD,RES/PUD,,,
20615,58-54-4-7-0,7725-06-8210,SNGL FAM URB,0.14,AC,115500,0,115500,330700,0,446200,95000,0,95000,319600,0,414600,RPUD,RES/PUD,,,
20616,58-54-4-8-0,7725-06-8214,SNGL FAM URB,0.096,AC,105000,0,105000,342900,0,447900,95000,0,95000,330000,0,425000,RPUD,RES/PUD,,,
20617,58-54-4-9-0,7725-06-8217,SNGL FAM URB,0.096,AC,105000,0,105000,404400,0,509400,95000,0,95000,383200,0,478200,RPUD,RES/PUD,,,
20618,58-54-4-10-0,7725-06-8311,SNGL FAM URB,0.096,AC,105000,0,105000,342900,0,447900,95000,0,95000,330000,0,425000,RPUD,RES/PUD,,,
20619,58-54-4-11-0,7725-06-8315,SNGL FAM URB,0.14,AC,115500,0,115500,393700,0,509200,95000,0,95000,374200,0,469200,RPUD,RES/PUD,,,
20620,58-54-4-12-0,7725-06-8410,SNGL FAM URB,0.177,AC,115500,0,115500,318500,0,434000,95000,0,95000,309200,0,404200,RPUD,RES/PUD,,,
20621,58-54-4-13-0,7725-06-8424,SNGL FAM URB,0.096,AC,105000,0,105000,317400,0,422400,95000,0,95000,308600,0,403600,RPUD,RES/PUD,,,
20622,58-54-4-14-0,7725-06-8428,SNGL FAM URB,0.097,AC,105000,0,105000,312700,0,417700,95000,0,95000,304200,0,399200,RPUD,RES/PUD,,,
20623,58-54-4-15-0,7725-06-8531,SNGL FAM URB,0.147,AC,115500,0,115500,372700,0,488200,95000,0,95000,356500,0,451500,RPUD,RES/PUD,,,
20624,58-54-4-16-0,7725-06-8546,SNGL FAM URB,0.155,AC,115500,0,115500,305700,0,421200,95000,0,95000,298100,0,393100,RPUD,RES/PUD,,,
20625,58-54-4-17-0,7725-06-8650,SNGL FAM URB,0.113,AC,105000,0,105000,339100,0,444100,95000,0,95000,326800,0,421800,RPUD,RES/PUD,,,
20626,58-54-4-18-0,7725-06-8664,SNGL FAM URB,0.167,AC,115500,0,115500,336900,0,452400,95000,0,95000,325700,0,420700,RPUD,RES/PUD,,,
20627,58-54-4-19-0,7725-06-9394,SNGL FAM URB,0.141,AC,115500,0,115500,352300,0,467800,95000,0,95000,338400,0,433400,RPUD,RES/PUD,,,
20628,58-54-4-20-0,7725-06-9390,SNGL FAM URB,0.097,AC,105000,0,105000,314300,0,419300,95000,0,95000,305000,0,400000,RPUD,RES/PUD,,,
20629,58-54-4-21-0,7725-06-9297,SNGL FAM URB,0.097,AC,105000,0,105000,322200,0,427200,95000,0,95000,301100,0,396100,RPUD,RES/PUD,,,
20630,58-54-4-22-0,7725-06-9294,SNGL FAM URB,0.098,AC,105000,0,105000,312700,0,417700,95000,0,95000,304200,0,399200,RPUD,RES/PUD,,,
20631,58-54-4-23-0,7725-06-9290,SNGL FAM URB,0.144,AC,115500,0,115500,337800,0,453300,95000,0,95000,325600,0,420600,RPUD,RES/PUD,,,
20632,58-54-4-24-0,7725-06-9195,SNGL FAM URB,0.145,AC,115500,0,115500,342000,0,457500,95000,0,95000,329200,0,424200,RPUD,RES/PUD,,,
20633,58-54-4-25-0,7725-06-9191,SNGL FAM URB,0.099,AC,105000,0,105000,332600,0,437600,95000,0,95000,320900,0,415900,RPUD,RES/PUD,,,
20634,58-54-4-26-0,7725-06-9098,SNGL FAM URB,0.1,AC,105000,0,105000,365300,0,470300,95000,0,95000,349500,0,444500,RPUD,RES/PUD,,,
20635,58-54-4-27-0,7725-06-9095,SNGL FAM URB,0.1,AC,105000,0,105000,325600,0,430600,95000,0,95000,314900,0,409900,RPUD,RES/PUD,,,
20636,58-54-4-28-0,7725-06-9091,SNGL FAM URB,0.148,AC,115500,0,115500,354600,0,470100,95000,0,95000,340200,0,435200,RPUD,RES/PUD,,,
20637,58-54-4-29-0,7725-05-9996,SNGL FAM URB,0.149,AC,115500,0,115500,407900,0,523400,95000,0,95000,386700,0,481700,RPUD,RES/PUD,,,
20638,58-54-4-30-0,7725-05-9992,SNGL FAM URB,0.102,AC,105000,0,105000,339300,0,444300,95000,0,95000,326700,0,421700,RPUD,RES/PUD,,,
20639,58-54-4-31-0,7725-05-9899,SNGL FAM URB,0.102,AC,105000,0,105000,350000,0,455000,95000,0,95000,336800,0,431800,RPUD,RES/PUD,,,
20640,58-54-4-32-0,7725-05-9896,SNGL FAM URB,0.103,AC,105000,0,105000,389600,0,494600,95000,0,95000,370200,0,465200,RPUD,RES/PUD,,,
20641,58-54-4-33-0,7725-05-9892,SNGL FAM URB,0.152,AC,115500,0,115500,410000,0,525500,95000,0,95000,388100,0,483100,RPUD,RES/PUD,,,
20642,58-54-4-34-0,7725-05-9797,SNGL FAM URB,0.154,AC,115500,0,115500,0,0,115500,95000,0,95000,0,0,95000,RPUD,RES/PUD,,,
20643,58-54-4-35-0,7725-05-9793,SNGL FAM URB,0.105,AC,105000,0,105000,0,0,105000,95000,0,95000,0,0,95000,RPUD,RES/PUD,,,
20644,58-54-4-36-0,7725-05-9790,SNGL FAM URB,0.106,AC,105000,0,105000,0,0,105000,95000,0,95000,0,0,95000,RPUD,RES/PUD,,,
20645,58-54-4-37-0,7725-05-9697,SNGL FAM URB,0.106,AC,105000,0,105000,0,0,105000,95000,0,95000,0,0,95000,RPUD,RES/PUD,,,
20646,58-54-4-38-0,7725-05-9693,SNGL FAM URB,0.157,AC,115500,0,115500,0,0,115500,95000,0,95000,0,0,95000,RPUD,RES/PUD,,,
20647,58-54-4-39-0,7725-05-8453,SNGL FAM URB,0.154,AC,115500,0,115500,0,0,115500,95000,0,95000,0,0,95000,RPUD,RES/PUD,,,
20648,58-54-4-40-0,7725-05-8436,SNGL FAM URB,0.102,AC,105000,0,105000,0,0,105000,95000,0,95000,0,0,95000,RPUD,RES/PUD,,,
20649,58-54-4-41-0,7725-05-7591,SNGL FAM URB,0.246,AC,127100,0,127100,0,0,127100,95000,0,95000,0,0,95000,RPUD,RES/PUD,,,
20650,58-54-4-42-0,7725-05-8507,SNGL FAM URB,0.145,AC,115500,0,115500,0,0,115500,95000,0,95000,0,0,95000,RPUD,RES/PUD,,,
20651,58-54-4-43-0,7725-05-8601,SNGL FAM URB,0.096,AC,105000,0,105000,0,0,105000,95000,0,95000,0,0,95000,RPUD,RES/PUD,,,
20652,58-54-4-44-0,7725-05-8604,SNGL FAM URB,0.096,AC,105000,0,105000,0,0,105000,95000,0,95000,0,0,95000,RPUD,RES/PUD,,,
20653,58-54-4-45-0,7725-05-8607,SNGL FAM URB,0.096,AC,105000,0,105000,0,0,105000,95000,0,95000,0,0,95000,RPUD,RES/PUD,,,
20654,58-54-4-46-0,7725-05-8700,SNGL FAM URB,0.096,AC,105000,0,105000,0,0,105000,95000,0,95000,0,0,95000,RPUD,RES/PUD,,,
20655,58-54-4-47-0,7725-05-8704,SNGL FAM URB,0.14,AC,115500,0,115500,0,0,115500,95000,0,95000,0,0,95000,RPUD,RES/PUD,,,
20656,58-54-4-48-0,7725-05-8709,SNGL FAM URB,0.14,AC,115500,0,115500,0,0,115500,95000,0,95000,0,0,95000,RPUD,RES/PUD,,,
20657,58-54-4-49-0,7725-05-8803,SNGL FAM URB,0.096,AC,105000,0,105000,0,0,105000,95000,0,95000,0,0,95000,RPUD,RES/PUD,,,
20658,58-54-4-50-0,7725-05-8806,SNGL FAM URB,0.096,AC,105000,0,105000,0,0,105000,95000,0,95000,0,0,95000,RPUD,RES/PUD,,,
20659,58-54-4-51-0,7725-05-8809,SNGL FAM URB,0.096,AC,105000,0,105000,0,0,105000,95000,0,95000,0,0,95000,RPUD,RES/PUD,,,
20660,58-54-4-52-0,7725-05-8903,SNGL FAM URB,0.14,AC,115500,0,115500,0,0,115500,95000,0,95000,0,0,95000,RPUD,RES/PUD,,,
20661,58-54-4-2-0,7725-06-8002,SNGL FAM URB,0.096,AC,105000,0,105000,367800,0,472800,95000,0,95000,351000,0,446000,RPUD,RES/PUD,,,
20662,28-10-0-2-0,6738-46-5202,SNGL FAM SUB,3,AC,63200,0,63200,0,0,63200,63000,0,63000,0,0,63000,A1,AG/GEN,,,
20663,28-10-0-3-0,6738-46-8871,SNGL FAM SUB,9.56,AC,98800,0,98800,14700,0,113500,98100,0,98100,12300,0,110400,A1,AG/GEN,,,
20664,27-16-0-1-0,6728-19-5885,AG 20-100 AC,20.3,AC,137200,0,137200,0,0,137200,134500,0,134500,0,0,134500,A1,AG/GEN,,,
20665,27-16-0-2-0,6728-19-3292,SNGL FAM SUB,3.29,AC,52800,0,52800,0,0,52800,51700,0,51700,0,0,51700,A1,AG/GEN,,,
20666,27-16-0-3-0,6728-19-7168,SNGL FAM SUB,4.24,AC,56900,0,56900,0,0,56900,55800,0,55800,0,0,55800,A1,AG/GEN,,,
20667,27-16-0-4-0,6728-29-0070,SNGL FAM SUB,3.02,AC,51100,0,51100,286500,0,337600,50100,0,50100,251400,0,301500,A1,AG/GEN,,,
20668,27-16-0-6-0,6728-28-6892,SNGL FAM SUB,3,AC,51000,0,51000,285000,0,336000,50000,0,50000,249800,0,299800,A1,AG/GEN,,,
20669,21-15-2-1-0,6850-31-5279,SNGL FAM SUB,1.5,AC,90000,0,90000,345600,0,435600,90000,0,90000,313900,0,403900,R1,RES/LTD,,,
20670,21-15-2-2-0,6850-31-3365,SNGL FAM SUB,1.62,AC,90000,0,90000,347300,0,437300,90000,0,90000,315200,0,405200,R1,RES/LTD,,,
20671,21-15-2-3-0,6850-31-1486,SNGL FAM SUB,1.61,AC,90000,0,90000,350600,0,440600,90000,0,90000,319300,0,409300,R1,RES/LTD,,,
20672,21-15-2-4-0,6850-31-0528,SNGL FAM SUB,1.66,AC,90000,0,90000,378000,0,468000,90000,0,90000,345100,0,435100,R1,RES/LTD,,,
20673,21-15-2-5-0,6850-21-8645,SNGL FAM SUB,1.75,AC,90000,0,90000,346300,0,436300,90000,0,90000,314700,0,404700,R1,RES/LTD,,,
20674,21-15-2-6-0,6850-21-6608,SNGL FAM SUB,1.5,AC,90000,0,90000,0,0,90000,90000,0,90000,0,0,90000,R1,RES/LTD,,,
20675,21-15-2-7-0,6850-21-4851,SNGL FAM SUB,1.61,AC,90000,0,90000,351200,0,441200,90000,0,90000,318500,0,408500,R1,RES/LTD,,,
20676,21-15-2-8-0,6850-22-5070,SNGL FAM SUB,1.5,AC,90000,0,90000,0,0,90000,90000,0,90000,0,0,90000,R1,RES/LTD,,,
20677,21-15-2-9-0,6850-21-9919,SNGL FAM SUB,1.96,AC,90000,0,90000,345600,0,435600,90000,0,90000,313900,0,403900,R1,RES/LTD,,,
20678,21-15-2-10-0,6850-32-0212,SNGL FAM SUB,2,AC,90000,0,90000,0,0,90000,90000,0,90000,0,0,90000,R1,RES/LTD,,,
20679,21-15-2-11-0,6850-32-3156,SNGL FAM SUB,2.02,AC,90000,0,90000,338200,0,428200,90000,0,90000,0,0,90000,R1,RES/LTD,,,
20680,21-15-2-12-0,6850-31-2858,SNGL FAM SUB,1.52,AC,90000,0,90000,0,0,90000,90000,0,90000,0,0,90000,R1,RES/LTD,,,
20681,21-15-2-13-0,6850-31-4725,SNGL FAM SUB,1.56,AC,90000,0,90000,0,0,90000,90000,0,90000,0,0,90000,R1,RES/LTD,,,
20682,21-15-2-14-0,6850-31-6614,SNGL FAM SUB,1.51,AC,90000,0,90000,0,0,90000,90000,0,90000,0,0,90000,R1,RES/LTD,,,
20683,21-15-2-15-0,6850-31-8525,SNGL FAM SUB,1.51,AC,90000,0,90000,0,0,90000,90000,0,90000,0,0,90000,R1,RES/LTD,,,
20684,21-15-2-16-0,6850-41-1658,SNGL FAM SUB,1.56,AC,90000,0,90000,0,0,90000,90000,0,90000,0,0,90000,R1,RES/LTD,,,
20685,21-15-2-17-0,6850-31-9872,SNGL FAM SUB,1.51,AC,90000,0,90000,289600,0,379600,90000,0,90000,0,0,90000,R1,RES/LTD,,,
20686,21-15-2-18-0,6850-31-7848,SNGL FAM SUB,1.54,AC,90000,0,90000,0,0,90000,90000,0,90000,0,0,90000,R1,RES/LTD,,,
20687,21-15-2-19-0,6850-32-5075,SNGL FAM SUB,1.51,AC,90000,0,90000,0,0,90000,90000,0,90000,0,0,90000,R1,RES/LTD,,,
20688,21-15-2-20-0,6850-32-7272,SNGL FAM SUB,2.03,AC,90000,0,90000,0,0,90000,90000,0,90000,0,0,90000,R1,RES/LTD,,,
20689,21-15-2-21-0,6850-42-0194,SNGL FAM SUB,2.03,AC,90000,0,90000,0,0,90000,90000,0,90000,0,0,90000,R1,RES/LTD,,,
20690,21-15-2-22-0,6850-41-3907,SNGL FAM SUB,1.5,AC,90000,0,90000,0,0,90000,90000,0,90000,0,0,90000,R1,RES/LTD,,,
20691,21-15-2-23-0,6850-42-5103,SNGL FAM SUB,2,AC,90000,0,90000,0,0,90000,90000,0,90000,0,0,90000,R1,RES/LTD,,,
20692,21-15-2-24-0,6850-42-7094,SNGL FAM SUB,2.06,AC,90000,0,90000,0,0,90000,90000,0,90000,0,0,90000,R1,RES/LTD,,,
20698,21-15-2-A-0,6850-42-1397,Cmn Area/Open Spc,9.26,AC,0,0,0,0,0,0,0,0,0,0,0,0,R1,RES/LTD,,,
20699,21-15-2-B-0,6850-22-7392,Cmn Area/Open Spc,3.49,AC,0,0,0,0,0,0,0,0,0,0,0,0,R1,RES/LTD,,,
20700,28-23-0-1-0,6728-87-7171,SNGL FAM SUB,3.153,AC,51900,0,51900,251400,0,303300,50900,0,50900,209800,0,260700,A1,AG/GEN,,,
20701,28-23-0-2-0,6728-86-9932,SNGL FAM SUB,2.479,AC,47800,0,47800,255400,0,303200,46900,0,46900,212600,0,259500,A1,AG/GEN,,,
20702,28-23-0-3-0,6728-86-7609,SNGL FAM SUB,3.017,AC,51100,0,51100,0,0,51100,50100,0,50100,0,0,50100,A1,AG/GEN,,,
20703,4-1-0-28-C,6803-75-8355,Cemetery,0,AC,100,0,100,0,0,100,100,0,100,0,0,100,A1,AG/GEN,,,
20704,42-1-0-116-C,6767-00-8503,Cemetery,0,AC,100,0,100,0,0,100,100,0,100,0,0,100,A2R3,AGRIC.R,,,
20705,27-17-0-A-0,6729-17-6490,SNGL FAM SUB,4.41,AC,60100,0,60100,0,0,60100,56800,0,56800,0,0,56800,A1,AG/GEN,,,
20706,27-17-0-B-0,6729-17-6204,SNGL FAM SUB,4.41,AC,60100,0,60100,0,0,60100,56800,0,56800,0,0,56800,A1,AG/GEN,,,
20707,27-17-0-C-0,6729-17-5057,SNGL FAM SUB,4.41,AC,60100,0,60100,0,0,60100,56800,0,56800,0,0,56800,A1,AG/GEN,,,
20708,4-1-0-28-D,6803-85-1038,SNGL FAM SUB,6.001,AC,65200,0,65200,201600,1400,268200,64000,0,64000,179600,1000,244600,A1,AG/GEN,,,
20709,63-10-0-1-0,7715-50-9547,SNGL FAM SUB,3.168,AC,152600,0,152600,389000,27600,569200,132700,0,132700,344900,24500,502100,A2,AG/LTD,,,
20710,63-10-0-2-0,7715-60-3629,SNGL FAM SUB,2.368,AC,136300,0,136300,335800,0,472100,118500,0,118500,0,0,118500,A2,AG/LTD,,,
20711,58-54-1-1-M,7725-15-2275,Cmn Area/Open Spc,14.772,AC,0,0,0,0,0,0,0,0,0,0,0,0,RPUD,RES/PUD,,,
20712,55-1-0-61-B,6786-64-8549,Cemetery,0,AC,100,0,100,0,0,100,100,0,100,0,0,100,A2,AG/LTD,,,
20713,55-1-0-76-D,6786-70-0806,Cemetery,0,AC,100,0,100,0,0,100,100,0,100,0,0,100,A2,AG/LTD,,,
20714,56-1-0-11-B,6795-09-7882,Cemetery,0,AC,100,0,100,0,0,100,100,0,100,0,0,100,A2,AG/LTD,,,
20715,44-1-0-61-B,6786-38-6113,Cemetery,0.02,AC,100,0,100,0,0,100,100,0,100,0,0,100,A2,AG/LTD,,,
20716,40-9-0-A-0,6737-64-1800,AG 20-100 AC,67.769,AC,263500,232300,31200,0,0,263500,257600,228800,28800,0,0,257600,A1,AG/GEN,,,
20717,40-9-0-D-0,6737-74-1542,SNGL FAM SUB,6.444,AC,79500,0,79500,160000,600,240100,77900,0,77900,137000,600,215500,A1,AG/GEN,,,
20718,40-9-0-B-0,6737-73-1409,SNGL FAM SUB,10.126,AC,100100,46500,53600,316600,33600,450300,98200,46300,51900,268700,31700,398600,A1,AG/GEN,,,
20719,40-9-0-C-0,6737-73-5646,SNGL FAM SUB,13.369,AC,118300,111800,6500,0,0,118300,116000,110300,5700,0,0,116000,A1,AG/GEN,,,
20720,67-10-0-7-A,7733-06-5735,SNGL FAM SUB,2.2,AC,323000,0,323000,683200,26800,1033000,270800,0,270800,559200,27000,857000,R1,RES/LTD,,,
20721,16-9-0-1-0,5890-34-5582,SNGL FAM SUB,3.03,AC,46100,0,46100,235800,0,281900,45100,0,45100,208900,0,254000,A1,AG/GEN,,,
20722,16-9-0-2-0,5890-34-7670,SNGL FAM SUB,3.11,AC,46400,0,46400,235800,0,282200,45400,0,45400,208900,0,254300,A1,AG/GEN,,,
20723,16-9-0-3-0,5890-34-8784,SNGL FAM SUB,3.29,AC,47000,0,47000,231400,0,278400,46000,0,46000,207800,0,253800,A1,AG/GEN,,,
20724,16-9-0-4-0,5890-34-9899,SNGL FAM SUB,3.01,AC,46000,0,46000,283900,0,329900,45000,0,45000,258100,0,303100,A1,AG/GEN,,,
20725,9-15-0-1-0,5892-73-5996,SNGL FAM SUB,3.711,AC,48600,0,48600,0,0,48600,47500,0,47500,0,0,47500,A1,AG/GEN,,,
20726,9-15-0-2-0,5892-74-5323,SNGL FAM SUB,2.402,AC,43800,0,43800,200000,0,243800,42900,0,42900,0,0,42900,A1,AG/GEN,,,
20727,9-15-0-3-0,5892-74-5629,SNGL FAM SUB,2.68,AC,44800,0,44800,149800,0,194600,43900,0,43900,0,0,43900,A1,AG/GEN,,,
20728,33-11-0-1-0,6798-45-3007,SNGL FAM SUB,2.66,AC,99600,0,99600,0,0,99600,88900,0,88900,0,0,88900,R1,RES/LTD,,,
20729,33-11-0-2-0,6798-45-6135,SNGL FAM SUB,1.5,AC,83600,0,83600,0,0,83600,74700,0,74700,0,0,74700,R1,RES/LTD,,,
20872,42-41-1-30-0,6757-95-5307,SNGL FAM URB,0.459,AC,120000,0,120000,0,0,120000,,,,,,,R3,RES/GEN,,,
20873,42-41-1-31-0,6757-95-3375,SNGL FAM URB,0.46,AC,120000,0,120000,0,0,120000,,,,,,,R3,RES/GEN,,,
20874,42-41-1-32-0,6757-95-4596,SNGL FAM URB,0.481,AC,120000,0,120000,0,0,120000,,,,,,,R3,RES/GEN,,,
20875,42-41-1-33-0,6757-95-6630,SNGL FAM URB,0.466,AC,120000,0,120000,0,0,120000,,,,,,,R3,RES/GEN,,,
20876,42-41-1-34-0,6757-95-7642,SNGL FAM URB,0.459,AC,120000,0,120000,0,0,120000,,,,,,,R3,RES/GEN,,,
20877,42-41-1-35-0,6757-95-8710,SNGL FAM URB,0.568,AC,120100,0,120100,0,0,120100,,,,,,,R3,RES/GEN,,,
20878,42-41-1-1-A,6757-95-5238,Cmn Area/Open Spc,7.361,AC,0,0,0,0,0,0,,,,,,,R3,RES/GEN,,,
20879,42-41-1-2-A,6757-96-8704,Cmn Area/Open Spc,1.179,AC,0,0,0,0,0,0,,,,,,,R3,RES/GEN,,,
20880,42-41-1-3-A,6757-96-4998,Cmn Area/Open Spc,0.368,AC,0,0,0,0,0,0,,,,,,,R3,RES/GEN,,,
20881,42-41-1-4-A,6757-95-1999,Cmn Area/Open Spc,0.16,AC,0,0,0,0,0,0,,,,,,,R3,RES/GEN,,,
20882,42-41-1-R-0,6757-95-5428,Roads,3.925,AC,0,0,0,0,0,0,,,,,,,R3,RES/GEN,,,
20883,42-41-1-P-0,6757-95-2328,General Gov,0.283,AC,30000,0,30000,0,0,30000,,,,,,,R3,RES/GEN,,,
20730,33-11-0-3-0,6798-45-8156,SNGL FAM SUB,1.5,AC,83600,0,83600,476000,0,559600,74700,0,74700,455400,0,530100,R1,RES/LTD,,,
20731,33-11-0-4-0,6798-55-0250,SNGL FAM SUB,1.5,AC,83600,0,83600,504100,0,587700,74700,0,74700,482900,0,557600,R1,RES/LTD,,,
20732,33-11-0-5-0,6798-55-2264,SNGL FAM SUB,1.86,AC,88600,0,88600,0,0,88600,79100,0,79100,0,0,79100,R1,RES/LTD,,,
20733,33-11-0-6-0,6798-54-1883,SNGL FAM SUB,1.504,AC,83700,0,83700,0,0,83700,74700,0,74700,0,0,74700,R1,RES/LTD,,,
20734,33-11-0-7-0,6798-44-9799,SNGL FAM SUB,1.504,AC,83700,0,83700,0,0,83700,74700,0,74700,0,0,74700,R1,RES/LTD,,,
20735,33-11-0-8-0,6798-44-8727,SNGL FAM SUB,1.513,AC,83800,0,83800,463700,0,547500,74800,0,74800,457900,0,532700,R1,RES/LTD,,,
20736,33-11-0-9-0,6798-44-6756,SNGL FAM SUB,1.88,AC,88800,0,88800,0,0,88800,79300,0,79300,0,0,79300,R1,RES/LTD,,,
20737,33-11-0-A-0,6798-35-7032,Cmn Area/Open Spc,3.717,AC,0,0,0,0,0,0,0,0,0,0,0,0,R1,RES/LTD,,,
20738,33-11-0-B-0,6798-54-0591,Cmn Area/Open Spc,1.543,AC,0,0,0,0,0,0,0,0,0,0,0,0,R1,RES/LTD,,,
20739,33-11-0-R-0,6798-44-7592,Roads,1.701,AC,0,0,0,0,0,0,0,0,0,0,0,0,R1,RES/LTD,,,
20740,64-1-0-50-F,7734-02-2390,COMM & IND,0.1719,AC,39500,0,39500,71500,0,111000,36600,0,36600,70400,0,107000,B1,BUS/GEN,,,
20741,47-39-0-1-0,7717-92-0902,AG 20-100 AC,25.211,AC,2495900,0,2495900,0,0,2495900,2228700,0,2228700,0,0,2228700,RPUD,RES/PUD,,,
20744,46-1-0-101-TW,7707-98-8002-9998,TAXED -SCC,0,AC,0,0,0,0,0,0,0,0,0,0,0,0,A2RR,AG& RUR,,,
20745,43-45-0-1-0,6778-40-5696,SNGL FAM SUB,4.515,AC,120700,0,120700,0,0,120700,107900,0,107900,0,0,107900,A2,AG/LTD,,,
20746,43-45-0-2-0,6778-50-0906,SNGL FAM SUB,2.566,AC,82000,0,82000,0,0,82000,73200,0,73200,0,0,73200,A2,AG/LTD,,,
20747,43-45-0-3-0,6778-50-0552,SNGL FAM SUB,3.383,AC,91300,0,91300,249700,0,341000,81500,0,81500,209000,0,290500,A2,AG/LTD,,,
20748,43-45-0-4-0,6778-40-6393,SNGL FAM SUB,4.276,AC,117300,0,117300,240900,0,358200,104900,0,104900,189000,0,293900,A2,AG/LTD,,,
20749,58-54-4-1-0,7725-05-8908,SNGL FAM URB,0.14,AC,115500,0,115500,397700,0,513200,95000,0,95000,377900,0,472900,RPUD,RES/PUD,,,
20750,58-54-4-1-A,7725-05-7901,Cmn Area/Open Spc,6.278,AC,0,0,0,0,0,0,0,0,0,0,0,0,RPUD,RES/PUD,,,
20751,58-54-4-1-RW,7725-06-9686,Roads,2.13,AC,0,0,0,0,0,0,0,0,0,0,0,0,RPUD,RES/PUD,,,
20752,40-8-0-D-1,6726-97-7273,SNGL FAM SUB,6,AC,76900,0,76900,0,0,76900,75500,0,75500,0,0,75500,A1,AG/GEN,,,
20753,40-8-0-D-2,6736-06-3942,SNGL FAM SUB,11.841,AC,93800,0,93800,560200,64100,718100,91800,0,91800,0,0,91800,A1,AG/GEN,,,
20754,40-8-0-D-3,6726-96-8771,SNGL FAM SUB,6,AC,76900,0,76900,0,0,76900,75500,0,75500,0,0,75500,A1,AG/GEN,,,
20755,40-8-0-D-4,6736-06-0270,SNGL FAM SUB,10.75,AC,88800,0,88800,0,0,88800,86900,0,86900,0,0,86900,A1,AG/GEN,,,
20756,20-1-0-26-TW,6749-09-8669-9998,AG 20-100 AC,0,AC,0,0,0,0,152800,152800,0,0,0,0,146300,146300,A1,AG/GEN,,,
20757,43-1-0-69-TW,6778-30-9431-9998,AG 20-100 AC,0,AC,0,0,0,0,152800,152800,0,0,0,0,146300,146300,A2,AG/LTD,,,
20758,20-31-0-4-0,6759-18-0342,SNGL FAM SUB,6,AC,91000,0,91000,0,0,91000,86400,0,86400,0,0,86400,RR,RES/RUR,,,
20759,20-31-0-5-0,6759-08-8726,SNGL FAM SUB,5.327,AC,85500,0,85500,0,0,85500,80800,0,80800,0,0,80800,RR,RES/RUR,,,
20760,58-54-4-1-B,7725-05-9586,Cmn Area/Open Spc,0.303,AC,0,0,0,0,0,0,0,0,0,0,0,0,RPUD,RES/PUD,,,
20761,47-40-1-1-0,7717-61-5342,SNGL FAM URB,0.59,AC,196400,0,196400,0,0,196400,78000,0,78000,0,0,78000,RPUD,RES/PUD,,,
20762,47-40-1-2-0,7717-61-5492,SNGL FAM URB,0.6,AC,196400,0,196400,0,0,196400,78000,0,78000,0,0,78000,RPUD,RES/PUD,,,
20763,47-40-1-3-0,7717-61-6580,SNGL FAM URB,0.6,AC,196400,0,196400,0,0,196400,78000,0,78000,0,0,78000,RPUD,RES/PUD,,,
20764,47-40-1-4-0,7717-61-7584,SNGL FAM URB,0.53,AC,196400,0,196400,0,0,196400,78000,0,78000,0,0,78000,RPUD,RES/PUD,,,
20765,47-40-1-5-0,7717-61-9543,SNGL FAM URB,0.63,AC,196400,0,196400,0,0,196400,78000,0,78000,0,0,78000,RPUD,RES/PUD,,,
20766,47-40-1-6-0,7717-61-9694,SNGL FAM URB,0.9,AC,196400,0,196400,0,0,196400,78000,0,78000,0,0,78000,RPUD,RES/PUD,,,
20767,47-40-1-7-0,7717-61-9796,SNGL FAM URB,0.55,AC,196400,0,196400,0,0,196400,78000,0,78000,0,0,78000,RPUD,RES/PUD,,,
20768,47-40-1-8-0,7717-71-0815,SNGL FAM URB,0.51,AC,196400,0,196400,0,0,196400,78000,0,78000,0,0,78000,RPUD,RES/PUD,,,
20769,47-40-1-9-0,7717-71-0924,SNGL FAM URB,0.48,AC,187000,0,187000,0,0,187000,78000,0,78000,0,0,78000,RPUD,RES/PUD,,,
20770,47-40-1-10-0,7717-72-0053,SNGL FAM URB,0.48,AC,187000,0,187000,0,0,187000,78000,0,78000,0,0,78000,RPUD,RES/PUD,,,
20771,47-40-1-11-0,7717-72-0181,SNGL FAM URB,0.51,AC,187000,0,187000,0,0,187000,78000,0,78000,0,0,78000,RPUD,RES/PUD,,,
20772,47-40-1-12-0,7717-72-1202,SNGL FAM URB,0.71,AC,196400,0,196400,0,0,196400,78000,0,78000,0,0,78000,RPUD,RES/PUD,,,
20773,47-40-1-13-0,7717-72-1382,SNGL FAM URB,0.36,AC,187000,0,187000,0,0,187000,78000,0,78000,0,0,78000,RPUD,RES/PUD,,,
20774,47-40-1-14-0,7717-72-2402,SNGL FAM URB,0.35,AC,187000,0,187000,0,0,187000,78000,0,78000,0,0,78000,RPUD,RES/PUD,,,
20775,47-40-1-15-0,7717-72-2532,SNGL FAM URB,0.38,AC,187000,0,187000,0,0,187000,78000,0,78000,0,0,78000,RPUD,RES/PUD,,,
20776,47-40-1-16-0,7717-72-2671,SNGL FAM URB,0.45,AC,187000,0,187000,0,0,187000,78000,0,78000,0,0,78000,RPUD,RES/PUD,,,
20777,47-40-1-17-0,7717-72-0574,SNGL FAM URB,0.62,AC,196400,0,196400,0,0,196400,78000,0,78000,0,0,78000,RPUD,RES/PUD,,,
20778,47-40-1-18-0,7717-62-9582,SNGL FAM URB,0.54,AC,196400,0,196400,0,0,196400,78000,0,78000,0,0,78000,RPUD,RES/PUD,,,
20779,47-40-1-19-0,7717-62-8565,SNGL FAM URB,0.46,AC,187000,0,187000,0,0,187000,78000,0,78000,0,0,78000,RPUD,RES/PUD,,,
20780,47-40-1-20-0,7717-62-6789,SNGL FAM URB,0.62,AC,196400,0,196400,0,0,196400,78000,0,78000,0,0,78000,RPUD,RES/PUD,,,
20781,10-1-0-33-B,6812-56-7555,Cemetery,0,AC,100,0,100,0,0,100,100,0,100,0,0,100,A1,AG/GEN,,,
20782,47-40-1-21-0,7717-62-7799,SNGL FAM URB,0.53,AC,196400,0,196400,0,0,196400,78000,0,78000,0,0,78000,RPUD,RES/PUD,,,
20783,47-40-1-22-0,7717-62-8799,SNGL FAM URB,0.46,AC,187000,0,187000,0,0,187000,78000,0,78000,0,0,78000,RPUD,RES/PUD,,,
20784,47-40-1-23-0,7717-72-0718,SNGL FAM URB,0.35,AC,187000,0,187000,0,0,187000,78000,0,78000,0,0,78000,RPUD,RES/PUD,,,
20785,47-40-1-24-0,7717-72-1800,SNGL FAM URB,0.35,AC,187000,0,187000,0,0,187000,78000,0,78000,0,0,78000,RPUD,RES/PUD,,,
20786,47-40-1-25-0,7717-72-2801,SNGL FAM URB,0.42,AC,187000,0,187000,0,0,187000,78000,0,78000,0,0,78000,RPUD,RES/PUD,,,
20787,47-40-1-26-0,7717-72-3801,SNGL FAM URB,0.44,AC,187000,0,187000,0,0,187000,78000,0,78000,0,0,78000,RPUD,RES/PUD,,,
20788,47-40-1-27-0,7717-72-4810,SNGL FAM URB,0.53,AC,196400,0,196400,0,0,196400,78000,0,78000,0,0,78000,RPUD,RES/PUD,,,
20789,47-40-1-28-0,7717-72-5703,SNGL FAM URB,0.52,AC,206200,0,206200,0,0,206200,78000,0,78000,0,0,78000,RPUD,RES/PUD,,,
20790,47-40-1-29-0,7717-72-5696,SNGL FAM URB,0.45,AC,196400,0,196400,0,0,196400,78000,0,78000,0,0,78000,RPUD,RES/PUD,,,
20791,47-40-1-30-0,7717-72-6557,SNGL FAM URB,0.39,AC,187000,0,187000,0,0,187000,78000,0,78000,0,0,78000,RPUD,RES/PUD,,,
20792,47-40-1-31-0,7717-72-6487,SNGL FAM URB,0.35,AC,187000,0,187000,0,0,187000,78000,0,78000,0,0,78000,RPUD,RES/PUD,,,
20793,47-40-1-32-0,7717-72-8509,SNGL FAM URB,0.41,AC,196400,0,196400,0,0,196400,78000,0,78000,0,0,78000,RPUD,RES/PUD,,,
20794,47-40-1-33-0,7717-72-9622,SNGL FAM URB,0.52,AC,202200,0,202200,0,0,202200,78000,0,78000,0,0,78000,RPUD,RES/PUD,,,
20795,47-40-1-34-0,7717-82-0541,SNGL FAM URB,0.75,AC,196400,0,196400,0,0,196400,78000,0,78000,0,0,78000,RPUD,RES/PUD,,,
20796,47-40-1-35-0,7717-82-0315,SNGL FAM URB,0.67,AC,196400,0,196400,0,0,196400,78000,0,78000,0,0,78000,RPUD,RES/PUD,,,
20797,47-40-1-36-0,7717-72-8373,SNGL FAM URB,0.34,AC,187000,0,187000,0,0,187000,78000,0,78000,0,0,78000,RPUD,RES/PUD,,,
20798,47-40-1-37-0,7717-72-7391,SNGL FAM URB,0.35,AC,187000,0,187000,0,0,187000,78000,0,78000,0,0,78000,RPUD,RES/PUD,,,
20799,47-40-1-38-0,7717-72-7218,SNGL FAM URB,0.36,AC,187000,0,187000,0,0,187000,78000,0,78000,0,0,78000,RPUD,RES/PUD,,,
20800,47-40-1-39-0,7717-72-5275,SNGL FAM URB,0.36,AC,187000,0,187000,0,0,187000,78000,0,78000,0,0,78000,RPUD,RES/PUD,,,
20801,47-40-1-40-0,7717-72-4282,SNGL FAM URB,0.35,AC,187000,0,187000,0,0,187000,78000,0,78000,0,0,78000,RPUD,RES/PUD,,,
20802,47-40-1-41-0,7717-72-3281,SNGL FAM URB,0.44,AC,187000,0,187000,0,0,187000,78000,0,78000,0,0,78000,RPUD,RES/PUD,,,
20803,47-40-1-42-0,7717-72-3047,SNGL FAM URB,0.45,AC,187000,0,187000,0,0,187000,78000,0,78000,0,0,78000,RPUD,RES/PUD,,,
20804,47-40-1-43-0,7717-71-3927,SNGL FAM URB,0.43,AC,187000,0,187000,0,0,187000,78000,0,78000,0,0,78000,RPUD,RES/PUD,,,
20805,47-40-1-44-0,7717-71-3808,SNGL FAM URB,0.45,AC,187000,0,187000,0,0,187000,78000,0,78000,0,0,78000,RPUD,RES/PUD,,,
20806,47-40-1-45-0,7717-71-2799,SNGL FAM URB,0.44,AC,187000,0,187000,0,0,187000,78000,0,78000,0,0,78000,RPUD,RES/PUD,,,
20807,47-40-1-46-0,7717-71-2780,SNGL FAM URB,0.42,AC,187000,0,187000,0,0,187000,78000,0,78000,0,0,78000,RPUD,RES/PUD,,,
20808,47-40-1-47-0,7717-71-2671,SNGL FAM URB,0.4,AC,187000,0,187000,0,0,187000,78000,0,78000,0,0,78000,RPUD,RES/PUD,,,
20809,47-40-1-48-0,7717-71-2552,SNGL FAM URB,0.41,AC,187000,0,187000,0,0,187000,78000,0,78000,0,0,78000,RPUD,RES/PUD,,,
20810,47-40-1-49-0,7717-71-2424,SNGL FAM URB,0.48,AC,196400,0,196400,0,0,196400,78000,0,78000,0,0,78000,RPUD,RES/PUD,,,
20811,47-40-1-R-0,7717-72-5490,Roads,4.93,AC,0,0,0,0,0,0,0,0,0,0,0,0,RPUD,RES/PUD,,,
20812,47-40-1-A-0,7717-61-6899,Cmn Area/Open Spc,10.01,AC,0,0,0,0,0,0,0,0,0,0,0,0,RPUD,RES/PUD,,,
20813,47-40-1-B-0,7717-72-8735,Cmn Area/Open Spc,11.52,AC,0,0,0,0,0,0,0,0,0,0,0,0,RPUD,RES/PUD,,,
20814,47-40-1-C-0,7717-72-4444,Cmn Area/Open Spc,0.88,AC,0,0,0,0,0,0,0,0,0,0,0,0,RPUD,RES/PUD,,,
20815,47-40-1-D-0,7717-71-1274,Cmn Area/Open Spc,5.24,AC,0,0,0,0,0,0,0,0,0,0,0,0,RPUD,RES/PUD,,,
20816,58-52-3-1-0,7715-33-4062,SNGL FAM SUB,2.291,AC,194900,0,194900,0,0,194900,169400,0,169400,0,0,169400,A2,AG/LTD,,,
20817,58-52-3-2-0,7715-42-0905,SNGL FAM SUB,2.089,AC,196700,0,196700,0,0,196700,171000,0,171000,0,0,171000,A2,AG/LTD,,,
20818,58-52-3-3-0,7715-32-8698,SNGL FAM SUB,4.14,AC,260900,0,260900,0,0,260900,226800,0,226800,0,0,226800,A2,AG/LTD,,,
20819,58-52-3-A-0,7715-33-4280,SNGL FAM SUB,0.225,AC,7000,0,7000,0,0,7000,6100,0,6100,0,0,6100,A2,AG/LTD,,,
20820,3-1-0-5-B,6803-22-2047,MINERALS,0,AC,0,0,0,0,0,0,0,0,0,0,0,0,A1,AG/GEN,,,
20821,42-1-0-99-LH,6767-02-8955,COMM & IND,0,AC,10400,0,10400,0,31800,42200,9900,0,9900,0,32200,42100,B1,BUS/GEN,,,
20823,38-16-0-A-0,6717-14-0620,SNGL FAM SUB,17.134,AC,104900,58100,46800,150000,2400,257300,102500,57500,45000,130700,2400,235600,A1,AG/GEN,,,
20824,38-16-0-1-0,6717-04-8050,SNGL FAM SUB,4.8,AC,56300,53900,2400,0,0,56300,55100,53000,2100,0,0,55100,A1,AG/GEN,,,
20825,38-16-0-2-0,6717-03-7571,SNGL FAM SUB,9.085,AC,76000,71800,4200,0,0,76000,74400,70500,3900,0,0,74400,A1,AG/GEN,,,
20826,63-1-0-2-D,7715-21-7905,Cemetery,0.187,AC,100,0,100,0,0,100,100,0,100,0,0,100,A2,AG/LTD,,,
20827,17-15-0-A-0,6800-69-2824,SNGL FAM SUB,15.95,AC,99300,0,99300,0,0,99300,90300,0,90300,0,0,90300,A1,AG/GEN,,,
20828,17-15-0-B-0,6800-67-7916,AG 20-100 AC,53.87,,161100,136300,24800,0,0,161100,161600,138700,22900,0,0,161600,A1,AG/GEN,,,
20830,44-30-0-1-0,6777-70-1094,SNGL FAM SUB,18.382,AC,299500,0,299500,325600,9000,634100,267700,0,267700,265600,9000,542300,A2,AG/LTD,,,
20831,44-30-0-2-0,6777-70-3748,SNGL FAM SUB,5.328,AC,129800,0,129800,0,0,129800,115800,0,115800,0,0,115800,A2,AG/LTD,,,
20832,44-30-0-3-0,6777-70-7787,SNGL FAM SUB,3.779,,108500,0,108500,0,0,108500,96800,0,96800,0,0,96800,A2,AG/LTD,,,
20833,44-30-0-4-0,6777-70-6056,SNGL FAM SUB,4.844,AC,123100,0,123100,0,0,123100,109900,0,109900,0,0,109900,A2,AG/LTD,,,
20834,44-30-0-5-0,6776-79-5739,SNGL FAM SUB,4.726,AC,121500,0,121500,0,0,121500,108400,0,108400,0,0,108400,A2,AG/LTD,,,
20835,59-3-2-88-A,7726-74-1879,COMM & IND,13,AC,5122000,0,5122000,0,0,5122000,4656600,0,4656600,0,0,4656600,M1,INDUS/L,,,
20837,18-1-0-3-B,6821-02-4995,AG 20-100 AC,26.491,AC,132300,120100,12200,0,0,132300,132500,121200,11300,0,0,132500,A1,AG/GEN,,,
20838,46-14-0-9-A,7718-01-0567,Cemetery,0,AC,100,0,100,0,0,100,,,,,,,A2,AG/LTD,,,
20839,12-1-0-59-F,6832-42-5554,SNGL FAM SUB,4,AC,60800,0,60800,266600,0,327400,,,,,,,A1,AG/GEN,,,
20840,44-1-0-17-B,6787-01-1645,SNGL FAM SUB,3.007,AC,101800,0,101800,0,0,101800,,,,,,,A2,AG/LTD,,,
20841,32-1-0-65-B,6789-40-0959,SNGL FAM SUB,15.301,AC,209800,202400,7400,0,0,209800,,,,,,,A2,AG/LTD,,,
20842,28-1-0-87-M,6739-22-3857,SNGL FAM SUB,12.86,AC,106600,0,106600,0,0,106600,,,,,,,A1,AG/GEN,,,
20843,42-41-1-1-0,6757-96-8542,SNGL FAM URB,0.489,AC,120000,0,120000,0,0,120000,,,,,,,R3,RES/GEN,,,
20844,42-41-1-2-0,6757-96-7650,SNGL FAM URB,0.462,AC,120000,0,120000,0,0,120000,,,,,,,R3,RES/GEN,,,
20845,42-41-1-3-0,6757-96-6678,SNGL FAM URB,0.466,AC,120000,0,120000,0,0,120000,,,,,,,R3,RES/GEN,,,
20846,42-41-1-4-0,6757-96-5522,SNGL FAM URB,0.459,AC,120000,0,120000,0,0,120000,,,,,,,R3,RES/GEN,,,
20847,42-41-1-5-0,6757-96-6414,SNGL FAM URB,0.46,AC,120000,0,120000,0,0,120000,,,,,,,R3,RES/GEN,,,
20848,42-41-1-6-0,6757-96-6395,SNGL FAM URB,0.459,AC,120000,0,120000,583500,2300,705800,,,,,,,R3,RES/GEN,,,
20849,42-41-1-7-0,6757-96-5279,SNGL FAM URB,0.461,AC,120000,0,120000,0,0,120000,,,,,,,R3,RES/GEN,,,
20850,42-41-1-8-0,6757-96-5201,SNGL FAM URB,0.461,AC,120000,0,120000,0,0,120000,,,,,,,R3,RES/GEN,,,
20851,42-41-1-9-0,6757-96-4122,SNGL FAM URB,0.705,AC,150100,0,150100,182100,0,332200,,,,,,,R3,RES/GEN,,,
20852,42-41-1-10-0,6757-96-3032,SNGL FAM URB,0.602,AC,120100,0,120100,0,0,120100,,,,,,,R3,RES/GEN,,,
20853,42-41-1-11-0,6757-95-2808,SNGL FAM URB,0.499,AC,120000,0,120000,0,0,120000,,,,,,,R3,RES/GEN,,,
20854,42-41-1-12-0,6757-95-1812,SNGL FAM URB,0.459,AC,120000,0,120000,0,0,120000,,,,,,,R3,RES/GEN,,,
20855,42-41-1-13-0,6757-95-0735,SNGL FAM URB,0.459,AC,120000,0,120000,0,0,120000,,,,,,,R3,RES/GEN,,,
20856,42-41-1-14-0,6757-95-0477,SNGL FAM URB,0.462,AC,120000,0,120000,0,0,120000,,,,,,,R3,RES/GEN,,,
20857,42-41-1-15-0,6757-95-1565,SNGL FAM URB,0.461,AC,120000,0,120000,0,0,120000,,,,,,,R3,RES/GEN,,,
20858,42-41-1-16-0,6757-95-2696,SNGL FAM URB,0.468,AC,120000,0,120000,0,0,120000,,,,,,,R3,RES/GEN,,,
20859,42-41-1-17-0,6757-95-3774,SNGL FAM URB,0.46,AC,120000,0,120000,0,0,120000,,,,,,,R3,RES/GEN,,,
20860,42-41-1-18-0,6757-95-4863,SNGL FAM URB,0.509,AC,120100,0,120100,0,0,120100,,,,,,,R3,RES/GEN,,,
20861,42-41-1-19-0,6757-95-5984,SNGL FAM URB,0.46,AC,120000,0,120000,0,0,120000,,,,,,,R3,RES/GEN,,,
20862,42-41-1-20-0,6757-96-6061,SNGL FAM URB,0.461,AC,120000,0,120000,0,0,120000,,,,,,,R3,RES/GEN,,,
20863,42-41-1-21-0,6757-96-7038,SNGL FAM URB,0.461,AC,120000,0,120000,0,0,120000,,,,,,,R3,RES/GEN,,,
20864,42-41-1-22-0,6757-96-7199,SNGL FAM URB,0.474,AC,120000,0,120000,0,0,120000,,,,,,,R3,RES/GEN,,,
20865,42-41-1-23-0,6767-05-0803,SNGL FAM URB,0.459,AC,120000,0,120000,0,0,120000,,,,,,,R3,RES/GEN,,,
20866,42-41-1-24-0,6767-05-0639,SNGL FAM URB,0.459,AC,120000,0,120000,0,0,120000,,,,,,,R3,RES/GEN,,,
20867,42-41-1-25-0,6767-05-0537,SNGL FAM URB,0.461,AC,120000,0,120000,0,0,120000,,,,,,,R3,RES/GEN,,,
20868,42-41-1-26-0,6767-05-0406,SNGL FAM URB,0.582,AC,120100,0,120100,0,0,120100,,,,,,,R3,RES/GEN,,,
20869,42-41-1-27-0,6757-95-8493,SNGL FAM URB,0.459,AC,120000,0,120000,0,0,120000,,,,,,,R3,RES/GEN,,,
20870,42-41-1-28-0,6757-95-7470,SNGL FAM URB,0.459,AC,120000,0,120000,0,0,120000,,,,,,,R3,RES/GEN,,,
20871,42-41-1-29-0,6757-95-6339,SNGL FAM URB,0.46,AC,120000,0,120000,0,0,120000,,,,,,,R3,RES/GEN,,,
20884,42-41-1-AR-0,6757-95-2957,SNGL FAM URB,0.207,AC,60000,0,60000,0,0,60000,,,,,,,R3,RES/GEN,,,
20885,43-42-E-1-0,6777-45-6055,SNGL FAM SUB,2,AC,150000,0,150000,0,0,150000,,,,,,,RP,"RURAL,P",,,
20886,43-42-E-2-0,6777-44-8912,SNGL FAM SUB,2,AC,150000,0,150000,0,0,150000,,,,,,,RP,"RURAL,P",,,
20887,43-42-E-3-0,6777-44-9779,SNGL FAM SUB,2,AC,150000,0,150000,0,0,150000,,,,,,,RP,"RURAL,P",,,
20888,43-42-E-4-0,6777-54-1798,SNGL FAM SUB,3.4,AC,150000,0,150000,0,0,150000,,,,,,,RP,"RURAL,P",,,
20889,43-42-E-5-0,6777-54-2571,SNGL FAM SUB,2.78,AC,150000,0,150000,0,0,150000,,,,,,,RP,"RURAL,P",,,
20890,43-42-E-6-0,6777-54-4367,SNGL FAM SUB,2.01,AC,150000,0,150000,0,0,150000,,,,,,,RP,"RURAL,P",,,
20891,43-42-E-7-0,6777-54-6232,SNGL FAM SUB,2.1,AC,150000,0,150000,0,0,150000,,,,,,,RP,"RURAL,P",,,
20892,43-42-E-8-0,6777-53-5976,SNGL FAM SUB,2.01,AC,150000,0,150000,0,0,150000,,,,,,,RP,"RURAL,P",,,
20893,43-42-E-9-0,6777-53-3844,SNGL FAM SUB,2.05,AC,150000,0,150000,0,0,150000,,,,,,,RP,"RURAL,P",,,
20894,43-42-E-10-0,6777-54-1137,SNGL FAM SUB,2.03,AC,150000,0,150000,0,0,150000,,,,,,,RP,"RURAL,P",,,
20895,43-42-E-11-0,6777-54-0010,SNGL FAM SUB,2.04,AC,150000,0,150000,0,0,150000,,,,,,,RP,"RURAL,P",,,
21054,58-54-2-66-0,7725-11-8701,SNGL FAM URB,0.254,AC,145000,0,145000,0,0,145000,,,,,,,RPUD,RES/PUD,,,
21055,27-1-0-7-A,6719-70-2710,Cemetery,0,,100,0,100,0,0,100,,,,,,,A1,AG/GEN,,,
21056,20-5-0-G-2,6840-17-0903,Cemetery,0,AC,100,0,100,0,0,100,,,,,,,A1,AG/GEN,,,
21057,50-11-0-2-0,6716-73-2415,AG > 100 AC,102.6,AC,404600,318000,86600,181700,2000,588300,,,,,,,A1,AG/GEN,,,
21058,50-11-0-1-0,6716-82-0382,AG 20-100 AC,78.09,AC,320200,283800,36400,0,0,320200,,,,,,,A1,AG/GEN,,,
21059,43-1-0-64-D,6778-51-0397,SNGL FAM SUB,2.53,AC,81500,0,81500,0,0,81500,,,,,,,A2,AG/LTD,,,
21060,46-44-0-1-0,7708-70-9127,SNGL FAM SUB,3.258,AC,143900,0,143900,0,0,143900,,,,,,,A2,AG/LTD,,,
21061,46-44-0-2-0,7708-70-8448,SNGL FAM SUB,3,AC,138000,0,138000,0,0,138000,,,,,,,A2,AG/LTD,,,
21062,46-44-0-3-0,7708-70-7809,SNGL FAM SUB,4.838,AC,179900,0,179900,0,0,179900,,,,,,,A2,AG/LTD,,,
21063,51-13-0-1-0,6735-29-9327,SNGL FAM SUB,3.609,AC,53400,0,53400,0,0,53400,,,,,,,A1,AG/GEN,,,
21064,51-13-0-2-0,6735-39-4248,SNGL FAM SUB,3.365,AC,52000,0,52000,0,0,52000,,,,,,,A1,AG/GEN,,,
21065,44-32-0-1-0,6787-23-1018,SNGL FAM SUB,7.33,,157500,0,157500,0,0,157500,,,,,,,A2,AG/LTD,,,
21066,44-32-0-2-0,6787-23-5144,SNGL FAM SUB,7.33,AC,157500,0,157500,0,0,157500,,,,,,,A2,AG/LTD,,,
21067,44-32-0-3-0,6787-21-1705,AG 20-100 AC,47.13,AC,591800,547000,44800,0,0,591800,,,,,,,A2,AG/LTD,,,
21068,44-32-0-4-0,6787-10-7228,AG 20-100 AC,48.3,AC,571700,549400,22300,0,0,571700,,,,,,,A2,AG/LTD,,,
21069,13-11-0-C-1,6831-94-9201,Cemetery,0,AC,100,0,100,0,0,100,,,,,,,A1,AG/GEN,,,
21070,16-10-0-1-0,5891-72-5303,SNGL FAM SUB,17.62,AC,81300,0,81300,0,0,81300,,,,,,,A1,AG/GEN,,,
21071,16-10-0-2-0,5891-71-6898,AG 20-100 AC,21.01,AC,89900,0,89900,0,0,89900,,,,,,,A1,AG/GEN,,,
21072,16-10-0-3-0,5891-71-4298,AG 20-100 AC,36.49,AC,114500,0,114500,0,0,114500,,,,,,,A1,AG/GEN,,,
21073,16-10-0-4-0,5891-70-3536,SNGL FAM SUB,8.65,AC,66300,0,66300,0,0,66300,,,,,,,A1,AG/GEN,,,
21074,16-10-0-5-0,5891-70-4176,SNGL FAM SUB,7.46,AC,62100,0,62100,0,0,62100,,,,,,,A1,AG/GEN,,,
21075,16-10-0-6-0,5890-79-5861,SNGL FAM SUB,8.17,AC,64600,0,64600,0,0,64600,,,,,,,A1,AG/GEN,,,
21076,47-41-0-1-0,7727-34-4371,COMM & IND,10.2,AC,1988600,1983400,5200,0,0,1988600,,,,,,,B1A2,BS AND,,,
21077,47-41-0-2-0,7727-24-6700,COMM & IND,27.577,AC,1771100,0,1771100,0,0,1771100,,,,,,,B1A2,BS AND,,,
21078,48-5-0-1-A1,7728-90-6319,AG 20-100 AC,21.149,AC,2825200,0,2825200,15100,1000,2841300,,,,,,,MULT,MULTI ZONING,,,
21079,57-1-0-79-B2,7706-63-0177,SNGL FAM SUB,3,AC,165000,0,165000,10000,124300,299300,,,,,,,A2,AG/LTD,,,
21080,63-1-0-172-C,7724-32-3725,Cemetery,0,AC,100,0,100,0,0,100,,,,,,,A2,AG/LTD,,,
21081,26-21-0-4-A,6709-94-4513,SNGL FAM SUB,9.952,AC,84000,0,84000,0,0,84000,,,,,,,RR,RES/RUR,,,
21082,55-26-0-A-0,6785-16-9904,SNGL FAM SUB,3.46,AC,104000,0,104000,29300,100,133400,,,,,,,A2,AG/LTD,,,
21083,55-26-0-B-0,6785-27-0227,SNGL FAM SUB,2.1,AC,85300,0,85300,0,0,85300,,,,,,,A2,AG/LTD,,,
21084,58-55-4-1-0,7726-15-3962,SNGL FAM URB,0.26,AC,130000,0,130000,0,0,130000,,,,,,,RPUD,RES/PUD,,,
21085,58-55-4-2-0,7726-15-3969,SNGL FAM URB,0.22,AC,130000,0,130000,0,0,130000,,,,,,,RPUD,RES/PUD,,,
21252,58-54-3-110-0,,SNGL FAM URB,0.089,AC,105000,0,105000,0,0,105000,,,,,,,RPUD,RES/PUD,,,
21253,58-54-3-111-0,,SNGL FAM URB,0.168,AC,115500,0,115500,0,0,115500,,,,,,,RPUD,RES/PUD,,,
21254,58-54-3-112-0,,SNGL FAM URB,0.173,AC,115500,0,115500,0,0,115500,,,,,,,RPUD,RES/PUD,,,
21255,58-54-3-113-0,,SNGL FAM URB,0.093,AC,105000,0,105000,0,0,105000,,,,,,,RPUD,RES/PUD,,,
21256,58-54-3-114-0,,SNGL FAM URB,0.095,AC,105000,0,105000,0,0,105000,,,,,,,RPUD,RES/PUD,,,
21257,58-54-3-115-0,,SNGL FAM URB,0.092,AC,105000,0,105000,0,0,105000,,,,,,,RPUD,RES/PUD,,,
21258,58-54-3-116-0,,SNGL FAM URB,0.09,AC,105000,0,105000,0,0,105000,,,,,,,RPUD,RES/PUD,,,
20896,43-42-E-12-0,6777-44-6351,SNGL FAM SUB,2.01,AC,150000,0,150000,0,0,150000,,,,,,,RP,"RURAL,P",,,
20897,43-42-E-13-0,6777-44-7487,SNGL FAM SUB,2,AC,150000,0,150000,0,0,150000,,,,,,,RP,"RURAL,P",,,
20898,43-42-E-14-0,6777-44-4588,SNGL FAM SUB,2,AC,150000,0,150000,0,0,150000,,,,,,,RP,"RURAL,P",,,
20899,43-42-E-15-0,6777-44-3702,SNGL FAM SUB,2.45,AC,150000,0,150000,0,0,150000,,,,,,,RP,"RURAL,P",,,
20900,12-23-0-D-TW,6831-06-9375,COMM & IND,0,AC,0,0,0,0,178600,178600,,,,,,,A1,AG/GEN,,,
20901,64-3-3-4-A,7724-82-1923,COMM & IND,0,AC,0,0,0,0,11400,11400,0,0,0,0,9500,9500,B1,BUS/GEN,,,
20902,59-1-0-5-B,7726-57-8338,SNGL FAM SUB,0.457,AC,130000,0,130000,0,0,130000,,,,,,,R3,RES/GEN,,,
20903,58-54-2-16-0,7725-21-0800,SNGL FAM URB,0.196,AC,145000,0,145000,0,0,145000,,,,,,,RPUD,RES/PUD,,,
20904,58-54-2-17-0,7725-21-0746,SNGL FAM URB,0.189,AC,145000,0,145000,0,0,145000,,,,,,,RPUD,RES/PUD,,,
20905,58-54-2-18-0,7725-21-0781,SNGL FAM URB,0.187,AC,145000,0,145000,0,0,145000,,,,,,,RPUD,RES/PUD,,,
20906,58-54-2-19-0,7725-21-1626,SNGL FAM URB,0.192,AC,145000,0,145000,0,0,145000,,,,,,,RPUD,RES/PUD,,,
20907,58-54-2-20-0,7725-21-1661,SNGL FAM URB,0.192,AC,145000,0,145000,0,0,145000,,,,,,,RPUD,RES/PUD,,,
20908,58-54-2-21-0,7725-21-2506,SNGL FAM URB,0.188,AC,145000,0,145000,0,0,145000,,,,,,,RPUD,RES/PUD,,,
20909,58-54-2-22-0,7725-21-2531,SNGL FAM URB,0.19,AC,145000,0,145000,0,0,145000,,,,,,,RPUD,RES/PUD,,,
20910,58-54-2-23-0,7725-21-2465,SNGL FAM URB,0.195,AC,145000,0,145000,0,0,145000,,,,,,,RPUD,RES/PUD,,,
20911,58-54-2-24-0,7725-21-2480,SNGL FAM URB,0.194,AC,145000,0,145000,0,0,145000,,,,,,,RPUD,RES/PUD,,,
20912,58-54-2-25-0,7725-21-3323,SNGL FAM URB,0.291,AC,145000,0,145000,0,0,145000,,,,,,,RPUD,RES/PUD,,,
20913,58-54-2-26-0,7725-21-3288,SNGL FAM URB,0.235,AC,145000,0,145000,0,0,145000,,,,,,,RPUD,RES/PUD,,,
20914,58-54-2-27-0,7725-21-4245,SNGL FAM URB,0.23,AC,145000,0,145000,0,0,145000,,,,,,,RPUD,RES/PUD,,,
20915,58-54-2-28-0,7725-21-5214,SNGL FAM URB,0.191,AC,145000,0,145000,0,0,145000,,,,,,,RPUD,RES/PUD,,,
20916,58-54-2-29-0,7725-21-5273,SNGL FAM URB,0.179,AC,145000,0,145000,0,0,145000,,,,,,,RPUD,RES/PUD,,,
20917,58-54-2-30-0,7725-21-6232,SNGL FAM URB,0.179,AC,145000,0,145000,0,0,145000,,,,,,,RPUD,RES/PUD,,,
20918,58-54-2-31-0,7725-21-6291,SNGL FAM URB,0.198,AC,145000,0,145000,0,0,145000,,,,,,,RPUD,RES/PUD,,,
20919,58-54-2-32-0,7725-21-8210,SNGL FAM URB,0.195,AC,145000,0,145000,0,0,145000,,,,,,,RPUD,RES/PUD,,,
20920,58-54-2-33-0,7725-21-8179,SNGL FAM URB,0.179,AC,145000,0,145000,0,0,145000,,,,,,,RPUD,RES/PUD,,,
20921,58-54-2-34-0,7725-21-9138,SNGL FAM URB,0.179,AC,145000,0,145000,0,0,145000,,,,,,,RPUD,RES/PUD,,,
20922,58-54-2-35-0,7725-21-9198,SNGL FAM URB,0.179,AC,145000,0,145000,0,0,145000,,,,,,,RPUD,RES/PUD,,,
20923,58-54-2-36-0,7725-40-0622,SNGL FAM URB,0.195,AC,145000,0,145000,0,0,145000,,,,,,,RPUD,RES/PUD,,,
20924,58-54-2-37-0,7725-40-0681,SNGL FAM URB,0.235,AC,145000,0,145000,0,0,145000,,,,,,,RPUD,RES/PUD,,,
20925,58-54-2-38-0,7725-40-1558,SNGL FAM URB,0.229,AC,145000,0,145000,0,0,145000,,,,,,,RPUD,RES/PUD,,,
20926,58-54-2-39-0,7725-40-2514,SNGL FAM URB,0.235,AC,145000,0,145000,0,0,145000,,,,,,,RPUD,RES/PUD,,,
20927,58-54-2-40-0,7725-40-2570,SNGL FAM URB,0.24,AC,145000,0,145000,0,0,145000,,,,,,,RPUD,RES/PUD,,,
20928,58-54-2-41-0,7725-40-3433,SNGL FAM URB,0.371,AC,145000,0,145000,0,0,145000,,,,,,,RPUD,RES/PUD,,,
20929,58-54-2-42-0,7725-40-4434,SNGL FAM URB,0.303,AC,145000,0,145000,0,0,145000,,,,,,,RPUD,RES/PUD,,,
20930,58-54-2-43-0,7725-40-0490,SNGL FAM URB,0.312,AC,145000,0,145000,0,0,145000,,,,,,,RPUD,RES/PUD,,,
20931,58-54-2-44-0,7725-40-0413,SNGL FAM URB,0.24,AC,145000,0,145000,0,0,145000,,,,,,,RPUD,RES/PUD,,,
20932,58-54-2-45-0,7725-30-9444,SNGL FAM URB,0.239,AC,145000,0,145000,0,0,145000,,,,,,,RPUD,RES/PUD,,,
20933,58-54-2-46-0,7725-30-8475,SNGL FAM URB,0.212,AC,145000,0,145000,0,0,145000,,,,,,,RPUD,RES/PUD,,,
20934,58-54-2-47-0,7725-21-9020,SNGL FAM URB,0.212,AC,145000,0,145000,0,0,145000,,,,,,,RPUD,RES/PUD,,,
20935,58-54-2-48-0,7725-21-8051,SNGL FAM URB,0.212,AC,145000,0,145000,0,0,145000,,,,,,,RPUD,RES/PUD,,,
20936,58-54-2-49-0,7725-21-7091,SNGL FAM URB,0.212,AC,145000,0,145000,0,0,145000,,,,,,,RPUD,RES/PUD,,,
20937,58-54-2-50-0,7725-21-7022,SNGL FAM URB,0.212,AC,145000,0,145000,0,0,145000,,,,,,,RPUD,RES/PUD,,,
20938,58-54-2-51-0,7725-21-6063,SNGL FAM URB,0.212,AC,145000,0,145000,0,0,145000,,,,,,,RPUD,RES/PUD,,,
20939,58-54-2-52-0,7725-21-5094,SNGL FAM URB,0.212,AC,145000,0,145000,0,0,145000,,,,,,,RPUD,RES/PUD,,,
20940,58-54-2-53-0,7725-21-5035,SNGL FAM URB,0.212,AC,145000,0,145000,0,0,145000,,,,,,,RPUD,RES/PUD,,,
20941,58-54-2-54-0,7725-21-4065,SNGL FAM URB,0.222,AC,145000,0,145000,0,0,145000,,,,,,,RPUD,RES/PUD,,,
20942,58-54-2-55-0,7725-21-3096,SNGL FAM URB,0.247,AC,145000,0,145000,0,0,145000,,,,,,,RPUD,RES/PUD,,,
20943,58-54-2-56-0,7725-21-3028,SNGL FAM URB,0.287,AC,145000,0,145000,0,0,145000,,,,,,,RPUD,RES/PUD,,,
20944,58-54-2-58-0,7725-21-1238,SNGL FAM URB,0.247,AC,145000,0,145000,0,0,145000,,,,,,,RPUD,RES/PUD,,,
20945,58-54-2-59-0,7725-21-1304,SNGL FAM URB,0.22,AC,145000,0,145000,0,0,145000,,,,,,,RPUD,RES/PUD,,,
20946,58-54-2-60-0,7725-21-0470,SNGL FAM URB,0.227,AC,145000,0,145000,0,0,145000,,,,,,,RPUD,RES/PUD,,,
20947,58-54-2-61-0,7725-21-0446,SNGL FAM URB,0.235,AC,145000,0,145000,0,0,145000,,,,,,,RPUD,RES/PUD,,,
20948,58-54-2-62-0,7725-21-0501,SNGL FAM URB,0.237,AC,145000,0,145000,0,0,145000,,,,,,,RPUD,RES/PUD,,,
20949,58-54-2-63-0,7725-11-9567,SNGL FAM URB,0.232,AC,145000,0,145000,0,0,145000,,,,,,,RPUD,RES/PUD,,,
20950,58-54-2-64-0,7725-11-9612,SNGL FAM URB,0.226,AC,145000,0,145000,0,0,145000,,,,,,,RPUD,RES/PUD,,,
20951,58-54-2-65-0,7725-11-8666,SNGL FAM URB,0.233,AC,145000,0,145000,0,0,145000,,,,,,,RPUD,RES/PUD,,,
20952,58-54-2-1-A,7725-03-9456,Cmn Area/Open Spc,5.055,AC,0,0,0,0,0,0,,,,,,,RPUD,RES/PUD,,,
20953,58-54-2-2-A,7725-12-2618,Cmn Area/Open Spc,0.35,AC,0,0,0,0,0,0,,,,,,,RPUD,RES/PUD,,,
20954,58-54-2-3-A,7725-12-4162,Cmn Area/Open Spc,0.863,AC,0,0,0,0,0,0,,,,,,,RPUD,RES/PUD,,,
20955,58-54-2-4-A,7725-30-7859,Cmn Area/Open Spc,11.211,AC,0,0,0,0,0,0,,,,,,,RPUD,RES/PUD,,,
20956,58-54-2-5-A,7725-30-8269,Cmn Area/Open Spc,1.251,AC,0,0,0,0,0,0,,,,,,,RPUD,RES/PUD,,,
20957,58-54-2-6-A,7725-30-2880,Cmn Area/Open Spc,2.341,AC,0,0,0,0,0,0,,,,,,,RPUD,RES/PUD,,,
20958,58-54-2-7-A,7725-11-5859,Cmn Area/Open Spc,0.339,AC,0,0,0,0,0,0,,,,,,,RPUD,RES/PUD,,,
20959,58-54-2-8-A,7725-12-1409,Cmn Area/Open Spc,0.478,AC,0,0,0,0,0,0,,,,,,,RPUD,RES/PUD,,,
20960,58-54-2-9-A,7725-02-6994,Cmn Area/Open Spc,0.089,AC,0,0,0,0,0,0,,,,,,,RPUD,RES/PUD,,,
20961,58-54-2-10-A,7725-03-5754,Cmn Area/Open Spc,3.71,AC,0,0,0,0,0,0,,,,,,,RPUD,RES/PUD,,,
20971,42-41-1-R-1,6757-96-9593,Roads,0,AC,0,0,0,0,0,0,,,,,,,R3,RES/GEN,,,
20972,58-54-2-R-0,7725-11-6905,Roads,9.971,AC,0,0,0,0,0,0,,,,,,,RPUD,RES/PUD,,,
20973,31-1-0-59-A,6779-06-6272,SNGL FAM SUB,5.287,AC,113000,0,113000,276200,3800,393000,,,,,,,A2,AG/LTD,,,
20974,43-42-E-A-0,6777-64-2710,Cmn Area/Open Spc,59.18,AC,0,0,0,0,0,0,,,,,,,RP,"RURAL,P",,,
20975,43-42-E-B-0,6777-44-3366,Cmn Area/Open Spc,1.39,AC,0,0,0,0,0,0,,,,,,,RP,"RURAL,P",,,
20976,43-42-E-R-0,6777-44-8294,Roads,2.22,AC,0,0,0,0,0,0,,,,,,,RP,"RURAL,P",,,
20977,4-1-0-21-A,6802-68-4586,AG 20-100 AC,61.66,AC,253400,191700,61700,337800,51100,642300,,,,,,,A1,AG/GEN,,,
20978,4-1-0-21-B,6802-87-0994,SNGL FAM SUB,10.43,AC,77000,0,77000,0,0,77000,,,,,,,A1,AG/GEN,,,
20979,59-1-0-5-A,7726-57-9338,SNGL FAM SUB,0.521,AC,130000,0,130000,0,0,130000,,,,,,,R3,RES/GEN,,,
20980,39-8-0-D-3,6727-25-2385,SNGL FAM SUB,2.377,AC,43800,0,43800,0,0,43800,,,,,,,A1,AG/GEN,,,
20981,1-1-0-30-B,6814-34-1919,SNGL FAM SUB,2.092,AC,45300,0,45300,178600,3500,227400,,,,,,,A1,AG/GEN,,,
20982,17-16-0-1-0,6810-02-9372,AG 20-100 AC,20,AC,109500,0,109500,0,0,109500,,,,,,,A1,AG/GEN,,,
20983,17-16-0-2-0,6810-02-6743,SNGL FAM SUB,9.43,AC,86300,0,86300,0,0,86300,,,,,,,A1,AG/GEN,,,
20984,17-16-0-3-0,6810-03-8060,SNGL FAM SUB,11.15,AC,94800,0,94800,0,0,94800,,,,,,,A1,AG/GEN,,,
20985,17-16-0-4-0,6810-12-8524,SNGL FAM SUB,4.69,AC,61700,0,61700,0,0,61700,,,,,,,A1,AG/GEN,,,
20986,17-16-0-5-0,6810-12-9842,SNGL FAM SUB,5.64,AC,66700,0,66700,0,0,66700,,,,,,,A1,AG/GEN,,,
20987,17-16-0-6-0,6810-13-5290,AG 20-100 AC,20.76,AC,109900,0,109900,0,0,109900,,,,,,,A1,AG/GEN,,,
20988,18-16-0-1-0,6810-77-5303,SNGL FAM SUB,3.1,AC,52600,0,52600,0,0,52600,,,,,,,A1,AG/GEN,,,
20989,18-16-0-2-0,6810-77-8515,SNGL FAM SUB,3.09,AC,52500,0,52500,0,0,52500,,,,,,,A1,AG/GEN,,,
20990,18-16-0-3-0,6810-77-1520,SNGL FAM SUB,3.15,AC,52900,0,52900,0,0,52900,,,,,,,A1,AG/GEN,,,
20991,18-16-0-4-0,6810-67-7983,AG 20-100 AC,20.04,AC,105000,0,105000,0,0,105000,,,,,,,A1,AG/GEN,,,
20992,18-16-0-5-0,6810-77-6833,SNGL FAM SUB,2.28,AC,47700,0,47700,0,0,47700,,,,,,,A1,AG/GEN,,,
20993,1-1-0-2-A2,6805-81-8858,SNGL FAM SUB,8.411,AC,77500,0,77500,0,0,77500,,,,,,,A1,AG/GEN,,,
20994,27-1-0-41-C,6728-05-4644,AG 20-100 AC,28.58,AC,117200,104000,13200,0,0,117200,,,,,,,A1,AG/GEN,,,
20995,48-5-0-1-0,7728-80-1271,AG 20-100 AC,35.855,AC,1263700,1245700,18000,0,13800,1277500,,,,,,,MULT,MULTI ZONING,,,
20996,48-5-0-1-A,7738-00-1929,COMM & IND,19.748,AC,1941200,0,1941200,176900,1000,2119100,,,,,,,RPUD,RES/PUD,,,
20997,63-41-0-6-A,7724-23-3701,SNGL FAM URB,0,,112300,0,112300,420200,0,532500,,,,,,,R3,RES/GEN,,,
20998,63-41-0-6-B,7724-23-3713,SNGL FAM URB,0,,84300,0,84300,376700,0,461000,,,,,,,R3,RES/GEN,,,
20999,63-41-0-6-C,7724-23-3716,SNGL FAM URB,0,,112300,0,112300,420200,0,532500,,,,,,,R3,RES/GEN,,,
21000,64-29-0-1-R,7724-84-5524,Roads,6.855,AC,0,0,0,0,0,0,,,,,,,M1,INDUS/L,,,
21001,64-29-0-2-0,7724-73-4330,COMM & IND,5.838,AC,1294500,0,1294500,0,0,1294500,,,,,,,M1,INDUS/L,,,
21002,64-29-0-3-0,7724-73-3674,COMM & IND,3.987,AC,15200,0,15200,0,0,15200,,,,,,,M1,INDUS/L,,,
21003,64-29-0-4-0,7724-95-7136,COMM & IND,9.858,AC,1314000,0,1314000,0,0,1314000,,,,,,,B1M1,B1M1,,,
21004,64-29-0-5-0,7724-74-4297,COMM & IND,18,AC,8598900,0,8598900,0,0,8598900,,,,,,,M1,INDUS/L,,,
21005,64-29-0-6-0,7724-85-4067,COMM & IND,37.942,AC,7535000,0,7535000,0,0,7535000,,,,,,,M1,INDUS/L,,,
21006,1-1-0-30-C,6814-25-5250,AG 20-100 AC,20.001,AC,122600,113000,9600,0,109600,232200,,,,,,,A1,AG/GEN,,,
21007,44-31-0-1-0,6787-84-0336,SNGL FAM SUB,3.528,AC,110000,0,110000,0,0,110000,,,,,,,A2,AG/LTD,,,
21008,44-31-0-2-0,6787-74-7553,SNGL FAM SUB,3,AC,101700,0,101700,0,0,101700,,,,,,,A2,AG/LTD,,,
21009,44-31-0-3-0,6787-84-2608,SNGL FAM SUB,5.211,AC,136600,0,136600,0,0,136600,,,,,,,A2,AG/LTD,,,
21010,64-29-0-1-R1,7724-72-8914,Roads,0.03,AC,0,0,0,0,0,0,,,,,,,B1,BUS/GEN,,,
21011,64-29-0-1-R2,7724-72-9924,Roads,0.033,AC,0,0,0,0,0,0,,,,,,,B1,BUS/GEN,,,
21012,64-29-0-1-R3,7724-82-0953,Roads,0.034,AC,0,0,0,0,0,0,,,,,,,B1,BUS/GEN,,,
21013,63-42-0-1-0,7714-36-9710,SNGL FAM SUB,3.269,AC,176100,0,176100,0,0,176100,,,,,,,R3,RES/GEN,,,
21014,63-42-0-2-0,7714-46-2677,SNGL FAM SUB,4.308,AC,204100,0,204100,0,0,204100,,,,,,,R3,RES/GEN,,,
21015,63-42-0-3-0,7714-46-5762,SNGL FAM SUB,2.568,AC,157300,0,157300,0,0,157300,,,,,,,R3,RES/GEN,,,
21016,63-42-0-4-0,7714-47-2101,SNGL FAM SUB,4.444,AC,207700,0,207700,357700,26700,592100,,,,,,,R3,RES/GEN,,,
21017,1-1-0-29-A,6814-14-5183,AG 20-100 AC,20,AC,120600,69600,51000,748300,73400,942300,,,,,,,A1,AG/GEN,,,
21018,1-1-0-29-B,6814-05-8104,AG > 100 AC,150.85,AC,509100,437400,71700,0,42400,551500,,,,,,,A1,AG/GEN,,,
21019,1-1-0-29-C,6814-13-0947,Cemetery,0.067,AC,100,0,100,0,0,100,,,,,,,A1,AG/GEN,,,
21020,44-1-0-37-B1,6787-09-0878,SNGL FAM SUB,4.249,AC,107400,0,107400,0,0,107400,,,,,,,A2,AG/LTD,,,
21021,58-54-0-1-A,7725-02-5362,SNGL FAM URB,17.037,AC,1405600,0,1405600,0,0,1405600,,,,,,,RPUD,RES/PUD,,,
21023,58-54-0-3-A,7725-11-8322,SNGL FAM URB,7.761,AC,640300,0,640300,0,0,640300,,,,,,,RPUD,RES/PUD,,,
21024,11-1-0-50-C,6822-31-8193,SNGL FAM SUB,6.895,AC,73600,0,73600,0,0,73600,,,,,,,A1,AG/GEN,,,
21025,58-54-2-1-0,7725-12-0809,SNGL FAM URB,0.199,AC,145000,0,145000,0,0,145000,,,,,,,RPUD,RES/PUD,,,
21026,58-54-2-2-0,7725-12-0855,SNGL FAM URB,0.194,AC,145000,0,145000,0,0,145000,,,,,,,RPUD,RES/PUD,,,
21027,58-54-2-3-0,7725-12-1800,SNGL FAM URB,0.196,AC,145000,0,145000,0,0,145000,,,,,,,RPUD,RES/PUD,,,
21028,58-54-2-4-0,7725-12-1756,SNGL FAM URB,0.194,AC,145000,0,145000,0,0,145000,,,,,,,RPUD,RES/PUD,,,
21029,58-54-2-5-0,7725-12-2559,SNGL FAM URB,0.192,AC,145000,0,145000,0,0,145000,,,,,,,RPUD,RES/PUD,,,
21030,58-54-2-6-0,7725-12-2583,SNGL FAM URB,0.2,AC,145000,0,145000,0,0,145000,,,,,,,RPUD,RES/PUD,,,
21031,58-54-2-7-0,7725-12-3407,SNGL FAM URB,0.199,AC,145000,0,145000,0,0,145000,,,,,,,RPUD,RES/PUD,,,
21032,58-54-2-8-0,7725-12-3411,SNGL FAM URB,0.189,AC,145000,0,145000,0,0,145000,,,,,,,RPUD,RES/PUD,,,
21033,58-54-2-9-0,7725-12-3314,SNGL FAM URB,0.204,AC,145000,0,145000,0,0,145000,,,,,,,RPUD,RES/PUD,,,
21034,58-54-2-10-0,7725-12-6043,SNGL FAM URB,0.179,AC,145000,0,145000,0,0,145000,,,,,,,RPUD,RES/PUD,,,
21035,58-54-2-11-0,7725-12-6090,SNGL FAM URB,0.179,AC,145000,0,145000,0,0,145000,,,,,,,RPUD,RES/PUD,,,
21036,58-54-2-12-0,7725-11-7947,SNGL FAM URB,0.179,AC,145000,0,145000,0,0,145000,,,,,,,RPUD,RES/PUD,,,
21037,58-54-2-13-0,7725-11-8904,SNGL FAM URB,0.18,AC,145000,0,145000,0,0,145000,,,,,,,RPUD,RES/PUD,,,
21038,58-54-2-14-0,7725-11-9808,SNGL FAM URB,0.191,AC,145000,0,145000,0,0,145000,,,,,,,RPUD,RES/PUD,,,
21039,58-54-2-15-0,7725-11-9854,SNGL FAM URB,0.196,AC,145000,0,145000,0,0,145000,,,,,,,RPUD,RES/PUD,,,
21040,58-54-2-69-0,7725-12-0630,SNGL FAM URB,0.24,AC,145000,0,145000,0,0,145000,,,,,,,RPUD,RES/PUD,,,
21041,58-54-2-70-0,7725-02-9686,SNGL FAM URB,0.237,AC,145000,0,145000,0,0,145000,,,,,,,RPUD,RES/PUD,,,
21042,58-54-2-71-0,7725-02-9731,SNGL FAM URB,0.241,AC,145000,0,145000,0,0,145000,,,,,,,RPUD,RES/PUD,,,
21043,58-54-2-72-0,7725-02-8774,SNGL FAM URB,0.242,AC,145000,0,145000,0,0,145000,,,,,,,RPUD,RES/PUD,,,
21044,58-54-2-73-0,7725-02-8718,SNGL FAM URB,0.235,AC,145000,0,145000,0,0,145000,,,,,,,RPUD,RES/PUD,,,
21045,58-54-2-74-0,7725-02-7853,SNGL FAM URB,0.236,AC,145000,0,145000,0,0,145000,,,,,,,RPUD,RES/PUD,,,
21046,58-54-2-75-0,7725-02-7818,SNGL FAM URB,0.228,AC,145000,0,145000,0,0,145000,,,,,,,RPUD,RES/PUD,,,
21047,58-54-2-76-0,7725-03-6047,SNGL FAM URB,0.234,AC,145000,0,145000,0,0,145000,,,,,,,RPUD,RES/PUD,,,
21048,58-54-2-77-0,7725-03-5176,SNGL FAM URB,0.25,AC,145000,0,145000,0,0,145000,,,,,,,RPUD,RES/PUD,,,
21049,58-54-2-78-0,7725-03-5263,SNGL FAM URB,0.237,AC,145000,0,145000,0,0,145000,,,,,,,RPUD,RES/PUD,,,
21050,58-54-2-79-0,7725-03-5360,SNGL FAM URB,0.239,AC,145000,0,145000,0,0,145000,,,,,,,RPUD,RES/PUD,,,
21051,58-54-2-67-0,7725-11-6883,SNGL FAM URB,0.184,AC,145000,0,145000,0,0,145000,,,,,,,RPUD,RES/PUD,,,
21052,58-54-2-68-0,7725-11-5895,SNGL FAM URB,0.179,AC,145000,0,145000,0,0,145000,,,,,,,RPUD,RES/PUD,,,
21053,58-54-2-57-0,7725-21-2166,SNGL FAM URB,0.274,AC,145000,0,145000,0,0,145000,,,,,,,RPUD,RES/PUD,,,
21086,58-55-4-3-0,7726-16-3066,SNGL FAM URB,0.25,AC,130000,0,130000,0,0,130000,,,,,,,RPUD,RES/PUD,,,
21087,58-55-4-4-0,7726-16-3194,SNGL FAM URB,0.3,AC,130000,0,130000,0,0,130000,,,,,,,RPUD,RES/PUD,,,
21088,58-55-4-5-0,7726-16-9049,SNGL FAM URB,0.21,AC,130000,0,130000,0,0,130000,,,,,,,RPUD,RES/PUD,,,
21089,58-55-4-6-0,7726-26-0005,SNGL FAM URB,0.28,AC,130000,0,130000,0,0,130000,,,,,,,RPUD,RES/PUD,,,
21090,58-55-4-7-0,7726-26-0084,SNGL FAM URB,0.3,AC,130000,0,130000,0,0,130000,,,,,,,RPUD,RES/PUD,,,
21091,58-55-4-8-0,7726-25-1907,SNGL FAM URB,0.33,AC,130000,0,130000,0,0,130000,,,,,,,RPUD,RES/PUD,,,
21092,58-55-4-9-0,7726-25-3938,SNGL FAM URB,0.32,AC,130000,0,130000,0,0,130000,,,,,,,RPUD,RES/PUD,,,
21093,58-55-4-10-0,7726-25-4916,SNGL FAM URB,0.22,AC,130000,0,130000,0,0,130000,,,,,,,RPUD,RES/PUD,,,
21094,58-55-4-11-0,7726-26-4145,SNGL FAM URB,0.2,AC,130000,0,130000,0,0,130000,,,,,,,RPUD,RES/PUD,,,
21095,58-55-4-12-0,7726-26-3186,SNGL FAM URB,0.22,AC,130000,0,130000,0,0,130000,,,,,,,RPUD,RES/PUD,,,
21096,58-55-4-13-0,7726-26-3116,SNGL FAM URB,0.26,AC,130000,0,130000,0,0,130000,,,,,,,RPUD,RES/PUD,,,
21097,58-55-4-14-0,7726-26-2147,SNGL FAM URB,0.3,AC,130000,0,130000,0,0,130000,,,,,,,RPUD,RES/PUD,,,
21098,58-55-4-15-0,7726-26-1290,SNGL FAM URB,0.25,AC,130000,0,130000,0,0,130000,,,,,,,RPUD,RES/PUD,,,
21099,58-55-4-16-0,7726-26-1223,SNGL FAM URB,0.22,AC,130000,0,130000,0,0,130000,,,,,,,RPUD,RES/PUD,,,
21100,58-55-4-17-0,7726-26-0265,SNGL FAM URB,0.21,AC,130000,0,130000,0,0,130000,,,,,,,RPUD,RES/PUD,,,
21101,58-55-4-18-0,7726-26-0207,SNGL FAM URB,0.2,AC,130000,0,130000,0,0,130000,,,,,,,RPUD,RES/PUD,,,
21102,58-55-4-19-0,7726-16-9248,SNGL FAM URB,0.2,AC,130000,0,130000,0,0,130000,,,,,,,RPUD,RES/PUD,,,
21103,58-55-4-20-0,7726-16-8370,SNGL FAM URB,0.2,AC,130000,0,130000,0,0,130000,,,,,,,RPUD,RES/PUD,,,
21104,58-55-4-21-0,7726-16-8312,SNGL FAM URB,0.2,AC,130000,0,130000,0,0,130000,,,,,,,RPUD,RES/PUD,,,
21105,58-55-4-22-0,7726-16-7353,SNGL FAM URB,0.2,AC,130000,0,130000,0,0,130000,,,,,,,RPUD,RES/PUD,,,
21106,58-55-4-23-0,7726-16-6385,SNGL FAM URB,0.2,AC,130000,0,130000,0,0,130000,,,,,,,RPUD,RES/PUD,,,
21107,58-55-4-24-0,7726-16-3208,SNGL FAM URB,0.25,AC,130000,0,130000,0,0,130000,,,,,,,RPUD,RES/PUD,,,
21108,58-55-4-25-0,7726-16-2330,SNGL FAM URB,0.22,AC,130000,0,130000,0,0,130000,,,,,,,RPUD,RES/PUD,,,
21109,58-55-4-26-0,7726-16-1360,SNGL FAM URB,0.22,AC,130000,0,130000,0,0,130000,,,,,,,RPUD,RES/PUD,,,
21110,58-55-4-27-0,7726-16-1301,SNGL FAM URB,0.22,AC,130000,0,130000,0,0,130000,,,,,,,RPUD,RES/PUD,,,
21111,58-55-4-28-0,7726-16-0321,SNGL FAM URB,0.27,AC,130000,0,130000,0,0,130000,,,,,,,RPUD,RES/PUD,,,
21112,58-55-4-29-0,7726-16-1412,SNGL FAM URB,0.3,AC,130000,0,130000,0,0,130000,,,,,,,RPUD,RES/PUD,,,
21113,58-55-4-30-0,7726-16-0540,SNGL FAM URB,0.29,AC,130000,0,130000,0,0,130000,,,,,,,RPUD,RES/PUD,,,
21114,58-55-4-31-0,7726-06-9544,SNGL FAM URB,0.39,AC,130000,0,130000,0,0,130000,,,,,,,RPUD,RES/PUD,,,
21115,58-55-4-32-0,7726-06-8561,SNGL FAM URB,0.37,AC,130000,0,130000,0,0,130000,,,,,,,RPUD,RES/PUD,,,
21116,58-55-4-33-0,7726-06-8462,SNGL FAM URB,0.19,AC,130000,0,130000,0,0,130000,,,,,,,RPUD,RES/PUD,,,
21117,58-55-4-34-0,7726-06-8365,SNGL FAM URB,0.22,AC,130000,0,130000,0,0,130000,,,,,,,RPUD,RES/PUD,,,
21118,58-55-4-35-0,7726-06-8258,SNGL FAM URB,0.21,AC,130000,0,130000,0,0,130000,,,,,,,RPUD,RES/PUD,,,
21119,58-55-4-36-0,7726-06-8242,SNGL FAM URB,0.21,AC,130000,0,130000,0,0,130000,,,,,,,RPUD,RES/PUD,,,
21120,58-55-4-37-0,7726-06-8135,SNGL FAM URB,0.21,AC,130000,0,130000,0,0,130000,,,,,,,RPUD,RES/PUD,,,
21121,58-55-4-38-0,7726-06-8026,SNGL FAM URB,0.3,AC,130000,0,130000,0,0,130000,,,,,,,RPUD,RES/PUD,,,
21122,58-55-4-39-0,7726-05-8914,SNGL FAM URB,0.38,AC,130000,0,130000,0,0,130000,,,,,,,RPUD,RES/PUD,,,
21123,58-55-4-40-0,7726-05-9901,SNGL FAM URB,0.3,AC,130000,0,130000,0,0,130000,,,,,,,RPUD,RES/PUD,,,
21124,58-55-4-41-0,7726-15-0914,SNGL FAM URB,0.31,AC,130000,0,130000,0,0,130000,,,,,,,RPUD,RES/PUD,,,
21125,58-55-4-42-0,7726-16-0031,SNGL FAM URB,0.2,AC,130000,0,130000,0,0,130000,,,,,,,RPUD,RES/PUD,,,
21126,58-55-4-43-0,7726-16-0038,SNGL FAM URB,0.23,AC,130000,0,130000,0,0,130000,,,,,,,RPUD,RES/PUD,,,
21127,58-55-4-44-0,7726-16-0135,SNGL FAM URB,0.25,AC,130000,0,130000,0,0,130000,,,,,,,RPUD,RES/PUD,,,
21128,58-55-4-45-0,7726-16-1184,SNGL FAM URB,0.25,AC,130000,0,130000,0,0,130000,,,,,,,RPUD,RES/PUD,,,
21129,58-55-4-46-0,7726-16-1077,SNGL FAM URB,0.23,AC,130000,0,130000,0,0,130000,,,,,,,RPUD,RES/PUD,,,
21130,58-55-4-47-0,7726-16-1070,SNGL FAM URB,0.22,AC,130000,0,130000,0,0,130000,,,,,,,RPUD,RES/PUD,,,
21131,58-55-4-48-0,7726-15-1964,SNGL FAM URB,0.23,AC,130000,0,130000,0,0,130000,,,,,,,RPUD,RES/PUD,,,
21132,58-55-4-49-0,7726-15-1867,SNGL FAM URB,0.24,AC,130000,0,130000,0,0,130000,,,,,,,RPUD,RES/PUD,,,
21133,58-55-4-R-0,7726-16-6276,Roads,3.45,AC,0,0,0,0,0,0,,,,,,,RPUD,RES/PUD,,,
21134,58-55-4-A-0,7726-16-7001,Cmn Area/Open Spc,4.65,AC,0,0,0,0,0,0,,,,,,,RPUD,RES/PUD,,,
21135,58-55-4-B-0,7726-25-3896,Cmn Area/Open Spc,0.08,AC,0,0,0,0,0,0,,,,,,,RPUD,RES/PUD,,,
21136,58-55-4-C-0,7726-16-5471,Cmn Area/Open Spc,6.06,AC,0,0,0,0,0,0,,,,,,,RPUD,RES/PUD,,,
21137,13-24-0-27-0,6842-95-2588,SNGL FAM SUB,4.721,AC,65200,0,65200,0,0,65200,,,,,,,A1,AG/GEN,,,
21138,13-24-0-28-0,6842-95-5433,SNGL FAM SUB,2.261,AC,59300,0,59300,0,0,59300,,,,,,,A1,AG/GEN,,,
21139,13-24-0-29-0,6842-95-7302,SNGL FAM SUB,2.186,AC,59300,0,59300,0,0,59300,,,,,,,A1,AG/GEN,,,
21140,13-24-0-30-0,6842-95-8271,SNGL FAM SUB,2.095,AC,59300,0,59300,0,0,59300,,,,,,,A1,AG/GEN,,,
21141,12-1-0-76-B,6831-62-8587,SNGL FAM SUB,2.855,AC,60200,0,60200,105400,1000,166600,,,,,,,A1,AG/GEN,,,
21142,32-1-0-14-C,6779-62-9818,Cemetery,0,AC,100,0,100,0,0,100,,,,,,,A2,AG/LTD,,,
21143,58-54-3-1-0,,SNGL FAM URB,0.153,AC,115500,0,115500,0,0,115500,,,,,,,RPUD,RES/PUD,,,
21144,58-54-3-2-0,,SNGL FAM URB,0.09,AC,105000,0,105000,0,0,105000,,,,,,,RPUD,RES/PUD,,,
21145,58-54-3-3-0,,SNGL FAM URB,0.092,AC,105000,0,105000,0,0,105000,,,,,,,RPUD,RES/PUD,,,
21146,58-54-3-4-0,,SNGL FAM URB,0.191,AC,115500,0,115500,0,0,115500,,,,,,,RPUD,RES/PUD,,,
21147,58-54-3-5-0,,SNGL FAM URB,0.148,AC,115500,0,115500,0,0,115500,,,,,,,RPUD,RES/PUD,,,
21148,58-54-3-6-0,,SNGL FAM URB,0.087,AC,105000,0,105000,0,0,105000,,,,,,,RPUD,RES/PUD,,,
21149,58-54-3-7-0,,SNGL FAM URB,0.087,AC,105000,0,105000,0,0,105000,,,,,,,RPUD,RES/PUD,,,
21150,58-54-3-8-0,,SNGL FAM URB,0.087,AC,105000,0,105000,0,0,105000,,,,,,,RPUD,RES/PUD,,,
21151,58-54-3-9-0,,SNGL FAM URB,0.087,AC,105000,0,105000,0,0,105000,,,,,,,RPUD,RES/PUD,,,
21152,58-54-3-10-0,,SNGL FAM URB,0.214,AC,115500,0,115500,0,0,115500,,,,,,,RPUD,RES/PUD,,,
21153,58-54-3-11-0,,SNGL FAM URB,0.192,AC,115500,0,115500,0,0,115500,,,,,,,RPUD,RES/PUD,,,
21154,58-54-3-12-0,,SNGL FAM URB,0.088,AC,105000,0,105000,0,0,105000,,,,,,,RPUD,RES/PUD,,,
21155,58-54-3-13-0,,SNGL FAM URB,0.101,AC,105000,0,105000,0,0,105000,,,,,,,RPUD,RES/PUD,,,
21156,58-54-3-14-0,,SNGL FAM URB,0.101,AC,105000,0,105000,0,0,105000,,,,,,,RPUD,RES/PUD,,,
21157,58-54-3-15-0,,SNGL FAM URB,0.088,AC,105000,0,105000,0,0,105000,,,,,,,RPUD,RES/PUD,,,
21158,58-54-3-16-0,,SNGL FAM URB,0.138,AC,115500,0,115500,0,0,115500,,,,,,,RPUD,RES/PUD,,,
21159,58-54-3-17-0,,SNGL FAM URB,0.148,AC,115500,0,115500,0,0,115500,,,,,,,RPUD,RES/PUD,,,
21160,58-54-3-18-0,,SNGL FAM URB,0.089,AC,105000,0,105000,0,0,105000,,,,,,,RPUD,RES/PUD,,,
21161,58-54-3-19-0,,SNGL FAM URB,0.102,AC,105000,0,105000,0,0,105000,,,,,,,RPUD,RES/PUD,,,
21162,58-54-3-20-0,,SNGL FAM URB,0.101,AC,105000,0,105000,0,0,105000,,,,,,,RPUD,RES/PUD,,,
21163,58-54-3-21-0,,SNGL FAM URB,0.087,AC,105000,0,105000,0,0,105000,,,,,,,RPUD,RES/PUD,,,
21164,58-54-3-22-0,,SNGL FAM URB,0.139,AC,115500,0,115500,0,0,115500,,,,,,,RPUD,RES/PUD,,,
21165,58-54-3-23-0,,SNGL FAM URB,0.177,AC,115500,0,115500,0,0,115500,,,,,,,RPUD,RES/PUD,,,
21166,58-54-3-24-0,,SNGL FAM URB,0.102,AC,105000,0,105000,0,0,105000,,,,,,,RPUD,RES/PUD,,,
21167,58-54-3-25-0,,SNGL FAM URB,0.173,AC,115500,0,115500,0,0,115500,,,,,,,RPUD,RES/PUD,,,
21168,58-54-3-26-0,,SNGL FAM URB,0.137,AC,115500,0,115500,0,0,115500,,,,,,,RPUD,RES/PUD,,,
21169,58-54-3-27-0,,SNGL FAM URB,0.087,AC,105000,0,105000,0,0,105000,,,,,,,RPUD,RES/PUD,,,
21170,58-54-3-28-0,,SNGL FAM URB,0.195,AC,115500,0,115500,0,0,115500,,,,,,,RPUD,RES/PUD,,,
21171,58-54-3-29-0,,SNGL FAM URB,0.189,AC,115500,0,115500,0,0,115500,,,,,,,RPUD,RES/PUD,,,
21172,58-54-3-30-0,,SNGL FAM URB,0.117,AC,105000,0,105000,0,0,105000,,,,,,,RPUD,RES/PUD,,,
21173,58-54-3-31-0,,SNGL FAM URB,0.123,AC,105000,0,105000,0,0,105000,,,,,,,RPUD,RES/PUD,,,
21174,58-54-3-32-0,,SNGL FAM URB,0.104,AC,105000,0,105000,0,0,105000,,,,,,,RPUD,RES/PUD,,,
21175,58-54-3-33-0,,SNGL FAM URB,0.089,AC,105000,0,105000,0,0,105000,,,,,,,RPUD,RES/PUD,,,
21176,58-54-3-34-0,,SNGL FAM URB,0.183,AC,115500,0,115500,0,0,115500,,,,,,,RPUD,RES/PUD,,,
21177,58-54-3-35-0,,SNGL FAM URB,0.173,AC,115500,0,115500,0,0,115500,,,,,,,RPUD,RES/PUD,,,
21178,58-54-3-36-0,,SNGL FAM URB,0.089,AC,105000,0,105000,0,0,105000,,,,,,,RPUD,RES/PUD,,,
21179,58-54-3-37-0,,SNGL FAM URB,0.101,AC,105000,0,105000,0,0,105000,,,,,,,RPUD,RES/PUD,,,
21180,58-54-3-38-0,,SNGL FAM URB,0.11,AC,105000,0,105000,0,0,105000,,,,,,,RPUD,RES/PUD,,,
21181,58-54-3-39-0,,SNGL FAM URB,0.096,AC,105000,0,105000,0,0,105000,,,,,,,RPUD,RES/PUD,,,
21182,58-54-3-40-0,,SNGL FAM URB,0.145,AC,115500,0,115500,0,0,115500,,,,,,,RPUD,RES/PUD,,,
21183,58-54-3-41-0,,SNGL FAM URB,0.14,AC,115500,0,115500,0,0,115500,,,,,,,RPUD,RES/PUD,,,
21184,58-54-3-42-0,,SNGL FAM URB,0.099,AC,105000,0,105000,0,0,105000,,,,,,,RPUD,RES/PUD,,,
21185,58-54-3-43-0,,SNGL FAM URB,0.086,AC,105000,0,105000,0,0,105000,,,,,,,RPUD,RES/PUD,,,
21186,58-54-3-44-0,,SNGL FAM URB,0.098,AC,105000,0,105000,0,0,105000,,,,,,,RPUD,RES/PUD,,,
21187,58-54-3-45-0,,SNGL FAM URB,0.134,AC,115500,0,115500,0,0,115500,,,,,,,RPUD,RES/PUD,,,
21188,58-54-3-46-0,,SNGL FAM URB,0.133,AC,115500,0,115500,0,0,115500,,,,,,,RPUD,RES/PUD,,,
21189,58-54-3-47-0,,SNGL FAM URB,0.097,AC,105000,0,105000,0,0,105000,,,,,,,RPUD,RES/PUD,,,
21190,58-54-3-48-0,,SNGL FAM URB,0.085,AC,105000,0,105000,0,0,105000,,,,,,,RPUD,RES/PUD,,,
21191,58-54-3-49-0,,SNGL FAM URB,0.099,AC,105000,0,105000,0,0,105000,,,,,,,RPUD,RES/PUD,,,
21192,58-54-3-50-0,,SNGL FAM URB,0.159,AC,115500,0,115500,0,0,115500,,,,,,,RPUD,RES/PUD,,,
21193,58-54-3-51-0,,SNGL FAM URB,0.168,AC,115500,0,115500,0,0,115500,,,,,,,RPUD,RES/PUD,,,
21194,58-54-3-52-0,,SNGL FAM URB,0.112,AC,105000,0,105000,0,0,105000,,,,,,,RPUD,RES/PUD,,,
21195,58-54-3-53-0,,SNGL FAM URB,0.098,AC,105000,0,105000,0,0,105000,,,,,,,RPUD,RES/PUD,,,
21196,58-54-3-54-0,,SNGL FAM URB,0.111,AC,105000,0,105000,0,0,105000,,,,,,,RPUD,RES/PUD,,,
21197,58-54-3-55-0,,SNGL FAM URB,0.148,AC,115500,0,115500,0,0,115500,,,,,,,RPUD,RES/PUD,,,
21198,58-54-3-56-0,,SNGL FAM URB,0.143,AC,115500,0,115500,0,0,115500,,,,,,,RPUD,RES/PUD,,,
21199,58-54-3-57-0,,SNGL FAM URB,0.102,AC,105000,0,105000,0,0,105000,,,,,,,RPUD,RES/PUD,,,
21200,58-54-3-58-0,,SNGL FAM URB,0.088,AC,105000,0,105000,0,0,105000,,,,,,,RPUD,RES/PUD,,,
21201,58-54-3-59-0,,SNGL FAM URB,0.1,AC,105000,0,105000,0,0,105000,,,,,,,RPUD,RES/PUD,,,
21202,58-54-3-60-0,,SNGL FAM URB,0.153,AC,115500,0,115500,0,0,115500,,,,,,,RPUD,RES/PUD,,,
21203,58-54-3-61-0,,SNGL FAM URB,0.165,AC,115500,0,115500,0,0,115500,,,,,,,RPUD,RES/PUD,,,
21204,58-54-3-62-0,,SNGL FAM URB,0.089,AC,105000,0,105000,0,0,105000,,,,,,,RPUD,RES/PUD,,,
21205,58-54-3-63-0,,SNGL FAM URB,0.091,AC,105000,0,105000,0,0,105000,,,,,,,RPUD,RES/PUD,,,
21206,58-54-3-64-0,,SNGL FAM URB,0.092,AC,105000,0,105000,0,0,105000,,,,,,,RPUD,RES/PUD,,,
21207,58-54-3-65-0,,SNGL FAM URB,0.094,AC,105000,0,105000,0,0,105000,,,,,,,RPUD,RES/PUD,,,
21208,58-54-3-66-0,,SNGL FAM URB,0.153,AC,115500,0,115500,0,0,115500,,,,,,,RPUD,RES/PUD,,,
21209,58-54-3-67-0,,SNGL FAM URB,0.159,AC,115500,0,115500,0,0,115500,,,,,,,RPUD,RES/PUD,,,
21210,58-54-3-68-0,,SNGL FAM URB,0.096,AC,105000,0,105000,0,0,105000,,,,,,,RPUD,RES/PUD,,,
21211,58-54-3-69-0,,SNGL FAM URB,0.102,AC,105000,0,105000,0,0,105000,,,,,,,RPUD,RES/PUD,,,
21212,58-54-3-70-0,,SNGL FAM URB,0.093,AC,105000,0,105000,0,0,105000,,,,,,,RPUD,RES/PUD,,,
21213,58-54-3-71-0,,SNGL FAM URB,0.208,AC,115500,0,115500,0,0,115500,,,,,,,RPUD,RES/PUD,,,
21214,58-54-3-72-0,,SNGL FAM URB,0.18,AC,115500,0,115500,0,0,115500,,,,,,,RPUD,RES/PUD,,,
21215,58-54-3-73-0,,SNGL FAM URB,0.1,AC,105000,0,105000,0,0,105000,,,,,,,RPUD,RES/PUD,,,
21216,58-54-3-74-0,,SNGL FAM URB,0.097,AC,105000,0,105000,0,0,105000,,,,,,,RPUD,RES/PUD,,,
21217,58-54-3-75-0,,SNGL FAM URB,0.17,AC,115500,0,115500,0,0,115500,,,,,,,RPUD,RES/PUD,,,
21218,58-54-3-76-0,,SNGL FAM URB,0.137,AC,115500,0,115500,0,0,115500,,,,,,,RPUD,RES/PUD,,,
21219,58-54-3-77-0,,SNGL FAM URB,0.088,AC,105000,0,105000,0,0,105000,,,,,,,RPUD,RES/PUD,,,
21220,58-54-3-78-0,,SNGL FAM URB,0.101,AC,105000,0,105000,0,0,105000,,,,,,,RPUD,RES/PUD,,,
21221,58-54-3-79-0,,SNGL FAM URB,0.101,AC,105000,0,105000,0,0,105000,,,,,,,RPUD,RES/PUD,,,
21222,58-54-3-80-0,,SNGL FAM URB,0.1,AC,105000,0,105000,0,0,105000,,,,,,,RPUD,RES/PUD,,,
21223,58-54-3-81-0,,SNGL FAM URB,0.087,AC,105000,0,105000,0,0,105000,,,,,,,RPUD,RES/PUD,,,
21224,58-54-3-82-0,,SNGL FAM URB,0.194,AC,115500,0,115500,0,0,115500,,,,,,,RPUD,RES/PUD,,,
21225,58-54-3-83-0,,SNGL FAM URB,0.141,AC,115500,0,115500,0,0,115500,,,,,,,RPUD,RES/PUD,,,
21226,58-54-3-84-0,,SNGL FAM URB,0.086,AC,105000,0,105000,0,0,105000,,,,,,,RPUD,RES/PUD,,,
21227,58-54-3-85-0,,SNGL FAM URB,0.099,AC,105000,0,105000,0,0,105000,,,,,,,RPUD,RES/PUD,,,
21228,58-54-3-86-0,,SNGL FAM URB,0.099,AC,105000,0,105000,0,0,105000,,,,,,,RPUD,RES/PUD,,,
21229,58-54-3-87-0,,SNGL FAM URB,0.087,AC,105000,0,105000,0,0,105000,,,,,,,RPUD,RES/PUD,,,
21230,58-54-3-88-0,,SNGL FAM URB,0.136,AC,115500,0,115500,0,0,115500,,,,,,,RPUD,RES/PUD,,,
21231,58-54-3-89-0,,SNGL FAM URB,0.136,AC,115500,0,115500,0,0,115500,,,,,,,RPUD,RES/PUD,,,
21232,58-54-3-90-0,,SNGL FAM URB,0.099,AC,105000,0,105000,0,0,105000,,,,,,,RPUD,RES/PUD,,,
21233,58-54-3-91-0,,SNGL FAM URB,0.087,AC,105000,0,105000,0,0,105000,,,,,,,RPUD,RES/PUD,,,
21234,58-54-3-92-0,,SNGL FAM URB,0.099,AC,105000,0,105000,0,0,105000,,,,,,,RPUD,RES/PUD,,,
21235,58-54-3-93-0,,SNGL FAM URB,0.137,AC,115500,0,115500,0,0,115500,,,,,,,RPUD,RES/PUD,,,
21236,58-54-3-94-0,,SNGL FAM URB,0.133,AC,115500,0,115500,0,0,115500,,,,,,,RPUD,RES/PUD,,,
21237,58-54-3-95-0,,SNGL FAM URB,0.086,AC,105000,0,105000,0,0,105000,,,,,,,RPUD,RES/PUD,,,
21238,58-54-3-96-0,,SNGL FAM URB,0.087,AC,105000,0,105000,0,0,105000,,,,,,,RPUD,RES/PUD,,,
21239,58-54-3-97-0,,SNGL FAM URB,0.088,AC,105000,0,105000,0,0,105000,,,,,,,RPUD,RES/PUD,,,
21240,58-54-3-98-0,,SNGL FAM URB,0.091,AC,105000,0,105000,0,0,105000,,,,,,,RPUD,RES/PUD,,,
21241,58-54-3-99-0,,SNGL FAM URB,0.145,AC,115500,0,115500,0,0,115500,,,,,,,RPUD,RES/PUD,,,
21242,58-54-3-100-0,,SNGL FAM URB,0.144,AC,115500,0,115500,0,0,115500,,,,,,,RPUD,RES/PUD,,,
21243,58-54-3-101-0,,SNGL FAM URB,0.089,AC,105000,0,105000,0,0,105000,,,,,,,RPUD,RES/PUD,,,
21244,58-54-3-102-0,,SNGL FAM URB,0.087,AC,105000,0,105000,0,0,105000,,,,,,,RPUD,RES/PUD,,,
21245,58-54-3-103-0,,SNGL FAM URB,0.088,AC,105000,0,105000,0,0,105000,,,,,,,RPUD,RES/PUD,,,
21246,58-54-3-104-0,,SNGL FAM URB,0.088,AC,105000,0,105000,0,0,105000,,,,,,,RPUD,RES/PUD,,,
21247,58-54-3-105-0,,SNGL FAM URB,0.138,AC,115500,0,115500,0,0,115500,,,,,,,RPUD,RES/PUD,,,
21248,58-54-3-106-0,,SNGL FAM URB,0.138,AC,115500,0,115500,0,0,115500,,,,,,,RPUD,RES/PUD,,,
21249,58-54-3-107-0,,SNGL FAM URB,0.088,AC,105000,0,105000,0,0,105000,,,,,,,RPUD,RES/PUD,,,
21250,58-54-3-108-0,,SNGL FAM URB,0.088,AC,105000,0,105000,0,0,105000,,,,,,,RPUD,RES/PUD,,,
21251,58-54-3-109-0,,SNGL FAM URB,0.088,AC,105000,0,105000,0,0,105000,,,,,,,RPUD,RES/PUD,,,
21259,58-54-3-117-0,,SNGL FAM URB,0.18,AC,115500,0,115500,0,0,115500,,,,,,,RPUD,RES/PUD,,,
21260,58-54-3-118-0,,SNGL FAM URB,0.138,AC,115500,0,115500,0,0,115500,,,,,,,RPUD,RES/PUD,,,
21261,58-54-3-119-0,,SNGL FAM URB,0.086,AC,105000,0,105000,0,0,105000,,,,,,,RPUD,RES/PUD,,,
21262,58-54-3-120-0,,SNGL FAM URB,0.087,AC,105000,0,105000,0,0,105000,,,,,,,RPUD,RES/PUD,,,
21263,58-54-3-121-0,,SNGL FAM URB,0.154,AC,115500,0,115500,0,0,115500,,,,,,,RPUD,RES/PUD,,,
21264,58-54-3-122-0,,SNGL FAM URB,0.191,AC,115500,0,115500,0,0,115500,,,,,,,RPUD,RES/PUD,,,
21265,58-54-3-123-0,,SNGL FAM URB,0.087,AC,105000,0,105000,0,0,105000,,,,,,,RPUD,RES/PUD,,,
21266,58-54-3-124-0,,SNGL FAM URB,0.087,AC,105000,0,105000,0,0,105000,,,,,,,RPUD,RES/PUD,,,
21267,58-54-3-125-0,,SNGL FAM URB,0.129,AC,115500,0,115500,0,0,115500,,,,,,,RPUD,RES/PUD,,,
21268,58-54-3-126-0,,SNGL FAM URB,0.135,AC,115500,0,115500,0,0,115500,,,,,,,RPUD,RES/PUD,,,
21269,58-54-3-127-0,,SNGL FAM URB,0.089,AC,105000,0,105000,0,0,105000,,,,,,,RPUD,RES/PUD,,,
21270,58-54-3-128-0,,SNGL FAM URB,0.088,AC,105000,0,105000,0,0,105000,,,,,,,RPUD,RES/PUD,,,
21271,58-54-3-129-0,,SNGL FAM URB,0.088,AC,105000,0,105000,0,0,105000,,,,,,,RPUD,RES/PUD,,,
21272,58-54-3-130-0,,SNGL FAM URB,0.087,AC,105000,0,105000,0,0,105000,,,,,,,RPUD,RES/PUD,,,
21273,58-54-3-131-0,,SNGL FAM URB,0.137,AC,115500,0,115500,0,0,115500,,,,,,,RPUD,RES/PUD,,,
21274,58-54-3-132-0,,SNGL FAM URB,0.137,AC,115500,0,115500,0,0,115500,,,,,,,RPUD,RES/PUD,,,
21275,58-54-3-133-0,,SNGL FAM URB,0.087,AC,105000,0,105000,0,0,105000,,,,,,,RPUD,RES/PUD,,,
21276,58-54-3-134-0,,SNGL FAM URB,0.087,AC,105000,0,105000,0,0,105000,,,,,,,RPUD,RES/PUD,,,
21277,58-54-3-135-0,,SNGL FAM URB,0.087,AC,105000,0,105000,0,0,105000,,,,,,,RPUD,RES/PUD,,,
21278,58-54-3-136-0,,SNGL FAM URB,0.087,AC,105000,0,105000,0,0,105000,,,,,,,RPUD,RES/PUD,,,
21279,58-54-3-137-0,,SNGL FAM URB,0.136,AC,115500,0,115500,0,0,115500,,,,,,,RPUD,RES/PUD,,,
21280,58-54-3-138-0,,SNGL FAM URB,0.157,AC,115500,0,115500,0,0,115500,,,,,,,RPUD,RES/PUD,,,
21281,58-54-3-139-0,,SNGL FAM URB,0.087,AC,105000,0,105000,0,0,105000,,,,,,,RPUD,RES/PUD,,,
21282,58-54-3-140-0,,SNGL FAM URB,0.088,AC,105000,0,105000,0,0,105000,,,,,,,RPUD,RES/PUD,,,
21283,58-54-3-141-0,,SNGL FAM URB,0.088,AC,105000,0,105000,0,0,105000,,,,,,,RPUD,RES/PUD,,,
21284,58-54-3-142-0,,SNGL FAM URB,0.087,AC,105000,0,105000,0,0,105000,,,,,,,RPUD,RES/PUD,,,
21285,58-54-3-143-0,,SNGL FAM URB,0.136,AC,115500,0,115500,0,0,115500,,,,,,,RPUD,RES/PUD,,,
21286,58-54-3-144-0,,SNGL FAM URB,0.156,AC,115500,0,115500,0,0,115500,,,,,,,RPUD,RES/PUD,,,
21287,58-54-3-145-0,,SNGL FAM URB,0.085,AC,105000,0,105000,0,0,105000,,,,,,,RPUD,RES/PUD,,,
21288,58-54-3-146-0,,SNGL FAM URB,0.085,AC,105000,0,105000,0,0,105000,,,,,,,RPUD,RES/PUD,,,
21289,58-54-3-147-0,,SNGL FAM URB,0.087,AC,105000,0,105000,0,0,105000,,,,,,,RPUD,RES/PUD,,,
21290,58-54-3-148-0,,SNGL FAM URB,0.089,AC,105000,0,105000,0,0,105000,,,,,,,RPUD,RES/PUD,,,
21291,58-54-3-149-0,,SNGL FAM URB,0.136,AC,115500,0,115500,0,0,115500,,,,,,,RPUD,RES/PUD,,,
21292,58-54-3-1-A,,Cmn Area/Open Spc,0.299,AC,0,0,0,0,0,0,,,,,,,RPUD,RES/PUD,,,
21293,58-54-3-2-A,,Cmn Area/Open Spc,0.078,AC,0,0,0,0,0,0,,,,,,,RPUD,RES/PUD,,,
21294,58-54-3-3-A,,Cmn Area/Open Spc,0.137,AC,0,0,0,0,0,0,,,,,,,RPUD,RES/PUD,,,
21295,58-54-3-4-A,,Cmn Area/Open Spc,0.523,AC,0,0,0,0,0,0,,,,,,,RPUD,RES/PUD,,,
21296,58-54-3-5-A,,Cmn Area/Open Spc,0.271,AC,0,0,0,0,0,0,,,,,,,RPUD,RES/PUD,,,
21297,58-54-3-6-A,,Cmn Area/Open Spc,4.295,AC,0,0,0,0,0,0,,,,,,,RPUD,RES/PUD,,,
21298,58-54-3-7-A,,Cmn Area/Open Spc,0.027,AC,0,0,0,0,0,0,,,,,,,RPUD,RES/PUD,,,
21299,58-54-3-1-RW,,Roads,4.068,AC,0,0,0,0,0,0,,,,,,,RPUD,RES/PUD,,,
21300,17-1-0-86-K,6719-17-5267,SNGL FAM SUB,10,AC,81100,0,81100,0,0,81100,,,,,,,A1,AG/GEN,,,
21301,17-1-0-86-L,6719-26-5973,SNGL FAM SUB,10,AC,81100,0,81100,0,0,81100,,,,,,,A1,AG/GEN,,,
